ibge,anomes,bpc_ben,bpc_pcd_ben,bpc_idoso_ben,bpc_pcd_val,bpc_idoso_val,bpc_val
110001,202001,503,402,101,418717,104939.78,523656.78
110002,202001,2753,1692,1061,1760069.21,1105500.09,2865569.30
110003,202001,87,73,14,75847,14546,90393
110004,202001,1989,1297,692,1347585.88,721066.19,2068652.07
110005,202001,445,355,90,369885.48,93510,463395.48
110006,202001,446,346,100,359494.7,103900,463394.7
110007,202001,67,57,10,59223,10390,69613
110008,202001,238,135,103,140265,107017,247282
110009,202001,851,604,247,628596.56,257673.19,886269.75
110010,202001,1772,1081,691,1123161.73,718989.56,1842151.29
110011,202001,1808,1412,396,1467074.24,412486.12,1879560.36
110012,202001,4123,2408,1715,2506072.68,1786047.16,4292119.84
110013,202001,766,609,157,633791.56,163127.68,796919.24
110014,202001,379,328,51,341831.7,52989,394820.7
110015,202001,1395,1125,270,1170960.38,280533.04,1451493.42
110018,202001,1098,685,413,711718.12,430150.67,1141868.79
110020,202001,15534,8991,6543,9355197.75,6808609.87,16163807.62
110025,202001,620,460,160,478980.48,168319.95,647300.43
110026,202001,35,27,8,28053,8312,36365
110028,202001,1649,1202,447,1250959.64,466513.88,1717473.52
110029,202001,137,126,11,130914,11429,142343
110030,202001,2430,1639,791,1703795.66,821853.67,2525649.33
110032,202001,299,229,70,238970.28,72730.19,311700.47
110033,202001,661,487,174,505995.82,180787.17,686782.99
110034,202001,359,266,93,277413.96,96627.78,374041.74
110037,202001,97,86,11,89354,12468,101822
110040,202001,372,256,116,265984,120524,386508
110045,202001,922,636,286,660809.22,297157.92,957967.14
110050,202001,89,79,10,82081.7,10390,92471.7
110060,202001,72,41,31,42599,32209,74808
110070,202001,110,70,40,72730,41560.7,114290.7
110080,202001,432,245,187,254556.56,194293,448849.56
110090,202001,28,23,5,23897,5195,29092
110092,202001,100,53,47,55067,48833,103900
110094,202001,190,139,51,144421.78,52989,197410.78
110100,202001,33,26,7,27014,8312,35326
110110,202001,69,38,31,39482,32209,71691
110120,202001,69,58,11,60262,11429,71691
110130,202001,295,243,52,252477.98,54028.78,306506.76
110140,202001,240,164,76,170396,78964,249360
110143,202001,50,41,9,42599,9351,51950
110145,202001,25,20,5,20780,5195,25975
110146,202001,23,12,11,12468,11429,23897
110147,202001,35,26,9,27014,9351,36365
110148,202001,33,22,11,22858,11429,34287
110149,202001,309,217,92,225463,95590.34,321053.34
110150,202001,132,101,31,104939,32209,137148
110155,202001,9,7,2,7273,2078,9351
110160,202001,67,53,14,55067,14546,69613
110170,202001,207,168,39,174552,40521,215073
110175,202001,64,48,16,49872,16624,66496
110180,202001,91,77,14,80003,14546,94549
120001,202001,162,111,51,115329.78,55068.16,170397.94
120005,202001,195,113,82,117407.78,86237.78,203645.56
120010,202001,1078,676,402,703406.34,417678.39,1121084.73
120013,202001,147,99,48,102861,49872,152733
120017,202001,98,58,40,60262,41560.78,101822.78
120020,202001,3538,2851,687,2964269.27,717950.56,3682219.83
120025,202001,543,309,234,322094.73,244166.56,566261.29
120030,202001,1066,901,165,936141.94,171435,1107576.94
120032,202001,41,38,3,39482,3117,42599
120033,202001,216,191,25,198449,25975,224424
120034,202001,168,123,45,127797,46755,174552
120035,202001,35,28,7,29092,7273,36365
120038,202001,393,252,141,262869.34,146501.34,409370.68
120039,202001,27,26,1,27014,1039,28053
120040,202001,13989,9589,4400,9980043.45,4577878.72,14557922.17
120042,202001,41,37,4,38443,4156,42599
120043,202001,11,3,8,3117,8312,11429
120045,202001,555,361,194,376121.51,201567.95,577689.46
120050,202001,1278,977,301,1016145.51,314817.78,1330963.29
120060,202001,1455,1193,262,1242644.78,272218,1514862.78
120070,202001,448,319,129,332485.34,134031,466516.34
120080,202001,166,99,67,103901.56,69613,173514.56
130002,202001,149,108,41,112212,42599,154811
130006,202001,88,54,34,56106,35326,91432
130008,202001,135,72,63,74808,65457,140265
130010,202001,141,80,61,84159.78,63379,147538.78
130014,202001,261,190,71,197410.78,74808,272218.78
130020,202001,99,59,40,61301,42599,103900
130030,202001,952,566,386,588074,403132,991206
130040,202001,342,171,171,177669,178708.48,356377.48
130050,202001,568,296,272,307544,282608.78,590152.78
130060,202001,866,590,276,615088,289881,904969
130063,202001,592,337,255,350143,264945,615088
130068,202001,189,123,66,127797,68574,196371
130070,202001,1296,888,408,922633.17,423912.78,1346545.95
130080,202001,713,468,245,486252.78,254555,740807.78
130083,202001,68,38,30,39482,31170,70652
130090,202001,342,173,169,179747,176630,356377
130100,202001,1114,481,633,499759,661848.46,1161607.46
130110,202001,741,309,432,321051.78,449887,770938.78
130115,202001,160,66,94,69613,97666,167279
130120,202001,1631,1047,584,1088872,609893,1698765
130130,202001,603,413,190,429107,199488,628595
130140,202001,1506,1158,348,1204201,364689,1568890
130150,202001,415,364,51,378196,52989,431185
130160,202001,449,262,187,273257,195332,468589
130165,202001,27,21,6,21819,6234,28053
130170,202001,949,664,285,691908.28,296115,988023.28
130180,202001,181,122,59,126758,61301,188059
130185,202001,2344,1112,1232,1159525.56,1282130.3,2441655.86
130190,202001,3472,2177,1295,2265020.24,1346546.06,3611566.30
130195,202001,275,220,55,228580,57145,285725
130200,202001,183,84,99,87276,103900,191176
130210,202001,77,39,38,40521,39482,80003
130220,202001,181,124,57,128836,59223,188059
130230,202001,372,239,133,249360,138187,387547
130240,202001,1358,853,505,886267.19,527812,1414079.19
130250,202001,4736,3030,1706,3154410.94,1777731.34,4932142.28
130255,202001,429,207,222,215073,230658,445731
130260,202001,56877,27096,29781,28193212.06,30998651.89,59191863.95
130270,202001,1534,1030,504,1071302.51,525734,1597036.51
130280,202001,128,72,56,74808,58184,132992
130290,202001,2095,1484,611,1548110,636907,2185017
130300,202001,440,311,129,323129,135070,458199
130310,202001,918,481,437,500798,458199,958997
130320,202001,506,276,230,287803,240009,527812
130330,202001,748,471,277,489369,287803,777172
130340,202001,3497,2029,1468,2108133.18,1529414.86,3637548.04
130350,202001,441,287,154,299232,160006,459238
130353,202001,912,385,527,400015.78,549631.78,949647.56
130356,202001,825,381,444,395859,463394.78,859253.78
130360,202001,90,66,24,68574,25975,94549
130370,202001,717,554,163,575606,169357,744963
130380,202001,681,520,161,541319,167279,708598
130390,202001,497,402,95,417678,99744,517422
130395,202001,161,35,126,36365,130914,167279
130400,202001,64,45,19,46755,20780,67535
130406,202001,2100,1278,822,1327842.7,855097,2182939.7
130410,202001,438,200,238,207800,248321,456121
130420,202001,3008,2443,565,2542437.57,589116.9,3131554.47
130423,202001,155,79,76,82081,78964,161045
130426,202001,146,79,67,82081,69613,151694
130430,202001,406,260,146,270140,152733,422873
130440,202001,202,67,135,69613,140265,209878
140002,202001,32,10,22,10390,22858.78,33248.78
140005,202001,200,118,82,122602.78,85198.78,207801.56
140010,202001,10357,6714,3643,6989423.81,3793458.03,10782881.84
140015,202001,131,56,75,58184,77925,136109
140017,202001,119,78,41,82081.78,42600.56,124682.34
140020,202001,476,313,163,325207.78,170398.73,495606.51
140023,202001,50,24,26,24937.75,27014,51951.75
140028,202001,18,10,8,11429,8312,19741
140030,202001,343,242,101,251438.78,104939.78,356378.56
140040,202001,58,40,18,41560,18702,60262
140045,202001,243,99,144,103900,149616,253516
140047,202001,609,405,204,421840.16,211960.68,633800.84
140050,202001,149,92,57,95589.56,59223,154812.56
140060,202001,44,31,13,32210.56,13507,45717.56
140070,202001,33,30,3,31170.78,3117,34287.78
150010,202001,4624,2847,1777,2961155.38,1848381.78,4809537.16
150013,202001,162,112,50,116368.39,51950,168318.39
150020,202001,1070,571,499,595347.78,518461,1113808.78
150030,202001,673,280,393,290920,410405,701325
150034,202001,197,127,70,131953,72730,204683
150040,202001,1440,836,604,868605.56,629636.34,1498241.90
150050,202001,633,366,267,381313,277413,658726
150060,202001,4778,3069,1709,3195886.6,1785443.06,4981329.66
150070,202001,325,143,182,148577,189098,337675
150080,202001,14689,7124,7565,7414315.9,7869401.17,15283717.07
150085,202001,409,259,150,269101.78,155850.78,424952.56
150090,202001,747,626,121,650414,126758,777172
150095,202001,360,224,136,232736,142343,375079
150100,202001,62,39,23,40521,23897,64418
150110,202001,170,84,86,87276,89354,176630
150120,202001,405,301,104,313778,109095.78,422873.78
150125,202001,52,20,32,20780,33248,54028
150130,202001,1980,1053,927,1094069.34,965231.78,2059301.12
150140,202001,54527,24942,29585,25934501.91,30780404.71,56714906.62
150145,202001,191,104,87,108056.78,91432,199488.78
150150,202001,2921,1318,1603,1370441.78,1669675.96,3040117.74
150157,202001,394,280,114,290921.73,118446,409367.73
150160,202001,130,100,30,103900,31170,135070
150170,202001,3587,2683,904,2789715,940295.78,3730010.78
150172,202001,332,227,105,235854.56,110134.78,345989.34
150175,202001,77,48,29,49872,30131.78,80003.78
150178,202001,780,523,257,543397,269104.12,812501.12
150180,202001,3157,1547,1610,1608373.53,1675910.82,3284284.35
150190,202001,339,216,123,224424,128836,353260
150195,202001,107,53,54,55067.78,56106,111173.78
150200,202001,196,92,104,95588,108056,203644
150210,202001,3111,2500,611,2598541.34,637946.97,3236488.31
150215,202001,565,368,197,383391.78,204684.48,588076.26
150220,202001,3637,2452,1185,2554902.09,1236412.48,3791314.57
150230,202001,1170,944,226,980817.5,236892,1217709.5
150240,202001,6230,3609,2621,3754953.42,2730493.17,6485446.59
150250,202001,38,17,21,17663,21819,39482
150260,202001,85,54,31,56106,32209,88315
150270,202001,2261,1469,792,1530457.14,827050.94,2357508.08
150275,202001,527,333,194,345987,202606.56,548593.56
150276,202001,104,43,61,44677,63379,108056
150277,202001,753,326,427,338717.51,443657.68,782375.19
150280,202001,327,209,118,217151,122602,339753
150285,202001,95,48,47,49872,48833,98705
150290,202001,980,592,388,617166.78,403132.7,1020299.48
150293,202001,630,307,323,318974.56,336636.78,655611.34
150295,202001,482,223,259,231699.34,270142.82,501842.16
150300,202001,79,39,40,40521,41560,82081
150304,202001,170,107,63,111173,65457,176630
150307,202001,399,331,68,344948,70652,415600
150309,202001,577,413,164,429108.95,170397.37,599506.32
150310,202001,233,155,78,163123,81042,244165
150320,202001,1918,1337,581,1390182,607815,1997997
150330,202001,2005,1168,837,1213552.78,872760,2086312.78
150340,202001,198,133,65,138187,67535,205722
150345,202001,618,342,276,356377,288842,645219
150350,202001,409,318,91,330402.78,95588,425990.78
150360,202001,4636,2907,1729,3022461.58,1797477.8,4819939.38
150370,202001,814,564,250,587038.51,261832.29,848870.80
150375,202001,187,93,94,96627,97666,194293
150380,202001,1457,981,476,1020299.56,495604.56,1515904.12
150390,202001,795,458,337,475862.97,351183.56,827046.53
150400,202001,106,88,18,91432,19741,111173
150405,202001,1220,789,431,819773.34,448848.78,1268622.12
150410,202001,124,81,43,84159,44677,128836
150420,202001,7328,4022,3306,4190481.51,3445365.26,7635846.77
150430,202001,577,378,199,392742.78,206761.78,599504.56
150440,202001,548,335,213,349104,221307,570411
150442,202001,2288,1219,1069,1268620.4,1111730.78,2380351.18
150445,202001,536,342,194,355341.12,201567.56,556908.68
150450,202001,236,126,110,130914,114290,245204
150460,202001,727,545,182,568334.56,190137,758471.56
150470,202001,1307,788,519,819771.78,539242.56,1359014.34
150475,202001,229,176,53,182864.78,55067.78,237932.56
150480,202001,1294,904,390,939259.12,405210.78,1344469.90
150490,202001,592,328,264,340792,276374,617166
150495,202001,328,241,87,250399,90393,340792
150497,202001,296,199,97,206761,100783.78,307544.78
150500,202001,217,138,79,143382,82081,225463
150503,202001,1005,496,509,515349.38,528859.19,1044208.57
150506,202001,941,628,313,653531.78,329367.68,982899.46
150510,202001,1263,700,563,727303.82,585996.78,1313300.60
150520,202001,266,175,91,181825,94549,276374
150530,202001,1695,933,762,969396.75,793799.9,1763196.65
150540,202001,231,167,64,173513,67535,241048
150543,202001,788,422,366,438458.78,381314.56,819773.34
150548,202001,466,329,137,341831,142344.56,484175.56
150549,202001,60,42,18,43638,18702,62340
150550,202001,2908,1492,1416,1551228.53,1471226.26,3022454.79
150553,202001,3344,1955,1389,2036458.1,1446309.84,3482767.94
150555,202001,143,74,69,76886,71691,148577
150560,202001,28,13,15,13507,15585,29092
150563,202001,93,47,46,48833,47794,96627
150565,202001,178,108,70,112212,72730,184942
150570,202001,404,267,137,277413,142343,419756
150580,202001,1606,753,853,784445.78,887307.56,1671753.34
150590,202001,806,528,278,548592,288842,837434
150600,202001,460,280,180,291959,187020,478979
150610,202001,141,120,21,124680,21819,146499
150611,202001,119,81,38,84159,39482,123641
150613,202001,3207,1941,1266,2021898.68,1317468.69,3339367.37
150616,202001,514,302,212,313778,221307.7,535085.7
150618,202001,1308,708,600,735612.39,624439.78,1360052.17
150619,202001,390,297,93,308583,96627,405210
150620,202001,1233,727,506,756392.78,528851,1285243.78
150630,202001,298,192,106,199488,110134,309622
150635,202001,467,194,273,201566,283647.78,485213.78
150640,202001,54,27,27,28053,28053,56106
150650,202001,2347,1369,978,1422651.7,1019260.67,2441912.37
150655,202001,245,184,61,191176,63379,254555
150658,202001,92,50,42,51950.78,43638.78,95589.56
150660,202001,523,350,173,363652.34,180786,544438.34
150670,202001,1035,372,663,387550.51,691983.75,1079534.26
150680,202001,9949,5298,4651,5517121.45,4842815.6,10359937.05
150690,202001,15,9,6,9351,6234,15585
150700,202001,481,318,163,331441,170396,501837
150710,202001,278,155,123,161045,127797,288842
150715,202001,811,500,311,522617.39,325209.34,847826.73
150720,202001,407,315,92,327285,95588.78,422873.78
150730,202001,986,516,470,538203.56,489370.56,1027574.12
150740,202001,226,155,71,161045,73769,234814
150745,202001,799,441,358,460279.34,373008.02,833287.36
150746,202001,61,36,25,37404,25975.78,63379.78
150747,202001,236,182,54,189098,57145,246243
150750,202001,138,78,60,81042,62340,143382
150760,202001,1815,1182,633,1229138.45,660804,1889942.45
150770,202001,386,210,176,218190,182864,401054
150775,202001,95,45,50,46755,51950,98705
150780,202001,187,108,79,112212,82081,194293
150790,202001,837,457,380,474823.78,394820,869643.78
150795,202001,1505,896,609,931984.56,633792.34,1565776.90
150796,202001,357,209,148,218190,153772,371962
150797,202001,308,158,150,165201,155850,321051
150800,202001,1458,851,607,885228,632751,1517979
150803,202001,548,449,99,466512.56,102861,569373.56
150805,202001,195,121,74,125719,76886.19,202605.19
150808,202001,986,536,450,557947.68,470668.56,1028616.24
150810,202001,3277,2263,1014,2354377.17,1058750.28,3413127.45
150812,202001,436,226,210,235853.78,218190,454043.78
150815,202001,1003,633,370,657687.78,384430,1042117.78
150820,202001,1535,917,618,953802,643141,1596943
150830,202001,741,542,199,563138.78,207800.78,770939.56
150835,202001,199,115,84,119485,87276,206761
150840,202001,1368,854,514,888347.94,535088.9,1423436.84
160005,202001,52,32,20,33248,20780,54028
160010,202001,190,122,68,126758,70652,197410
160015,202001,117,70,47,72730,48833,121563
160020,202001,123,73,50,75847.78,51950.78,127798.56
160021,202001,55,28,27,29092,28053,57145
160023,202001,65,43,22,44677,22858,67535
160025,202001,26,10,16,10390.78,16624,27014.78
160027,202001,1521,861,660,894580.53,685741.56,1580322.09
160030,202001,15764,8150,7614,8485549.21,7927602.67,16413151.88
160040,202001,294,169,125,175591,129875.8,305466.8
160050,202001,728,361,367,376118,381313,757431
160053,202001,290,168,122,174552.7,126758.78,301311.48
160055,202001,28,19,9,19741,9351,29092
160060,202001,6565,3457,3108,3598066.16,3236499.15,6834565.31
160070,202001,174,105,69,109095,72730,181825
160080,202001,100,50,50,51950,51950,103900
170025,202001,26,14,12,14546,12468.78,27014.78
170030,202001,218,178,40,184942.38,42599,227541.38
170035,202001,231,109,122,113251.78,126758,240009.78
170040,202001,181,138,43,144421.08,44677,189098.08
170070,202001,313,192,121,199488.78,125720.56,325209.34
170100,202001,356,260,96,270140,99744,369884
170105,202001,58,46,12,47794,12468,60262
170110,202001,110,71,39,73769,41560,115329
170130,202001,68,33,35,34287,36365.7,70652.7
170190,202001,96,61,35,63379,36365,99744
170200,202001,376,262,114,272218.39,119485,391703.39
170210,202001,6034,3222,2812,3351821.18,2927917.9,6279739.08
170215,202001,119,47,72,48833,74808,123641
170220,202001,1407,1036,371,1076407.12,386509.56,1462916.68
170230,202001,149,98,51,101822,52989,154811
170240,202001,529,355,174,368845.4,181825,550670.4
170255,202001,1094,887,207,922632.78,216113.56,1138746.34
170270,202001,45,31,14,32209,14546,46755
170290,202001,112,77,35,80003,36365,116368
170300,202001,90,61,29,63379,30131,93510
170305,202001,47,36,11,37404,11429,48833
170307,202001,62,48,14,49872,14546,64418
170310,202001,109,60,49,62340,50911,113251
170320,202001,26,18,8,18702,8312,27014
170330,202001,23,21,2,21819,2078,23897
170360,202001,28,17,11,17663,11429,29092
170370,202001,99,49,50,50911,51950,102861
170380,202001,77,60,17,62340,17663,80003
170382,202001,42,36,6,37404,6234,43638
170384,202001,145,110,35,114290,36365,150655
170386,202001,64,26,38,27014,39482,66496
170388,202001,48,19,29,19741,30131,49872
170389,202001,25,20,5,20780,5195,25975
170390,202001,67,39,28,40521.39,29092,69613.39
170410,202001,32,24,8,24936,8312,33248
170460,202001,16,11,5,11429,5195,16624
170510,202001,35,27,8,28053,8312,36365
170550,202001,1542,900,642,936140.56,668084.8,1604225.36
170555,202001,115,81,34,84159,35326,119485
170560,202001,98,68,30,70652,31170,101822
170600,202001,35,17,18,17663,18702,36365
170610,202001,194,105,89,110134.78,92472.87,202607.65
170625,202001,36,21,15,21819,15585,37404
170650,202001,79,58,21,60262,21819,82081
170700,202001,577,441,136,459238.75,141304,600542.75
170710,202001,160,100,60,103900,62341.17,166241.17
170720,202001,88,71,17,73769,17663,91432
170730,202001,85,49,36,50911,37404,88315
170740,202001,83,61,22,63379,22858,86237
170755,202001,65,35,30,36365,31170,67535
170765,202001,139,75,64,77925.4,66496,144421.4
170770,202001,208,129,79,134031,82081.78,216112.78
170820,202001,592,396,196,412483.78,204683.7,617167.48
170825,202001,35,17,18,17663,18702,36365
170830,202001,81,68,13,70652,13507,84159
170900,202001,187,144,43,149616,44677,194293
170930,202001,897,478,419,496643.94,435344.04,931987.98
170950,202001,3120,1434,1686,1490966.17,1755919.67,3246885.84
170980,202001,17,10,7,10390,7273,17663
171050,202001,143,114,29,118446,30131,148577
171070,202001,36,31,5,32209,6234,38443
171090,202001,42,30,12,31170,12468,43638
171110,202001,22,15,7,15585,7273,22858
171150,202001,41,20,21,20780,21819,42599
171180,202001,25,13,12,13507,12468.78,25975.78
171190,202001,146,82,64,85198,66497.56,151695.56
171195,202001,65,55,10,57145,10390,67535
171200,202001,49,25,24,25975,24936.78,50911.78
171215,202001,4,3,1,3117,1039,4156
171240,202001,58,42,16,43638,16624,60262
171245,202001,58,49,9,50911.78,9351,60262.78
171250,202001,73,40,33,41560.78,35326,76886.78
171270,202001,14,10,4,10390,4156,14546
171280,202001,42,37,5,38443,5195,43638
171320,202001,977,574,403,597426.71,419758.34,1017185.05
171330,202001,432,214,218,222346,227541,449887
171360,202001,85,61,24,63379,24936,88315
171370,202001,33,16,17,16624,17663,34287
171380,202001,132,111,21,115329,21819,137148
171395,202001,52,32,20,33248,20780,54028
171420,202001,283,185,98,192215,101822,294037
171430,202001,76,62,14,64418.78,14546,78964.78
171488,202001,178,98,80,102861,83120.78,185981.78
171500,202001,54,31,23,32209,23897,56106
171510,202001,72,44,28,45716,29092,74808
171515,202001,41,34,7,35326,7273.7,42599.7
171525,202001,29,27,2,28053,2078,30131
171550,202001,13,9,4,9351.78,4156,13507.78
171570,202001,53,28,25,29092,25975,55067
171575,202001,313,204,109,212995,113251,326246
171610,202001,1750,893,857,929908.12,893549.75,1823457.87
171620,202001,135,92,43,95588,44677,140265
171630,202001,61,32,29,33248,30131,63379
171650,202001,277,185,92,192215,96628.56,288843.56
171660,202001,270,151,119,156889.78,123642.48,280532.26
171665,202001,59,40,19,41560,19741,61301
171670,202001,421,248,173,257674.31,179747.78,437422.09
171700,202001,66,59,7,61301,7273,68574
171720,202001,27,10,17,10390,17663.78,28053.78
171750,202001,104,54,50,56106,51950,108056
171780,202001,72,57,15,59223,15585,74808
171790,202001,77,67,10,69613,10390,80003
171800,202001,32,24,8,24936,8312,33248
171820,202001,2108,1218,890,1268620.58,927831.41,2196451.99
171830,202001,35,28,7,29092,7273,36365
171840,202001,62,41,21,42599,21819.78,64418.78
171845,202001,30,18,12,18702,12468,31170
171850,202001,38,28,10,29092,11429,40521
171855,202001,76,60,16,62340,16624,78964
171865,202001,7,6,1,6234,1039,7273
171870,202001,31,22,9,22858,9351.78,32209.78
171875,202001,76,53,23,55067,23897,78964
171880,202001,30,19,11,19741,11429,31170
171884,202001,49,27,22,28053,23897,51950
171886,202001,131,54,77,56106,80003.78,136109.78
171888,202001,29,23,6,23897,6234,30131
171889,202001,19,13,6,13507,6234,19741
171890,202001,55,46,9,47794,9351,57145
171900,202001,39,26,13,27014.78,13507,40521.78
172000,202001,43,34,9,35326,9351,44677
172010,202001,50,39,11,40521,11429,51950
172015,202001,28,19,9,19741.19,9351,29092.19
172020,202001,137,87,50,90393,51950,142343
172025,202001,34,21,13,21819,14546,36365
172030,202001,43,25,18,25975,18702.39,44677.39
172049,202001,80,52,28,54028,29092,83120
172065,202001,140,88,52,91432,55067,146499
172080,202001,105,69,36,71691,38444.56,110135.56
172085,202001,29,15,14,15585,14546,30131
172090,202001,413,322,91,334558.77,94549,429107.77
172093,202001,17,15,2,15585,2078,17663
172097,202001,19,12,7,12468,7273.7,19741.7
172100,202001,5013,2858,2155,2975704.08,2242184.56,5217888.64
172110,202001,78,49,29,50911,30131,81042
172120,202001,1659,1407,252,1461876.39,261828.78,1723705.17
172125,202001,5,4,1,4156,1039,5195
172130,202001,16,12,4,12468,4156.78,16624.78
172208,202001,196,122,74,126758,76886,203644
172210,202001,387,188,199,195332,206763.26,402095.26
210005,202001,2954,1860,1094,1935658.6,1139792.18,3075450.78
210010,202001,166,92,74,95588,76886,172474
210015,202001,39,29,10,30131,10390,40521
210020,202001,340,193,147,200527,152733,353260
210030,202001,325,213,112,222346,116368.39,338714.39
210040,202001,139,111,28,115329,31170,146499
210043,202001,250,187,63,194293,65457,259750
210047,202001,528,306,222,317934,230658,548592
210050,202001,289,212,77,221307,80003,301310
210055,202001,45,34,11,35326,11429,46755
210060,202001,547,436,111,455082,115329,570411
210070,202001,402,310,92,322090,95588,417678
210080,202001,116,105,11,109095,11429,120524
210083,202001,304,149,155,155850.5,161045,316895.5
210087,202001,2,1,1,1039,1039,2078
210090,202001,451,323,128,335597,134031,469628
210095,202001,444,339,105,352221,109095,461316
210100,202001,693,540,153,561060,160006,721066
210110,202001,126,79,47,82081,48833,130914
210120,202001,5090,3958,1132,4117562.16,1178227.94,5295790.10
210125,202001,200,120,80,124680,83120,207800
210130,202001,486,277,209,287803,217151.78,504954.78
210135,202001,28,19,9,19741,9351,29092
210140,202001,4367,3425,942,3559614.8,978738.78,4538353.58
210150,202001,382,245,137,254555,142343,396898
210160,202001,3282,2782,500,2892577.22,521578,3414155.22
210170,202001,1149,924,225,961075,233775,1194850
210173,202001,123,107,16,111173,16624,127797
210177,202001,375,209,166,217151,175591,392742
210180,202001,31,16,15,16624,15585,32209
210190,202001,423,283,140,294037,145460,439497
210193,202001,2,1,1,1039,1039,2078
210197,202001,79,55,24,57145,25975,83120
210200,202001,628,516,112,536124,117407,653531
210203,202001,232,157,75,164162,78964,243126
210207,202001,371,300,71,312739,73769,386508
210210,202001,756,699,57,726261,60262,786523
210215,202001,72,65,7,67535,7273,74808
210220,202001,394,333,61,345987,63379,409366
210230,202001,308,245,63,254555,65457,320012
210232,202001,1376,930,446,969387,466511,1435898
210235,202001,171,127,44,131953,45716,177669
210237,202001,38,23,15,23897,15585,39482
210240,202001,89,75,14,77925,14546,92471
210250,202001,185,156,29,162084,30131,192215
210255,202001,355,266,89,276374,92471,368845
210260,202001,397,273,124,283647,128836,412483
210270,202001,647,428,219,444692,227541,672233
210275,202001,67,52,15,54028,15585,69613
210280,202001,1045,689,356,715871.14,370923,1086794.14
210290,202001,540,362,178,376118,187020,563138
210300,202001,5353,3368,1985,3499352.18,2072805.58,5572157.76
210310,202001,106,76,30,78964,31170,110134
210312,202001,115,80,35,83120,36365,119485
210315,202001,105,84,21,87276,21819,109095
210317,202001,125,94,31,97666,32209,129875
210320,202001,2332,1971,361,2049947,375079,2425026
210325,202001,130,89,41,92471.7,42599.7,135071.4
210330,202001,4573,2606,1967,2712829.85,2052025,4764854.85
210340,202001,1267,937,330,976660,343910.86,1320570.86
210350,202001,613,515,98,535085,101822,636907
210355,202001,148,119,29,123641,30131,153772
210360,202001,2289,1562,727,1622918.99,762627.48,2385546.47
210370,202001,1217,587,630,609893,656648,1266541
210375,202001,186,96,90,99744.78,93510,193254.78
210380,202001,702,539,163,560021,169357.78,729378.78
210390,202001,193,164,29,170396,31170,201566
210400,202001,396,343,53,356377,56106,412483
210405,202001,983,689,294,716910,306505,1023415
210407,202001,52,42,10,43638,10390,54028
210408,202001,60,53,7,55067,7273,62340
210409,202001,324,281,43,292998,44677,337675
210410,202001,434,340,94,353260,97666,450926
210420,202001,193,158,35,164162,36365,200527
210430,202001,48,32,16,33248,16624,49872
210440,202001,333,222,111,231697,116368,348065
210450,202001,149,117,32,121563,33248,154811
210455,202001,227,122,105,126758.7,110134,236892.7
210460,202001,311,206,105,214034,110134,324168
210462,202001,64,53,11,55067,11429,66496
210465,202001,145,109,36,113251,38443,151694
210467,202001,524,387,137,402093,142343.39,544436.39
210470,202001,50,43,7,44677,7273,51950
210480,202001,1275,916,359,953802.78,373003.43,1326806.21
210490,202001,204,135,69,140265,71691,211956
210500,202001,512,305,207,316895,215073,531968
210510,202001,560,445,115,462355,119485,581840
210515,202001,379,233,146,242087,151694,393781
210520,202001,402,360,42,375079,44677,419756
210530,202001,9360,4992,4368,5199165.08,4548750.38,9747915.46
210535,202001,130,96,34,99744,35326,135070
210540,202001,1475,959,516,996401.6,539241,1535642.6
210542,202001,1194,614,580,637946,603661.96,1241607.96
210545,202001,16,15,1,16624,1039,17663
210547,202001,130,114,16,118446,16624,135070
210550,202001,693,500,193,519500.42,202605.78,722106.20
210560,202001,160,140,20,146499,20780,167279
210565,202001,21,16,5,16624,5195,21819
210570,202001,1300,1048,252,1090950.54,262867,1353817.54
210580,202001,119,102,17,105978,17663,123641
210590,202001,738,602,136,625478,141304,766782
210592,202001,32,29,3,31170,3117,34287
210594,202001,106,90,16,93510,16624,110134
210596,202001,96,81,15,84159,15585,99744
210598,202001,130,96,34,99744,35326,135070
210600,202001,323,277,46,287803,48833,336636
210610,202001,256,240,16,249360,16624,265984
210620,202001,41,27,14,28053,15585,43638
210630,202001,73,70,3,72730,3117,75847
210632,202001,1014,704,310,731456,324168,1055624
210635,202001,22,19,3,19741,3117,22858
210637,202001,108,78,30,81042,31170,112212
210640,202001,581,512,69,531968,71691,603659
210650,202001,389,324,65,338714,67535,406249
210660,202001,388,296,92,307544,95588,403132
210663,202001,32,22,10,22858,10390,33248
210667,202001,99,35,64,36365,66496,102861
210670,202001,249,221,28,230658,29092,259750
210675,202001,541,302,239,313778,248321,562099
210680,202001,216,144,72,149616,74808,224424
210690,202001,623,515,108,536124,112212,648336
210700,202001,164,123,41,127797,42599,170396
210710,202001,260,159,101,165201,104939,270140
210720,202001,131,118,13,122602,15585,138187
210725,202001,68,59,9,61301,9351,70652
210730,202001,25,18,7,18702,7273,25975
210735,202001,290,201,89,208839,93510.7,302349.7
210740,202001,539,461,78,478979,81042,560021
210745,202001,151,113,38,117407,39482,156889
210750,202001,2361,1190,1171,1237449.75,1217709.4,2455159.15
210760,202001,252,193,59,200527,62340,262867
210770,202001,385,302,83,313778,86237,400015
210780,202001,444,327,117,339753,121563,461316
210790,202001,185,151,34,156889,35326,192215
210800,202001,168,127,41,131953,42599,174552
210805,202001,50,46,4,47794,4156,51950
210810,202001,463,370,93,385469.78,98705,484174.78
210820,202001,2141,1783,358,1855655.18,374040.78,2229695.96
210825,202001,155,88,67,91432,69613,161045
210830,202001,723,479,244,497681,253516,751197
210840,202001,201,140,61,145460,63379,208839
210845,202001,242,166,76,172474,80003,252477
210850,202001,763,517,246,539241,257672,796913
210860,202001,3745,2101,1644,2187095.75,1712272,3899367.75
210870,202001,444,348,96,361572,100783,462355
210880,202001,70,55,15,57145,16624,73769
210890,202001,311,268,43,278452.78,45716,324168.78
210900,202001,626,410,216,427029,226502.78,653531.78
210905,202001,64,32,32,33248,33248,66496
210910,202001,1960,1477,483,1535643.52,502876,2038519.52
210920,202001,175,64,111,66496,115329,181825
210923,202001,79,59,20,61301,20780,82081
210927,202001,403,186,217,194293,226502,420795
210930,202001,73,58,15,60262,15585,75847
210940,202001,83,65,18,67535,18702,86237
210945,202001,188,99,89,102861,93510,196371
210950,202001,528,389,139,405210,144421,549631
210955,202001,78,52,26,54028,27014,81042
210960,202001,2173,1074,1099,1115886,1148095,2263981
210970,202001,112,99,13,103900,13507,117407
210975,202001,80,74,6,76886,6234,83120
210980,202001,1081,518,563,538202,585996.7,1124198.7
210990,202001,4076,2665,1411,2769975.58,1470186.56,4240162.14
211000,202001,1322,1066,256,1109652.7,269101.78,1378754.48
211003,202001,1007,713,294,740807,306505,1047312
211010,202001,489,436,53,453004,55067,508071
211020,202001,1453,601,852,624439.78,885228,1509667.78
211023,202001,31,28,3,29092,3117,32209
211027,202001,73,53,20,55067,20780,75847
211030,202001,370,259,111,270140,115329,385469
211040,202001,297,247,50,257672.7,51950,309622.7
211050,202001,1142,754,388,785484,404171.7,1189655.7
211060,202001,643,553,90,574567.7,93510.09,668077.79
211065,202001,23,18,5,18702,5195,23897
211070,202001,899,744,155,773017.13,162084,935101.13
211080,202001,86,82,4,85198,4156,89354
211085,202001,55,28,27,29092,28053,57145
211090,202001,90,73,17,75847,17663,93510
211100,202001,481,397,84,412483,87276.7,499759.7
211102,202001,248,173,75,179747,77925,257672
211105,202001,223,156,67,162084,69613,231697
211107,202001,132,82,50,85198,51950,137148
211110,202001,820,531,289,552748,300272.17,853020.17
211120,202001,5348,2647,2701,2753352.1,2812573.68,5565925.78
211125,202001,34,25,9,25975,9351,35326
211130,202001,42095,19112,22983,19880239.9,23931298.67,43811538.57
211140,202001,401,347,54,360533.19,57145,417678.19
211150,202001,1228,806,422,839512,438459.67,1277971.67
211153,202001,169,102,67,105978,69613,175591
211157,202001,64,51,13,52989,13507,66496
211160,202001,697,593,104,617166,108056,725222
211163,202001,0,,,,,0.0
211167,202001,10,9,1,9351,1039,10390
211170,202001,422,315,107,327285,111173,438458
211172,202001,119,81,38,84159,39482,123641
211174,202001,253,153,100,158967,103900,262867
211176,202001,489,364,125,379235.7,129875,509110.7
211178,202001,89,59,30,61301,31170,92471
211180,202001,211,168,43,175591,44677,220268
211190,202001,71,66,5,68574,5195,73769
211195,202001,35,24,11,24936,11429,36365
211200,202001,148,127,21,131953,21819,153772
211210,202001,452,329,123,341831,127797,469628
211220,202001,4026,2349,1677,2442690.66,1747600.49,4190291.15
211223,202001,94,91,3,94549,3117,97666
211227,202001,72,56,16,58184,16624,74808
211230,202001,748,619,129,643141,134031,777172
211240,202001,397,309,88,321051,91432,412483
211245,202001,187,89,98,92471,101822,194293
211250,202001,1566,1349,217,1402650.99,225463,1628113.99
211260,202001,809,663,146,690935,151694,842629
211270,202001,1959,1607,352,1670712.7,366767.7,2037480.4
211280,202001,1737,1113,624,1158485,651453,1809938
211285,202001,198,122,76,126758,78964,205722
211290,202001,674,472,202,490408,209878,700286
211300,202001,768,609,159,633790,167279,801069
211400,202001,1552,949,603,987050,632751,1619801
220005,202001,15,14,1,14546,1039,15585
220010,202001,86,67,19,69613,19741,89354
220020,202001,690,547,143,569372,148577,717949
220025,202001,113,110,3,114290,3117,117407
220027,202001,42,34,8,35326,8312,43638
220030,202001,109,91,18,94549,18702,113251
220040,202001,1220,930,290,967309.8,301310,1268619.8
220045,202001,32,22,10,22858,10390,33248
220050,202001,679,573,106,595347.86,111173,706520.86
220060,202001,169,150,19,155850,19741,175591
220070,202001,112,102,10,105978,10390,116368
220080,202001,16,14,2,14546,2078,16624
220090,202001,31,26,5,27014,5195,32209
220095,202001,2,1,1,1039,1039,2078
220100,202001,22,16,6,16624,6234,22858
220105,202001,24,22,2,22858.7,2078,24936.7
220110,202001,219,200,19,207800,19741,227541
220115,202001,36,35,1,36365,1039,37404
220117,202001,21,20,1,20780,2078,22858
220120,202001,1478,1118,360,1161602,374040,1535642
220130,202001,31,30,1,31170,1039,32209
220140,202001,102,78,24,81042,24936,105978
220150,202001,489,357,132,370923,138187,509110
220155,202001,6,6,0,6234,0,6234
220157,202001,18,15,3,15585,3117,18702
220160,202001,87,75,12,77925,12468,90393
220170,202001,30,30,0,31170,0,31170
220173,202001,7,7,0,7273,0,7273
220177,202001,6,6,0,6234,0,6234
220180,202001,68,68,0,70652,0,70652
220190,202001,1056,944,112,981855,116368,1098223
220191,202001,43,38,5,39482,5195,44677
220192,202001,79,76,3,78964,3117,82081
220194,202001,49,47,2,48833,2078,50911
220196,202001,95,79,16,82081,16624,98705
220198,202001,3,2,1,2078,1039,3117
220200,202001,418,347,71,360534.53,73769,434303.53
220202,202001,39,35,4,36365,4156,40521
220205,202001,48,43,5,44677,5195,49872
220207,202001,11,11,0,11429,0,11429
220208,202001,78,41,37,42599,38443,81042
220209,202001,30,27,3,28053,3117,31170
220210,202001,19,16,3,16624,3117,19741
220211,202001,28,26,2,27014,2078,29092
220213,202001,40,36,4,37404,4156.7,41560.7
220217,202001,41,32,9,33248,9351,42599
220220,202001,2157,1409,748,1466029,784447.05,2250476.05
220225,202001,10,5,5,5195,5195,10390
220230,202001,967,761,206,790679,214034,1004713
220240,202001,160,145,15,150655,15585,166240
220245,202001,33,30,3,31170.54,3117,34287.54
220250,202001,120,108,12,112212,12468,124680
220253,202001,42,35,7,36365,7273,43638
220255,202001,28,26,2,27014,2078,29092
220260,202001,692,514,178,534046,184942,718988
220265,202001,9,7,2,7273,2078,9351
220270,202001,743,666,77,691974,80003,771977
220271,202001,38,31,7,32209,7273,39482
220272,202001,24,24,0,24936,0,24936
220273,202001,17,15,2,15585,2078,17663
220275,202001,57,46,11,47794,11429,59223
220277,202001,14,12,2,12468,2078,14546
220280,202001,16,13,3,13507,3117,16624
220285,202001,44,41,3,42599,3117,45716
220290,202001,1458,1251,207,1300829.2,216112.95,1516942.15
220300,202001,39,38,1,39482,1039,40521
220310,202001,317,271,46,281569.19,47794,329363.19
220320,202001,443,410,33,425990.7,34287,460277.7
220323,202001,0,,,,,0.0
220325,202001,12,11,1,11429,1039,12468
220327,202001,12,11,1,11429,1039,12468
220330,202001,225,164,61,170396,63379,233775
220335,202001,137,120,17,124680,17663,142343
220340,202001,39,25,14,25975,14546,40521
220342,202001,57,50,7,51950,7273,59223
220345,202001,81,75,6,77925,6234,84159
220350,202001,437,382,55,396898,57145,454043
220360,202001,44,31,13,32209,13507,45716
220370,202001,1218,1005,213,1045234,221307,1266541
220375,202001,20,18,2,18702,2078,20780
220380,202001,19,16,3,16624,3117,19741
220385,202001,15,13,2,13507,2078,15585
220390,202001,2305,1312,993,1365246.12,1033805.85,2399051.97
220400,202001,32,28,4,29092,4156,33248
220410,202001,20,17,3,17663,3117,20780
220415,202001,12,11,1,11429,1039,12468
220420,202001,124,103,21,109095,21819,130914
220430,202001,130,118,12,122602,12468,135070
220435,202001,22,16,6,16624,6234,22858
220440,202001,291,248,43,257672,44677,302349
220450,202001,328,168,160,174552,166240.78,340792.78
220455,202001,52,51,1,52989,1039,54028
220460,202001,21,20,1,20780,1039,21819
220465,202001,94,64,30,66496,31170,97666
220470,202001,237,208,29,216112,30131,246243
220480,202001,72,64,8,66496,8312,74808
220490,202001,89,76,13,78964,13507,92471
220500,202001,104,91,13,94549,13507,108056
220510,202001,424,329,95,342870,99744,442614
220515,202001,22,20,2,20780,2078,22858
220520,202001,379,342,37,355338.87,38443,393781.87
220525,202001,10,7,3,7273,3117,10390
220527,202001,21,14,7,14546,7273,21819
220530,202001,31,13,18,13507,18702,32209
220535,202001,3,3,0,3117,0,3117
220540,202001,65,54,11,56106,11429,67535
220545,202001,42,28,14,29092,14546,43638
220550,202001,682,538,144,558982.78,151694,710676.78
220551,202001,13,10,3,10390,3117,13507
220552,202001,14,14,0,14546,0,14546
220553,202001,53,47,6,48833,6234,55067
220554,202001,10,8,2,8312,2078,10390
220555,202001,32,29,3,30131,3117,33248
220556,202001,49,45,4,47794,4156,51950
220557,202001,56,53,3,55067,3117,58184
220558,202001,8,3,5,3117,5195,8312
220559,202001,3,2,1,2078,1039,3117
220560,202001,67,45,22,46755,22858,69613
220570,202001,766,470,296,488330.7,307544,795874.7
220580,202001,543,502,41,521578,42599,564177
220585,202001,7,6,1,6234,1039,7273
220590,202001,14,14,0,14546,0,14546
220595,202001,61,47,14,48833,14546,63379
220600,202001,19,12,7,12468,7273,19741
220605,202001,25,23,2,23897,2078,25975
220610,202001,72,64,8,66496,8312,74808
220620,202001,547,452,95,469628,98705,568333
220630,202001,5,4,1,4156,1039,5195
220635,202001,36,32,4,33248,4156,37404
220640,202001,104,85,19,88315,19741,108056
220650,202001,110,105,5,109095,5195,114290
220660,202001,51,40,11,41560,11429,52989
220665,202001,4,4,0,4156,0,4156
220667,202001,18,16,2,16624,2078,18702
220669,202001,27,24,3,24936,3117,28053
220670,202001,64,52,12,54028,12468,66496
220672,202001,66,45,21,46755,21819,68574
220675,202001,34,27,7,28053,7273,35326
220680,202001,39,33,6,34287,6234,40521
220690,202001,46,43,3,44677,3117,47794
220695,202001,35,18,17,18702,17663,36365
220700,202001,1696,1318,378,1372519,392742,1765261
220710,202001,4,3,1,3117,1039,4156
220720,202001,106,89,17,92471,18702,111173
220730,202001,15,15,0,15585,0,15585
220735,202001,5,1,4,1039,4156,5195
220740,202001,48,44,4,45716,4156,49872
220750,202001,111,94,17,98705,17663,116368
220755,202001,14,13,1,13507,1039,14546
220760,202001,65,60,5,62340,5195,67535
220770,202001,5528,2999,2529,3121160.53,2631788.08,5752948.61
220775,202001,16,10,6,10390,6234,16624
220777,202001,18,17,1,17663,1039,18702
220779,202001,0,0,0,0,0,0
220780,202001,885,758,127,788601,131953.7,920554.7
220785,202001,4,1,3,1039,3117,4156
220790,202001,1075,860,215,894579.51,223385,1117964.51
220793,202001,7,6,1,6234,1039,7273
220795,202001,14,13,1,13507,1039,14546
220800,202001,4003,3065,938,3186615.37,977699.19,4164314.56
220810,202001,67,59,8,61301.7,8312,69613.7
220820,202001,241,220,21,229619,21819,251438
220830,202001,1206,1039,167,1081599,173513,1255112
220840,202001,2417,1687,730,1755913.21,760548.29,2516461.50
220850,202001,55,45,10,46755,10390,57145
220855,202001,8,5,3,5195,3117,8312
220860,202001,15,13,2,13507,2078,15585
220865,202001,33,31,2,32209,2078,34287
220870,202001,74,66,8,68574,8312,76886
220880,202001,319,252,67,261828,69613,331441
220885,202001,34,31,3,32209,3117,35326
220887,202001,12,12,0,12468,0,12468
220890,202001,97,86,11,89354,11429,100783
220900,202001,19,12,7,12468,7273,19741
220910,202001,52,44,8,45716,8312,54028
220915,202001,11,9,2,9351,2078,11429
220920,202001,49,45,4,46755,4156,50911
220930,202001,41,40,1,41560,1039,42599
220935,202001,15,15,0,15585,0,15585
220937,202001,34,33,1,34287,1039,35326
220940,202001,56,51,5,52989,5195,58184
220945,202001,1,1,0,1039,0,1039
220950,202001,44,38,6,39482,6234,45716
220955,202001,21,20,1,20780,1039,21819
220960,202001,10,9,1,9351,1039,10390
220965,202001,38,34,4,35326,4156,39482
220970,202001,59,48,11,50911,11429,62340
220975,202001,13,10,3,10390,3117,13507
220980,202001,29,27,2,28053,2078,30131
220985,202001,63,56,7,58184,7273,65457
220987,202001,29,27,2,28053,2078,30131
220990,202001,18,17,1,17663,1039,18702
220995,202001,19,15,4,15585,4156,19741
220997,202001,64,53,11,55067,11429,66496
221000,202001,1176,1064,112,1106535,116368,1222903
221005,202001,55,49,6,50911,6234,57145
221010,202001,16,12,4,12468,4156,16624
221020,202001,39,37,2,38443,2078,40521
221030,202001,32,26,6,27014,6234,33248
221035,202001,23,23,0,23897,0,23897
221037,202001,12,8,4,8312,4156,12468
221038,202001,25,22,3,22858,3117,25975
221039,202001,21,21,0,21819,0,21819
221040,202001,249,216,33,226502.78,34287,260789.78
221050,202001,231,196,35,204683,36365,241048
221060,202001,1850,1623,227,1687336,235853,1923189
221062,202001,33,33,0,34287,0,34287
221063,202001,13,9,4,9351,4156,13507
221065,202001,55,45,10,47794,10390,58184
221070,202001,140,121,19,125719,19741,145460
221080,202001,377,327,50,339753,51950,391703
221090,202001,28,26,2,27014,2078,29092
221093,202001,48,32,16,33248,16624,49872
221095,202001,8,8,0,8312,0,8312
221097,202001,13,10,3,11429,3117,14546
221100,202001,25026,14833,10193,15423967.13,10607152.56,26031119.69
221110,202001,1076,806,270,838473,280530,1119003
221120,202001,526,390,136,406249.7,141304,547553.7
221130,202001,962,787,175,817693,182864,1000557
221135,202001,34,31,3,32209,3117,35326
221140,202001,42,36,6,37404,6234,43638
221150,202001,12,9,3,9351,3117,12468
221160,202001,13,13,0,13507,0,13507
221170,202001,15,15,0,15585,0,15585
230010,202001,164,150,14,155850,14546,170396
230015,202001,123,100,23,103900,23897,127797
230020,202001,1625,1377,248,1432781.7,259754.06,1692535.76
230030,202001,1676,1211,465,1258230.79,483135,1741365.79
230040,202001,217,187,30,194293.7,31170,225463.7
230050,202001,229,171,58,177669,60262,237931
230060,202001,160,128,32,132992,33248,166240
230070,202001,297,259,38,269101,39482,308583
230075,202001,835,726,109,754315.9,113251,867566.9
230080,202001,197,169,28,175591,29092,204683
230090,202001,123,88,35,91432,36365,127797
230100,202001,2109,1218,891,1266542.4,926788,2193330.4
230110,202001,2827,1830,997,1903449.4,1035883.7,2939333.1
230120,202001,973,768,205,797952.8,212995,1010947.8
230125,202001,151,126,25,130914,25975,156889
230130,202001,482,434,48,450926,49872,500798
230140,202001,225,188,37,196371,38443,234814
230150,202001,152,117,35,121563,36365,157928
230160,202001,945,803,142,835356,147538,982894
230170,202001,607,551,56,572490.5,58184,630674.5
230180,202001,74,69,5,71691,5195,76886
230185,202001,395,342,53,355338,56106,411444
230190,202001,2308,1846,462,1920073.81,480018,2400091.81
230195,202001,489,426,63,443653,65457,509110
230200,202001,387,332,55,344948,58184,403132
230205,202001,406,264,142,274296,147538,421834
230210,202001,1338,1046,292,1086794.61,303388,1390182.61
230220,202001,1551,1053,498,1095106.5,519500,1614606.5
230230,202001,910,782,128,816654,132992,949646
230240,202001,1721,1485,236,1544215.35,245204.6,1789419.95
230250,202001,1798,1486,312,1547071.39,325207,1872278.39
230260,202001,3184,1984,1200,2063454,1251995,3315449
230270,202001,1354,1097,257,1142902.15,268063.28,1410965.43
230280,202001,2723,2046,677,2126833,703403.7,2830236.7
230290,202001,405,360,45,374040.09,47794,421834.09
230300,202001,516,380,136,394820,141304,536124
230310,202001,426,321,105,333519,110134,443653
230320,202001,928,797,131,829124.2,136109,965233.2
230330,202001,311,250,61,259750,63379.8,323129.8
230340,202001,451,366,85,380274.8,88315,468589.8
230350,202001,3137,1991,1146,2069688.6,1193811,3263499.6
230360,202001,277,224,53,232736,55067,287803
230365,202001,136,115,21,119485,21819,141304
230370,202001,10020,4904,5116,5099416.56,5326954.69,10426371.25
230380,202001,475,408,67,423912.7,70652.6,494565.3
230390,202001,530,299,231,310661,240009,550670
230393,202001,247,206,41,214034,42599,256633
230395,202001,357,288,69,299232.14,71691,370923.14
230400,202001,611,487,124,505993,128836,634829
230410,202001,2711,1700,1011,1767339.74,1053547.5,2820887.24
230420,202001,6262,4171,2091,4337829.07,2175668.08,6513497.15
230423,202001,327,286,41,297154,42599,339753
230425,202001,412,338,74,351182.87,76886,428068.87
230426,202001,121,98,23,101822,23897,125719
230427,202001,77,75,2,77925,2078,80003
230428,202001,1477,747,730,776133,761587,1537720
230430,202001,455,373,82,387547.19,85198,472745.19
230435,202001,883,633,250,657687,259750.52,917437.52
230440,202001,88046,39079,48967,40641552.57,50944281.02,91585833.59
230445,202001,307,217,90,225463,93510,318973
230450,202001,545,436,109,453004,113251,566255
230460,202001,65,51,14,52989,14546,67535
230465,202001,310,254,56,263906,60262,324168
230470,202001,1984,1570,414,1632269,431185.75,2063454.75
230480,202001,161,152,9,157928,9351,167279
230490,202001,298,237,61,246243,64418,310661
230495,202001,453,334,119,347026,123641,470667
230500,202001,1010,748,262,779250,273257,1052507
230510,202001,58,45,13,46755,13507,60262
230520,202001,375,297,78,308583,83120,391703
230523,202001,2283,1444,839,1500316,872760.7,2373076.7
230526,202001,269,228,41,237931,42599,280530
230530,202001,682,509,173,529890,179747,709637
230533,202001,199,186,13,193254,13507,206761
230535,202001,368,275,93,285725,96627,382352
230540,202001,1817,1602,215,1664478,224424,1888902
230550,202001,3795,2442,1353,2540357.78,1406806.58,3947164.36
230560,202001,580,441,139,458199,144421,602620
230565,202001,226,166,60,173513,62340,235853
230570,202001,291,258,33,268062,34287,302349
230580,202001,1166,861,305,894579,317934,1212513
230590,202001,991,778,213,810420.75,221307,1031727.75
230600,202001,247,223,24,232736,24936,257672
230610,202001,363,282,81,292998.8,84159,377157.8
230620,202001,182,153,29,158967.7,30131,189098.7
230625,202001,758,534,224,554826.75,233775,788601.75
230630,202001,1338,1053,285,1094067,296115,1390182
230640,202001,3728,3207,521,3333114,543399.91,3876513.91
230650,202001,447,384,63,398976.58,65457,464433.58
230655,202001,679,585,94,608855.38,97667.55,706522.93
230660,202001,363,304,59,317934,61301,379235
230670,202001,432,377,55,391703,57145,448848
230680,202001,203,184,19,191176,19741,210917
230690,202001,906,776,130,807303,135070,942373
230700,202001,812,684,128,711715,132992,844707
230710,202001,707,673,34,700286.8,35326,735612.8
230720,202001,154,135,19,140265,19741,160006
230725,202001,261,214,47,223385,50911.39,274296.39
230730,202001,12131,6622,5509,6891689.99,5733206.45,12624896.44
230740,202001,677,550,127,571450.7,131953,703403.7
230750,202001,823,698,125,726261.8,130914,857175.8
230760,202001,1390,1197,193,1245761,200527,1446288
230763,202001,320,267,53,277413,55067,332480
230765,202001,7372,3402,3970,3538835.37,4132107.02,7670942.39
230770,202001,5100,2587,2513,2687894.92,2621398.28,5309293.20
230780,202001,713,628,85,652492.7,88315,740807.7
230790,202001,272,228,44,236892,45716,282608
230800,202001,1139,831,308,863409,321051,1184460
230810,202001,1356,1202,154,1249917,160006,1409923
230820,202001,353,247,106,257672.7,110134,367806.7
230830,202001,959,823,136,858214,141304,999518
230835,202001,275,240,35,249360,36365,285725
230837,202001,169,141,28,147538,29092,176630
230840,202001,911,724,187,752236.7,195332.7,947569.4
230850,202001,1484,1290,194,1341349,202605,1543954
230860,202001,296,222,74,230658,76886,307544
230870,202001,1819,1555,264,1618762,275335,1894097
230880,202001,64,48,16,49872,16624,66496
230890,202001,542,498,44,519500,45716.58,565216.58
230900,202001,281,210,71,218190,74808.07,292998.07
230910,202001,218,173,45,179747,46755,226502
230920,202001,425,335,90,348065,93510,441575
230930,202001,977,692,285,721066.24,296115,1017181.24
230940,202001,854,674,180,700286,187020.8,887306.8
230945,202001,511,422,89,438459.5,92471,530930.5
230950,202001,412,358,54,371962,56106,428068
230960,202001,2655,1790,865,1861888.79,899775.48,2761664.27
230970,202001,1744,967,777,1005752.78,809381,1815133.78
230980,202001,204,169,35,177669,36365,214034
230990,202001,138,113,25,117407,25975,143382
231000,202001,205,186,19,193254,19741,212995
231010,202001,144,110,34,114290,35326,149616
231020,202001,1353,940,413,976661.45,429107,1405768.45
231025,202001,1050,786,264,818732.8,274296.7,1093029.5
231030,202001,1099,925,174,961076.17,180786,1141862.17
231040,202001,137,93,44,96627,45716,142343
231050,202001,958,850,108,885228,112212,997440
231060,202001,151,127,24,131953,24936,156889
231070,202001,1489,1045,444,1085757.43,461316,1547073.43
231080,202001,261,241,20,251438,20780,272218
231085,202001,600,361,239,377157.8,249360,626517.8
231090,202001,242,198,44,206761,45716,252477
231095,202001,168,133,35,138187,37404,175591
231100,202001,149,124,25,128836,25975,154811
231110,202001,363,311,52,324168,55067,379235
231120,202001,273,232,41,241048,42599,283647
231123,202001,145,138,7,143382,7273,150655
231126,202001,333,261,72,271179.7,74808,345987.7
231130,202001,4614,3602,1012,3745596.22,1057703.28,4803299.50
231135,202001,210,182,28,189098,29092,218190
231140,202001,3069,2260,809,2348140,840551,3188691
231150,202001,365,347,18,360533,18702,379235
231160,202001,1195,945,250,981855,259750,1241605
231170,202001,522,360,162,375079,169357,544436
231180,202001,1681,1434,247,1492004,256633,1748637
231190,202001,208,175,33,182864,34287,217151
231195,202001,217,186,31,193254,32209,225463
231200,202001,811,665,146,691974.78,152733.8,844708.58
231210,202001,582,488,94,507032,97666,604698
231220,202001,1045,768,277,798992.45,287803,1086795.45
231230,202001,1455,1157,298,1203162,309622,1512784
231240,202001,1443,1040,403,1080560,418717,1499277
231250,202001,112,103,9,107017,9351,116368
231260,202001,277,183,94,190137,97666,287803
231270,202001,1014,833,181,865489.02,188059,1053548.02
231280,202001,73,56,17,58184,17663,75847
231290,202001,7572,4245,3327,4419907.53,3464026.48,7883934.01
231300,202001,617,572,45,596386,46755,643141
231310,202001,741,686,55,716911.5,57145.78,774057.28
231320,202001,591,448,143,466513.5,148577,615090.5
231325,202001,94,83,11,86237,11429,97666
231330,202001,2013,1559,454,1624220.3,471706.7,2095927.0
231335,202001,253,225,28,233775,29092,262867
231340,202001,1711,1267,444,1320569,465472,1786041
231350,202001,1287,1057,230,1101340,238971.4,1340311.4
231355,202001,437,375,62,391703,64418,456121
231360,202001,503,377,126,391704.01,130914,522618.01
231370,202001,86,74,12,76886,13507,90393
231375,202001,287,210,77,218190,80003,298193
231380,202001,483,391,92,409366,95588,504954
231390,202001,202,160,42,167279,43638,210917
231395,202001,731,457,274,474823,284686,759509
231400,202001,1119,931,188,969389.71,195333.86,1164723.57
231410,202001,1312,1078,234,1123159.6,243126,1366285.6
240010,202001,389,174,215,180786.26,223385.39,404171.65
240020,202001,2288,1834,454,1905527.27,472745.58,2378272.85
240030,202001,118,102,16,105978,16624,122602
240040,202001,31,31,0,32209,0,32209
240050,202001,532,457,75,474823,77925,552748
240060,202001,64,60,4,62340,4156,66496
240070,202001,212,165,47,171435,48833,220268
240080,202001,508,347,161,360533.19,168318.41,528851.60
240090,202001,105,94,11,97666,11429,109095
240100,202001,1496,1417,79,1472263.75,83120,1555383.75
240110,202001,1048,690,358,716912.67,371963.68,1088876.35
240120,202001,127,105,22,109095,22858,131953
240130,202001,280,260,20,271179,20780,291959
240140,202001,78,58,20,60262,20780,81042
240145,202001,728,653,75,678467,77925,756392
240150,202001,22,16,6,16624,6234,22858
240160,202001,40,35,5,36365,5195,41560
240165,202001,33,26,7,28053.75,7273,35326.75
240170,202001,99,75,24,77925,24936,102861
240180,202001,86,71,15,73769,15585,89354
240185,202001,43,40,3,41560,3117,44677
240190,202001,15,13,2,13507,2078,15585
240200,202001,3080,1726,1354,1794357.4,1407846.7,3202204.1
240210,202001,171,133,38,138187,39482,177669
240220,202001,1107,798,309,830161.85,323129,1153290.85
240230,202001,853,787,66,818734.43,68574,887308.43
240240,202001,70,49,21,51950,21819,73769
240250,202001,89,77,12,80003,12468,92471
240260,202001,1805,1345,460,1397455,478979,1876434
240270,202001,187,164,23,171435,23897,195332
240280,202001,42,34,8,35326,8312,43638
240290,202001,51,49,2,50911,2078,52989
240300,202001,171,98,73,101822,75847,177669
240310,202001,2297,1278,1019,1328883.8,1058741,2387624.8
240320,202001,191,181,10,190137,10390,200527
240325,202001,4468,2689,1779,2796990.58,1849421.13,4646411.71
240330,202001,71,68,3,70652,3117,73769
240340,202001,66,41,25,42599,25975,68574
240350,202001,100,88,12,91432,12468,103900
240360,202001,541,343,198,356377,205722,562099
240370,202001,50,46,4,47794,4156,51950
240375,202001,66,39,27,40521,28053,68574
240380,202001,228,190,38,197410,39482.9,236892.9
240390,202001,12,11,1,11429,1039,12468
240400,202001,84,78,6,81042,6234,87276
240410,202001,12,7,5,7273,5195,12468
240420,202001,970,726,244,756392.6,253516,1009908.6
240430,202001,264,246,18,255594,18702,274296
240440,202001,112,64,48,66496,49872,116368
240450,202001,223,153,70,158967.7,72730,231697.7
240460,202001,63,47,16,48833,16624,65457
240470,202001,235,207,28,216112,29092,245204
240480,202001,15,13,2,13507,2078,15585
240485,202001,78,65,13,67535,13507,81042
240490,202001,46,44,2,45716,2078,47794
240500,202001,80,63,17,65457,17663,83120
240510,202001,44,32,12,33248,12468,45716
240520,202001,117,112,5,116368,5195,121563
240530,202001,51,46,5,47794,5195,52989
240540,202001,77,66,11,68574,11429,80003
240550,202001,13,12,1,12468,1039,13507
240560,202001,375,273,102,283647.5,105978,389625.5
240570,202001,452,286,166,298193,172474.7,470667.7
240580,202001,1275,1020,255,1060820.55,264945.19,1325765.74
240590,202001,30,28,2,29092,2078,31170
240600,202001,109,105,4,109095,4156,113251
240610,202001,513,432,81,449888.48,84159,534047.48
240615,202001,20,19,1,19741,1039,20780
240620,202001,88,84,4,87276,4156,91432
240630,202001,38,33,5,34287,5195,39482
240640,202001,26,22,4,22858,4156,27014
240650,202001,239,200,39,207800,40521,248321
240660,202001,107,93,14,98705,14546,113251
240670,202001,300,177,123,183903.85,127797,311700.85
240680,202001,50,38,12,40521,12468,52989
240690,202001,47,44,3,45716,3117,48833
240700,202001,186,154,32,160006,33248,193254
240710,202001,2011,1255,756,1304985.65,785484,2090469.65
240720,202001,1063,794,269,828083,280530.6,1108613.6
240725,202001,63,59,4,61301,4156,65457
240730,202001,142,125,17,129875,17663,147538
240740,202001,232,199,33,206761,35326.07,242087.07
240750,202001,51,26,25,27014,25975,52989
240760,202001,47,43,4,44677,4156,48833
240770,202001,146,112,34,116368,35326,151694
240780,202001,673,551,122,572489,126758,699247
240790,202001,42,40,2,41560,2078,43638
240800,202001,9170,6242,2928,6491685.91,3048431.06,9540116.97
240810,202001,20269,11042,9227,11492397.39,9595177.26,21087574.65
240820,202001,237,139,98,144422.45,101822,246244.45
240830,202001,1638,1347,291,1399533.85,304427,1703960.85
240840,202001,79,70,9,72730,9351,82081
240850,202001,87,77,10,80003,10390,90393
240860,202001,108,104,4,109095,4156,113251
240870,202001,59,51,8,52989,8312,61301
240880,202001,31,27,4,28053,4156,32209
240890,202001,1116,651,465,676389.68,483135.19,1159524.87
240895,202001,57,36,21,37404,21819,59223
240910,202001,159,143,16,148577,16624,165201
240920,202001,13,10,3,11429,3117,14546
240930,202001,412,369,43,383391,44677,428068
240933,202001,39,29,10,30131,10390,40521
240940,202001,2403,2134,269,2219304.19,279491.78,2498795.97
240950,202001,46,42,4,43638,4156,47794
240960,202001,29,25,4,25975,4156,30131
240970,202001,110,81,29,84159,31170,115329
240980,202001,194,157,37,163123,38443,201566
240990,202001,130,88,42,91432,43638,135070
241000,202001,62,58,4,60262,4156,64418
241010,202001,65,50,15,51950,15585,67535
241020,202001,114,106,8,110134,8312,118446
241025,202001,11,6,5,6234,5195,11429
241030,202001,109,89,20,92471,20780,113251
241040,202001,43,31,12,32209,12468,44677
241050,202001,83,74,9,76886,9351,86237
241060,202001,29,24,5,24936,5195,30131
241070,202001,17,17,0,17663,0,17663
241080,202001,61,54,7,56106,7273,63379
241090,202001,55,45,10,46755,10390,57145
241100,202001,73,62,11,64418,11429,75847
241105,202001,5,1,4,1039,4156,5195
241110,202001,46,44,2,45716,2078,47794
241120,202001,1469,1125,344,1171993.28,359494,1531487.28
241140,202001,218,180,38,187020.7,39482,226502.7
241142,202001,41,36,5,37404,5195,42599
241150,202001,1178,1035,143,1076404,148577,1224981
241160,202001,23,20,3,20780,3117,23897
241170,202001,43,37,6,38443,6234,44677
241180,202001,43,37,6,39482,6234,45716
241190,202001,37,36,1,38443,1039,39482
241200,202001,3853,2034,1819,2117484.65,1894097.19,4011581.84
241210,202001,68,58,10,60262,10390,70652
241220,202001,1428,967,461,1005753.44,478979.58,1484733.02
241230,202001,241,204,37,212995.78,38443,251438.78
241240,202001,54,43,11,45716,11429,57145
241250,202001,1145,1050,95,1093028.7,99744,1192772.7
241255,202001,50,40,10,42599,10390,52989
241260,202001,669,521,148,541319,153772,695091
241270,202001,66,43,23,44677,23897,68574
241280,202001,95,82,13,85198,13507,98705
241290,202001,123,88,35,91432,36365,127797
241300,202001,76,55,21,57145,21819,78964
241310,202001,51,37,14,38443.85,14546,52989.85
241320,202001,28,15,13,15585,13507,29092
241330,202001,59,55,4,58184,4156,62340
241335,202001,73,65,8,68574,8312,76886
241340,202001,181,134,47,139226,48833,188059
241350,202001,60,51,9,52989,10390,63379
241355,202001,47,41,6,42599,6234,48833
241360,202001,52,51,1,52989,1039,54028
241370,202001,50,42,8,43638,8312,51950
241380,202001,38,34,4,35326,4156,39482
241390,202001,83,66,17,68574,18702,87276
241400,202001,217,177,40,183903,41560,225463
241410,202001,186,166,20,172474,20780,193254
241415,202001,101,81,20,84159,20780,104939
241420,202001,103,73,30,75847,31170.02,107017.02
241430,202001,28,25,3,25975,3117,29092
241440,202001,533,431,102,447812.7,105978,553790.7
241445,202001,35,33,2,34287,2078,36365
241450,202001,285,234,51,243126,52989,296115
241460,202001,137,123,14,127797.75,14546,142343.75
241470,202001,40,34,6,35326,6234,41560
241475,202001,57,54,3,56106,3117,59223
241480,202001,89,64,25,66496,25975,92471
241490,202001,11,10,1,10390,1039,11429
241500,202001,47,36,11,37404,11429,48833
250010,202001,102,86,16,89354,16624,105978
250020,202001,33,30,3,31170,3117,34287
250030,202001,850,643,207,669116,215073.8,884189.8
250040,202001,373,305,68,316895,71691,388586
250050,202001,249,204,45,211956.19,46755,258711.19
250053,202001,54,41,13,42599,13507,56106
250057,202001,0,,,,,0.0
250060,202001,547,400,147,415600,152733,568333
250070,202001,716,570,146,594308.78,151694,746002.78
250073,202001,8,8,0,8312,0,8312
250077,202001,183,140,43,145460,44677,190137
250080,202001,426,332,94,344948.46,97666,442614.46
250090,202001,209,135,74,140265,76886,217151
250100,202001,518,427,91,444692,94549.6,539241.6
250110,202001,592,455,137,472745,142343,615088
250115,202001,21,7,14,7273,14546,21819
250120,202001,118,86,32,89354,33248,122602
250130,202001,569,465,104,484174,109095.8,593269.8
250135,202001,17,10,7,10390,7273,17663
250140,202001,83,74,9,76886,9351,86237
250150,202001,587,426,161,442614,167279,609893
250153,202001,9,6,3,6234,3117,9351
250157,202001,31,24,7,24936,7273,32209
250160,202001,226,176,50,182864,51950,234814
250170,202001,63,41,22,42599,22858,65457
250180,202001,4181,2868,1313,2984010.98,1365248.57,4349259.55
250190,202001,847,557,290,579762,301310.75,881072.75
250200,202001,50,43,7,44677,7273,51950
250205,202001,24,20,4,20780,4156,24936
250210,202001,86,76,10,78964,10390,89354
250215,202001,65,55,10,58184,10390,68574
250220,202001,24,18,6,18702,6234,24936
250230,202001,77,71,6,73769.19,6234,80003.19
250240,202001,234,196,38,203644,39482,243126
250250,202001,396,343,53,358455,55067,413522
250260,202001,42,36,6,37404,6234,43638
250270,202001,67,50,17,51950,17663,69613
250280,202001,387,320,67,332480,69613,402093
250290,202001,89,81,8,84159,8312,92471
250300,202001,549,376,173,390664,179747.58,570411.58
250310,202001,47,43,4,44677,4156,48833
250320,202001,1938,1323,615,1375637.86,640025.09,2015662.95
250330,202001,96,81,15,84159,15585,99744
250340,202001,24,22,2,22858,2078,24936
250350,202001,155,102,53,107017,55067,162084
250355,202001,35,27,8,28053,8312,36365
250360,202001,201,164,37,170396,38443,208839
250370,202001,2377,1600,777,1665517,808342,2473859
250375,202001,9,5,4,5195,4156,9351
250380,202001,59,43,16,44677,16624,61301
250390,202001,43,33,10,34287,10390,44677
250400,202001,16288,8252,8036,8580054.06,8361876.27,16941930.33
250403,202001,334,275,59,285725,61301,347026
250407,202001,58,48,10,50911,10390,61301
250410,202001,30,26,4,27014,4156,31170
250415,202001,39,26,13,27014,13507,40521
250420,202001,44,38,6,39482,6234,45716
250430,202001,1458,1255,203,1307321.75,210917,1518238.75
250435,202001,19,14,5,14546,5195,19741
250440,202001,679,569,110,591191.8,115329,706520.8
250450,202001,81,67,14,69613,14546,84159
250460,202001,460,314,146,326246,151694,477940
250470,202001,91,64,27,66496,28053,94549
250480,202001,326,260,66,270140,68574,338714
250485,202001,1,1,0,1039,0,1039
250490,202001,225,183,42,190137,43638,233775
250500,202001,86,65,21,67535,21819,89354
250510,202001,747,592,155,615088,161045,776133
250520,202001,179,124,55,128836,57145,185981
250523,202001,116,94,22,97666,22858,120524
250527,202001,100,79,21,82081,21819,103900
250530,202001,9,5,4,5195,4156,9351
250535,202001,27,20,7,20780,7273,28053
250540,202001,130,101,29,104939,30131,135070
250550,202001,72,69,3,71691,3117,74808
250560,202001,46,34,12,35326,12468,47794
250570,202001,164,134,30,139226,31170,170396
250580,202001,110,84,26,87343,27014,114357
250590,202001,25,15,10,15585,10390,25975
250600,202001,1359,905,454,941335.6,471706,1413041.6
250610,202001,155,131,24,136109,24936,161045
250620,202001,24,18,6,18702,6234,24936
250625,202001,70,51,19,52989,19741,72730
250630,202001,3016,1931,1085,2007353.25,1128355.52,3135708.77
250640,202001,218,176,42,183903,43638,227541
250650,202001,27,19,8,19741,8312,28053
250660,202001,49,38,11,39482,11429,50911
250670,202001,65,44,21,45716,21819,67535
250680,202001,399,325,74,337675,80003,417678
250690,202001,1969,1362,607,1416160.44,631712,2047872.44
250700,202001,934,816,118,847824.75,122602,970426.75
250710,202001,432,339,93,352221,96627,448848
250720,202001,111,84,27,87276,28053,115329
250730,202001,373,313,60,325207,62340,387547
250740,202001,53,49,4,50911,4156,55067
250750,202001,21901,13228,8673,13753145.38,9022681.04,22775826.42
250760,202001,88,70,18,72730,18702,91432
250770,202001,361,237,124,246243.92,128836,375079.92
250780,202001,63,45,18,46755,18702,65457
250790,202001,465,303,162,315856,170396,486252
250800,202001,149,136,13,141304,13507,154811
250810,202001,79,60,19,62340,19741,82081
250820,202001,152,127,25,131953,27014,158967
250830,202001,435,296,139,308583.7,145460,454043.7
250840,202001,52,48,4,49872,4156,54028
250850,202001,56,47,9,48833,9351,58184
250855,202001,14,11,3,11429,3117,14546
250860,202001,207,143,64,148577,66496,215073
250870,202001,31,26,5,27014,5195,32209
250880,202001,81,62,19,64418,19741,84159
250890,202001,2761,2074,687,2154886.9,715871,2870757.9
250900,202001,48,41,7,42599,7273,49872
250905,202001,117,91,26,94549,27014,121563
250910,202001,1138,826,312,858214.19,325207,1183421.19
250915,202001,106,74,32,76886,33248,110134
250920,202001,138,102,36,105978,37404,143382
250930,202001,165,100,65,103900,67535,171435
250933,202001,2,2,0,2078,0,2078
250937,202001,8,7,1,7273,1039,8312
250939,202001,35,26,9,27014,9351,36365
250940,202001,107,80,27,83120,28053,111173
250950,202001,71,48,23,49872,23897,73769
250960,202001,90,50,40,51950,41560,93510
250970,202001,1230,871,359,904969.78,373001,1277970.78
250980,202001,102,70,32,72730,33248,105978
250990,202001,165,127,38,132992,39482,172474
251000,202001,76,68,8,70652,8312,78964
251010,202001,111,83,28,86237.19,29092,115329.19
251020,202001,81,68,13,70652,13507,84159
251030,202001,45,35,10,37404,10390,47794
251040,202001,53,39,14,40521,14546,55067
251050,202001,23,21,2,21819,2078,23897
251060,202001,50,39,11,40521,11429,51950
251065,202001,4,4,0,4156,0,4156
251070,202001,20,16,4,16624.39,4156,20780.39
251080,202001,4966,2394,2572,2487375.45,2674389.05,5161764.50
251090,202001,194,167,27,173513,28053,201566
251100,202001,19,18,1,18702,1039,19741
251110,202001,45,36,9,37404,9351,46755
251120,202001,1852,1135,717,1182385.5,746002.24,1928387.74
251130,202001,389,316,73,328324,75847,404171
251140,202001,552,361,191,375080.6,199488,574568.6
251150,202001,328,282,46,292998.39,47794,340792.39
251160,202001,93,76,17,78964.19,17663,96627.19
251170,202001,103,83,20,86237.19,20780,107017.19
251180,202001,287,176,111,182864.19,115329.19,298193.38
251190,202001,199,131,68,136109,70652,206761
251200,202001,267,220,47,228580,48833,277413
251203,202001,35,33,2,34287,2078,36365
251207,202001,90,74,16,76886,16624,93510
251210,202001,1473,1076,397,1117964,412483,1530447
251220,202001,48,36,12,37404,12468,49872
251230,202001,595,502,93,521578.78,96627,618205.78
251240,202001,100,69,31,71691,32209,103900
251250,202001,1399,999,400,1040040.45,416639.85,1456680.30
251260,202001,12,6,6,6234,6234,12468
251270,202001,325,248,77,257672,80003,337675
251272,202001,65,58,7,60262,7273,67535
251274,202001,29,22,7,22858,7273,30131
251275,202001,33,20,13,20780,13507,34287
251276,202001,12,10,2,10390,3117,13507
251278,202001,10,8,2,8312,2078,10390
251280,202001,100,96,4,99744,4156,103900
251290,202001,753,554,199,576645,207800,784445
251300,202001,14,12,2,12468,2078,14546
251310,202001,372,266,106,276374.19,110134,386508.19
251315,202001,30,27,3,28053,3117,31170
251320,202001,60,47,13,48833,13507,62340
251330,202001,77,68,9,70652,9351,80003
251335,202001,14,9,5,9351,5195,14546
251340,202001,720,426,294,442614,305466,748080
251350,202001,34,33,1,34287,1039,35326
251360,202001,78,68,10,71691,10390,82081
251365,202001,15,15,0,15585,0,15585
251370,202001,5522,3738,1784,3886900.9,1856693.8,5743594.7
251380,202001,45,37,8,38443,8312,46755
251385,202001,3,3,0,3117,0,3117
251390,202001,777,590,187,613010,194293.7,807303.7
251392,202001,14,8,6,8312,6234,14546
251394,202001,10,10,0,10390,0,10390
251396,202001,12,8,4,8312,4156,12468
251398,202001,17,15,2,15585,2078,17663
251400,202001,38,33,5,34287,5195,39482
251410,202001,37,30,7,31170,7273,38443
251420,202001,102,74,28,76886,29092,105978
251430,202001,42,39,3,40521,3117,43638
251440,202001,36,22,14,22858,14546,37404
251445,202001,49,43,6,44677.75,6234,50911.75
251450,202001,401,350,51,363650.6,52989,416639.6
251455,202001,4,2,2,2078,2078,4156
251460,202001,16,14,2,14546,2078,16624
251465,202001,4,2,2,2078,2078,4156
251470,202001,47,38,9,39482,9351,48833
251480,202001,27,22,5,22858,5195,28053
251490,202001,122,84,38,87276,39482.7,126758.7
251500,202001,127,103,24,107017,24936,131953
251510,202001,43,30,13,31170,13507,44677
251520,202001,26,26,0,27014,0,27014
251530,202001,4491,3156,1335,3283240.9,1388104,4671344.9
251540,202001,76,63,13,65457,13507,78964
251550,202001,408,314,94,326246,97667.45,423913.45
251560,202001,22,15,7,15585,7273,22858
251570,202001,19,18,1,18702,1039,19741
251580,202001,132,105,27,109095,28053,137148
251590,202001,121,88,33,91629,34287,125916
251593,202001,26,16,10,16624,10390,27014
251597,202001,70,54,16,56106,16624,72730
251600,202001,1096,779,317,811465.46,330402.8,1141868.26
251610,202001,236,183,53,190137,55067,245204
251615,202001,6,6,0,6234,0,6234
251620,202001,4212,2773,1439,2885306.12,1498240.3,4383546.42
251630,202001,459,338,121,352221,125719.39,477940.39
251640,202001,144,102,42,105978,43638,149616
251650,202001,266,195,71,202605.85,73769,276374.85
251660,202001,188,169,19,175591,19741,195332
251670,202001,367,289,78,301310,81042,382352
251675,202001,6,6,0,6234,0,6234
251680,202001,94,87,7,90393,7273,97666
251690,202001,340,280,60,290920,63379,354299
251700,202001,287,249,38,258711.58,39482,298193.58
251710,202001,23,15,8,15585,8312,23897
251720,202001,23,15,8,15585,8312.7,23897.7
251740,202001,10,8,2,8312,2078,10390
260005,202001,3200,1777,1423,1850462.98,1484733.34,3335196.32
260010,202001,1597,1170,427,1215630.35,444692.02,1660322.37
260020,202001,414,366,48,382352,50911,433263
260030,202001,606,429,177,445731,183903,629634
260040,202001,808,509,299,528851,310661,839512
260050,202001,1169,838,331,871721,344949.4,1216670.4
260060,202001,383,351,32,364689,33248,397937
260070,202001,1376,852,524,887308.45,545475.26,1432783.71
260080,202001,737,575,162,597425,168318,765743
260090,202001,509,329,180,342870.78,188059,530929.78
260100,202001,220,153,67,158967,69613,228580
260105,202001,229,126,103,130914,107017,237931
260110,202001,2872,2123,749,2206837.79,779250.89,2986088.68
260120,202001,2836,1457,1379,1514864.76,1436937.85,2951802.61
260130,202001,167,115,52,119485,54028,173513
260140,202001,2148,1397,751,1453567.71,780289.39,2233857.10
260150,202001,214,138,76,145460,78964,224424
260160,202001,330,278,52,288842,54028,342870
260170,202001,3369,2050,1319,2132028.84,1371480.7,3503509.54
260180,202001,157,129,28,135070,29092,164162
260190,202001,2304,1592,712,1655127,739768,2394895
260200,202001,973,782,191,813537.29,199488.7,1013025.99
260210,202001,1437,1029,408,1071209,423912.39,1495121.39
260220,202001,708,637,71,661843.7,74808,736651.7
260230,202001,1201,898,303,933022.13,314817,1247839.13
260240,202001,225,170,55,176630,57145,233775
260250,202001,91,68,23,70652,23897,94549
260260,202001,1045,745,300,774055,312739,1086794
260270,202001,417,331,86,343909,89354,433263
260280,202001,1317,924,393,961075,409366.7,1370441.7
260290,202001,6515,3533,2982,3678065.57,3107653.47,6785719.04
260300,202001,941,818,123,850942.3,128836,979778.3
260310,202001,518,408,110,423912,115329,539241
260320,202001,871,643,228,668077.78,236892,904969.78
260330,202001,59,41,18,42599,18702,61301
260340,202001,76,56,20,58184,20780,78964
260345,202001,5553,3056,2497,3183498.89,2600618.56,5784117.45
260350,202001,489,355,134,368845.7,139226.39,508072.09
260360,202001,271,144,127,149616,132992,282608
260370,202001,714,473,241,492486.75,250399.19,742885.94
260380,202001,586,430,156,448848.78,164162.47,613011.25
260390,202001,300,253,47,262867,48833,311700
260392,202001,103,89,14,92471,14546,107017
260400,202001,4112,2372,1740,2466588.96,1813055,4279643.96
260410,202001,14736,7725,7011,8029395.29,7289625.04,15319020.33
260415,202001,134,118,16,122602,16624,139226
260420,202001,1749,1067,682,1111731.2,708598,1820329.2
260430,202001,190,173,17,180787.39,18702,199489.39
260440,202001,206,146,60,152733.39,62340,215073.39
260450,202001,434,318,116,330402.67,120524,450926.67
260460,202001,830,440,390,457161.6,406249,863410.6
260470,202001,354,217,137,225463,142343.9,367806.9
260480,202001,227,148,79,153772,82081,235853
260490,202001,213,177,36,183903,37404,221307
260500,202001,1128,758,370,788601,385469,1174070
260510,202001,777,625,152,650414,157928,808342
260515,202001,245,222,23,230658,23897,254555
260520,202001,3257,1983,1274,2064493.19,1324725.99,3389219.18
260530,202001,811,665,146,690935,152733,843668
260540,202001,556,437,119,455082,124680,579762
260545,202001,11,9,2,9351,2078,11429
260550,202001,332,207,125,215073,129875,344948
260560,202001,534,401,133,416639.7,138187,554826.7
260570,202001,981,803,178,837434.7,184942,1022376.7
260580,202001,252,223,29,231697,30131,261828
260590,202001,628,364,264,378196,275335.7,653531.7
260600,202001,7978,4323,3655,4492640.34,3806897.28,8299537.62
260610,202001,495,328,167,340792,173513,514305
260620,202001,3694,1934,1760,2011507.01,1831759.7,3843266.71
260630,202001,88,82,6,85198,6234,91432
260640,202001,3575,1993,1582,2071767.45,1645776.78,3717544.23
260650,202001,329,241,88,250399,91432,341831
260660,202001,556,376,180,390664,187020,577684
260670,202001,104,77,27,80003,28053,108056
260680,202001,3693,2074,1619,2160082.96,1686298.48,3846381.44
260690,202001,129,95,34,98705,35326,134031
260700,202001,314,207,107,215073,111173,326246
260710,202001,41,36,5,37404,5195,42599
260720,202001,2394,1422,972,1480577.8,1013025,2493602.8
260730,202001,684,514,170,534046,176630,710676
260740,202001,62,58,4,60262,4156,64418
260750,202001,607,436,171,453004,177669,630673
260760,202001,647,342,305,356377.13,316895,673272.13
260765,202001,984,506,478,525734.19,496642,1022376.19
260770,202001,221,165,56,172456,59223,231679
260775,202001,795,456,339,474825.55,353260.39,828085.94
260780,202001,259,167,92,173513,96627,270140
260790,202001,12839,6792,6047,7061054.26,6296343.41,13357397.67
260795,202001,170,115,55,119485,57145,176630
260800,202001,283,238,45,247282.5,47794,295076.5
260805,202001,171,114,57,118446,59223,177669
260810,202001,744,644,100,670155,103900,774055
260820,202001,292,187,105,194293.87,110134,304427.87
260825,202001,208,148,60,153772,62340,216112
260830,202001,279,174,105,180786,110134,290920
260840,202001,233,172,61,178708,63379,242087
260845,202001,172,120,52,124680,55067,179747
260850,202001,455,335,120,348065,124680,472745
260860,202001,253,190,63,197410,65457,262867
260870,202001,374,281,93,292998,96627,389625
260875,202001,730,522,208,545475,216112,761587
260880,202001,1591,1015,576,1056663.6,599503,1656166.6
260890,202001,2392,1686,706,1753833.92,734573.9,2488407.82
260900,202001,984,694,290,721066,302349,1023415
260910,202001,261,205,56,212995,58184,271179
260915,202001,296,214,82,222346,85198,307544
260920,202001,175,95,80,98705,83120,181825
260930,202001,401,343,58,356378.74,60262.58,416641.32
260940,202001,2721,1490,1231,1551229.68,1281088.2,2832317.88
260950,202001,2019,1167,852,1214591.85,889384,2103975.85
260960,202001,13809,7064,6745,7346784.34,7016372.8,14363157.14
260970,202001,425,358,67,371962,70652,442614
260980,202001,192,171,21,177669,21819,199488
260990,202001,2598,2111,487,2193331.17,505993,2699324.17
261000,202001,4298,2568,1730,2674387.61,1800587.8,4474975.41
261010,202001,175,129,46,134031,48833,182864
261020,202001,605,454,151,471707.09,156889,628596.09
261030,202001,239,177,62,183903,64418,248321
261040,202001,375,327,48,339753,49872,389625
261050,202001,504,438,66,455082,68574,523656
261060,202001,1375,888,487,923671.75,507032,1430703.75
261070,202001,8724,4373,4351,4550840.96,4534232.94,9085073.90
261080,202001,382,291,91,302349,94549,396898
261090,202001,2239,1723,516,1794356.57,536124.25,2330480.82
261100,202001,1144,803,341,835357.65,354299,1189656.65
261110,202001,8603,5285,3318,5501507.93,3450522.27,8952030.20
261120,202001,262,225,37,233775,40521,274296
261130,202001,581,345,236,358455.8,247282.41,605738.21
261140,202001,190,121,69,125719,71691,197410
261150,202001,685,424,261,440536.77,271179,711715.77
261153,202001,68,64,4,66496,4156,70652
261160,202001,76341,38150,38191,39694017.13,39769823.48,79463840.61
261170,202001,473,360,113,375079,118446,493525
261180,202001,1786,1103,683,1150173,715871,1866044
261190,202001,620,435,185,451966.36,192215.39,644181.75
261200,202001,219,189,30,196371,31170,227541
261210,202001,34,28,6,29092,6234,35326
261220,202001,2703,1904,799,1982414.52,833278.58,2815693.10
261230,202001,344,257,87,270140,92471,362611
261240,202001,463,404,59,420795,62340,483135
261245,202001,233,193,40,201566,41560,243126
261247,202001,172,137,35,143382,37404,180786
261250,202001,3060,1527,1533,1589671.45,1593826,3183497.45
261255,202001,249,228,21,236892,21819,258711
261260,202001,864,750,114,780289.24,118446,898735.24
261270,202001,197,142,55,147538,57145,204683
261280,202001,176,144,32,149616,33248,182864
261290,202001,121,87,34,90393,35326,125719
261300,202001,1305,947,358,983933,371962,1355895
261310,202001,815,550,265,572489,275335,847824
261320,202001,563,387,176,403132,182864.39,585996.39
261330,202001,989,757,232,787562,241048.29,1028610.29
261340,202001,290,164,126,170396,130914,301310
261350,202001,839,599,240,622361.7,250399,872760.7
261360,202001,1289,844,445,881072,462355,1343427
261370,202001,4834,2928,1906,3046351.58,1986569.79,5032921.37
261380,202001,553,417,136,433263.17,141304.7,574567.87
261390,202001,3608,2434,1174,2533083.66,1219786.85,3752870.51
261400,202001,288,263,25,273257,25975,299232
261410,202001,1102,735,367,767821,381313,1149134
261420,202001,875,546,329,567295.78,343909,911204.78
261430,202001,334,299,35,310661,36365,347026
261440,202001,123,113,10,117407,10390,127797
261450,202001,2531,2064,467,2149693.65,485213.7,2634907.35
261460,202001,710,568,142,590152.07,148577,738729.07
261470,202001,242,189,53,196371,55067,251438
261480,202001,449,351,98,365728.8,102815.19,468543.99
261485,202001,346,212,134,221307,139226,360533
261500,202001,602,413,189,430146.04,196371,626517.04
261510,202001,48,31,17,32209,17663,49872
261520,202001,114,100,14,103900,14546,118446
261530,202001,4130,2611,1519,2716987.12,1582398.45,4299385.57
261540,202001,1310,787,523,818732,544436,1363168
261550,202001,266,131,135,136109.7,140265,276374.7
261560,202001,837,554,283,576646.85,295077.09,871723.94
261570,202001,394,311,83,323129,86237,409366
261580,202001,376,293,83,304427,87276,391703
261590,202001,195,158,37,164162,38443,202605
261600,202001,294,237,57,247282,59223.5,306505.5
261610,202001,95,81,14,84159,14546,98705
261618,202001,77,62,15,64418,15585,80003
261620,202001,207,127,80,131953,83120,215073
261630,202001,568,445,123,462355,127797,590152
261640,202001,6399,3401,2998,3536761.11,3121157.45,6657918.56
261650,202001,485,306,179,317934,185981,503915
270010,202001,526,467,59,485213,61301,546514
270020,202001,289,232,57,242087.19,60262,302349.19
270030,202001,8769,5670,3099,5898449.91,3226109.16,9124559.07
270040,202001,1987,1248,739,1296672,767821,2064493
270050,202001,153,116,37,120524,38443,158967
270060,202001,113,63,50,66496,51950,118446
270070,202001,873,641,232,665999,243126.39,909125.39
270080,202001,38,31,7,32209,7273,39482
270090,202001,20,15,5,15585,5195,20780
270100,202001,1221,817,404,848863.39,422873,1271736.39
270110,202001,126,97,29,100783,30131,130914
270120,202001,222,182,40,189098,41560,230658
270130,202001,252,176,76,182864,78964,261828
270135,202001,115,72,43,74808.85,44677,119485.85
270140,202001,1368,857,511,891463.67,530929.39,1422393.06
270150,202001,257,202,55,209878,57145,267023
270160,202001,513,399,114,414561,118446,533007
270170,202001,787,513,274,534046,284686,818732
270180,202001,74,57,17,59223,17663,76886
270190,202001,89,78,11,81042,11429,92471
270200,202001,102,90,12,93510,12468,105978
270210,202001,498,281,217,296115,226502,522617
270220,202001,176,141,35,146499,37404,183903
270230,202001,2099,1294,805,1346131.22,838473.39,2184604.61
270235,202001,700,543,157,564179.73,163124.95,727304.68
270240,202001,3085,2447,638,2546590.61,666002.47,3212593.08
270250,202001,158,114,44,118446,45716,164162
270255,202001,208,177,31,183903,32209,216112
270260,202001,364,297,67,308583,69613,378196
270270,202001,96,42,54,43638.39,56106,99744.39
270280,202001,242,135,107,140265,111173,251438
270290,202001,1168,895,273,929905,285725.39,1215630.39
270300,202001,297,202,95,209878,98705,308583
270310,202001,857,705,152,733536.34,158967.39,892503.73
270320,202001,837,717,120,748081.38,124680,872761.38
270330,202001,285,242,43,251438,44677,296115
270340,202001,60,47,13,48833,13507,62340
270350,202001,92,49,43,50911,44677,95588
270360,202001,60,34,26,35326,27014,62340
270370,202001,54,45,9,46755,9351,56106
270375,202001,72,46,26,47794,27014,74808
270380,202001,1004,621,383,647297,401054,1048351
270390,202001,188,112,76,116368,78964,195332
270400,202001,712,525,187,545476.77,194293,739769.77
270410,202001,661,486,175,504954,182864,687818
270420,202001,396,272,124,282608,128836.78,411444.78
270430,202001,32823,23600,9223,24553881.19,9597249.7,34151130.89
270440,202001,487,386,101,401054,104939,505993
270450,202001,793,444,349,461316,363650,824966
270460,202001,194,155,39,161045,40521,201566
270470,202001,1411,998,413,1037961,431185,1469146
270480,202001,536,442,94,460277.7,99744,560021.7
270490,202001,25,20,5,20780,5195,25975
270500,202001,489,408,81,424951,85198,510149
270510,202001,786,486,300,507032,313778,820810
270520,202001,307,196,111,203644,115329,318973
270530,202001,67,58,9,60262,9351,69613
270540,202001,110,86,24,89354,24936,114290
270550,202001,1761,1348,413,1402650.38,429107,1831757.38
270560,202001,272,140,132,145460,137148,282608
270570,202001,502,354,148,368117.7,153772,521889.7
270580,202001,96,72,24,74808,24936,99744
270590,202001,68,54,14,56106,14546,70652
270600,202001,179,148,31,153772,32209,185981
270610,202001,209,176,33,182864,35326,218190
270620,202001,30,29,1,30131,1039,31170
270630,202001,3750,2860,890,2972582.18,924710.58,3897292.76
270640,202001,874,649,225,675350,233776.95,909126.95
270642,202001,219,186,33,193254,34287,227541
270644,202001,247,162,85,168318.39,88315,256633.39
270650,202001,320,190,130,198449,135070,333519
270660,202001,249,206,43,215073,44677,259750
270670,202001,3053,2340,713,2431263.95,742885,3174148.95
270680,202001,450,265,185,275335,194293,469628
270690,202001,1160,755,405,784445,421834,1206279
270700,202001,30,24,6,24936,6234,31170
270710,202001,873,673,200,699247,207801.56,907048.56
270720,202001,245,194,51,201566,52989,254555
270730,202001,1854,1115,739,1158485.9,769900.94,1928386.84
270740,202001,40,27,13,28053,13507,41560
270750,202001,641,483,158,501837.8,165201,667038.8
270760,202001,293,215,78,223385,81042,304427
270770,202001,2762,1808,954,1881631.15,992245.78,2873876.93
270780,202001,76,49,27,50911,29092.38,80003.38
270790,202001,256,171,85,177669,88315,265984
270800,202001,1975,1587,388,1654088.19,404171,2058259.19
270810,202001,281,223,58,231697,60262,291959
270820,202001,148,98,50,101822,51950.9,153772.9
270830,202001,798,590,208,613010.38,217151.19,830161.57
270840,202001,1405,1071,334,1116925.5,348065.07,1464990.57
270850,202001,1531,951,580,991207.5,605737,1596944.5
270860,202001,2511,1668,843,1734092.38,878994.58,2613086.96
270870,202001,128,68,60,70652,63379,134031
270880,202001,896,694,202,722144.7,209880.73,932025.43
270890,202001,302,221,81,229619,84159,313778
270895,202001,64,55,9,57145,9351,66496
270900,202001,94,73,21,75847,21819,97666
270910,202001,310,250,60,259750,62340,322090
270915,202001,1904,1190,714,1236421.79,744968.6,1981390.39
270920,202001,473,398,75,415600,78964,494564
270930,202001,6014,4492,1522,4671522.63,1584478.05,6256000.68
270940,202001,2326,1810,516,1886824,538202,2425026
280010,202001,40,34,6,35326,6234,41560
280020,202001,465,406,59,421834.66,61301,483135.66
280030,202001,20218,13095,7123,13627566.7,7421589.64,21049156.34
280040,202001,327,213,114,221307,118446,339753
280050,202001,386,296,90,307544,93510,401054
280060,202001,353,230,123,238970.14,127797,366767.14
280067,202001,1045,750,295,780289.72,306505.87,1086795.59
280070,202001,119,98,21,101822,21819,123641
280100,202001,623,488,135,508071.7,140265.8,648337.5
280110,202001,74,69,5,71691,5195,76886
280120,202001,630,519,111,539241,115329,654570
280130,202001,1671,1091,580,1135627,605737.9,1741364.9
280140,202001,475,389,86,406249,89354,495603
280150,202001,384,276,108,286764,112212,398976
280160,202001,96,82,14,85198,14546,99744
280170,202001,399,271,128,281569,132992,414561
280190,202001,28,27,1,28053,1039,29092
280200,202001,27,23,4,23897,4156,28053
280210,202001,2905,2094,811,2176585.68,843669.4,3020255.08
280220,202001,40,32,8,34287,8312,42599
280230,202001,325,267,58,278452,60262,338714
280240,202001,116,111,5,115329,5195,120524
280250,202001,16,10,6,10390,6234,16624
280260,202001,83,74,9,76886,9351,86237
280270,202001,149,117,32,121563,34287,155850
280280,202001,190,121,69,125719.92,71691,197410.92
280290,202001,3330,2421,909,2517432.47,945490.02,3462922.49
280300,202001,1592,1237,355,1286282.7,369884,1656166.7
280310,202001,101,97,4,100783.9,4156,104939.9
280320,202001,662,463,199,482096,207800,689896
280330,202001,335,240,95,251438,98705,350143
280340,202001,398,324,74,337675,76886,414561
280350,202001,3627,2820,807,2931023.32,838473.85,3769497.17
280360,202001,458,302,156,313778,163123,476901
280370,202001,97,86,11,89354.33,11429,100783.33
280380,202001,55,43,12,44677,12468,57145
280390,202001,172,148,24,153772,24936,178708
280400,202001,352,240,112,249361.48,116368,365729.48
280410,202001,289,235,54,244165.8,56106,300271.8
280420,202001,172,144,28,149616,29092,178708
280430,202001,35,26,9,27014,9351,36365
280440,202001,696,544,152,565218.03,157928,723146.03
280445,202001,120,110,10,114290,10390,124680
280450,202001,1179,1016,163,1055624,169357,1224981
280460,202001,621,455,166,472745.85,172474,645219.85
280470,202001,189,175,14,181825,14546.85,196371.85
280480,202001,2564,1802,762,1877476.8,798991.4,2676468.2
280490,202001,272,256,16,265984.32,16624,282608.32
280500,202001,38,35,3,36365,3117,39482
280510,202001,138,110,28,114290,29092.7,143382.7
280520,202001,54,39,15,40521,15585,56106
280530,202001,72,47,25,48833,27014,75847
280540,202001,531,440,91,458199,95588,553787
280550,202001,725,672,53,698208.88,55067,753275.88
280560,202001,497,438,59,455082,62340,517422
280570,202001,2210,1726,484,1794735.75,503915,2298650.75
280580,202001,600,466,134,485214.79,139226.9,624441.69
280590,202001,190,116,74,120524,76886,197410
280600,202001,388,324,64,338714,66496,405210
280610,202001,121,92,29,95588,30131,125719
280620,202001,551,454,97,471706,100783,572489
280630,202001,148,124,24,128836,24936,153772
280640,202001,188,151,37,157928.78,38443,196371.78
280650,202001,89,61,28,63379,29092,92471
280660,202001,142,108,34,112212,35326,147538
280670,202001,1795,1134,661,1180310.13,689897,1870207.13
280680,202001,170,148,22,153772.69,22858,176630.69
280690,202001,82,73,9,75847,9351,85198
280700,202001,22,22,0,22858,0,22858
280710,202001,1457,1125,332,1169914.8,349104,1519018.8
280720,202001,113,73,40,76886,42599,119485
280730,202001,26,21,5,21819,5195,27014
280740,202001,2512,1875,637,1949164,661843,2611007
280750,202001,228,199,29,206761,30131,236892
280760,202001,753,517,236,537163,245204,782367
290010,202001,202,142,60,147538,63379,210917
290020,202001,180,164,16,170396,16624,187020
290030,202001,616,397,219,412483,227541,640024
290035,202001,128,103,25,107017,25975,132992
290040,202001,302,203,99,211956,102861,314817
290050,202001,86,66,20,68574,20780,89354
290060,202001,261,118,143,124680,148577,273257
290070,202001,5693,2806,2887,2921669.67,3005831.19,5927500.86
290080,202001,471,215,256,223385.78,265984.78,489370.56
290090,202001,390,177,213,183903,221307,405210
290100,202001,1638,1079,559,1121082.6,580802.2,1701884.8
290110,202001,824,488,336,507032.84,350143.19,857176.03
290115,202001,199,185,14,192215,14546,206761
290120,202001,758,503,255,522617.29,264945,787562.29
290130,202001,426,263,163,273257,170396,443653
290135,202001,297,227,70,235853,72730,308583
290140,202001,314,259,55,269101,57145,326246
290150,202001,136,100,36,103900,37404,141304
290160,202001,236,179,57,185981,59223,245204
290170,202001,91,66,25,68574,25975,94549
290180,202001,180,133,47,139226.8,48833,188059.8
290190,202001,435,356,79,369884,82081,451965
290195,202001,309,199,110,206761,114290,321051
290200,202001,274,222,52,230658,54028,284686
290205,202001,148,91,57,94549,59223,153772
290210,202001,1160,856,304,889384.7,315856,1205240.7
290220,202001,221,123,98,127797,101822,229619
290225,202001,286,110,176,114290,182864,297154
290230,202001,73,48,25,49872,25975,75847
290240,202001,343,136,207,141304,215073,356377
290250,202001,257,237,20,246243,20780,267023
290260,202001,313,254,59,263906.7,61301,325207.7
290265,202001,189,161,28,167279,29092.78,196371.78
290270,202001,1431,1189,242,1237449.75,251439.48,1488889.23
290280,202001,472,336,136,349104.39,141304,490408.39
290290,202001,1290,768,522,797953.68,542359.4,1340313.08
290300,202001,442,376,66,390664.7,68574,459238.7
290310,202001,303,136,167,141304,173513,314817
290320,202001,4077,2534,1543,2636982.74,1604216.82,4241199.56
290323,202001,194,169,25,175591,25975,201566
290327,202001,164,129,35,134031,36365,170396
290330,202001,98,55,43,57145,44677,101822
290340,202001,853,348,505,361572,526773,888345
290350,202001,622,377,245,392742.2,254555,647297.2
290360,202001,361,277,84,287803.87,87276,375079.87
290370,202001,922,390,532,406249,554826.58,961075.58
290380,202001,319,198,121,205722,126758,332480
290390,202001,2456,1542,914,1604220.45,949646,2553866.45
290395,202001,252,146,106,151694.75,110134,261828.75
290400,202001,276,207,69,215074.5,71691,286765.5
290405,202001,249,215,34,224424,35326,259750
290410,202001,632,530,102,550671.19,107017,657688.19
290420,202001,253,205,48,212995,49872,262867
290430,202001,476,307,169,320012,175591,495603
290440,202001,73,66,7,68574,7273,75847
290450,202001,204,159,45,165201,46755,211956
290460,202001,1937,1177,760,1222906.9,791719.12,2014626.02
290470,202001,1413,602,811,626520.9,844713.63,1471234.53
290475,202001,567,529,38,551709.24,39482,591191.24
290480,202001,285,158,127,164162,131953,296115
290485,202001,243,225,18,233775,18702,252477
290490,202001,1217,880,337,915359,350143,1265502
290500,202001,727,377,350,392742,363650,756392
290510,202001,227,177,50,184942,51950,236892
290515,202001,148,93,55,96627,57145,153772
290520,202001,1440,958,482,995363.47,500799.64,1496163.11
290530,202001,303,280,23,291959,23897,315856
290540,202001,103,55,48,57145,49872,107017
290550,202001,153,127,26,131953,27014,158967
290560,202001,3219,1361,1858,1417196.78,1934619.56,3351816.34
290570,202001,6127,3027,3100,3146095.43,3231294.65,6377390.08
290580,202001,1292,771,521,803147,541319,1344466
290590,202001,568,470,98,488330,101822,590152
290600,202001,1757,1212,545,1261346.94,570411,1831757.94
290610,202001,207,186,21,193254.97,21819,215073.97
290620,202001,352,314,38,326246,39482,365728
290630,202001,2007,855,1152,889384,1196929.87,2086313.87
290640,202001,155,125,30,129875,31170,161045
290650,202001,1746,812,934,846785.92,971465,1818250.92
290660,202001,278,225,53,233775,55067,288842
290670,202001,937,487,450,507034.16,468589,975623.16
290680,202001,1240,999,241,1037961,251438,1289399
290682,202001,310,232,78,241048.59,81042,322090.59
290685,202001,237,154,83,160006,86237,246243
290687,202001,1027,661,366,686948.02,381313,1068261.02
290689,202001,142,76,66,78964.58,69613,148577.58
290690,202001,607,257,350,267023.39,363653.12,630676.51
290700,202001,246,118,128,122602,132992,255594
290710,202001,720,490,230,510149,240009,750158
290720,202001,1034,839,195,873799,202605,1076404
290730,202001,1150,663,487,689896.7,505993,1195889.7
290740,202001,16,14,2,14546,2078,16624
290750,202001,1416,632,784,657687,815618.61,1473305.61
290755,202001,73,65,8,67535,8312,75847
290760,202001,298,259,39,269101,40521,309622
290770,202001,190,179,11,185981,11429.7,197410.7
290780,202001,1079,831,248,864450.57,258711,1123161.57
290790,202001,366,254,112,263906,116368.7,380274.7
290800,202001,2546,1022,1524,1063936.89,1584475,2648411.89
290810,202001,468,325,143,337675,149616,487291
290820,202001,401,237,164,246243,170396,416639
290830,202001,409,293,116,304427,121563,425990
290840,202001,1742,1087,655,1129394.54,680546.4,1809940.94
290850,202001,819,444,375,461316,389625,850941
290860,202001,629,289,340,300271,353260.7,653531.7
290870,202001,640,451,189,468590.52,196371.12,664961.64
290880,202001,121,66,55,68574,57145,125719
290890,202001,382,264,118,274296,122602,396898
290900,202001,167,129,38,134031,39482,173513
290910,202001,386,300,86,311700,89354,401054
290920,202001,216,186,30,193254,32209,225463
290930,202001,837,634,203,658726.7,210917.78,869644.48
290940,202001,246,204,42,212995,43638,256633
290950,202001,154,94,60,97666,62340,160006
290960,202001,473,328,145,342870,150655,493525
290970,202001,251,221,30,230658,31170.2,261828.2
290980,202001,1606,1141,465,1186538.94,483136.6,1669675.54
290990,202001,397,336,61,349105.17,63380.56,412485.73
291000,202001,864,250,614,259750,638985,898735
291005,202001,2286,1016,1270,1055624.56,1321608,2377232.56
291010,202001,155,141,14,147538,14546,162084
291020,202001,102,80,22,83120,22858,105978
291030,202001,96,70,26,72730,27014,99744
291040,202001,598,331,267,343909,277413,621322
291050,202001,1426,786,640,817693.78,668077,1485770.78
291060,202001,1539,851,688,885228,715871,1601099
291070,202001,1976,1467,509,1526293.39,528851.51,2055144.90
291072,202001,7273,2723,4550,2831277.01,4733687.58,7564964.59
291075,202001,231,190,41,198449.8,42599,241048.8
291077,202001,54,37,17,38443,17663,56106
291080,202001,20221,8943,11278,9302176.97,11732396.13,21034573.10
291085,202001,302,248,54,257672,56106,313778
291090,202001,305,121,184,125719.7,191176,316895.7
291100,202001,664,199,465,206761,483135,689896
291110,202001,421,320,101,332480,104939,437419
291120,202001,2447,1205,1242,1253034.85,1291477.19,2544512.04
291125,202001,64,30,34,31170,35326,66496
291130,202001,207,184,23,191176,23897,215073
291140,202001,144,115,29,119485,30131.7,149616.7
291150,202001,385,148,237,153772,246243,400015
291160,202001,388,320,68,332480.75,70652,403132.75
291165,202001,35,29,6,30131,6234,36365
291170,202001,3115,1563,1552,1624998.63,1615645.7,3240644.33
291180,202001,1270,504,766,523657.26,795876.34,1319533.60
291185,202001,86,83,3,86237,3117,89354
291190,202001,1349,594,755,617166.75,785484,1402650.75
291200,202001,170,129,41,134031,42599,176630
291210,202001,2271,911,1360,946529.94,1415118.7,2361648.64
291220,202001,275,209,66,218190,69613,287803
291230,202001,994,350,644,364689.7,670155,1034844.7
291240,202001,423,400,23,415600.7,23897,439497.7
291250,202001,449,364,85,378196,88315,466511
291260,202001,56,46,10,47794,10390,58184
291270,202001,1164,488,676,507032,704442,1211474
291280,202001,366,174,192,180786,199488,380274
291290,202001,1734,892,842,927827.7,875878.5,1803706.2
291300,202001,231,182,49,189098,50911,240009
291310,202001,225,206,19,214034,19741,233775
291320,202001,1369,973,396,1015103,411444,1426547
291330,202001,132,113,19,117407,19741,137148
291340,202001,200,114,86,118446,89354,207800
291345,202001,138,95,43,98705,44677,143382
291350,202001,1638,582,1056,604698,1098223.85,1702921.85
291360,202001,8480,4146,4334,4310815.53,4508224.11,8819039.64
291370,202001,1128,639,489,663921.7,511188.39,1175110.09
291380,202001,261,206,55,214034,57145,271179
291390,202001,3890,1716,2174,1783965.92,2260865.4,4044831.32
291400,202001,2076,1486,590,1543954,614049.69,2158003.69
291410,202001,187,165,22,171435,22858,194293
291420,202001,120,88,32,91432,33248,124680
291430,202001,164,89,75,92471,77925.35,170396.35
291440,202001,521,428,93,444693.4,97666,542359.4
291450,202001,902,579,323,601581.75,335597,937178.75
291460,202001,1837,1503,334,1563697.8,348065.7,1911763.5
291465,202001,2178,1034,1144,1077453.45,1190702.58,2268156.03
291470,202001,2859,1440,1419,1498239.6,1476419.7,2974659.3
291480,202001,11843,5279,6564,5492171.3,6838750.52,12330921.82
291490,202001,593,242,351,251438,364689,616127
291500,202001,375,219,156,229619,163123,392742
291510,202001,1231,477,754,496642,785484,1282126
291520,202001,941,429,512,446770,535085,981855
291530,202001,947,259,688,269101,715871,984972
291535,202001,124,103,21,107017,21819,128836
291540,202001,340,100,240,103900.7,249360.6,353261.3
291550,202001,1228,579,649,601582.6,675351.09,1276933.69
291560,202001,5320,2702,2618,2810554.49,2724370.74,5534925.23
291570,202001,198,103,95,107017,98705,205722
291580,202001,1221,756,465,785484.5,483135,1268619.5
291590,202001,87,36,51,37404,52989.7,90393.7
291600,202001,1149,572,577,595347,601581.78,1196928.78
291610,202001,1471,717,754,744963,786524.19,1531487.19
291620,202001,576,267,309,277413,323129,600542
291630,202001,479,148,331,154811,343909,498720
291640,202001,3956,2018,1938,2098783.1,2013588,4112371.1
291650,202001,417,289,128,300271.57,135070,435341.57
291660,202001,402,159,243,165201.29,252477,417678.29
291670,202001,224,138,86,143382,89354,232736
291680,202001,661,392,269,407288,281569.9,688857.9
291685,202001,591,330,261,342870,271179,614049
291690,202001,544,314,230,326246,238970.72,565216.72
291700,202001,971,760,211,792757,219229,1011986
291710,202001,1654,803,851,835356.75,887306,1722662.75
291720,202001,421,282,139,292998,144421,437419
291730,202001,947,560,387,581840,403132,984972
291733,202001,285,196,89,205722,92471,298193
291735,202001,75,56,19,58184,19741,77925
291740,202001,357,278,79,289881,82081,371962
291750,202001,2108,1376,732,1430704.8,763665,2194369.8
291760,202001,2997,1656,1341,1723701,1396416,3120117
291770,202001,786,531,255,551712.86,267023,818735.86
291780,202001,58,36,22,37404,22858,60262
291790,202001,165,83,82,87276,85198,172474
291800,202001,10044,4151,5893,4316009.54,6135298.44,10451307.98
291810,202001,1109,823,286,856136.7,300271.8,1156408.5
291820,202001,273,197,76,204683,78964,283647
291830,202001,1100,442,658,459239.71,683662.39,1142902.10
291835,202001,579,537,42,557943,43638,601581
291840,202001,4836,2469,2367,2568408.78,2463469.7,5031878.48
291845,202001,272,91,181,94549,189098,283647
291850,202001,325,289,36,300271,37404,337675
291855,202001,260,102,158,105978,164162,270140
291860,202001,167,107,60,111173,62340,173513
291870,202001,83,33,50,34287,51950,86237
291875,202001,180,167,13,173513,13507,187020
291880,202001,463,370,93,386508.8,96627,483135.8
291890,202001,239,76,163,78964,169357.7,248321.7
291900,202001,57,32,25,33248,25975,59223
291905,202001,127,93,34,96627.7,35326,131953.7
291910,202001,164,134,30,139226,31170,170396
291915,202001,430,381,49,395859.75,50911,446770.75
291920,202001,5063,2586,2477,2689972.97,2576720.7,5266693.67
291930,202001,177,105,72,109095.84,74808,183903.84
291940,202001,359,203,156,211956.5,162084,374040.5
291950,202001,1148,931,217,968349.2,225463,1193812.2
291955,202001,1242,744,498,775094,519500,1294594
291960,202001,186,135,51,140265,52989,193254
291970,202001,769,586,183,609893,192215,802108
291980,202001,1517,1345,172,1397456.5,178708.7,1576165.2
291990,202001,131,121,10,125719,10390,136109
291992,202001,172,87,85,90393,89354,179747
291995,202001,167,110,57,114290,59223,173513
292000,202001,393,305,88,316895.7,91432,408327.7
292010,202001,301,210,91,218190,95588,313778
292020,202001,291,212,79,221307,82081,303388
292030,202001,148,114,34,118446,35326,153772
292040,202001,635,318,317,330402,329363,659765
292045,202001,103,96,7,99744,7273,107017
292050,202001,944,692,252,718988,263906.7,982894.7
292060,202001,919,767,152,797953.23,158967,956920.23
292070,202001,51,19,32,19741,34287,54028
292080,202001,140,96,44,100783,45716,146499
292090,202001,532,188,344,196371,359494,555865
292100,202001,1476,638,838,663921.8,872760.39,1536682.19
292105,202001,198,172,26,179747,27014,206761
292110,202001,2261,837,1424,871721,1480577.73,2352298.73
292120,202001,692,550,142,572489,147538,720027
292130,202001,445,258,187,268062,194293,462355
292140,202001,207,167,40,173513,41560,215073
292145,202001,163,88,75,91432.7,77925,169357.7
292150,202001,1478,1205,273,1251995,284686,1536681
292160,202001,173,142,31,147538,32209,179747
292170,202001,1214,1059,155,1100301,161045,1261346
292180,202001,216,158,58,164162,60262,224424
292190,202001,163,104,59,108056,61301,169357
292200,202001,1324,488,836,509110.78,868604.7,1377715.48
292205,202001,126,112,14,116368,14546,130914
292210,202001,365,258,107,268062,111173.75,379235.75
292220,202001,27,21,6,21819,6234,28053
292225,202001,39,34,5,35326,5195,40521
292230,202001,979,781,198,811459.65,205722,1017181.65
292240,202001,622,447,175,465472.85,181825,647297.85
292250,202001,1743,1153,590,1199006,615088,1814094
292260,202001,415,249,166,258711,172474,431185
292265,202001,251,179,72,185981,74808,260789
292270,202001,737,339,398,352221,413522.8,765743.8
292273,202001,197,111,86,115329,89354,204683
292275,202001,176,86,90,89354,94549,183903
292280,202001,141,100,41,104939,42599,147538
292285,202001,71,60,11,62340,11429,73769
292290,202001,573,391,182,406249,189098.7,595347.7
292300,202001,1674,635,1039,660804,1080560.46,1741364.46
292303,202001,110,73,37,75847,38443,114290
292305,202001,116,86,30,89354,31170,120524
292310,202001,907,600,307,623401.82,320012.58,943414.40
292320,202001,603,457,146,474823,151694,626517
292330,202001,175,101,74,104939,76886,181825
292335,202001,281,218,63,226502,65457,291959
292340,202001,573,404,169,419756.7,176630,596386.7
292350,202001,270,144,126,149616,130914,280530
292360,202001,709,540,169,561060.58,175591,736651.58
292370,202001,751,578,173,600542,180786,781328
292380,202001,648,519,129,540280.97,134031,674311.97
292390,202001,482,191,291,198449,302349,500798
292400,202001,3581,2207,1374,2300352.03,1433821.5,3734173.53
292405,202001,260,173,87,179747,90393,270140
292410,202001,140,86,54,89354,56106,145460
292420,202001,290,250,40,259750,41560,301310
292430,202001,528,408,120,424951,124680,549631
292440,202001,583,503,80,522617.48,83120,605737.48
292450,202001,251,196,55,203644,57145,260789
292460,202001,552,413,139,430146.89,144421,574567.89
292465,202001,213,177,36,184942,37404,222346
292467,202001,113,68,45,70652,46755,117407
292470,202001,286,194,92,201566,95588,297154
292480,202001,356,243,113,252477,117407.7,369884.7
292490,202001,237,166,71,172474,73769,246243
292500,202001,867,389,478,405211.4,498720,903931.4
292510,202001,3423,1587,1836,1649932.92,1912799.8,3562732.72
292520,202001,1088,509,579,529890.19,602620.39,1132510.58
292525,202001,401,281,120,291959.8,124680,416639.8
292530,202001,4356,1772,2584,1845265.33,2692053.75,4537319.08
292540,202001,461,260,201,270140,209878,480018
292550,202001,1073,579,494,601590.36,513273.41,1114863.77
292560,202001,328,308,20,321051,20780,341831
292570,202001,306,237,69,246243,72730,318973
292575,202001,497,327,170,339753.7,176630.7,516384.4
292580,202001,984,655,329,680545,343909.7,1024454.7
292590,202001,555,486,69,504954,71691,576645
292593,202001,140,110,30,114290,31170,145460
292595,202001,196,152,44,157928,45716,203644
292600,202001,1254,917,337,953802.29,350143,1303945.29
292610,202001,136,104,32,108056,33248,141304
292620,202001,522,442,80,460277.7,83120,543397.7
292630,202001,1412,801,611,833278.43,635868.87,1469147.30
292640,202001,808,554,254,575606,263906,839512
292650,202001,183,154,29,161045.7,30131,191176.7
292660,202001,2032,1464,568,1522135,592230.06,2114365.06
292665,202001,144,105,39,109095,40521,149616
292670,202001,395,324,71,336636.19,73769,410405.19
292680,202001,251,192,59,199488,61301.5,260789.5
292690,202001,191,145,46,150655,47794,198449
292700,202001,956,635,321,660804,333519,994323
292710,202001,111,98,13,101822,13507,115329
292720,202001,915,525,390,546514,406249,952763
292730,202001,196,92,104,95588,108056,203644
292740,202001,68596,33767,34829,35129668.74,36255937.43,71385606.17
292750,202001,387,277,110,287803.29,114290,402093.29
292760,202001,333,277,56,287803.79,58184,345987.79
292770,202001,804,347,457,360533.7,475862,836395.7
292780,202001,406,159,247,165201,256633,421834
292790,202001,758,388,370,404171,384430,788601
292800,202001,1241,746,495,777172,516383,1293555
292805,202001,401,120,281,124680,291959,416639
292810,202001,1497,853,644,886269.1,671194.39,1557463.49
292820,202001,725,599,126,622362.25,130914.39,753276.64
292830,202001,108,89,19,92471,19741,112212
292840,202001,689,569,120,591191.8,124680,715871.8
292850,202001,138,94,44,97666,46755,144421
292860,202001,2172,1271,901,1320569.7,940295.8,2260865.5
292870,202001,3455,2321,1134,2413598.16,1180304.9,3593903.06
292880,202001,1495,984,511,1024454.51,530929,1555383.51
292890,202001,519,444,75,463395.16,77925,541320.16
292895,202001,140,91,49,94549,50911,145460
292900,202001,392,280,112,291960.18,117407,409367.18
292905,202001,470,241,229,251438,237931,489369
292910,202001,450,340,110,355338.65,114290,469628.65
292920,202001,516,230,286,240009,298193,538202
292925,202001,486,448,38,465472,39482,504954
292930,202001,603,366,237,380274,248321,628595
292935,202001,288,123,165,127797,171435.39,299232.39
292937,202001,231,163,68,169357,71691,241048
292940,202001,195,152,43,157928,44677,202605
292950,202001,1152,586,566,608856.45,588074.6,1196931.05
292960,202001,593,420,173,437419,180786,618205
292970,202001,246,175,71,181825,73769,255594
292975,202001,126,71,55,73769,57145.8,130914.8
292980,202001,285,191,94,198449.53,97666,296115.53
292990,202001,1331,990,341,1028612.64,354299,1382911.64
293000,202001,110,77,33,80003,34287,114290
293010,202001,2771,1670,1101,1736169.65,1144979.69,2881149.34
293015,202001,644,523,121,543397,125719,669116
293020,202001,333,272,61,283647,63379.5,347026.5
293030,202001,596,520,76,541319.4,78964,620283.4
293040,202001,355,284,71,296115,73769,369884
293050,202001,2848,1696,1152,1763183.7,1199007.89,2962191.59
293060,202001,259,210,49,218190.96,50911,269101.96
293070,202001,3473,1769,1704,1840072.99,1772536.14,3612609.13
293075,202001,92,61,31,63379,32209,95588
293076,202001,70,49,21,50911,21819,72730
293077,202001,497,294,203,306505.7,210917,517422.7
293080,202001,439,393,46,408328.57,47794,456122.57
293090,202001,136,120,16,124680,16624,141304
293100,202001,523,369,154,383391,160006,543397
293105,202001,344,246,98,255594,101822,357416
293110,202001,169,121,48,125719,49872,175591
293120,202001,323,223,100,231697.72,103900,335597.72
293130,202001,246,170,76,176630,78964,255594
293135,202001,7994,3151,4843,3277021.09,5042307.85,8319328.94
293140,202001,205,134,71,139226.8,73769,212995.8
293150,202001,332,286,46,297154,47794,344948
293160,202001,419,244,175,253516,182864,436380
293170,202001,172,119,53,123641,55067,178708
293180,202001,495,354,141,367806.7,146499,514305.7
293190,202001,1340,934,406,970426.73,423912,1394338.73
293200,202001,544,483,61,501837,63379,565216
293210,202001,392,300,92,311700,95588,407288
293220,202001,2513,1060,1453,1103418,1510706,2614124
293230,202001,1707,632,1075,657688.01,1123159,1780847.01
293240,202001,230,212,18,220268,18702,238970
293245,202001,123,104,19,108056,19741,127797
293250,202001,709,254,455,263906.34,472745,736651.34
293260,202001,295,245,50,255594.78,51950,307544.78
293270,202001,1157,543,614,565216.7,638985,1204201.7
293280,202001,264,146,118,152733,122602,275335
293290,202001,3025,1985,1040,2062415,1084716.58,3147131.58
293300,202001,722,518,204,538203.43,211956,750159.43
293305,202001,187,152,35,157928,36365,194293
293310,202001,147,112,35,116368,36365,152733
293315,202001,163,127,36,131953,37404,169357
293317,202001,94,68,26,70652,27014,97666
293320,202001,1038,588,450,610932.35,468589,1079521.35
293325,202001,182,67,115,69613,119485,189098
293330,202001,13518,6375,7143,6627786.19,7431973.51,14059759.70
293340,202001,267,192,75,199488,77925,277413
293345,202001,246,202,44,209878,45716,255594
293350,202001,614,353,261,366767.7,271179,637946.7
293360,202001,1542,1103,439,1147056,457160,1604216
310010,202001,138,75,63,77925,65457.7,143382.7
310020,202001,1025,573,452,595347,471706.92,1067053.92
310030,202001,335,270,65,280530.6,67535,348065.6
310040,202001,42,29,13,30131,13507,43638
310050,202001,186,117,69,121563,71691,193254
310060,202001,242,171,71,177669.5,73769,251438.5
310070,202001,13,8,5,8312,5195,13507
310080,202001,43,25,18,27014,18702,45716
310090,202001,996,523,473,543399.8,491448.4,1034848.2
310100,202001,298,225,73,233775,75847,309622
310110,202001,718,391,327,407288,340792.7,748080.7
310120,202001,373,218,155,226502,161045,387547
310130,202001,31,19,12,19741,12468,32209
310140,202001,25,13,12,13507,12468,25975
310150,202001,1232,843,389,875879.3,405211.4,1281090.7
310160,202001,2039,1022,1017,1062898.35,1059781.4,2122679.75
310163,202001,87,50,37,51950,38443,90393
310170,202001,2545,1141,1404,1187577.77,1460836.8,2648414.57
310180,202001,137,52,85,54028.7,88315,142343.7
310190,202001,470,330,140,342870,145460,488330
310200,202001,491,315,176,327285.7,182864,510149.7
310205,202001,51,36,15,37404,15585,52989
310210,202001,282,227,55,235853,57145,292998
310220,202001,58,33,25,34287,25975,60262
310230,202001,273,190,83,197410,86237,283647
310240,202001,105,95,10,98705,10390,109095
310250,202001,98,80,18,83120,18702,101822
310260,202001,770,414,356,430147.71,370923,801070.71
310270,202001,271,177,94,183903.92,97666,281569.92
310280,202001,378,278,100,288842,103900,392742
310285,202001,209,151,58,156889,60262,217151
310290,202001,249,135,114,140265,118446,258711
310300,202001,156,129,27,134031,28053,162084
310310,202001,10,8,2,8312,2078,10390
310320,202001,29,13,16,13507,16624,30131
310330,202001,36,25,11,25975,11429,37404
310340,202001,1749,1157,592,1204204.4,615088.7,1819293.1
310350,202001,2807,1518,1289,1580319,1342388,2922707
310360,202001,41,34,7,35326,7273,42599
310370,202001,116,97,19,100783,19741.7,120524.7
310375,202001,103,39,64,40521,66496.78,107017.78
310380,202001,49,28,21,29092,21819,50911
310390,202001,92,63,29,65457,31170,96627
310400,202001,2365,1545,820,1607334.4,851980,2459314.4
310410,202001,126,72,54,75847,56106,131953
310420,202001,678,358,320,371962.8,332480.6,704443.4
310430,202001,312,203,109,211956,113251,325207
310440,202001,76,44,32,45716,33248,78964
310445,202001,80,67,13,69613,13507,83120
310450,202001,635,385,250,400015.78,261828,661843.78
310460,202001,257,183,74,191176,76886,268062
310470,202001,509,325,184,337675,192215,529890
310480,202001,73,53,20,55067,20780,75847
310490,202001,537,257,280,267023,290920,557943
310500,202001,132,53,79,55067,82081,137148
310510,202001,604,418,186,434302,193254.39,627556.39
310520,202001,131,92,39,96627,40521,137148
310530,202001,101,42,59,43638,61301,104939
310540,202001,455,272,183,282608.8,191176,473784.8
310550,202001,80,51,29,52989,30131,83120
310560,202001,2994,2069,925,2152810.78,962114,3114924.78
310570,202001,103,69,34,71691,35326,107017
310590,202001,365,236,129,245204.55,135070,380274.55
310600,202001,150,81,69,84159.7,71691,155850.7
310610,202001,59,23,36,23897,37404,61301
310620,202001,47101,22660,24441,23588375.8,25450321.88,49038697.68
310630,202001,636,402,234,418717,243126.7,661843.7
310640,202001,138,107,31,111173,32209,143382
310650,202001,163,145,18,151694,18702,170396
310660,202001,96,63,33,65457,34287,99744
310665,202001,59,44,15,45716,16624,62340
310670,202001,6602,2911,3691,3029728.55,3841194.15,6870922.70
310680,202001,57,36,21,37404,21819,59223
310690,202001,601,417,184,433263.55,191176,624439.55
310700,202001,58,39,19,40521,19741,60262
310710,202001,1332,916,416,952764.09,434302.7,1387066.79
310720,202001,120,35,85,36365,88315,124680
310730,202001,1420,997,423,1037962.95,441575.7,1479538.65
310740,202001,975,540,435,561061.4,453004.75,1014066.15
310750,202001,244,146,98,151694.63,101822,253516.63
310760,202001,61,44,17,45716,18702.7,64418.7
310770,202001,101,48,53,49872,55067,104939
310780,202001,364,296,68,307544.39,70652,378196.39
310790,202001,99,81,18,84159,18702,102861
310800,202001,453,219,234,227541.75,245204,472745.75
310810,202001,170,123,47,127798.71,48833,176631.71
310820,202001,346,275,71,285725,73769,359494
310825,202001,194,165,29,171435,30131,201566
310830,202001,469,228,241,236892.7,250399,487291.7
310840,202001,364,214,150,222346,156889,379235
310850,202001,106,86,20,89354,20780,110134
310855,202001,394,312,82,324168,85198,409366
310860,202001,1595,1180,415,1227063.3,431186.35,1658249.65
310870,202001,52,43,9,44677,9351,54028
310880,202001,81,63,18,66496,18702,85198
310890,202001,304,179,125,185981,129875,315856
310900,202001,647,300,347,312748.66,362624.74,675373.40
310910,202001,235,162,73,168319.3,75847,244166.3
310920,202001,456,269,187,279493.37,194293.97,473787.34
310925,202001,35,28,7,29092,7273.7,36365.7
310930,202001,1316,832,484,865489.85,502877.9,1368367.75
310940,202001,677,346,331,360533,344948,705481
310945,202001,122,77,45,80003,47794,127797
310950,202001,243,196,47,204683,48833,253516
310960,202001,79,27,52,28053,54028.19,82081.19
310970,202001,159,100,59,104939,61301.7,166240.7
310980,202001,46,29,17,30131,17663,47794
310990,202001,153,81,72,85198,74808,160006
311000,202001,803,408,395,429108.62,412484.09,841592.71
311010,202001,44,38,6,39482,6234,45716
311020,202001,45,28,17,29092,17663,46755
311030,202001,390,228,162,236892.5,168318,405210.5
311040,202001,42,35,7,36365,7273,43638
311050,202001,484,194,290,201566.4,301310,502876.4
311060,202001,779,436,343,453004,356377.7,809381.7
311070,202001,346,160,186,167279,193254,360533
311080,202001,108,59,49,61301,50911,112212
311090,202001,345,162,183,168318,190137,358455
311100,202001,598,361,237,375079,246243,621322
311110,202001,688,482,206,500798,215073,715871
311115,202001,77,55,22,58184,22858,81042
311120,202001,1085,578,507,602620.7,527812,1130432.7
311130,202001,364,219,145,227541,150655,378196
311140,202001,166,89,77,92471,80003,172474
311150,202001,354,233,121,243126,125719,368845
311160,202001,703,505,198,526773.7,205722,732495.7
311170,202001,84,67,17,69613,17663,87276
311180,202001,328,223,105,231697,109095.7,340792.7
311190,202001,36,19,17,19741,17663,37404
311200,202001,324,229,95,237931,98705,336636
311205,202001,33,23,10,23897,10390,34287
311210,202001,45,40,5,42599.7,5195,47794.7
311220,202001,22,20,2,20780,2078,22858
311230,202001,1633,1077,556,1120043.5,580801,1700844.5
311240,202001,182,118,64,122602,66496,189098
311250,202001,96,28,68,29092,70652,99744
311260,202001,556,350,206,364689,214034,578723
311265,202001,122,83,39,86237,40521,126758
311270,202001,289,196,93,203644,97666,301310
311280,202001,214,100,114,103900,118446,222346
311290,202001,106,88,18,91432,18702,110134
311300,202001,586,368,218,382352,226502,608854
311310,202001,22,17,5,17663,5195,22858
311320,202001,663,492,171,511188,178708,689896
311330,202001,1108,819,289,850941,300271.9,1151212.9
311340,202001,2612,1853,759,1927346.4,790679.39,2718025.79
311350,202001,279,216,63,224424,65457,289881
311360,202001,175,109,66,113251,68574,181825
311370,202001,1206,500,706,520539.75,736651,1257190.75
311380,202001,7,6,1,6234,1039,7273
311390,202001,261,143,118,148577,123641,272218
311400,202001,139,90,49,93510,50911,144421
311410,202001,105,57,48,59223,49872,109095
311420,202001,303,168,135,174552.8,140265,314817.8
311430,202001,850,568,282,590152.75,294037.7,884190.45
311440,202001,466,329,137,343909,142343,486252
311450,202001,318,199,119,206761,123641,330402
311455,202001,285,191,94,199488,97666,297154
311460,202001,143,62,81,64418,84159,148577
311470,202001,23,13,10,13507,10390,23897
311480,202001,47,21,26,21819,27014,48833
311490,202001,14,9,5,9351,5195,14546
311500,202001,23,10,13,10390,13507,23897
311510,202001,632,441,191,459238,199488,658726
311520,202001,41,33,8,34287,8312,42599
311530,202001,1807,1337,470,1391223.34,489369,1880592.34
311535,202001,68,49,19,50911,19741,70652
311540,202001,34,30,4,31170,4156,35326
311545,202001,181,135,46,140265,48833,189098
311547,202001,36,30,6,31170,6234,37404
311550,202001,691,323,368,336636,382352.39,718988.39
311560,202001,43,29,14,30131,14546,44677
311570,202001,285,193,92,200527,96627,297154
311580,202001,330,197,133,204683,138187,342870
311590,202001,33,30,3,31170,3117,34287
311600,202001,104,82,22,85198,22858,108056
311610,202001,253,218,35,226502.75,36365,262867.75
311615,202001,69,58,11,60262,11429,71691
311620,202001,26,14,12,14546,12468,27014
311630,202001,83,69,14,71691,14546,86237
311640,202001,129,64,65,67535,67535,135070
311650,202001,127,89,38,92471,39482,131953
311660,202001,407,198,209,206761,219229,425990
311670,202001,152,101,51,104939.66,52989,157928.66
311680,202001,209,155,54,161045,56106,217151
311690,202001,14,10,4,10390,4156,14546
311700,202001,199,141,58,146499,60262,206761
311710,202001,202,132,70,137148,72730,209878
311720,202001,38,28,10,29092.7,10390,39482.7
311730,202001,583,390,193,406249,200527,606776
311740,202001,35,25,10,25975,10390,36365
311750,202001,716,484,232,503916.06,244165,748081.06
311760,202001,66,31,35,32209,36365,68574
311770,202001,397,200,197,207801.37,204683,412484.37
311780,202001,180,99,81,102861.7,84159,187020.7
311783,202001,85,76,9,78964,9351,88315
311787,202001,35,13,22,13507,22858,36365
311790,202001,263,119,144,123641,150655,274296
311800,202001,670,447,223,465473.45,232736,698209.45
311810,202001,47,39,8,40521,8312,48833
311820,202001,120,99,21,102861,21819,124680
311830,202001,1932,1208,724,1259270.95,754314,2013584.95
311840,202001,1012,562,450,584958.4,468589.95,1053548.35
311850,202001,10,6,4,6234,4156,10390
311860,202001,9604,4246,5358,4417832.55,5573200.64,9991033.19
311870,202001,130,66,64,68574,66496,135070
311880,202001,930,677,253,704443.09,262867.7,967310.79
311890,202001,212,104,108,107970,112212,220182
311900,202001,76,31,45,32209,46755,78964
311910,202001,1413,894,519,928867.45,541319.7,1470187.15
311920,202001,228,152,76,157928,78964,236892
311930,202001,906,520,386,541319.7,401054,942373.7
311940,202001,2497,1321,1176,1373558,1222903.53,2596461.53
311950,202001,60,46,14,47794,14546,62340
311960,202001,59,43,16,44677,16624,61301
311970,202001,24,15,9,15585,9351,24936
311980,202001,45,36,9,37404,9351,46755
311990,202001,39,31,8,32209,8312,40521
311995,202001,56,37,19,38443,19741,58184
312000,202001,29,22,7,22858,7273,30131
312010,202001,77,61,16,63379,16624,80003
312015,202001,83,63,20,65457,21819,87276
312020,202001,125,81,44,84159,45716,129875
312030,202001,55,41,14,42599,14546,57145
312040,202001,88,53,35,55067.2,36365,91432.2
312050,202001,210,117,93,121563,96627,218190
312060,202001,25,13,12,13507,12468,25975
312070,202001,76,49,27,50911,28053,78964
312080,202001,533,242,291,252477,302349,554826
312083,202001,58,39,19,40521,19741,60262
312087,202001,111,87,24,90393,24936,115329
312090,202001,3157,1910,1247,1987612.82,1299789.7,3287402.52
312100,202001,150,106,44,109895.73,45716,155611.73
312110,202001,114,70,44,72730,45716,118446
312120,202001,143,105,38,109096.16,39482,148578.16
312125,202001,90,48,42,49872,44677,94549
312130,202001,125,84,41,87276,42599,129875
312140,202001,137,109,28,113251,29092,142343
312150,202001,45,35,10,36365,10390,46755
312160,202001,1557,1028,529,1069227.8,552748.7,1621976.5
312170,202001,11,10,1,10390,1039,11429
312180,202001,113,68,45,70652,46755.9,117407.9
312190,202001,35,31,4,32209,4156,36365
312200,202001,763,651,112,677428.7,116368,793796.7
312210,202001,108,60,48,62340,50911,113251
312220,202001,135,99,36,102861.75,37404,140265.75
312230,202001,3602,1726,1876,1793315.26,1951246.33,3744561.59
312235,202001,171,116,55,120524,57145,177669
312240,202001,97,69,28,71691,29092,100783
312245,202001,182,126,56,130914.19,58184,189098.19
312247,202001,69,48,21,49872,21819,71691
312250,202001,179,88,91,91432,94549,185981
312260,202001,112,73,39,75847,41560,117407
312270,202001,129,78,51,81042,52989,134031
312280,202001,26,12,14,12468,14546,27014
312290,202001,151,108,43,112212,44677.8,156889.8
312300,202001,204,131,73,137148,75847,212995
312310,202001,60,53,7,55067,7273,62340
312320,202001,428,273,155,283647,162084.85,445731.85
312330,202001,91,79,12,82081,12468,94549
312340,202001,38,17,21,17663,21819,39482
312350,202001,18,11,7,11429,7273,18702
312352,202001,95,70,25,72730,25975,98705
312360,202001,575,255,320,264945,335597,600542
312370,202001,298,170,128,176630,132992.7,309622.7
312380,202001,143,95,48,99744,49872,149616
312385,202001,169,135,34,140265,35326,175591
312390,202001,306,189,117,196371,121563,317934
312400,202001,380,288,92,299232,96628.5,395860.5
312410,202001,967,316,651,328324,677428.19,1005752.19
312420,202001,632,487,145,505993.7,150655,656648.7
312430,202001,876,648,228,673273.2,237931,911204.2
312440,202001,41,31,10,32209,10390,42599
312450,202001,207,130,77,135070,80003,215073
312460,202001,33,16,17,16624,17663,34287
312470,202001,48,32,16,33248,16624,49872
312480,202001,194,119,75,123641,78964,202605
312490,202001,267,190,77,197410,80003,277413
312500,202001,35,20,15,20780,15585,36365
312510,202001,524,207,317,215073,330402.78,545475.78
312520,202001,31,10,21,10390,21819,32209
312530,202001,49,34,15,35326,15585,50911
312540,202001,98,86,12,89354,12468,101822
312550,202001,37,29,8,30131,8312,38443
312560,202001,219,169,50,175591.7,51950,227541.7
312570,202001,441,270,171,280530,178708,459238
312580,202001,89,47,42,48833,43638,92471
312590,202001,251,200,51,207800,54028,261828
312595,202001,137,124,13,128836,13507,142343
312600,202001,68,39,29,40521.55,30131,70652.55
312610,202001,1571,814,757,846788.8,786524.4,1633313.2
312620,202001,207,147,60,152733,62340,215073
312630,202001,62,53,9,55067,10390,65457
312640,202001,47,14,33,14546,34287,48833
312650,202001,149,124,25,129875.7,25975,155850.7
312660,202001,84,62,22,64418.85,22858,87276.85
312670,202001,914,600,314,623400,326246,949646
312675,202001,33,26,7,27014,7273,34287
312680,202001,78,50,28,51950,29092,81042
312690,202001,250,130,120,135070,124680,259750
312695,202001,37,31,6,32209,6234,38443
312700,202001,226,131,95,136109,98705,234814
312705,202001,84,69,15,71691,15585,87276
312707,202001,126,92,34,95588,35326,130914
312710,202001,1869,998,871,1041079,910164,1951243
312720,202001,62,31,31,32209,32209,64418
312730,202001,278,162,116,168318,121563,289881
312733,202001,54,46,8,47794,8312,56106
312735,202001,23,15,8,15585,8312,23897
312737,202001,69,37,32,38443,33248,71691
312738,202001,57,42,15,43638,15585,59223
312740,202001,79,53,26,55067,27014,82081
312750,202001,75,55,20,57145,20780,77925
312760,202001,287,208,79,217151,82081,299232
312770,202001,7768,3592,4176,3738366.81,4347177.95,8085544.76
312780,202001,422,321,101,334558,104939,439497
312790,202001,22,17,5,17663,5195,22858
312800,202001,1586,1105,481,1150174.45,501837.53,1652011.98
312810,202001,369,235,134,244165,139226,383391
312820,202001,186,141,45,146499,46755,193254
312825,202001,26,17,9,17663,9351,27014
312830,202001,239,138,101,143382.53,104939,248321.53
312840,202001,159,110,49,114290,50911,165201
312850,202001,45,41,4,42599,4156,46755
312860,202001,156,99,57,102861,60262,163123
312870,202001,1042,544,498,566255.45,517422,1083677.45
312880,202001,135,93,42,96627,43638,140265
312890,202001,160,115,45,119485,47794,167279
312900,202001,198,148,50,153772,51950,205722
312910,202001,176,92,84,95588,88315,183903
312920,202001,155,87,68,90393,70652,161045
312930,202001,329,232,97,241048,100783,341831
312940,202001,112,80,32,83120,33248,116368
312950,202001,690,466,224,485213,232736,717949
312960,202001,176,131,45,136109.28,46755,182864.28
312965,202001,74,63,11,65457,11429,76886
312970,202001,273,222,51,230658.75,52989,283647.75
312980,202001,2457,1253,1204,1304986.79,1255112,2560098.79
312990,202001,43,23,20,23897,20780,44677
313000,202001,49,28,21,29092,21819,50911
313005,202001,174,135,39,140265,40521.7,180786.7
313010,202001,914,374,540,389625.4,561060.39,950685.79
313020,202001,190,102,88,105978,91432,197410
313030,202001,196,130,66,135070.97,69613,204683.97
313040,202001,74,25,49,25975,50911,76886
313050,202001,185,132,53,137148,55067,192215
313055,202001,41,32,9,33248,9351,42599
313060,202001,127,90,37,93510,38443,131953
313065,202001,61,44,17,45716,17663,63379
313070,202001,134,71,63,74808,65457,140265
313080,202001,41,17,24,17663,24936,42599
313090,202001,657,437,220,456121,230658,686779
313100,202001,173,65,108,67535,112212,179747
313110,202001,136,73,63,75847,65457,141304
313115,202001,203,116,87,121563,90393,211956
313120,202001,788,448,340,466511.7,355338.7,821850.4
313130,202001,5614,3076,2538,3206362.24,2642179.45,5848541.69
313140,202001,143,76,67,78964,70652,149616
313150,202001,302,243,59,254555,61301,315856
313160,202001,191,141,50,146499.7,51950,198449.7
313170,202001,1381,950,431,988091.3,449887.39,1437978.69
313180,202001,299,177,122,183903.34,126758,310661.34
313190,202001,750,454,296,471706.7,307544.6,779251.3
313200,202001,28,25,3,25975,3117,29092
313210,202001,996,848,148,883152.41,153772,1036924.41
313220,202001,261,168,93,174552,96627.7,271179.7
313230,202001,265,203,62,210917.82,64418,275335.82
313240,202001,2106,1108,998,1154334.34,1039000,2193334.34
313250,202001,1267,959,308,997442.2,323130.16,1320572.36
313260,202001,92,50,42,51950,43638,95588
313270,202001,963,570,393,593269.65,408328.4,1001598.05
313280,202001,53,44,9,45716,9351,55067
313290,202001,220,177,43,183903,44677,228580
313300,202001,346,182,164,189098.8,171435,360533.8
313310,202001,249,122,127,127797,131953,259750
313320,202001,375,283,92,294037.8,95588,389625.8
313330,202001,1396,864,532,898735,552748,1451483
313340,202001,324,229,95,237931,100783,338714
313350,202001,502,336,166,349104,172474,521578
313360,202001,125,69,56,71691,58184.7,129875.7
313370,202001,202,70,132,72730,137148,209878
313375,202001,278,166,112,173513,116368,289881
313380,202001,1339,709,630,737691.1,656648.19,1394339.29
313390,202001,52,46,6,47794.8,6234,54028.8
313400,202001,406,278,128,288842.6,132993.4,421836.0
313410,202001,22,12,10,12468,10390,22858
313420,202001,4614,2480,2134,2579838,2222421.7,4802259.7
313430,202001,139,68,71,71691,73769,145460
313440,202001,1429,984,445,1025495.14,465474.8,1490969.94
313450,202001,65,27,38,28053,39482,67535
313460,202001,381,172,209,178708.7,217151,395859.7
313470,202001,527,251,276,260789.4,286765.4,547554.8
313480,202001,149,109,40,113251.7,41560,154811.7
313490,202001,512,241,271,250399.7,281569.95,531969.65
313500,202001,25,15,10,15585,10390,25975
313505,202001,1016,801,215,832239.46,223385,1055624.46
313507,202001,102,59,43,61301,44677,105978
313510,202001,2773,1761,1012,1830720,1055624,2886344
313520,202001,3464,2706,758,2812575.64,791718.77,3604294.41
313530,202001,35,24,11,24936,11429,36365
313535,202001,56,46,10,47794,10390,58184
313540,202001,71,54,17,56106,17663,73769
313545,202001,115,96,19,99744,19741,119485
313550,202001,232,197,35,204683,36365.7,241048.7
313560,202001,331,165,166,171435,173513,344948
313570,202001,62,29,33,30131,34287,64418
313580,202001,1317,744,573,773017.35,596388.1,1369405.45
313590,202001,70,40,30,41560,31170,72730
313600,202001,681,418,263,434302,275335.7,709637.7
313610,202001,59,47,12,48833.17,12468,61301.17
313620,202001,1383,703,680,732496.4,708598,1441094.4
313630,202001,1609,1239,370,1289400.4,384430.78,1673831.18
313640,202001,122,75,47,77925,48833,126758
313650,202001,234,112,122,117407,127797.7,245204.7
313652,202001,17,17,0,17663,0,17663
313655,202001,61,39,22,40521,22858,63379
313657,202001,49,45,4,46755,4156,50911
313660,202001,134,94,40,97666,41578.7,139244.7
313665,202001,662,321,341,335597.84,357416,693013.84
313670,202001,10415,7162,3253,7451715.76,3382986.8,10834702.56
313680,202001,43,33,10,34287,10390.29,44677.29
313690,202001,146,111,35,115329,36365,151694
313695,202001,76,59,17,61301,17663,78964
313700,202001,301,243,58,252477.5,60262,312739.5
313710,202001,144,98,46,102861,47794,150655
313720,202001,1109,535,574,555865.7,596387.7,1152253.4
313730,202001,71,44,27,45716,28053,73769
313740,202001,148,119,29,123641,30131,153772
313750,202001,426,311,115,323129,119485,442614
313753,202001,240,178,62,184942,64418,249360
313760,202001,1288,468,820,487291,853021.25,1340312.25
313770,202001,376,274,102,285725.75,105978,391703.75
313780,202001,767,408,359,423912,374040,797952
313790,202001,27,26,1,27014,1039,28053
313800,202001,136,84,52,87276,54028,141304
313810,202001,75,42,33,43638,34287,77925
313820,202001,1325,648,677,675351.4,704443.67,1379795.07
313830,202001,62,44,18,45716,18702,64418
313835,202001,62,52,10,54028,10390,64418
313840,202001,1652,1006,646,1046275.9,673273.4,1719549.3
313850,202001,204,74,130,76886,136109,212995
313860,202001,481,367,114,381313.7,118446,499759.7
313862,202001,164,109,55,113251,57145,170396
313865,202001,113,85,28,88315,29092,117407
313867,202001,47,38,9,39482,9351,48833
313868,202001,32,20,12,20780,12468,33248
313870,202001,120,63,57,65457,59223,124680
313880,202001,372,234,138,243126,143382,386508
313890,202001,329,178,151,184942.8,156889,341831.8
313900,202001,896,487,409,508072.55,425990.95,934063.50
313910,202001,136,102,34,105978,36365,142343
313920,202001,632,449,183,467550,190137.97,657687.97
313925,202001,31,28,3,29092,3117,32209
313930,202001,848,662,186,687818,193254.97,881072.97
313940,202001,1845,1159,686,1205240,712754,1917994
313950,202001,915,576,339,599503.4,354299,953802.4
313960,202001,1389,790,599,820811.18,622363.4,1443174.58
313970,202001,139,95,44,98705,45716,144421
313980,202001,214,136,78,141304.75,81042,222346.75
313990,202001,231,156,75,163123,77925,241048
314000,202001,920,614,306,637946.07,318973,956919.07
314010,202001,81,52,29,54028,30131,84159
314015,202001,65,19,46,19741,47794,67535
314020,202001,56,37,19,38443,19741,58184
314030,202001,75,37,38,38443,39482,77925
314040,202001,41,24,17,24936,17663,42599
314050,202001,285,173,112,179747,116368,296115
314053,202001,101,65,36,67535.7,38443,105978.7
314055,202001,299,189,110,196371,114290.7,310661.7
314060,202001,139,121,18,125719,18702,144421
314070,202001,1059,557,502,580801,524695,1105496
314080,202001,212,138,74,143382,76886.48,220268.48
314085,202001,140,95,45,98705,46755,145460
314090,202001,372,270,102,280530.95,105978,386508.95
314100,202001,485,394,91,409366.65,94549.78,503916.43
314110,202001,743,393,350,408327.7,364689,773016.7
314120,202001,89,53,36,55067,37404,92471
314130,202001,21,11,10,11429,10390,21819
314140,202001,1099,683,416,709637.6,433263,1142900.6
314150,202001,168,106,62,110134,64418,174552
314160,202001,336,257,79,267023.8,82081.8,349105.6
314170,202001,77,62,15,64418,15585,80003
314180,202001,731,649,82,674311.7,85198.75,759510.45
314190,202001,97,60,37,63379,38443,101822
314200,202001,485,332,153,347026.7,158967,505993.7
314210,202001,255,196,59,203644,61301.7,264945.7
314220,202001,309,229,80,237931.7,83120,321051.7
314225,202001,66,47,19,48833,19741,68574
314230,202001,119,55,64,57145,66496,123641
314240,202001,141,108,33,112212,34287,146499
314250,202001,52,30,22,31170,22858,54028
314260,202001,215,106,109,110134,113251,223385
314270,202001,353,276,77,286764,80003,366767
314280,202001,708,392,316,407289.2,329363,736652.2
314290,202001,540,441,99,458199,102861,561060
314300,202001,364,261,103,273260.25,107017.95,380278.20
314310,202001,1376,932,444,969647.16,461316,1430963.16
314315,202001,32,26,6,27014,6234,33248
314320,202001,599,398,201,415600.7,208839,624439.7
314330,202001,10968,5427,5541,5642814.84,5767492,11410306.84
314340,202001,599,277,322,288842,335598.4,624440.4
314345,202001,42,30,12,32209.19,12468,44677.19
314350,202001,185,117,68,121563,70652,192215
314360,202001,66,41,25,42599,25975,68574
314370,202001,64,47,17,48833,17663,66496
314380,202001,93,60,33,62340,34287,96627
314390,202001,3340,2164,1176,2250477.47,1228098.8,3478576.27
314400,202001,682,490,192,509111.25,199488,708599.25
314410,202001,466,304,162,317934,169357,487291
314420,202001,18,8,10,8312,10390,18702
314430,202001,2443,904,1539,939258.77,1601099.7,2540358.47
314435,202001,221,136,85,141304,88315,229619
314437,202001,28,22,6,22858,6234,29092
314440,202001,94,69,25,72730,25975,98705
314450,202001,155,109,46,113251,47794,161045
314460,202001,643,303,340,314817,353260,668077
314465,202001,89,60,29,62340,30131,92471
314467,202001,68,55,13,57145,13507,70652
314470,202001,409,205,204,212997.29,212995,425992.29
314480,202001,1071,514,557,534046,578723,1112769
314490,202001,53,38,15,39482,15585,55067
314500,202001,288,194,94,201566,97666,299232
314505,202001,121,81,40,84159,41560,125719
314510,202001,236,194,42,201566,43638,245204
314520,202001,1282,687,595,714843.2,620285.1,1335128.3
314530,202001,741,596,145,619245.01,150655,769900.01
314535,202001,193,119,74,123641,76886,200527
314537,202001,62,37,25,38443,25975,64418
314540,202001,15,10,5,10390,5195,15585
314545,202001,53,35,18,36365,18702,55067
314550,202001,81,42,39,43638,40521,84159
314560,202001,868,480,388,500798.7,403132,903930.7
314570,202001,20,16,4,16624,4156,20780
314580,202001,13,5,8,5195,8312,13507
314585,202001,26,19,7,19741,7273,27014
314587,202001,86,73,13,75847,13507,89354
314590,202001,563,410,153,425991.45,160006,585997.45
314600,202001,935,611,324,634830.6,338714.99,973545.59
314610,202001,951,503,448,522618.15,466511,989129.15
314620,202001,142,106,36,110134,37404.7,147538.7
314625,202001,94,69,25,71691.1,25975,97666.1
314630,202001,1173,621,552,645219,573528,1218747
314640,202001,79,53,26,55067,28053.7,83120.7
314650,202001,182,105,77,109095,80003,189098
314655,202001,65,47,18,48833,18702,67535
314660,202001,17,14,3,14546,3117,17663
314670,202001,201,153,48,160006.7,49872,209878.7
314675,202001,213,126,87,130914,90393,221307
314690,202001,583,314,269,326246,279491,605737
314700,202001,2303,1253,1050,1303947.8,1094067,2398014.8
314710,202001,1681,988,693,1028612.05,720027.7,1748639.75
314720,202001,387,234,153,243126,158967,402093
314730,202001,507,267,240,278453.4,249360.39,527813.79
314740,202001,700,343,357,356377,373001,729378
314750,202001,22,19,3,19741,3117,22858
314760,202001,338,159,179,165201,187020,352221
314770,202001,106,75,31,77925,32209,110134
314780,202001,18,6,12,6234,12468,18702
314790,202001,2356,1487,869,1544996.37,902891,2447887.37
314795,202001,50,40,10,41560,10390,51950
314800,202001,2917,1708,1209,1776692.87,1257190,3033882.87
314810,202001,1527,870,657,904969,683662.8,1588631.8
314820,202001,111,63,48,66496,49872,116368
314830,202001,216,174,42,180786,43638,224424
314840,202001,89,51,38,52989,39482,92471
314850,202001,373,187,186,194293.7,193254,387547.7
314860,202001,682,518,164,540280.7,172474,712754.7
314870,202001,1503,800,703,832239.7,730417,1562656.7
314875,202001,58,50,8,51950,8312,60262
314880,202001,45,31,14,32209,14546,46755
314890,202001,55,33,22,34287,22858,57145
314900,202001,30,23,7,23897,7273,31170
314910,202001,246,166,80,172474,83120,255594
314915,202001,145,128,17,132992,17663,150655
314920,202001,102,62,40,64418,42599,107017
314930,202001,1068,528,540,548593.07,563138,1111731.07
314940,202001,48,38,10,39482,10390,49872
314950,202001,34,23,11,23897,11429,35326
314960,202001,40,31,9,32209,10390,42599
314970,202001,146,72,74,74808,76886,151694
314980,202001,305,198,107,205722,113251,318973
314990,202001,443,246,197,256633,204683,461316
314995,202001,205,67,138,69613,143382,212995
315000,202001,88,68,20,70652,20780,91432
315010,202001,44,28,16,29092,16624,45716
315015,202001,169,136,33,141304,34287,175591
315020,202001,70,58,12,60262,12468,72730
315030,202001,112,88,24,91432.5,24936,116368.5
315040,202001,71,50,21,51950,21819,73769
315050,202001,180,108,72,113251,74808,188059
315053,202001,43,36,7,37404,8312,45716
315057,202001,101,79,22,82081.7,22858,104939.7
315060,202001,72,62,10,64418.8,10390,74808.8
315070,202001,107,59,48,61301,49872,111173
315080,202001,375,304,71,315856,73769,389625
315090,202001,102,60,42,62340,43638,105978
315100,202001,83,42,41,43638,42599,86237
315110,202001,271,145,126,150655,130914,281569
315120,202001,1697,845,852,883150,888345.24,1771495.24
315130,202001,345,249,96,258711,99744,358455
315140,202001,516,300,216,311700.7,225463.9,537164.6
315150,202001,964,463,501,482096,522617.7,1004713.7
315160,202001,219,111,108,115329,112212.78,227541.78
315170,202001,316,208,108,216112.7,112212,328324.7
315180,202001,3296,1379,1917,1439019.2,1998001.05,3437020.25
315190,202001,327,194,133,201566.6,138187,339753.6
315200,202001,1240,732,508,760548,528851,1289399
315210,202001,1645,944,701,983933.8,731456.6,1715390.4
315213,202001,40,23,17,23897,17663,41560
315217,202001,215,171,44,177669,45716,223385
315220,202001,1571,1193,378,1240567.69,394820,1635387.69
315230,202001,174,126,48,130914.7,49872,180786.7
315240,202001,421,271,150,281569,155850.89,437419.89
315250,202001,2545,1269,1276,1320569,1330959.9,2651528.9
315260,202001,143,83,60,86237,62340,148577
315270,202001,127,91,36,94549,37404,131953
315280,202001,656,428,228,445731.6,237931,683662.6
315290,202001,195,118,77,122602,80003,202605
315300,202001,72,55,17,57145,17663,74808
315310,202001,73,65,8,67535,8312,75847
315320,202001,168,99,69,102861,71691,174552
315330,202001,55,46,9,48833,9351,58184
315340,202001,387,280,107,292998,111173,404171
315350,202001,152,93,59,96627,61301,157928
315360,202001,90,47,43,48833,44677,93510
315370,202001,55,34,21,35326,21819,57145
315380,202001,11,8,3,8312,3117,11429
315390,202001,68,17,51,17663,52989.7,70652.7
315400,202001,854,641,213,666000.05,222346,888346.05
315410,202001,332,197,135,206761.7,140266.7,347028.4
315415,202001,60,45,15,46755,15585,62340
315420,202001,201,150,51,155850.7,52989,208839.7
315430,202001,663,381,282,396898.7,292998.8,689897.5
315440,202001,93,66,27,68574,28053,96627
315445,202001,235,192,43,199488,44677,244165
315450,202001,182,139,43,144421,44677,189098
315460,202001,3932,1945,1987,2021895.09,2068649.39,4090544.48
315470,202001,41,16,25,17663,25975,43638
315480,202001,64,23,41,23897,42599,66496
315490,202001,649,404,245,419756,255594,675350
315500,202001,19,12,7,12468,7273,19741
315510,202001,150,100,50,103900,51950,155850
315520,202001,69,62,7,64418,7273,71691
315530,202001,48,26,22,27014,22858,49872
315540,202001,240,164,76,171435,78964,250399
315550,202001,176,141,35,146499,36365,182864
315560,202001,737,594,143,617166.7,148577,765743.7
315570,202001,310,161,149,167281.08,154811.8,322092.88
315580,202001,707,472,235,491447,244165,735612
315590,202001,202,107,95,111173,98705,209878
315600,202001,309,233,76,242087,78964,321051
315610,202001,98,52,46,54028,47794,101822
315620,202001,35,28,7,29092,7273,36365
315630,202001,133,89,44,92471,45716,138187
315640,202001,68,42,26,43638,27014,70652
315645,202001,48,33,15,34287,15585.5,49872.5
315650,202001,174,126,48,130915.4,49872,180787.4
315660,202001,462,203,259,211956.7,269101,481057.7
315670,202001,2390,1172,1218,1220827.8,1269658.78,2490486.58
315680,202001,845,588,257,610932,268062,878994
315690,202001,678,469,209,488332.38,218190,706522.38
315700,202001,1892,1003,889,1043158.42,924710,1967868.42
315710,202001,340,100,240,103900,249360,353260
315720,202001,448,281,167,292998.7,175591,468589.7
315725,202001,195,156,39,163123.7,40521,203644.7
315727,202001,48,23,25,23897,25975,49872
315730,202001,50,48,2,49872,2078,51950
315733,202001,88,61,27,63379,28053,91432
315737,202001,50,37,13,38443,13507,51950
315740,202001,34,27,7,28053,7273,35326
315750,202001,163,123,40,127797,41560,169357
315760,202001,43,33,10,34287,10390,44677
315765,202001,125,76,49,78964,50911,129875
315770,202001,221,139,82,144421,85198.7,229619.7
315780,202001,3462,1754,1708,1823447.25,1778769.95,3602217.20
315790,202001,221,174,47,180786,48833,229619
315800,202001,288,204,84,211956,87276,299232
315810,202001,96,57,39,59223,40521.7,99744.7
315820,202001,751,545,206,566257.1,214034,780291.1
315830,202001,127,77,50,80003,51950,131953
315840,202001,86,58,28,60262,29092,89354
315850,202001,251,183,68,190137.75,71691,261828.75
315860,202001,14,5,9,5195,9351,14546
315870,202001,37,28,9,29092,9351,38443
315880,202001,107,68,39,70652,40521,111173
315890,202001,89,66,23,68574,23897,92471
315895,202001,449,298,151,310661.75,156890.4,467552.15
315900,202001,69,32,37,33248,38443,71691
315910,202001,38,23,15,23897,15585,39482
315920,202001,168,108,60,112212,62340.65,174552.65
315930,202001,47,18,29,18702,30131,48833
315935,202001,132,103,29,107017.7,30131.39,137149.09
315940,202001,99,73,26,75847,27014,102861
315950,202001,42,31,11,32209,11429,43638
315960,202001,536,257,279,268062,289881.7,557943.7
315970,202001,33,27,6,28053,6234,34287
315980,202001,693,341,352,354299,366767,721066
315990,202001,250,147,103,152733,107018.09,259751.09
316000,202001,52,34,18,35326,18702,54028
316010,202001,79,69,10,71691,10390,82081
316020,202001,116,99,17,102861,17663,120524
316030,202001,393,218,175,226502.7,182865.45,409368.15
316040,202001,520,221,299,230658.7,310661.7,541320.4
316045,202001,62,56,6,58184,6234,64418
316050,202001,15,13,2,13507,2078,15585
316060,202001,97,64,33,67535,34287,101822
316070,202001,1096,706,390,734574.85,406249,1140823.85
316080,202001,103,67,36,69613,37404,107017
316090,202001,40,22,18,22858,18702,41560
316095,202001,104,86,18,89354,18702,108056
316100,202001,307,180,127,187020.75,132992,320012.75
316105,202001,38,25,13,25975,13507,39482
316110,202001,1861,1491,370,1550189.05,386508,1936697.05
316120,202001,79,58,21,60262,21819,82081
316130,202001,123,93,30,96627.7,31170,127797.7
316140,202001,32,23,9,23897,9351,33248
316150,202001,203,140,63,145460,65457,210917
316160,202001,81,46,35,47794,36365,84159
316165,202001,64,49,15,50911.8,15585,66496.8
316170,202001,185,123,62,127797,64418,192215
316180,202001,199,87,112,90393,116368.7,206761.7
316190,202001,139,102,37,105978,38443,144421
316200,202001,659,368,291,383391,302349,685740
316210,202001,770,515,255,537341.7,265984,803325.7
316220,202001,114,75,39,77925,40521,118446
316225,202001,27,15,12,15585,12468,28053
316230,202001,33,19,14,19741,14546,34287
316240,202001,652,525,127,546514,131953,678467
316245,202001,128,111,17,115329,17663,132992
316250,202001,1541,1052,489,1095108.2,509110.39,1604218.59
316255,202001,120,97,23,100783,23897,124680
316257,202001,176,93,83,97666,86237,183903
316260,202001,194,138,56,143382.75,58184.9,201567.65
316265,202001,27,19,8,19741,8312,28053
316270,202001,688,484,204,502877.3,211956.12,714833.42
316280,202001,543,343,200,359495.09,210919.2,570414.29
316290,202001,750,499,251,518461.63,260789,779250.63
316292,202001,511,204,307,211956,321051,533007
316294,202001,102,61,41,63379,42599,105978
316295,202001,306,134,172,139227.44,178708,317935.44
316300,202001,102,71,31,73769,32209,105978
316310,202001,34,19,15,19741,15585,35326
316320,202001,45,26,19,27014,19741,46755
316330,202001,155,105,50,110134.75,51950,162084.75
316340,202001,139,98,41,101822,42599,144421
316350,202001,194,136,58,141304.64,60262,201566.64
316360,202001,22,13,9,13507,9351,22858
316370,202001,1115,583,532,605738.95,553787,1159525.95
316380,202001,118,89,29,92471,31170,123641
316390,202001,117,86,31,89354,33248,122602
316400,202001,133,102,31,105978,32209,138187
316410,202001,291,209,82,217151,85198,302349
316420,202001,206,141,65,146499,67535,214034
316430,202001,152,81,71,84159,73769,157928
316440,202001,87,43,44,44677,45716,90393
316443,202001,41,39,2,40521,2078,42599
316447,202001,52,39,13,40521,13507,54028
316450,202001,227,174,53,180786,55067,235853
316460,202001,74,27,47,28053,49872,77925
316470,202001,1673,1234,439,1284197.59,456121,1740318.59
316480,202001,12,9,3,9351,3117,12468
316490,202001,18,7,11,7273,11429,18702
316500,202001,151,101,50,104939,51950,156889
316510,202001,156,121,35,126758,36365,163123
316520,202001,192,121,71,126758,73769,200527
316530,202001,159,109,50,113251,51950,165201
316540,202001,140,74,66,77925,68574,146499
316550,202001,129,86,43,89354,44677,134031
316553,202001,294,136,158,141304,164162.72,305466.72
316555,202001,38,32,6,33248,6234,39482
316556,202001,12,9,3,9351,3117,12468
316557,202001,19,17,2,17663,2078,19741
316560,202001,66,47,19,49872,19741,69613
316570,202001,227,206,21,214034,22858,236892
316580,202001,18,15,3,15585,3117,18702
316590,202001,102,86,16,89354,16624,105978
316600,202001,181,150,31,155850.5,32209,188059.5
316610,202001,68,51,17,52989,17663,70652
316620,202001,141,107,34,111173,35326,146499
316630,202001,42,33,9,34287,9351,43638
316640,202001,23,15,8,15585,8312,23897
316650,202001,78,63,15,65457,15585,81042
316660,202001,8,3,5,3117,5195,8312
316670,202001,439,155,284,161045.78,296115,457160.78
316680,202001,159,110,49,114290,50911.8,165201.8
316690,202001,192,121,71,125719,73769,199488
316695,202001,64,55,9,57145,9351,66496
316700,202001,15,9,6,9351,6234,15585
316710,202001,770,576,194,598464.75,202605,801069.75
316720,202001,4946,2450,2496,2550750.65,2599579.59,5150330.24
316730,202001,16,16,0,16624,0,16624
316740,202001,143,91,52,94549,54028,148577
316750,202001,19,12,7,12468,7273,19741
316760,202001,321,257,64,267023,66496,333519
316770,202001,149,79,70,82081,72730,154811
316780,202001,69,43,26,44677,27014,71691
316790,202001,54,40,14,41560,14546,56106
316800,202001,1746,1089,657,1131471,684702.5,1816173.5
316805,202001,20,12,8,12468,9351,21819
316810,202001,68,44,24,45716,24936,70652
316820,202001,42,21,21,21819,21819,43638
316830,202001,94,44,50,46755,51950,98705
316840,202001,527,305,222,316895,230658,547553
316850,202001,333,222,111,230658,116368,347026
316860,202001,5930,2653,3277,2757511.23,3412076.65,6169587.88
316870,202001,1534,1001,533,1042121.15,555866.6,1597987.75
316880,202001,129,66,63,68574,65457,134031
316890,202001,241,164,77,170396,80003,250399
316900,202001,423,299,124,310662.23,128836,439498.23
316905,202001,21,10,11,10390,11429,21819
316910,202001,63,27,36,28053,37404,65457
316920,202001,134,107,27,111173,28053,139226
316930,202001,1899,981,918,1020299.4,958997.65,1979297.05
316935,202001,905,556,349,577684.02,363650.7,941334.72
316940,202001,1094,630,464,654570.9,482096.7,1136667.6
316950,202001,181,90,91,93510.7,94549,188059.7
316960,202001,1103,622,481,649376.4,499759,1149135.4
316970,202001,657,519,138,539241.7,143382,682623.7
316980,202001,77,46,31,47794,32209,80003
316990,202001,2183,1464,719,1523174.87,749121.25,2272296.12
317000,202001,328,251,77,260789,81042,341831
317005,202001,242,170,72,176630,74808,251438
317010,202001,6367,3540,2827,3685341.06,2947644.4,6632985.46
317020,202001,16100,7104,8996,7398737.28,9364520.96,16763258.24
317030,202001,80,31,49,32209,50911,83120
317040,202001,3086,1935,1151,2011506.9,1196928.8,3208435.7
317043,202001,77,56,21,58184,21819,80003
317047,202001,29,17,12,17663,12468.19,30131.19
317050,202001,167,127,40,131953,41560,173513
317052,202001,129,96,33,99744,34287,134031
317057,202001,170,132,38,137148,39482,176630
317060,202001,65,42,23,43638,23897,67535
317065,202001,55,44,11,45716,11429,57145
317070,202001,1972,922,1050,961075.7,1094068.4,2055144.1
317075,202001,106,58,48,60262,49872,110134
317080,202001,892,464,428,482097.45,444692.8,926790.25
317090,202001,648,522,126,542358,132992,675350
317100,202001,424,320,104,332480,108056,440536
317103,202001,104,85,19,88315,19741,108056
317107,202001,45,40,5,41560,5195,46755
317110,202001,113,48,65,49872,67535,117407
317115,202001,40,35,5,36365,5195,41560
317120,202001,1898,939,959,977700.9,1000557.7,1978258.6
317130,202001,1971,1314,657,1368122.56,682623,2050745.56
317140,202001,12,10,2,10390,2078,12468
317150,202001,264,160,104,166240.7,109095,275335.7
317160,202001,321,238,83,248321.99,86237,334558.99
317170,202001,218,151,67,156889,69613,226502
317180,202001,447,314,133,326246,138187,464433
317190,202001,261,182,79,189098,82081,271179
317200,202001,819,575,244,599507.38,253516,853023.38
317210,202001,188,103,85,107017,88315,195332
317220,202001,24,13,11,13507,11429,24936
320010,202001,611,447,164,464433.75,170396,634829.75
320013,202001,123,89,34,93510,35326,128836
320016,202001,272,169,103,176630,108056,284686
320020,202001,719,419,300,437421.22,311700,749121.22
320030,202001,152,107,45,111173,46755.75,157928.75
320035,202001,139,104,35,108056,36365,144421
320040,202001,492,251,241,260789,251438,512227
320050,202001,104,77,27,80003,28053,108056
320060,202001,1635,784,851,816655.73,887308.63,1703964.36
320070,202001,105,69,36,71691,37404,109095
320080,202001,802,465,337,483136.45,352221,835357.45
320090,202001,1232,840,392,872760,408327,1281087
320100,202001,326,188,138,195332,143382,338714
320110,202001,122,79,43,82082.55,44677.7,126760.25
320115,202001,109,90,19,93510,19741,113251
320120,202001,3422,1866,1556,1943972.23,1623958.42,3567930.65
320130,202001,7427,3415,4012,3553392.82,4173679.35,7727072.17
320140,202001,439,290,149,301310.8,154811.87,456122.67
320150,202001,2040,1165,875,1214593.77,911203,2125796.77
320160,202001,661,300,361,311700.19,376119.09,687819.28
320170,202001,111,88,23,91432,23897,115329
320180,202001,52,30,22,31170,22858,54028
320190,202001,247,160,87,166240,90393.7,256633.7
320200,202001,58,45,13,46755,13507,60262
320210,202001,902,502,400,521579.4,415601.68,937181.08
320220,202001,301,109,192,113251.39,199488,312739.39
320225,202001,90,72,18,74808,18702,93510
320230,202001,598,386,212,401054.8,221307.7,622362.5
320240,202001,3194,1574,1620,1639544.8,1685259.09,3324803.89
320245,202001,470,319,151,331441.7,157928,489369.7
320250,202001,229,118,111,122602,115329,237931
320255,202001,144,114,30,118446,31170,149616
320260,202001,197,139,58,145460,61301,206761
320265,202001,163,130,33,135070,34287,169357
320270,202001,157,125,32,129875,33248,163123
320280,202001,995,578,417,600542.86,433263,1033805.86
320290,202001,60,51,9,52989,10390,63379
320300,202001,572,397,175,412485.37,182866.72,595352.09
320305,202001,680,370,310,384430,322091.5,706521.5
320310,202001,209,122,87,126759.18,90393,217152.18
320313,202001,328,165,163,171435.95,169357.7,340793.65
320316,202001,114,89,25,92471,25975,118446
320320,202001,3448,1577,1871,1640581.72,1947086.19,3587667.91
320330,202001,261,197,64,205722,66496,272218
320332,202001,850,517,333,537165.3,345987.95,883153.25
320334,202001,243,151,92,157928.7,95588,253516.7
320335,202001,148,103,45,107017,46755,153772
320340,202001,556,382,174,396899.45,180786,577685.45
320350,202001,980,421,559,437419.84,581841.4,1019261.24
320360,202001,171,92,79,95588,82081,177669
320370,202001,245,186,59,193254.58,61301.7,254556.28
320380,202001,282,196,86,204683.7,89354,294037.7
320390,202001,1144,697,447,724184.12,465472.9,1189657.02
320400,202001,311,229,82,237933.2,85198,323131.2
320405,202001,952,403,549,418718.14,570412.89,989131.03
320410,202001,976,501,475,520539,495603.95,1016142.95
320420,202001,501,245,256,254556.65,267023,521579.65
320425,202001,190,103,87,107017,90393,197410
320430,202001,385,213,172,221308.09,179747,401055.09
320435,202001,160,107,53,111173,55067,166240
320440,202001,200,119,81,124680,85198,209878
320450,202001,127,68,59,71691,61301,132992
320455,202001,249,205,44,214034.7,45716,259750.7
320460,202001,272,168,104,174552,109095,283647
320465,202001,115,79,36,82081,37404,119485
320470,202001,693,432,261,450927.69,271179.19,722106.88
320480,202001,194,124,70,128836,73769,202605
320490,202001,3059,1511,1548,1573050.24,1611498.18,3184548.42
320495,202001,109,68,41,70652,42600.4,113252.4
320500,202001,9646,4773,4873,4966435.04,5072409.58,10038844.62
320501,202001,555,281,274,291959,285725,577684
320503,202001,284,199,85,207800,88315,296115
320506,202001,262,188,74,196371,76886,273257
320510,202001,1015,464,551,484174,572489.39,1056663.39
320515,202001,86,69,17,71691,17663,89354
320517,202001,213,155,58,161045,60262,221307
320520,202001,6885,2986,3899,3106616.44,4053147.37,7159763.81
320530,202001,6073,3036,3037,3160642.21,3157524.35,6318166.56
330010,202001,3094,1594,1500,1657208.5,1560578,3217786.5
330015,202001,161,69,92,71691.58,96627,168318.58
330020,202001,3631,1582,2049,1645777.42,2135145.7,3780923.12
330022,202001,246,127,119,131953,123641,255594
330023,202001,593,199,394,206761,409366,616127
330025,202001,572,111,461,116368,480018,596386
330030,202001,1935,1242,693,1294595.93,724183.7,2018779.63
330040,202001,2440,1267,1173,1317455.05,1219787.65,2537242.70
330045,202001,8676,2705,5971,2818808.4,6221534.3,9040342.7
330050,202001,900,577,323,599503,336636,936139
330060,202001,986,596,390,619245.95,406249,1025494.95
330070,202001,3560,1311,2249,1364208.07,2343985.76,3708193.83
330080,202001,1574,709,865,738730.59,901852,1640582.59
330090,202001,377,224,153,232736,158967.7,391703.7
330093,202001,270,120,150,124680,155850.26,280530.26
330095,202001,83,45,38,46755,39482,86237
330100,202001,9695,4910,4785,5109808.18,4979927.85,10089736.03
330110,202001,472,201,271,208839.85,281569,490408.85
330115,202001,540,281,259,291959,269101,561060
330120,202001,375,197,178,204683,184943.8,389626.8
330130,202001,1545,391,1154,406249.8,1200045.74,1606295.54
330140,202001,607,322,285,334558.13,296115,630673.13
330150,202001,507,294,213,306505,223385,529890
330160,202001,212,130,82,135070,85198,220268
330170,202001,26772,9192,17580,9575431.88,18310311.16,27885743.04
330180,202001,243,144,99,149616,102861,252477
330185,202001,927,335,592,349104.39,615088.39,964192.78
330187,202001,350,106,244,110134,253516,363650
330190,202001,5755,2210,3545,2298272.13,3693645.7,5991917.83
330200,202001,4685,1403,3282,1460835.75,3415194.5,4876030.25
330205,202001,430,252,178,261828,184942.7,446770.7
330210,202001,989,613,376,637950.15,391704.99,1029655.14
330220,202001,2647,1597,1050,1661362.04,1094067.7,2755429.74
330225,202001,565,293,272,304427.8,282608,587035.8
330227,202001,2385,731,1654,760548,1720585.75,2481133.75
330230,202001,230,134,96,139226,99744,238970
330240,202001,3763,1898,1865,1978259.51,1941902.85,3920162.36
330245,202001,152,70,82,72730.42,85198,157928.42
330250,202001,6671,3431,3240,3577281.45,3371559.65,6948841.10
330260,202001,571,156,415,162084,432224,594308
330270,202001,3514,1212,2302,1259268.8,2394898.4,3654167.2
330280,202001,452,290,162,301312.1,168318.39,469630.49
330285,202001,7085,2245,4840,2335674.25,5038115.4,7373789.65
330290,202001,638,234,404,243126.55,420795,663921.55
330300,202001,771,503,268,522619.05,278452.13,801071.18
330310,202001,451,256,195,267024.45,202605,469629.45
330320,202001,7958,2991,4967,3111808.89,5176300.8,8288109.69
330330,202001,8882,3448,5434,3588708.85,5664635.1,9253343.95
330340,202001,2705,1599,1106,1662400.22,1152251,2814651.22
330350,202001,18346,7149,11197,7438211.63,11653436.86,19091648.49
330360,202001,2293,1107,1186,1151213.4,1232254.39,2383467.79
330370,202001,1031,523,508,543399,527812,1071211
330380,202001,870,373,497,387547,516384.61,903931.61
330385,202001,630,325,305,337675.75,317934,655609.75
330390,202001,5413,2950,2463,3069209.2,2562174.7,5631383.9
330395,202001,312,192,120,200527,125719.85,326246.85
330400,202001,707,379,328,396898.8,341831,738729.8
330410,202001,511,374,137,389627.35,142343.7,531971.05
330411,202001,250,136,114,141304.41,118446,259750.41
330412,202001,238,97,141,100783.7,146499,247282.7
330414,202001,5414,2213,3201,2301388.94,3337269.4,5638658.34
330415,202001,593,263,330,273258.7,342870.8,616129.5
330420,202001,2232,1151,1081,1199007.81,1127316.09,2326323.90
330430,202001,1789,825,964,861333.2,1005755.5,1867088.7
330440,202001,276,136,140,141304,145460,286764
330450,202001,121,51,70,54028,72730,126758
330452,202001,1943,870,1073,903931.32,1115886.7,2019818.02
330455,202001,110613,39417,71196,41022952.71,74185677.43,115208630.14
330460,202001,264,110,154,114290,160006.13,274296.13
330470,202001,1228,668,560,696133.45,583920.95,1280054.40
330475,202001,1470,391,1079,407288,1121081,1528369
330480,202001,810,428,382,445731,396898.8,842629.8
330490,202001,14161,4717,9444,4908237.55,9829983.83,14738221.38
330500,202001,1409,607,802,631712,836395.52,1468107.52
330510,202001,10849,3733,7116,3883784.73,7413270.25,11297054.98
330513,202001,102,52,50,54028,51950,105978
330515,202001,824,339,485,352222.15,503915.9,856138.05
330520,202001,2491,898,1593,935100.97,1656166,2591266.97
330530,202001,208,116,92,120524.75,96627.8,217152.55
330540,202001,371,183,188,190137.7,195332.5,385470.2
330550,202001,2884,1025,1859,1067053.74,1939814.4,3006868.14
330555,202001,819,317,502,329363,522617,851980
330560,202001,669,218,451,226502,469628.13,696130.13
330570,202001,267,192,75,200527,77925,278452
330575,202001,781,302,479,314817,497684.05,812501.05
330580,202001,3352,1877,1475,1951245.17,1534604.6,3485849.77
330590,202001,290,150,140,155850.81,145460.39,301311.20
330600,202001,1158,736,422,767822.2,438458,1206280.2
330610,202001,1580,856,724,889388.15,754315.7,1643703.85
330615,202001,205,161,44,167279,45716,212995
330620,202001,1072,430,642,446770.8,667038,1113808.8
330630,202001,4050,2569,1481,2675427.94,1540839.35,4216267.29
350010,202001,597,404,193,419756.76,200527,620283.76
350020,202001,51,22,29,22858,30131,52989
350030,202001,519,328,191,341831.7,198449.7,540281.4
350040,202001,125,50,75,51950,77925,129875
350050,202001,300,158,142,164162,147538,311700
350055,202001,92,49,43,50911,44677,95588
350060,202001,86,30,56,31170,58184,89354
350070,202001,814,482,332,502877.59,345987.9,848865.49
350075,202001,70,49,21,50911,21819,72730
350080,202001,56,30,26,31170,27014,58184
350090,202001,83,48,35,49872,36365,86237
350100,202001,290,179,111,187020,115329,302349
350110,202001,59,40,19,41560,19741,61301
350115,202001,152,92,60,95588,62340,157928
350120,202001,105,69,36,73769,37404,111173
350130,202001,357,165,192,171435.77,200527.39,371963.16
350140,202001,43,29,14,30131,14546,44677
350150,202001,72,54,18,57145,18702,75847
350160,202001,2482,979,1503,1019262.11,1564735.33,2583997.44
350170,202001,387,233,154,242089.27,160006.7,402095.97
350180,202001,173,97,76,100783,78964.7,179747.7
350190,202001,1012,534,478,555865.99,498720.7,1054586.69
350200,202001,69,24,45,24936,46755,71691
350210,202001,1307,729,578,757433.9,600542.29,1357976.19
350220,202001,671,560,111,581840.29,115329,697169.29
350230,202001,72,52,20,54028,21819,75847
350240,202001,64,45,19,46755,19741,66496
350250,202001,1132,540,592,561062,616128.55,1177190.55
350260,202001,90,67,23,69613.5,23897,93510.5
350270,202001,852,568,284,591193,296115.7,887308.7
350275,202001,303,125,178,129875,185981,315856
350280,202001,4619,2354,2265,2448931.95,2356452.95,4805384.90
350290,202001,439,201,238,208839,247282.7,456121.7
350300,202001,55,29,26,30131,27014,57145
350310,202001,89,56,33,58184,34287,92471
350315,202001,44,24,20,24936,20780,45716
350320,202001,3314,1620,1694,1687337.2,1763183.8,3450521.0
350330,202001,1661,893,768,928870.39,797954.1,1726824.49
350335,202001,18,13,5,13507,5195,18702
350340,202001,122,56,66,58184,68574.65,126758.65
350350,202001,88,45,43,46755,44677,91432
350360,202001,122,81,41,84159.19,42599,126758.19
350370,202001,89,52,37,54028.29,38443,92471.29
350380,202001,782,332,450,344948.7,467551.6,812500.3
350390,202001,1543,603,940,626518.11,978738.7,1605256.81
350395,202001,25,20,5,20780,5195,25975
350400,202001,1698,871,827,908089.02,859253.48,1767342.50
350410,202001,2559,1123,1436,1167836,1493044.07,2660880.07
350420,202001,251,153,98,158967.99,101822,260789.99
350430,202001,74,45,29,46755,30131,76886
350440,202001,151,110,41,114290.7,42599,156889.7
350450,202001,1636,979,657,1023417.58,683664.5,1707082.08
350460,202001,382,129,253,134031,262867,396898
350470,202001,18,11,7,11429,7273,18702
350480,202001,171,95,76,98705,78964,177669
350490,202001,232,116,116,120524,120524,241048
350500,202001,50,19,31,19741,32209,51950
350510,202001,163,109,54,113251,57145,170396
350520,202001,457,227,230,235853.29,238970,474823.29
350530,202001,446,208,238,217151,247282,464433
350535,202001,81,66,15,68574,15585,84159
350540,202001,381,189,192,197410,201566,398976
350550,202001,2735,1628,1107,1695648.92,1152253.44,2847902.36
350560,202001,642,447,195,464433,203644,668077
350570,202001,4135,1724,2411,1794354.79,2508150.7,4302505.49
350580,202001,370,176,194,182864,201566.19,384430.19
350590,202001,902,490,412,514305.7,428068,942373.7
350600,202001,6115,2981,3134,3105577.74,3262461.27,6368039.01
350610,202001,1524,793,731,824966.58,760549.19,1585515.77
350620,202001,31,20,11,20780,11429,32209
350630,202001,245,137,108,142343.29,112212.29,254555.58
350635,202001,946,383,563,398977.57,584958.49,983936.06
350640,202001,127,94,33,97666,34287,131953
350650,202001,1891,1256,635,1307063.69,660804.39,1967868.08
350660,202001,744,318,426,331441,443653.19,775094.19
350670,202001,309,152,157,157928,163123,321051
350680,202001,179,93,86,96627,89355.4,185982.4
350690,202001,198,100,98,103900,101822,205722
350700,202001,767,365,402,379236.2,418717.7,797953.9
350710,202001,364,132,232,137148,241048,378196
350715,202001,54,43,11,44677,11429,56106
350720,202001,16,11,5,11429,5195,16624
350730,202001,44,27,17,28053,17663,45716
350740,202001,213,124,89,128836,92471,221307
350745,202001,22,11,11,11429,11429,22858
350750,202001,2190,1362,828,1417197.84,863409,2280606.84
350760,202001,3761,1644,2117,1708116.79,2202680,3910796.79
350770,202001,63,46,17,47794,17663,65457
350775,202001,44,32,12,33248,12468.39,45716.39
350780,202001,435,221,214,229619,223385.7,453004.7
350790,202001,375,159,216,165201,225463,390664
350800,202001,463,274,189,285725,198449,484174
350810,202001,514,418,96,435341.65,99744,535085.65
350820,202001,93,57,36,59223,37404,96627
350830,202001,81,42,39,43638,40521,84159
350840,202001,758,312,446,325207.7,463395.09,788602.79
350850,202001,1745,983,762,1022377.25,793797.67,1816174.92
350860,202001,598,340,258,353262.95,269101,622363.95
350870,202001,426,287,139,298193,145460,443653
350880,202001,285,157,128,163123.75,134031,297154.75
350890,202001,40,27,13,28053,13507,41560
350900,202001,1456,457,999,475862.85,1042118.09,1517980.94
350910,202001,25,14,11,15585,11429,27014
350920,202001,670,359,311,373001,324168,697169
350925,202001,1203,644,559,670155.29,583920.91,1254076.20
350930,202001,99,62,37,65457,38443,103900
350940,202001,713,397,316,412483,328324,740807
350945,202001,108,78,30,81042,31170,112212
350950,202001,16256,7697,8559,8011736.73,8910468.51,16922205.24
350960,202001,1326,618,708,643141.05,736651.62,1379792.67
350970,202001,1104,583,521,605627.29,542359.6,1147986.89
350980,202001,95,63,32,65457,33248,98705
350990,202001,377,136,241,141304,251438,392742
350995,202001,37,16,21,17663,21819,39482
351000,202001,635,437,198,454043.58,208839,662882.58
351010,202001,51,32,19,33248,19741,52989
351015,202001,51,37,14,38443,14546,52989
351020,202001,1589,958,631,998479.89,656648,1655127.89
351030,202001,345,231,114,240009,119485,359494
351040,202001,885,463,422,482096.64,438458.23,920554.87
351050,202001,3320,1516,1804,1576167.24,1877475.34,3453642.58
351060,202001,5242,2073,3169,2159045.53,3305059.76,5464105.29
351070,202001,407,253,154,262869.06,162084,424953.06
351080,202001,757,553,204,577685.1,212995,790680.1
351090,202001,55,24,31,24936,32209,57145
351100,202001,439,252,187,261828.74,194293,456121.74
351110,202001,2047,979,1068,1020303.36,1113816.89,2134120.25
351120,202001,67,33,34,34287,35326,69613
351130,202001,185,59,126,61301,131953,193254
351140,202001,327,225,102,235853,105978,341831
351150,202001,442,231,211,241048.65,219229.7,460278.35
351160,202001,270,183,87,190137.7,90393,280530.7
351170,202001,185,98,87,101822,90393,192215
351190,202001,84,58,26,60262,27014,87276
351200,202001,363,245,118,254555.7,123641,378196.7
351210,202001,123,63,60,65457,62340,127797
351220,202001,532,321,211,333519.82,219229,552748.82
351230,202001,276,192,84,199488,87276,286764
351240,202001,234,113,121,117407,125719,243126
351250,202001,79,56,23,58184.16,23897,82081.16
351260,202001,153,115,38,119485,39482,158967
351270,202001,46,19,27,19741,28053,47794
351280,202001,1011,463,548,481057.29,572490.38,1053547.67
351290,202001,242,106,136,111173,141304.7,252477.7
351300,202001,3760,1685,2075,1750636.79,2161120.48,3911757.27
351310,202001,767,386,381,401054,396898.39,797952.39
351320,202001,115,67,48,69613.86,49872,119485.86
351330,202001,40,26,14,27014,14546,41560
351340,202001,1242,738,504,766783.5,525734.97,1292518.47
351350,202001,2455,1413,1042,1472266.48,1084716,2556982.48
351360,202001,769,376,393,390664,408327,798991
351370,202001,394,198,196,206761.7,205722,412483.7
351380,202001,9087,4124,4963,4288999.46,5169028.57,9458028.03
351385,202001,28,18,10,18702,10390,29092
351390,202001,280,211,69,219229.97,71691,290920.97
351400,202001,68,44,24,45716,24937.17,70653.17
351410,202001,434,277,157,287804.24,164162,451966.24
351420,202001,64,52,12,54028,12468,66496
351430,202001,68,36,32,37404,33248,70652
351440,202001,793,555,238,576649.24,247282,823931.24
351450,202001,266,131,135,136109,141304,277413
351460,202001,122,57,65,59223,67535,126758
351470,202001,142,75,67,77925,69613,147538
351480,202001,507,289,218,300272.32,228580,528852.32
351490,202001,289,104,185,108056,192215,300271
351492,202001,31,22,9,22858,9351,32209
351495,202001,24,18,6,18702,7273,25975
351500,202001,3582,1511,2071,1572008.37,2155926.98,3727935.35
351510,202001,1878,745,1133,774056.4,1177187.7,1951244.1
351512,202001,20,15,5,15585,5195,20780
351515,202001,195,111,84,115329,88315.78,203644.78
351518,202001,753,471,282,489369.19,294037,783406.19
351519,202001,74,45,29,46755,30131,76886
351520,202001,156,96,60,100783,63379,164162
351530,202001,24,15,9,15585,9351,24936
351535,202001,128,74,54,76886,56106,132992
351540,202001,456,328,128,340792.31,132992,473784.31
351550,202001,1413,835,578,872762.68,601581,1474343.68
351560,202001,67,39,28,40521,29092,69613
351565,202001,9,7,2,7273,2078,9351
351570,202001,2688,1336,1352,1390183.08,1404728.57,2794911.65
351580,202001,38,34,4,35326,4156,39482
351590,202001,63,42,21,43638,21819,65457
351600,202001,186,137,49,142343,50911,193254
351610,202001,52,23,29,23897,30131,54028
351620,202001,5858,3298,2560,3431820.9,2663998.85,6095819.75
351630,202001,2787,1393,1394,1450445.85,1448366,2898811.85
351640,202001,1959,918,1041,956919.01,1082639.49,2039558.50
351650,202001,29,25,4,25975,4156,30131
351660,202001,141,92,49,95588,50911,146499
351670,202001,720,446,274,463396.4,284686,748082.4
351680,202001,72,60,12,62340,12468,74808
351685,202001,27,15,12,15585,12468,28053
351690,202001,305,212,93,220268.72,97666,317934.72
351700,202001,161,112,49,116368.7,50911,167279.7
351710,202001,70,46,24,47794,24936,72730
351720,202001,131,74,57,76886,59223,136109
351730,202001,106,71,35,73769,36365.29,110134.29
351740,202001,735,480,255,500800.02,265984,766784.02
351750,202001,355,147,208,152733,216112,368845
351760,202001,775,586,189,608854,196371,805225
351770,202001,314,267,47,277413.29,48833,326246.29
351780,202001,158,93,65,96627.39,67535,164162.39
351790,202001,253,135,118,140265,122602.65,262867.65
351800,202001,41,27,14,28053,14546,42599
351810,202001,121,81,40,84159,41560,125719
351820,202001,830,599,231,623401.3,241048.89,864450.19
351830,202001,534,186,348,194293,362611,556904
351840,202001,1914,955,959,994325.62,999518.57,1993844.19
351850,202001,247,178,69,184942,71691,256633
351860,202001,676,463,213,482098.08,221307,703405.08
351870,202001,5609,2637,2972,2747120.24,3093105.26,5840225.50
351880,202001,19335,7988,11347,8314086.13,11807215.24,20121301.37
351885,202001,88,56,32,59223,34287,93510
351890,202001,73,62,11,64418,12468,76886
351900,202001,223,130,93,136109,96627,232736
351905,202001,76,31,45,32209,46755,78964
351907,202001,3424,1425,1999,1483694.37,2081119.57,3564813.94
351910,202001,177,71,106,73769,110134,183903
351920,202001,121,70,51,72730,52989.38,125719.38
351925,202001,90,58,32,60262,33248,93510
351930,202001,389,254,135,264945,140265,405210
351940,202001,242,106,136,110134,142343,252477
351950,202001,133,73,60,75847,62340,138187
351960,202001,903,441,462,458524.49,482096.7,940621.19
351970,202001,1870,992,878,1034844.7,915360.79,1950205.49
351980,202001,155,78,77,81042,80003,161045
351990,202001,256,169,87,175592.4,90393,265985.4
352000,202001,350,219,131,227542.4,136109,363651.4
352010,202001,398,253,145,262867,150655.5,413522.5
352020,202001,186,67,119,69613,123641,193254
352030,202001,1079,548,531,570411,551709,1122120
352040,202001,578,240,338,249360,353260,602620
352042,202001,281,86,195,89354,202606.4,291960.4
352044,202001,355,216,139,224424,144421,368845
352050,202001,3244,1275,1969,1327844.56,2046830.7,3374675.26
352060,202001,105,66,39,68574,40521,109095
352070,202001,93,69,24,71691.58,25975,97666.58
352080,202001,69,43,26,44677,27014,71691
352090,202001,162,108,54,112212,56106,168318
352100,202001,283,139,144,145460.89,149617.08,295077.97
352110,202001,112,32,80,33248,83120,116368
352115,202001,61,21,40,21819,41560,63379
352120,202001,87,61,26,63379.29,27014,90393.29
352130,202001,216,180,36,188059,37404,225463
352140,202001,188,88,100,91432,103900,195332
352150,202001,115,62,53,64418,55067,119485
352160,202001,140,90,50,93510,51950,145460
352170,202001,381,263,118,273257,123641,396898
352180,202001,616,402,214,417678.29,222346.19,640024.48
352190,202001,247,99,148,102861,154811,257672
352200,202001,30,16,14,16624,14546,31170
352210,202001,4043,1663,2380,1729937.52,2481135.19,4211072.71
352215,202001,55,31,24,32209,24936,57145
352220,202001,6860,2599,4261,2701402.76,4438612.24,7140015.00
352230,202001,3319,2146,1173,2232816.54,1219790.16,3452606.70
352240,202001,2357,1359,998,1413041.5,1036922.7,2449964.2
352250,202001,2740,1328,1412,1380834.47,1469147.28,2849981.75
352260,202001,961,497,464,523656.7,483135.7,1006792.4
352265,202001,54,25,29,25975,30131,56106
352270,202001,403,235,168,246243,176631.34,422874.34
352280,202001,438,275,163,285725.58,170396,456121.58
352290,202001,170,100,70,103900,72730,176630
352300,202001,93,67,26,69613,27014,96627
352310,202001,6271,2820,3451,2932063.41,3589746.45,6521809.86
352320,202001,1020,532,488,552748.7,508071,1060819.7
352330,202001,521,255,266,264945,279491.7,544436.7
352340,202001,1355,632,723,656650.6,753277.49,1409928.09
352350,202001,339,204,135,211956,140265.7,352221.7
352360,202001,218,99,119,102861,123641.6,226502.6
352370,202001,102,68,34,70652,36365,107017
352380,202001,116,74,42,76886,43638,120524
352390,202001,2420,1044,1376,1085757.2,1429665.91,2515423.11
352400,202001,494,218,276,226502,288842.7,515344.7
352410,202001,826,590,236,616127.29,245204,861331.29
352420,202001,104,69,35,71691,36365,108056
352430,202001,1717,782,935,815617.27,975621.97,1791239.24
352440,202001,3198,1592,1606,1654091.74,1671752.68,3325844.42
352450,202001,201,167,34,173513,35326,208839
352460,202001,616,318,298,330402.19,309622,640024.19
352470,202001,657,225,432,234814,448848,683662
352480,202001,1393,770,623,803147.78,650414.7,1453562.48
352490,202001,62,23,39,23897,40521,64418
352500,202001,1209,520,689,543397.87,717950.09,1261347.96
352510,202001,736,401,335,418717.58,350143,768860.58
352520,202001,650,311,339,323129.65,355338,678467.65
352530,202001,1742,919,823,957958,856136.7,1814094.7
352540,202001,76,49,27,51950,28053,80003
352550,202001,182,110,72,114290,75847,190137
352560,202001,47,38,9,39482,9351,48833
352570,202001,673,349,324,362611.29,336636,699247.29
352580,202001,55,42,13,43638,13507,57145
352585,202001,20,6,14,6234,14546,20780
352590,202001,4436,2222,2214,2315931.29,2308660.18,4624591.47
352600,202001,349,252,97,261828,100783,362611
352610,202001,946,430,516,447809.38,538202,986011.38
352620,202001,1010,407,603,422873,627556,1050429
352630,202001,175,63,112,65457,116368,181825
352640,202001,529,356,173,371962.78,180786,552748.78
352650,202001,85,61,24,63379,24936,88315
352660,202001,69,41,28,42599,29092,71691
352670,202001,1657,898,759,935101.33,791719.52,1726820.85
352680,202001,926,579,347,602620.99,360533,963153.99
352690,202001,4542,2052,2490,2135149.65,2592305.68,4727455.33
352700,202001,108,64,44,66496.7,45716,112212.7
352710,202001,1373,736,637,765743,663921,1429664
352720,202001,1345,626,719,654570,748080.7,1402650.7
352725,202001,24,20,4,20780,4156,24936
352730,202001,396,205,191,212995,198449,411444
352740,202001,406,259,147,269102.28,152733.16,421835.44
352750,202001,19,12,7,12468,7273,19741
352760,202001,177,116,61,120524,63379,183903
352770,202001,83,64,19,66496,19741,86237
352780,202001,76,41,35,42599,36365,78964
352790,202001,26,21,5,21819,5195,27014
352800,202001,239,174,65,180786,67535,248321
352810,202001,153,96,57,99744.99,59223,158967.99
352820,202001,63,51,12,52989,12468,65457
352830,202001,82,56,26,58184,27014,85198
352840,202001,665,336,329,349104,341831,690935
352850,202001,1490,496,994,517422,1033805,1551227
352860,202001,121,76,45,78964,47794,126758
352870,202001,43,27,16,28053,16624.7,44677.7
352880,202001,184,123,61,127797,64418,192215
352885,202001,32,22,10,22858,10390,33248
352890,202001,52,35,17,36365,17663.7,54028.7
352900,202001,4825,2353,2472,2449967.1,2573607.34,5023574.44
352910,202001,39,32,7,33248,7273,40521
352920,202001,662,398,264,413522,275335,688857
352930,202001,1223,584,639,608860.16,663939.22,1272799.38
352940,202001,6203,2593,3610,2699326.38,3754950.24,6454276.62
352950,202001,102,39,63,40521,65457,105978
352960,202001,56,39,17,40521,17663,58184
352965,202001,19,9,10,9351,10390,19741
352970,202001,512,389,123,406249.8,127797.39,534047.19
352980,202001,159,87,72,90393,75847,166240
352990,202001,972,443,529,462355,551709,1014064
353000,202001,65,30,35,31170,36365,67535
353010,202001,544,335,209,350143,217151,567294
353020,202001,296,213,83,222346,87276,309622
353030,202001,1249,574,675,596386.87,702364.39,1298751.26
353040,202001,90,58,32,60262,33248,93510
353050,202001,1338,868,470,901853.1,488330,1390183.1
353060,202001,8408,3695,4713,3844309.73,4909277.3,8753587.03
353070,202001,1749,1092,657,1137707.03,684516.05,1822223.08
353080,202001,1295,695,600,722106.37,624439,1346545.37
353090,202001,56,31,25,32209,25975,58184
353100,202001,51,43,8,44677,8312,52989
353110,202001,2063,624,1439,648337.48,1499278.64,2147616.12
353120,202001,93,49,44,50911,45716,96627
353130,202001,841,413,428,430147.96,447810.17,877958.13
353140,202001,554,226,328,234814.29,340792,575606.29
353150,202001,341,193,148,201566.29,154811,356377.29
353160,202001,94,77,17,81042,17663,98705
353170,202001,210,68,142,70652,147538.78,218190.78
353180,202001,1037,480,557,498720,578725.54,1077445.54
353190,202001,506,371,135,385469,140265.7,525734.7
353200,202001,213,107,106,111173,110134,221307
353205,202001,21,15,6,15585,6234,21819
353210,202001,78,46,32,48833,34287,83120
353215,202001,46,27,19,28053,19741,47794
353220,202001,82,46,36,47794,37404,85198
353230,202001,161,62,99,65457,103900,169357
353240,202001,317,167,150,173513,156889,330402
353250,202001,214,109,105,113251,109095,222346
353260,202001,461,321,140,333519.55,145460,478979.55
353270,202001,69,53,16,55067,17663,72730
353280,202001,106,54,52,56106.8,54028,110134.8
353282,202001,125,88,37,93510,38443,131953
353284,202001,25,18,7,18702,7273,25975
353286,202001,1,0,1,0,1039,1039
353290,202001,73,43,30,44677,31170,75847
353300,202001,441,241,200,251439.43,207800,459239.43
353310,202001,46,40,6,41560,6234,47794
353320,202001,58,34,24,35326,24936,60262
353325,202001,54,31,23,32209,23897.48,56106.48
353330,202001,63,44,19,45716.85,19741,65457.85
353340,202001,636,221,415,229619,432224.7,661843.7
353350,202001,900,433,467,449887.78,485214.48,935102.26
353360,202001,103,83,20,86237,20780,107017
353370,202001,118,65,53,68574,55067,123641
353380,202001,33,18,15,18702.19,15585,34287.19
353390,202001,1121,541,580,564177,604698,1168875
353400,202001,44,25,19,25975,19741,45716
353410,202001,106,66,40,68574,41560.95,110134.95
353420,202001,62,28,34,29092,35326,64418
353430,202001,588,397,191,413523.16,199488,613011.16
353440,202001,10649,4653,5996,4844859.86,6246473.22,11091333.08
353450,202001,56,30,26,31170,27014,58184
353460,202001,599,328,271,340792.55,285725,626517.55
353470,202001,2126,1120,1006,1164720.42,1047312.76,2212033.18
353475,202001,238,162,76,168319.09,80003,248322.09
353480,202001,184,153,31,158967,32209,191176
353490,202001,237,146,91,152733,94549.7,247282.7
353500,202001,195,115,80,119485.29,83120,202605.29
353510,202001,101,70,31,73769,32209,105978
353520,202001,211,148,63,154811,65457,220268
353530,202001,471,255,216,264945,225463,490408
353540,202001,372,250,122,260789,126758,387547
353550,202001,720,466,254,486253.31,263906,750159.31
353560,202001,598,239,359,248321,373001.8,621322.8
353570,202001,65,35,30,36365.7,31170,67535.7
353580,202001,360,269,91,280531.37,95588,376119.37
353590,202001,94,66,28,68574,29092,97666
353600,202001,275,160,115,166240.29,119485,285725.29
353610,202001,128,70,58,72730,61301,134031
353620,202001,606,319,287,331441,298193,629634
353625,202001,50,28,22,29092,22858,51950
353630,202001,230,169,61,175591.19,64418,240009.19
353640,202001,124,84,40,87276,41560,128836
353650,202001,927,359,568,374040,592230,966270
353657,202001,24,18,6,18702,7273,25975
353660,202001,268,143,125,148577,129875,278452
353670,202001,765,455,310,472745.99,322090.7,794836.69
353680,202001,105,74,31,76886.75,32209,109095.75
353690,202001,42,32,10,33248,10390,43638
353700,202001,283,203,80,211956,83120,295076
353710,202001,465,224,241,233775.8,251438.7,485214.5
353715,202001,45,33,12,34287,12468,46755
353720,202001,353,161,192,167280.09,199488,366768.09
353730,202001,1088,670,418,697169.9,436380.9,1133550.8
353740,202001,626,345,281,358455.5,294037,652492.5
353750,202001,81,48,33,49872,34287,84159
353760,202001,2905,1093,1812,1139784.43,1885787.21,3025571.64
353770,202001,88,71,17,73769,17663,91432
353780,202001,1196,574,622,598464.29,648336,1246800.29
353790,202001,507,305,202,316896.28,210917.7,527813.98
353800,202001,3324,1641,1683,1708139.64,1752864.66,3461004.30
353810,202001,239,135,104,140265.39,109095.78,249361.17
353820,202001,206,97,109,100783,113251,214034
353830,202001,49,42,7,43638,7273,50911
353850,202001,180,84,96,87276,99744,187020
353860,202001,500,228,272,236892,284686,521578
353870,202001,5303,2690,2613,2798035.69,2721144.05,5519179.74
353880,202001,683,482,201,502877.68,209878,712755.68
353890,202001,571,329,242,341831.7,253517.24,595348.94
353900,202001,132,70,62,72730,64418,137148
353910,202001,173,77,96,81042,99744,180786
353920,202001,433,239,194,248321.65,201566,449887.65
353930,202001,990,581,409,604698,427030.77,1031728.77
353940,202001,193,101,92,104939,95588,200527
353950,202001,516,317,199,330402,206761,537163
353960,202001,74,61,13,63379,13507,76886
353970,202001,65,40,25,41560,25975,67535
353980,202001,1660,773,887,807303,924711.46,1732014.46
353990,202001,72,43,29,44677,31170,75847
354000,202001,382,187,195,194293,202605.19,396898.19
354010,202001,88,47,41,48833,42599.5,91432.5
354020,202001,523,333,190,347026,197410,544436
354025,202001,53,43,10,45716,10390,56106
354030,202001,56,34,22,35326,22858,58184
354040,202001,102,77,25,80003,27014,107017
354050,202001,176,96,80,99744.71,86237,185981.71
354060,202001,778,383,395,397937,410405,808342
354070,202001,924,535,389,557943.7,406249.7,964193.4
354075,202001,224,107,117,111173,121563,232736
354080,202001,311,134,177,139226,184942,324168
354085,202001,20,13,7,13507,7273,20780
354090,202001,292,167,125,173425,130914,304339
354100,202001,5551,2304,3247,2395935.32,3379870.56,5775805.88
354105,202001,89,44,45,45716,46755,92471
354110,202001,48,24,24,24936,24936,49872
354120,202001,138,99,39,102861.39,40521,143382.39
354130,202001,705,453,252,471706.39,263907.09,735613.48
354140,202001,3147,1456,1691,1512786.5,1760066.96,3272853.46
354150,202001,630,381,249,396898.07,258711,655609.07
354160,202001,663,424,239,442614,248322.11,690936.11
354165,202001,18,14,4,14546,4156,18702
354170,202001,174,117,57,121563,59223,180786
354180,202001,63,37,26,39482.54,27014,66496.54
354190,202001,196,84,112,87276,116368,203644
354200,202001,119,63,56,65457,58184,123641
354210,202001,58,24,34,24936,35326,60262
354220,202001,646,406,240,423912.99,250399,674311.99
354230,202001,172,73,99,75847.8,102861,178708.8
354240,202001,329,214,115,222346.97,120524,342870.97
354250,202001,83,51,32,52989,33248,86237
354260,202001,2027,953,1074,990170.41,1123161.92,2113332.33
354270,202001,93,67,26,69613,27014,96627
354280,202001,43,23,20,23897,20780,44677
354290,202001,143,101,42,105978,44677,150655
354300,202001,390,272,118,282608.29,123641,406249.29
354310,202001,93,68,25,70652.7,27014,97666.7
354320,202001,196,98,98,101822,101822,203644
354323,202001,12,11,1,11429,1039,12468
354325,202001,114,68,46,70652.76,47794,118446.76
354330,202001,2482,828,1654,860144.9,1720585.09,2580729.99
354340,202001,10419,5064,5355,5271890.46,5576317.58,10848208.04
354350,202001,120,81,39,84159,40521,124680
354360,202001,77,45,32,46755,34287,81042
354370,202001,244,131,113,136109,117407,253516
354380,202001,189,112,77,116368,80003,196371
354390,202001,2701,989,1712,1030688.99,1780846.89,2811535.88
354400,202001,315,171,144,177669,149616,327285
354410,202001,611,296,315,308583,330402.7,638985.7
354420,202001,279,176,103,182864,107017,289881
354425,202001,304,182,122,189098,126758,315856
354430,202001,180,103,77,108056,80003,188059
354440,202001,36,27,9,28053,9351,37404
354450,202001,53,38,15,39482,16624.7,56106.7
354460,202001,102,59,43,61301,44677,105978
354470,202001,37,21,16,21819,16624,38443
354480,202001,112,60,52,62340,54028,116368
354490,202001,145,90,55,94549,57145,151694
354500,202001,375,183,192,190137,199488,389625
354510,202001,98,70,28,72730,29092,101822
354515,202001,37,12,25,12468,25975,38443
354520,202001,1609,691,918,720919.25,953802.9,1674722.15
354530,202001,736,374,362,388587.09,376118,764705.09
354540,202001,266,145,121,150655,126758,277413
354550,202001,41,24,17,24936,17663,42599
354560,202001,148,79,69,82081,71691,153772
354570,202001,140,90,50,93510.75,51950,145460.75
354580,202001,1893,902,991,940296.59,1030688.7,1970985.29
354600,202001,251,141,110,146499,115329,261828
354610,202001,75,63,12,65457.53,12468.39,77925.92
354620,202001,62,19,43,19741,44677,64418
354625,202001,15,10,5,10390,5195.19,15585.19
354630,202001,314,203,111,210917.39,115329,326246.39
354640,202001,802,515,287,536125.33,299232,835357.33
354650,202001,72,41,31,42599,32209.39,74808.39
354660,202001,788,584,204,607815.29,212995,820810.29
354670,202001,244,90,154,93510,162084.8,255594.8
354680,202001,1255,470,785,488330,820810,1309140
354690,202001,81,56,25,58184.7,25975,84159.7
354700,202001,69,49,20,50911,20780,71691
354710,202001,45,33,12,34287,12468,46755
354720,202001,20,20,0,20780,0,20780
354730,202001,1734,719,1015,747042.79,1058741.7,1805784.49
354740,202001,69,49,20,50911,20780,71691
354750,202001,434,247,187,258711.39,194293,453004.39
354760,202001,476,292,184,303390.15,193254.7,496644.85
354765,202001,10,5,5,5195,5195,10390
354770,202001,346,227,119,236892.7,123641,360533.7
354780,202001,8208,3284,4924,3416240.18,5122278.84,8538519.02
354790,202001,100,57,43,59223,44677,103900
354800,202001,453,247,206,256633,214034.7,470667.7
354805,202001,100,47,53,48833.7,56106,104939.7
354810,202001,105,62,43,64418,44677,109095
354820,202001,204,85,119,89354.58,123641,212995.58
354830,202001,41,21,20,21819,20780,42599
354840,202001,64,45,19,47794,19741,67535
354850,202001,4543,2023,2520,2105016.6,2622437.55,4727454.15
354860,202001,329,158,171,164162,177669.94,341831.94
354870,202001,12289,5508,6781,5732173.95,7057934.61,12790108.56
354880,202001,2854,1061,1793,1110692.78,1866047,2976739.78
354890,202001,2888,1557,1331,1620842.95,1386026,3006868.95
354900,202001,63,43,20,44677,20780,65457
354910,202001,1249,665,584,695092.2,608854,1303946.2
354920,202001,46,38,8,39482,8312,47794
354925,202001,12,7,5,7273,5195,12468
354930,202001,35,32,3,33248.07,3117,36365.07
354940,202001,812,592,220,615349.94,228580,843929.94
354950,202001,202,134,68,141304.55,70652,211956.55
354960,202001,158,62,96,64418,99744,164162
354970,202001,929,619,310,643143.06,322090.7,965233.76
354980,202001,8699,3170,5529,3297790.38,5756064.97,9053855.35
354990,202001,9158,4246,4912,4417834.45,5111899.59,9529734.04
354995,202001,540,182,358,190137,373001,563138
355000,202001,466,164,302,171435,315856,487291
355010,202001,606,380,226,395860.5,234815.59,630676.09
355020,202001,756,474,282,493525.26,294037.89,787563.15
355030,202001,207401,80579,126822,83855839.27,131984313.6,215840152.87
355040,202001,753,356,397,369884.7,412483,782367.7
355050,202001,150,98,52,101822,55067,156889
355060,202001,1590,802,788,833279.9,819771.8,1653051.7
355070,202001,1443,684,759,710677.76,792757.68,1503435.44
355080,202001,200,119,81,123641,84159,207800
355090,202001,285,171,114,177669,118446.05,296115.05
355100,202001,4981,2375,2606,2470642,2712830.79,5183472.79
355110,202001,264,176,88,182864.89,92471,275335.89
355120,202001,78,56,22,58184,22858.39,81042.39
355130,202001,51,29,22,30131,22858,52989
355140,202001,180,112,68,116368,70652,187020
355150,202001,674,412,262,429107.89,275335,704442.89
355160,202001,465,227,238,236892.29,248321.7,485213.99
355170,202001,2057,1086,971,1129393,1011986,2141379
355180,202001,675,286,389,298193,405210,703403
355190,202001,204,143,61,148577,63379,211956
355200,202001,112,64,48,66496,49872,116368
355210,202001,685,395,290,411444,302349.39,713793.39
355220,202001,7109,3716,3393,3872360.26,3533645.05,7406005.31
355230,202001,97,57,40,59223,41560,100783
355240,202001,4439,1881,2558,1958518.41,2663996.58,4622514.99
355250,202001,5750,2620,3130,2724277.98,3257269.09,5981547.07
355255,202001,47,28,19,29092,19741,48833
355260,202001,177,108,69,113251.7,74808.78,188060.48
355270,202001,170,107,63,111173,65457,176630
355280,202001,6289,2552,3737,2655688.2,3890017.79,6545705.99
355290,202001,72,57,15,59223.96,15585,74808.96
355300,202001,195,123,72,127797,74808.7,202605.7
355310,202001,108,60,48,62340,49872,112212
355320,202001,88,47,41,49872,42599,92471
355330,202001,280,160,120,166240,124680,290920
355340,202001,1528,519,1009,539242.66,1050429,1589671.66
355350,202001,132,69,63,71691,65457,137148
355360,202001,170,110,60,114290,62340,176630
355365,202001,21,17,4,17663,4156,21819
355370,202001,1033,602,431,625484.35,449890.12,1075374.47
355380,202001,802,522,280,542358,290920,833278
355385,202001,69,48,21,49872,21819,71691
355390,202001,108,63,45,65457,46755,112212
355395,202001,193,113,80,118446.33,83120,201566.33
355400,202001,1636,996,640,1035801.05,668077.29,1703878.34
355410,202001,4882,2325,2557,2416718.39,2666076.61,5082795.00
355420,202001,50,36,14,37404,14546,51950
355430,202001,367,225,142,233776.48,147538,381314.48
355440,202001,77,44,33,45716,34287,80003
355450,202001,463,231,232,241048.84,242087.85,483136.69
355460,202001,64,48,16,49872.97,16624,66496.97
355465,202001,47,30,17,31170,17663,48833
355470,202001,177,71,106,73769.85,110134,183903.85
355475,202001,13,9,4,9351,4156,13507
355480,202001,514,220,294,228580.8,305466,534046.8
355490,202001,117,84,33,87276,35326,122602
355495,202001,60,27,33,28053,34287,62340
355500,202001,1599,901,698,938219.53,725223.28,1663442.81
355510,202001,268,201,67,208840.09,69613,278453.09
355520,202001,33,24,9,24936.7,9351,34287.7
355530,202001,21,14,7,14546,7273,21819
355535,202001,78,37,41,38443,42599,81042
355540,202001,2442,970,1472,1009016.19,1532526.38,2541542.57
355550,202001,58,38,20,39482,21819,61301
355560,202001,250,117,133,121563,138187,259750
355570,202001,23,15,8,15585,8312,23897
355580,202001,244,170,74,176630,76886.89,253516.89
355590,202001,18,12,6,12468,7273,19741
355600,202001,276,142,134,147538,139226,286764
355610,202001,230,153,77,158967,80003,238970
355620,202001,1332,614,718,637946.7,748080.19,1386026.89
355630,202001,444,324,120,337675,124680.29,462355.29
355635,202001,118,54,64,56106,66496.58,122602.58
355640,202001,564,320,244,332480,255594,588074
355645,202001,843,340,503,354299,523658.1,877957.1
355650,202001,2008,858,1150,894582.07,1196928.39,2091510.46
355660,202001,256,136,120,141304,124680,265984
355670,202001,555,225,330,234814,342870,577684
355680,202001,203,120,83,125719,87276,212995
355690,202001,92,43,49,44677,50911.49,95588.49
355695,202001,16,10,6,10390,7273,17663
355700,202001,1153,608,545,631712.63,567295.4,1199008.03
355710,202001,2247,1236,1011,1288361.51,1050429.39,2338790.90
355715,202001,19,15,4,15585,4156,19741
355720,202001,211,126,85,130914.92,88315,219229.92
355730,202001,101,59,42,61301,43638,104939
410010,202001,133,109,24,113251,24936,138187
410020,202001,112,88,24,91432,24936,116368
410030,202001,164,103,61,107017.7,63379,170396.7
410040,202001,1133,568,565,590152,589113.8,1179265.8
410045,202001,35,28,7,29092,7273,36365
410050,202001,481,271,210,281569,219229,500798
410060,202001,281,212,69,220268,71691,291959
410070,202001,301,252,49,262867,50911,313778
410080,202001,165,105,60,109095,63379,172474
410090,202001,80,70,10,72730.58,10390,83120.58
410100,202001,288,205,83,215073,86237,301310
410105,202001,48,30,18,31170,18702,49872
410110,202001,321,196,125,203644,130914,334558
410115,202001,32,22,10,22858,10390,33248
410120,202001,415,210,205,218190,212995,431185
410130,202001,48,29,19,30131,19741,49872
410140,202001,3119,1523,1596,1585517.96,1660326.5,3245844.46
410150,202001,2694,1068,1626,1111731.57,1694610.4,2806341.97
410160,202001,510,315,195,327285,203644,530929
410165,202001,68,43,25,44677,25975,70652
410170,202001,165,114,51,118446.7,52989,171435.7
410180,202001,2257,1265,992,1314335.7,1034844.19,2349179.89
410185,202001,38,33,5,34287,5195,39482
410190,202001,491,323,168,335597.43,175591,511188.43
410200,202001,959,710,249,738729,258711,997440
410210,202001,594,312,282,324168,292998.7,617166.7
410220,202001,44,22,22,22858,22858,45716
410230,202001,149,67,82,69613,85198,154811
410240,202001,759,490,269,509112.45,280530,789642.45
410250,202001,380,275,105,285725,109095,394820
410260,202001,294,161,133,168318,138187,306505
410270,202001,28,20,8,20780,8312,29092
410275,202001,57,44,13,45716,13507,59223
410280,202001,321,188,133,195332,138187,333519
410290,202001,246,155,91,161045,94549,255594
410300,202001,77,55,22,57145,22858,80003
410302,202001,18,11,7,11429,7273,18702
410304,202001,43,29,14,30131,14546,44677
410305,202001,220,118,102,122602,105978,228580
410310,202001,215,129,86,134031,90393,224424
410315,202001,50,35,15,36365,15585,51950
410320,202001,133,93,40,96627,41560,138187
410322,202001,35,22,13,22858,13507,36365
410330,202001,172,121,51,125719,52989.8,178708.8
410335,202001,101,57,44,59223,45716,104939
410337,202001,43,33,10,34287,10390,44677
410340,202001,33,29,4,30131,4156,34287
410345,202001,216,127,89,132992,92471,225463
410347,202001,51,39,12,40521,12468,52989
410350,202001,241,149,92,154811,95588,250399
410360,202001,472,298,174,309623.4,180787.4,490410.8
410370,202001,2369,1006,1363,1047313.74,1416157.77,2463471.51
410380,202001,213,131,82,136109,85198,221307
410390,202001,385,270,115,280530,119485,400015
410395,202001,37,24,13,24936,13507,38443
410400,202001,830,396,434,411446.1,451378.75,862824.85
410405,202001,93,70,23,72730,23897,96627
410410,202001,34,26,8,27014,8312,35326
410420,202001,1662,790,872,821758.21,908086.87,1729845.08
410425,202001,177,76,101,78964.8,104939,183903.8
410430,202001,2269,1291,978,1343427,1017182.33,2360609.33
410440,202001,372,271,101,282608,104939,387547
410442,202001,350,236,114,245204,119485,364689
410445,202001,418,297,121,308583.7,126758,435341.7
410450,202001,389,199,190,206761,199488,406249
410460,202001,490,259,231,269101,240009.78,509110.78
410465,202001,214,136,78,141304,81042,222346
410470,202001,235,147,88,154811,91432,246243
410480,202001,6168,3020,3148,3140906.48,3278050.75,6418957.23
410490,202001,1421,886,535,921593.95,556904.7,1478498.65
410500,202001,262,152,110,158967,114290,273257
410510,202001,165,123,42,128836,44677.39,173513.39
410520,202001,252,187,65,194293,67535,261828
410530,202001,257,97,160,101822,166240.19,268062.19
410540,202001,320,237,83,246243.19,86237,332480.19
410550,202001,1670,729,941,757432.4,980817.99,1738250.39
410560,202001,146,106,40,110134,41560,151694
410570,202001,440,295,145,306506.26,150655,457161.26
410580,202001,3419,1506,1913,1565774.49,1987608.5,3553382.99
410590,202001,414,289,125,300253,130914,431167
410600,202001,200,171,29,177669,30131,207800
410610,202001,54,45,9,46755,9351,56106
410620,202001,246,169,77,175591,80003,255594
410630,202001,441,255,186,264945,194293,459238
410640,202001,1025,638,387,662882.85,402093.19,1064976.04
410645,202001,109,80,29,83120.6,30131,113251.6
410650,202001,355,234,121,243126,125719,368845
410655,202001,86,62,24,64418,24936,89354
410657,202001,24,9,15,9351,15585,24936
410660,202001,605,425,180,441575.45,187020,628595.45
410670,202001,77,66,11,68574,12468,81042
410680,202001,210,170,40,176630,41560,218190
410685,202001,19,11,8,11429,8312,19741
410690,202001,28452,12185,16267,12680912.08,16941942.96,29622855.04
410700,202001,342,251,91,260789.7,94549,355338.7
410710,202001,125,104,21,108056,21819,129875
410712,202001,28,21,7,21819,7273,29092
410715,202001,91,68,23,70652,23897,94549
410720,202001,692,397,295,412483,309622.39,722105.39
410725,202001,182,132,50,137148,51950,189098
410730,202001,92,49,43,50911,44677,95588
410740,202001,109,78,31,81042,32209,113251
410750,202001,257,173,84,179747,87276,267023
410752,202001,25,15,10,15585,10390,25975
410753,202001,52,23,29,23897,30131,54028
410754,202001,46,26,20,27014.7,20780,47794.7
410755,202001,82,52,30,54028,31170,85198
410760,202001,762,423,339,441575.7,353260,794835.7
410765,202001,1747,826,921,858216.35,960038.46,1818254.81
410770,202001,110,87,23,90393,23897,114290
410773,202001,56,40,16,41560,16624,58184
410775,202001,187,139,48,144421,49872,194293
410780,202001,86,45,41,46755,42599,89354
410785,202001,59,46,13,47794,13507,61301
410790,202001,73,35,38,36365,39482,75847
410800,202001,284,178,106,184942,110134.7,295076.7
410810,202001,21,17,4,17663,4156.7,21819.7
410820,202001,177,129,48,134031,49872,183903
410830,202001,8621,3774,4847,3925346.45,5046428.83,8971775.28
410832,202001,103,73,30,75847,31170,107017
410840,202001,1440,800,640,831201.98,664961.53,1496163.51
410845,202001,68,44,24,45716,24936,70652
410850,202001,197,138,59,143382,61301,204683
410855,202001,59,47,12,48833,12468,61301
410860,202001,729,413,316,430146.7,328324.78,758471.48
410865,202001,100,77,23,80003,23897,103900
410870,202001,152,130,22,135070,23897,158967
410880,202001,1108,576,532,600544.65,554827.17,1155371.82
410890,202001,89,63,26,65457,27014,92471
410895,202001,73,57,16,59223,16624,75847
410900,202001,23,16,7,16624,7273,23897
410910,202001,16,13,3,13507,3117,16624
410920,202001,39,27,12,28053,12468,40521
410930,202001,508,317,191,330402,198449,528851
410940,202001,4358,2476,1882,2578800.09,1961632.9,4540432.99
410950,202001,109,82,27,85198,28053,113251
410960,202001,804,343,461,356377,478979,835356
410965,202001,65,50,15,52989,15585,68574
410970,202001,637,453,184,470667,192215,662882
410975,202001,120,73,47,75848.69,49872,125720.69
410980,202001,1621,736,885,766782,919515.19,1686297.19
410990,202001,267,185,82,192215,85198,277413
411000,202001,66,41,25,42599,25975.7,68574.7
411005,202001,25,21,4,21819,4156,25975
411007,202001,265,157,108,163123,114290,277413
411010,202001,600,412,188,428068,195332,623400
411020,202001,292,202,90,209878.87,93510,303388.87
411030,202001,17,10,7,10390,7273,17663
411040,202001,57,40,17,41560,17663,59223
411050,202001,207,162,45,168318,46755,215073
411060,202001,514,349,165,362611.39,171435,534046.39
411065,202001,61,53,8,55067,8312,63379
411070,202001,1240,774,466,804186.8,486252,1290438.8
411080,202001,234,165,69,171435,71691,243126
411090,202001,104,78,26,81042,27014,108056
411095,202001,283,110,173,114290,179747,294037
411100,202001,118,97,21,100783,21819,122602
411110,202001,126,83,43,87276,44677,131953
411120,202001,201,143,58,148577,60262,208839
411125,202001,233,101,132,104939,137148,242087
411130,202001,129,112,17,116368,17663,134031
411140,202001,211,140,71,145460,73769,219229
411150,202001,1239,818,421,851980,439497.29,1291477.29
411155,202001,123,83,40,86237,41560,127797
411160,202001,25,12,13,12468,13507,25975
411170,202001,51,46,5,47794,5195,52989
411180,202001,964,641,323,668077,337675,1005752
411190,202001,329,197,132,205722,139226,344948
411200,202001,674,425,249,441575.29,258711,700286.29
411210,202001,691,374,317,388586,330402.39,718988.39
411220,202001,148,111,37,115329,38443,153772
411230,202001,40,34,6,35326,6234,41560
411240,202001,127,81,46,85198,47794,132992
411250,202001,437,323,114,336636,118446,455082
411260,202001,20,14,6,14546,6234.78,20780.78
411270,202001,281,147,134,152733,139226,291959
411275,202001,191,168,23,174552,23897,198449
411280,202001,211,150,61,155850.29,63379,219229.29
411290,202001,61,48,13,49872,13507,63379
411295,202001,140,109,31,113251,32209,145460
411300,202001,77,35,42,36365,43638,80003
411310,202001,90,71,19,73769,19741,93510
411320,202001,772,526,246,546514,255594.8,802108.8
411325,202001,61,42,19,43638,19741,63379
411330,202001,903,574,329,597425.9,341831.99,939257.89
411340,202001,25,18,7,18702,7273,25975
411342,202001,66,49,17,51950,17663,69613
411345,202001,119,59,60,61301,63379,124680
411350,202001,481,377,104,391703.19,108056.7,499759.89
411360,202001,54,35,19,36365,19741,56106
411370,202001,14255,5824,8431,6057376.57,8771244.21,14828620.78
411373,202001,176,128,48,132992,50911,183903
411375,202001,73,59,14,61301,14546,75847
411380,202001,92,69,23,71691,23897,95588
411390,202001,117,78,39,81042,40521,121563
411400,202001,366,277,89,287803.39,92471,380274.39
411410,202001,448,226,222,234814,230658.7,465472.7
411420,202001,1007,450,557,467550,578723,1046273
411430,202001,455,268,187,280530,194293.39,474823.39
411435,202001,32,21,11,21819,11429,33248
411440,202001,458,365,93,380274,96627,476901
411450,202001,419,355,64,369884,66496,436380
411460,202001,761,297,464,309622.6,483136.61,792759.21
411470,202001,86,63,23,65457,23897,89354
411480,202001,675,381,294,395859.7,307544,703403.7
411490,202001,292,190,102,197410,105978,303388
411500,202001,101,85,16,89354,16624,105978
411510,202001,219,175,44,181825,45716,227541
411520,202001,6012,2291,3721,2386585.39,3871319.81,6257905.20
411530,202001,121,85,36,88315,37404,125719
411535,202001,49,19,30,19741,32209,51950
411540,202001,350,240,110,249360,114290,363650
411545,202001,54,40,14,41560,14546,56106
411550,202001,76,59,17,61301,17663,78964
411560,202001,388,169,219,177669,227541,405210
411570,202001,817,301,516,312739.43,538202.8,850942.23
411573,202001,25,16,9,16624,9351,25975
411575,202001,288,183,105,190137,109095,299232
411580,202001,1295,488,807,510149,838473,1348622
411585,202001,77,37,40,38443,41560,80003
411590,202001,26,17,9,17663,9351,27014
411600,202001,25,11,14,11429,14546,25975
411605,202001,245,100,145,104939,150655,255594
411610,202001,208,138,70,143382,72730,216112
411620,202001,363,195,168,202605,174552,377157
411630,202001,55,38,17,39482,17663,57145
411640,202001,33,24,9,24936,9351,34287
411650,202001,12,7,5,7273,5195,12468
411660,202001,36,25,11,29092,11429,40521
411670,202001,239,177,62,183903,64418,248321
411680,202001,162,134,28,139226,29092,168318
411690,202001,593,317,276,329363,286764,616127
411695,202001,58,42,16,43638,16624,60262
411700,202001,137,115,22,119485,22858,142343
411705,202001,104,69,35,71691,36365,108056
411710,202001,306,207,99,216112,102861,318973
411720,202001,127,84,43,87276,44677,131953
411721,202001,67,56,11,58184,11429,69613
411722,202001,96,40,56,41560,58184,99744
411725,202001,157,118,39,122602.7,41560,164162.7
411727,202001,84,65,19,67535,19741,87276
411729,202001,41,33,8,34287,8312,42599
411730,202001,549,352,197,365728,205722,571450
411740,202001,40,25,15,25975,15585,41560
411745,202001,66,46,20,47794,20780,68574
411750,202001,871,401,470,418717.7,489369,908086.7
411760,202001,1189,884,305,919516.09,317934.39,1237450.48
411770,202001,455,303,152,314817,157928,472745
411780,202001,330,219,111,227541,115329.75,342870.75
411790,202001,527,300,227,311701.08,236892.39,548593.47
411800,202001,157,123,34,127797,35326,163123
411810,202001,174,130,44,135070,45716,180786
411820,202001,2176,978,1198,1017183.9,1246800.8,2263984.7
411830,202001,12,11,1,11429,1039,12468
411840,202001,2004,1237,767,1285243,797953.4,2083196.4
411845,202001,54,20,34,20780,35326,56106
411850,202001,1218,672,546,702364.89,569373.63,1271738.52
411860,202001,48,33,15,34287.7,15585,49872.7
411870,202001,73,50,23,51950,23897,75847
411880,202001,414,267,147,277413.38,152733,430146.38
411885,202001,108,70,38,72730,39482,112212
411890,202001,313,204,109,211957.89,113251,325208.89
411900,202001,74,55,19,57145.7,19741,76886.7
411910,202001,183,147,36,154811,38443,193254
411915,202001,2145,895,1250,931983,1300829.21,2232812.21
411920,202001,117,93,24,96627,24936,121563
411925,202001,12,8,4,8312,4156,12468
411930,202001,813,595,218,618206.57,226502,844708.57
411940,202001,585,401,184,416639.87,191176,607815.87
411950,202001,977,480,497,499759.19,517422,1017181.19
411960,202001,1031,701,330,729379.45,342870,1072249.45
411965,202001,20,14,6,14546,6234,20780
411970,202001,83,74,9,76886,9351,86237
411980,202001,172,115,57,119485,59223,178708
411990,202001,5170,2979,2191,3101423.06,2280608.35,5382031.41
411995,202001,481,175,306,181825,317934,499759
412000,202001,315,203,112,210917,116368,327285
412010,202001,48,32,16,33248,16624,49872
412015,202001,41,29,12,30131,12468,42599
412020,202001,33,26,7,27014,7273,34287
412030,202001,48,45,3,46755,3117,49872
412033,202001,52,34,18,35326,19741,55067
412035,202001,69,46,23,47794,23897,71691
412040,202001,42,25,17,25975.7,17663,43638.7
412050,202001,202,154,48,160006,49872,209878
412060,202001,778,589,189,611971,197410,809381
412065,202001,47,30,17,31170,17663,48833
412070,202001,168,114,54,120524,56106.7,176630.7
412080,202001,283,146,137,151694,142343,294037
412085,202001,34,16,18,16624,18702,35326
412090,202001,803,504,299,523656.95,310661,834317.95
412100,202001,239,205,34,212995.61,35326,248321.61
412110,202001,67,52,15,54028.48,15585,69613.48
412120,202001,325,194,131,201566,136109.78,337675.78
412125,202001,84,49,35,50911,36365,87276
412130,202001,40,27,13,28053.48,13507,41560.48
412135,202001,29,17,12,17663,12468,30131
412140,202001,334,227,107,236892,111173,348065
412150,202001,257,170,87,176630,90393,267023
412160,202001,89,52,37,54028,38443,92471
412170,202001,687,479,208,497681.7,216112,713793.7
412175,202001,39,28,11,29092,11429,40521
412180,202001,193,152,41,157928.6,43638,201566.6
412190,202001,341,271,70,282608,72730,355338
412200,202001,188,118,70,122602,72730,195332
412210,202001,73,57,16,59223,16624,75847
412215,202001,224,159,65,165201,68574,233775
412217,202001,66,53,13,55067,13507,68574
412220,202001,826,597,229,620283,238970,859253
412230,202001,333,205,128,212995,132992.78,345987.78
412240,202001,1353,679,674,705481.78,702364,1407845.78
412250,202001,404,256,148,267023,153772,420795
412260,202001,106,77,29,81042,30131,111173
412265,202001,177,140,37,146499,38443,184942
412270,202001,85,55,30,57145,31170,88315
412280,202001,88,72,16,74808,16624,91432
412290,202001,93,64,29,66496,30131,96627
412300,202001,210,139,71,144421,73769,218190
412310,202001,47,41,6,42599,7273,49872
412320,202001,95,79,16,82081,16624,98705
412330,202001,190,162,28,168318,29092,197410
412340,202001,150,104,46,108056,47794.7,155850.7
412350,202001,629,306,323,317934,335597,653531
412360,202001,29,24,5,24936,5195,30131
412370,202001,162,139,23,144421.5,23897,168318.5
412380,202001,261,196,65,204683,67535.39,272218.39
412382,202001,58,29,29,30131,30131,60262
412385,202001,146,108,38,112212,39482,151694
412390,202001,284,219,65,227541,67535,295076
412395,202001,69,56,13,58184,13507,71691
412400,202001,85,57,28,59223,30131,89354
412402,202001,237,115,122,119485.7,128836,248321.7
412405,202001,862,317,545,329363,568333,897696
412410,202001,976,597,379,621322.7,393781,1015103.7
412420,202001,12,10,2,10390,2078,12468
412430,202001,20,15,5,15585,5195,20780
412440,202001,615,336,279,349104,289881,638985
412450,202001,77,67,10,69613,10390,80003
412460,202001,92,70,22,72730,22858,95588
412470,202001,222,180,42,187020,43638,230658
412480,202001,148,108,40,112212.65,41560,153772.65
412490,202001,164,145,19,150655,20780,171435
412500,202001,437,360,77,374040.44,80003,454043.44
412510,202001,181,150,31,155850.7,32209,188059.7
412520,202001,89,59,30,61301,31170,92471
412530,202001,105,56,49,58184,50911,109095
412535,202001,92,69,23,71691.78,24936,96627.78
412540,202001,79,37,42,38443,43638,82081
412545,202001,95,66,29,68574,30131,98705
412550,202001,3766,1661,2105,1732013.7,2189175.18,3921188.88
412555,202001,13,9,4,9351,4156,13507
412560,202001,611,439,172,457161.9,179747.85,636909.75
412570,202001,755,393,362,408327,376118,784445
412575,202001,89,61,28,63379,29092,92471
412580,202001,177,117,60,121563,62340,183903
412590,202001,37,32,5,33248,5195,38443
412600,202001,165,123,42,127797.87,43638,171435.87
412610,202001,35,17,18,17663,18702,36365
412620,202001,148,126,22,130914,22858,153772
412625,202001,2173,1140,1033,1187578.74,1077446.26,2265025.00
412627,202001,70,53,17,55067,17663,72730
412630,202001,417,275,142,286764.8,147538,434302.8
412635,202001,62,15,47,15585,49872,65457
412640,202001,106,73,33,76886,34287,111173
412650,202001,347,223,124,231697,128836,360533
412660,202001,481,298,183,309622,191176,500798
412665,202001,47,42,5,44677,5195,49872
412667,202001,297,204,93,211956,96627,308583
412670,202001,66,55,11,57145,11429,68574
412680,202001,294,230,64,238970,66496.14,305466.14
412690,202001,103,69,34,71691,35326.7,107017.7
412700,202001,160,109,51,113251,52989,166240
412710,202001,1415,865,550,900815.15,571450,1472265.15
412720,202001,232,150,82,156889,86237,243126
412730,202001,192,160,32,167279,33248,200527
412740,202001,427,228,199,236892,206761,443653
412750,202001,443,255,188,267023,196371,463394
412760,202001,278,145,133,150655,138187,288842
412770,202001,2130,1173,957,1220826.38,996402.79,2217229.17
412780,202001,145,113,32,118446,33248,151694
412785,202001,278,140,138,146499,143382,289881
412788,202001,35,21,14,21819,14546,36365
412790,202001,128,109,19,113251,20780,134031
412795,202001,153,112,41,116368,42599,158967
412796,202001,321,214,107,222346,111173,333519
412800,202001,607,380,227,394820.75,236892.39,631713.14
412810,202001,2963,1622,1341,1687340.33,1397455,3084795.33
412820,202001,940,600,340,625481.55,355338.39,980819.94
412830,202001,14,11,3,11429,3117,14546
412840,202001,222,160,62,166240.7,64418,230658.7
412850,202001,769,504,265,525734,277413,803147
412853,202001,167,86,81,89354,84159.7,173513.7
412855,202001,199,109,90,113251.09,93510,206761.09
412860,202001,95,64,31,66496,32209,98705
412862,202001,56,43,13,44677,13507,58184
412863,202001,6,5,1,5195,1039,6234
412865,202001,45,32,13,33248,13507,46755
412870,202001,109,67,42,69613,44677,114290
412880,202001,98,73,25,76886.7,25975,102861.7
420005,202001,44,39,5,40521,5195,45716
420010,202001,368,241,127,250399.65,131953.7,382353.35
420020,202001,84,72,12,75847,12468,88315
420030,202001,22,20,2,20780,2078,22858
420040,202001,107,84,23,87276,23897,111173
420050,202001,56,34,22,35326,22858,58184
420055,202001,19,19,0,19741,0,19741
420060,202001,29,22,7,22858,7273,30131
420070,202001,102,85,17,88315,17663,105978
420075,202001,13,13,0,13507,0,13507
420080,202001,43,38,5,39482,5195,44677
420090,202001,36,33,3,34287,3117,37404
420100,202001,149,127,22,131953.7,22858,154811.7
420110,202001,21,21,0,21819,0,21819
420120,202001,63,48,15,49872,15585,65457
420125,202001,83,66,17,68574,17663,86237
420127,202001,31,27,4,28053,4156,32209
420130,202001,418,254,164,264945,170396,435341
420140,202001,1300,723,577,753277.04,600542,1353819.04
420150,202001,47,40,7,41560,7273,48833
420160,202001,37,35,2,36365,2078,38443
420165,202001,18,12,6,12468,6234,18702
420170,202001,76,49,27,50911,28053,78964
420180,202001,22,19,3,19741,3117,22858
420190,202001,27,23,4,23897,4156,28053
420195,202001,129,65,64,67535,67535,135070
420200,202001,1286,567,719,591191.7,748083.14,1339274.84
420205,202001,76,45,31,46755,33248,80003
420207,202001,120,65,55,67535.75,57145,124680.75
420208,202001,19,15,4,15585,4156,19741
420209,202001,19,16,3,16624,3117,19741
420210,202001,497,236,261,246243,271179.39,517422.39
420213,202001,47,36,11,37404,11429,48833
420215,202001,26,23,3,23897,3117,27014
420220,202001,70,48,22,49872,22858,72730
420230,202001,833,473,360,493526.19,376118.89,869645.08
420240,202001,2295,1521,774,1585515.97,805225,2390740.97
420243,202001,40,31,9,32209,9351,41560
420245,202001,140,73,67,75847,69613,145460
420250,202001,62,40,22,41560,22858,64418
420253,202001,41,32,9,33248,9351,42599
420257,202001,13,11,2,11429,2078,13507
420260,202001,99,83,16,86237,16624,102861
420270,202001,33,27,6,28053.19,6234,34287.19
420280,202001,287,214,73,223387.02,75848.63,299235.65
420285,202001,23,13,10,13507,10390,23897
420287,202001,49,32,17,33248,17663,50911
420290,202001,1003,701,302,733534.89,315856.57,1049391.46
420300,202001,1438,1150,288,1196931.87,300272.43,1497204.30
420310,202001,47,32,15,33248,15585,48833
420315,202001,36,29,7,30131,7273,37404
420320,202001,895,450,445,467550.82,462355.19,929906.01
420325,202001,0,,,,,0.0
420330,202001,120,81,39,85198,40521,125719
420340,202001,161,106,55,111173.99,57145,168318.99
420350,202001,245,179,66,185981,68574,254555
420360,202001,758,581,177,604698.39,184943.53,789641.92
420370,202001,123,75,48,77925,49872.7,127797.7
420380,202001,1165,813,352,845747.14,365730.26,1211477.40
420390,202001,254,176,78,183903,81042,264945
420395,202001,196,143,53,148577,55067,203644
420400,202001,249,188,61,196372.45,63379,259751.45
420410,202001,61,46,15,47794,15585,63379
420415,202001,31,28,3,29092,3117,32209
420417,202001,51,40,11,41560,11429,52989
420419,202001,11,11,0,11429,0,11429
420420,202001,2844,1760,1084,1832801.24,1126277.87,2959079.11
420425,202001,72,59,13,61301,13507.39,74808.39
420430,202001,1208,865,343,898735.85,356377.39,1255113.24
420435,202001,16,14,2,14546,2078,16624
420440,202001,97,68,29,70652.7,30131,100783.7
420445,202001,22,21,1,21819,1039,22858
420450,202001,78,40,38,41560,39482,81042
420455,202001,216,168,48,174553.17,49873.17,224426.34
420460,202001,2327,1519,808,1579284.36,843672.21,2422956.57
420470,202001,109,77,32,80003,33248,113251
420475,202001,7,7,0,7273,0,7273
420480,202001,873,659,214,685741.4,222346.9,908088.3
420490,202001,107,78,29,81042,30131,111173
420500,202001,488,249,239,258713.19,248321,507034.19
420510,202001,19,18,1,18702,1039,19741
420515,202001,26,19,7,19741,7273,27014
420517,202001,10,10,0,10390,0,10390
420519,202001,0,,,,,0.0
420520,202001,70,52,18,54028,18702,72730
420530,202001,168,113,55,117407.65,57145,174552.65
420535,202001,20,18,2,18702,2078,20780
420540,202001,5533,3305,2228,3440399.26,2318011.28,5758410.54
420543,202001,25,24,1,25975,1039,27014
420545,202001,210,150,60,155850.39,62340.78,218191.17
420550,202001,860,707,153,735614.05,158968.56,894582.61
420555,202001,37,27,10,28053,10390,38443
420560,202001,65,53,12,55067,12468,67535
420570,202001,157,92,65,95588,67535,163123
420580,202001,279,129,150,135070,156889.7,291959.7
420590,202001,516,351,165,364689,171435,536124
420600,202001,112,62,50,64418,51950,116368
420610,202001,39,36,3,38443,3117,41560
420620,202001,83,66,17,68574,17663,86237
420630,202001,151,107,44,111173.19,45716.57,156889.76
420640,202001,85,76,9,80003,9351,89354
420650,202001,247,128,119,132992,126758,259750
420660,202001,50,39,11,40521.5,11429,51950.5
420665,202001,37,28,9,29092,9351,38443
420670,202001,309,237,72,248321,75847.39,324168.39
420675,202001,14,13,1,13507,1039,14546
420680,202001,38,27,11,28053,11429,39482
420690,202001,176,137,39,144421,40521,184942
420700,202001,709,488,221,508074.14,232739.9,740814.04
420710,202001,148,87,61,90393,63379,153772
420720,202001,110,89,21,92471.39,21819,114290.39
420730,202001,592,376,216,392744.09,225465.26,618209.35
420740,202001,52,51,1,52989,1039,54028
420750,202001,512,350,162,365728,171435,537163
420757,202001,18,15,3,15585,3117,18702
420760,202001,38,30,8,31170,8312,39482
420765,202001,79,61,18,63379,18702,82081
420768,202001,50,46,4,47794,4156,51950
420770,202001,76,65,11,67535,11429,78964
420775,202001,43,40,3,41560,3117,44677
420780,202001,237,189,48,196371,50911,247282
420785,202001,12,10,2,10390,2078,12468
420790,202001,160,134,26,139227.17,27014.78,166241.95
420800,202001,65,49,16,50911,16624,67535
420810,202001,255,216,39,224424,40521,264945
420820,202001,2363,1365,998,1418237.09,1041079.98,2459317.07
420830,202001,598,330,268,342871.7,278452,621323.7
420840,202001,150,111,39,116368,40521,156889
420845,202001,422,184,238,191176,247282.7,438458.7
420850,202001,258,200,58,207800,60262,268062
420860,202001,61,51,10,52989,10390,63379
420870,202001,127,92,35,95588,36365,131953
420880,202001,183,122,61,126758,63379.39,190137.39
420890,202001,947,476,471,495604.75,490408,986012.75
420895,202001,9,9,0,9351,0,9351
420900,202001,414,331,83,344948,86237.39,431185.39
420910,202001,5915,3305,2610,3439098.92,2720105.04,6159203.96
420915,202001,71,66,5,69613,5195,74808
420917,202001,19,14,5,14546,5195,19741
420920,202001,23,16,7,16624,7273,23897
420930,202001,2812,1766,1046,1837946.76,1086857.42,2924804.18
420940,202001,601,442,159,460278.4,165202.94,625481.34
420945,202001,9,7,2,7273,2078,9351
420950,202001,60,53,7,55067,7273,62340
420960,202001,109,86,23,89354.78,23897.39,113252.17
420970,202001,294,238,56,247285.56,58184.39,305469.95
420980,202001,24,23,1,23897,1039,24936
420985,202001,57,51,6,52989,6234,59223
420990,202001,86,64,22,66496,22858,89354
421000,202001,37,23,14,23897,14546,38443
421003,202001,59,40,19,41560,19741.39,61301.39
421005,202001,6,3,3,3117,3117,6234
421010,202001,771,534,237,554826,248322.7,803148.7
421020,202001,26,20,6,20780,6234,27014
421030,202001,123,103,20,107017.65,20780,127797.65
421040,202001,71,54,17,56106,17663,73769
421050,202001,337,234,103,243127.4,107017,350144.4
421055,202001,21,17,4,17663,4156,21819
421060,202001,86,52,34,54028,35326,89354
421070,202001,49,44,5,45716.7,5195,50911.7
421080,202001,33,30,3,31170,3117,34287
421085,202001,23,18,5,18702,5195,23897
421090,202001,38,29,9,30131,9351,39482
421100,202001,124,91,33,94549,34287,128836
421105,202001,208,170,38,176630.39,39482.39,216112.78
421110,202001,111,89,22,92471,22858,115329
421120,202001,163,123,40,127798.15,41560,169358.15
421125,202001,17,12,5,12468,5195,17663
421130,202001,815,519,296,541319,307544.7,848863.7
421140,202001,32,22,10,22858,10390,33248
421145,202001,41,33,8,34287,8312,42599
421150,202001,105,76,29,80003,30131.4,110134.4
421160,202001,68,48,20,49872,20780,70652
421165,202001,17,16,1,16624,1039,17663
421170,202001,184,154,30,160133.26,31170.39,191303.65
421175,202001,165,113,52,117407,54028,171435
421180,202001,53,34,19,35326.82,19741,55067.82
421185,202001,17,14,3,14546,3117,17663
421187,202001,2,1,1,1039,1039,2078
421189,202001,42,30,12,31170,12468,43638
421190,202001,1658,1054,604,1098223,629635.38,1727858.38
421200,202001,93,70,23,72730,23897,96627
421205,202001,28,18,10,18702,10390,29092
421210,202001,173,121,52,125719,54028,179747
421220,202001,278,217,61,226502,63379,289881
421223,202001,48,39,9,40521.8,9351,49872.8
421225,202001,70,44,26,45716.8,27014,72730.8
421227,202001,85,67,18,70652,18702,89354
421230,202001,53,37,16,38443,16624,55067
421240,202001,19,19,0,19741,0,19741
421250,202001,371,225,146,233776.3,151694,385470.3
421260,202001,23,19,4,19741,4156,23897
421265,202001,2,2,0,2078,0,2078
421270,202001,46,41,5,42599,5195,47794
421280,202001,341,191,150,198449,155850,354299
421290,202001,336,226,110,234814,114290,349104
421300,202001,23,18,5,18702,5195,23897
421310,202001,44,32,12,33248,12468,45716
421315,202001,30,19,11,19741,11429,31170
421320,202001,140,92,48,96627,49872,146499
421330,202001,104,77,27,80003,28053.39,108056.39
421335,202001,39,27,12,28053,12468,40521
421340,202001,241,154,87,160007.35,90393,250400.35
421350,202001,191,109,82,113252.03,85198,198450.03
421360,202001,652,488,164,508072.14,170396.39,678468.53
421370,202001,204,157,47,163123,48833,211956
421380,202001,125,99,26,103900,27014,130914
421390,202001,18,12,6,12468,6234,18702
421400,202001,126,108,18,112212,18702,130914
421410,202001,20,18,2,18702,2078,20780
421415,202001,21,19,2,19741,2078,21819
421420,202001,136,114,22,118446,22858,141304
421430,202001,17,13,4,13507,4156,17663
421440,202001,59,48,11,49872,11429,61301
421450,202001,94,78,16,81042,16624,97666
421460,202001,60,48,12,49872,12468,62340
421470,202001,70,45,25,46755,25975,72730
421480,202001,722,545,177,568333,183903.39,752236.39
421490,202001,25,24,1,24936.39,1039,25975.39
421500,202001,490,316,174,329364.87,181832.02,511196.89
421505,202001,25,18,7,18702,7273,25975
421507,202001,31,23,8,23897,8312,32209
421510,202001,72,47,25,48833,25975,74808
421520,202001,56,47,9,48833,9351,58184
421530,202001,51,44,7,45716,8312,54028
421535,202001,27,25,2,25975,2078,28053
421540,202001,54,47,7,48833,7273,56106
421545,202001,101,75,26,77925.39,27014,104939.39
421550,202001,288,208,80,217151,83120,300271
421555,202001,23,19,4,19741,4156.9,23897.9
421560,202001,8,7,1,7273,1039,8312
421565,202001,124,84,40,88315,41560,129875
421567,202001,31,25,6,25975,6234,32209
421568,202001,29,26,3,27014,3117,30131
421569,202001,10,10,0,10390,0,10390
421570,202001,192,132,60,139226,62340,201566
421575,202001,27,22,5,23897,5195,29092
421580,202001,712,421,291,439565.39,302349,741914.39
421590,202001,20,19,1,19741,1039,20780
421600,202001,149,98,51,103900,52989.7,156889.7
421605,202001,117,79,38,82081.65,39482,121563.65
421610,202001,190,146,44,152733,45716,198449
421620,202001,1044,616,428,640024.39,444692,1084716.39
421625,202001,22,19,3,20780,3117,23897
421630,202001,306,194,112,202605.95,116370.8,318976.75
421635,202001,19,10,9,10390,9351,19741
421640,202001,100,85,15,88315.8,15585,103900.8
421650,202001,304,181,123,188059,127797.58,315856.58
421660,202001,2222,1339,883,1391223.19,921595.37,2312818.56
421670,202001,183,133,50,138187,51950,190137
421680,202001,174,156,18,162084,18702,180786
421690,202001,345,248,97,257673.48,100784.31,358457.79
421700,202001,58,38,20,39482,20780.4,60262.4
421710,202001,26,25,1,25975,1039,27014
421715,202001,6,6,0,6234,0,6234
421720,202001,613,436,177,453005.55,184942,637947.55
421725,202001,16,6,10,6234,10390,16624
421730,202001,35,25,10,25975,10390,36365
421740,202001,91,38,53,39482,55067,94549
421750,202001,213,159,54,165201,56106,221307
421755,202001,26,24,2,24936,2078,27014
421760,202001,99,70,29,72730,30131,102861
421770,202001,638,414,224,430153.37,232739.16,662892.53
421775,202001,30,18,12,18702,12468,31170
421780,202001,201,156,45,162084.7,46755,208839.7
421790,202001,153,131,22,137148,22858,160006
421795,202001,21,17,4,17663,4156,21819
421800,202001,512,327,185,340792,193254.75,534046.75
421810,202001,74,61,13,63379,13507,76886
421820,202001,338,227,111,235853.7,115329,351182.7
421825,202001,136,114,22,118446,22858,141304
421830,202001,135,96,39,99744,40521,140265
421835,202001,4,4,0,4156,0,4156
421840,202001,53,45,8,46755.39,8312,55067.39
421850,202001,78,67,11,69613,11429.19,81042.19
421860,202001,37,30,7,31170,7273,38443
421870,202001,994,745,249,776159.77,259755.28,1035915.05
421875,202001,54,44,10,45716,10390,56106
421880,202001,165,116,49,121563,50911.7,172474.7
421885,202001,22,18,4,18702,4156,22858
421890,202001,133,94,39,98705,40521.89,139226.89
421895,202001,50,44,6,45716,6234,51950
421900,202001,155,120,35,124680.78,36366.56,161047.34
421910,202001,69,41,28,42599.8,29092,71691.8
421915,202001,32,26,6,27014,6234,33248
421917,202001,39,29,10,30131,10390,40521
421920,202001,41,37,4,38443,4156,42599
421930,202001,711,571,140,594308.82,147539.17,741847.99
421935,202001,48,42,6,43638,6234,49872
421940,202001,44,39,5,40521,5195,45716
421950,202001,861,581,280,605737.7,291960.19,897697.89
421960,202001,46,40,6,41560.7,6234,47794.7
421970,202001,363,237,126,247282.7,130914.39,378197.09
421985,202001,27,18,9,18702,9351,28053
422000,202001,0,,,,,0.0
430003,202001,187,56,131,58184,136109,194293
430005,202001,37,28,9,29092,9351,38443
430010,202001,268,194,74,201566,76886,278452
430020,202001,143,95,48,98705.7,50911,149616.7
430030,202001,122,98,24,101822,24936,126758
430040,202001,2919,1726,1193,1796434.6,1241606.87,3038041.47
430045,202001,70,59,11,61301,11429,72730
430047,202001,7,6,1,6234,1039,7273
430050,202001,81,69,12,71691,12468,84159
430055,202001,13,11,2,12468,2078,14546
430057,202001,5,4,1,4156,1039,5195
430060,202001,3683,2153,1530,2238008.63,1590710.58,3828719.21
430063,202001,53,49,4,50911,4156,55067
430064,202001,154,124,30,128836,31170,160006
430066,202001,5,2,3,2078,3117,5195
430070,202001,45,33,12,34287,12468,46755
430080,202001,68,47,21,48833,21819,70652
430085,202001,33,11,22,11429,22858,34287
430087,202001,28,22,6,22858.85,6234,29092.85
430090,202001,73,66,7,68574,7273,75847
430100,202001,123,84,39,87276,40521,127797
430105,202001,148,80,68,83120.8,70652,153772.8
430107,202001,19,13,6,13507,6234,19741
430110,202001,438,252,186,261828,193254,455082
430120,202001,149,138,11,143382,11429,154811
430130,202001,803,491,312,510149.7,324168,834317.7
430140,202001,127,120,7,124680,7273,131953
430150,202001,109,71,38,73769,39482,113251
430155,202001,35,31,4,32209,4156,36365
430160,202001,3631,2138,1493,2223464.85,1552266.7,3775731.55
430163,202001,359,164,195,170396,202605,373001
430165,202001,30,20,10,20780,10390,31170
430170,202001,93,79,14,82081,14546,96627
430175,202001,79,62,17,64418,18702,83120
430180,202001,104,85,19,88315,19741,108056
430185,202001,33,23,10,23897,10390,34287
430187,202001,83,38,45,40521,46755,87276
430190,202001,229,125,104,129875,108056,237931
430192,202001,13,11,2,11429,2078,13507
430195,202001,17,11,6,11429,6234,17663
430200,202001,163,142,21,147538,21819,169357
430205,202001,20,19,1,19741,1039,20780
430210,202001,699,540,159,562099.7,165201.7,727301.4
430215,202001,12,10,2,10390,2078,12468
430220,202001,72,50,22,51950,22858,74808
430222,202001,12,6,6,6234,6234,12468
430223,202001,15,7,8,7273,8312,15585
430225,202001,2,1,1,1039,1039,2078
430230,202001,319,186,133,193254,139226,332480
430235,202001,52,39,13,40521,13507,54028
430237,202001,25,20,5,20780,5195,25975
430240,202001,131,86,45,90393.7,46755,137148.7
430245,202001,70,55,15,57145,15585,72730
430250,202001,191,113,78,117407,81042,198449
430258,202001,9,8,1,8312,1039,9351
430260,202001,34,30,4,31170,4156,35326
430265,202001,36,32,4,33248,4156,37404
430270,202001,518,385,133,400016.35,138188.56,538204.91
430280,202001,1038,642,396,667038,412483,1079521
430290,202001,390,214,176,222346,182864,405210
430300,202001,2086,1162,924,1209397.5,961077.26,2170474.76
430310,202001,1981,1010,971,1049391.5,1008872.74,2058264.24
430320,202001,55,44,11,46755,11429,58184
430330,202001,97,86,11,89354,11429,100783
430340,202001,72,60,12,62340,12468,74808
430350,202001,1660,1130,530,1176149.8,550670.39,1726820.19
430355,202001,21,19,2,19741,2078,21819
430360,202001,88,45,43,46755,44677,91432
430367,202001,35,26,9,27014,9351,36365
430370,202001,54,47,7,48833,7273,56106
430380,202001,139,105,34,109095,35326,144421
430390,202001,591,368,223,382352,231697,614049
430400,202001,136,104,32,108056.7,33248,141304.7
430410,202001,58,46,12,47794,12468,60262
430420,202001,503,336,167,350144.67,173513,523657.67
430430,202001,54,53,1,54375.02,1039,55414.02
430435,202001,155,115,40,119485,41560,161045
430440,202001,504,332,172,347026.8,178708,525734.8
430450,202001,1173,963,210,1003674,218190,1221864
430460,202001,5168,2755,2413,2866603.23,2509193.67,5375796.90
430461,202001,16,15,1,15585,1039,16624
430462,202001,9,5,4,5195,4156,9351
430463,202001,1065,574,491,597425,512227.78,1109652.78
430465,202001,23,13,10,13507,10390,23897
430466,202001,684,490,194,509110.7,201566,710676.7
430467,202001,101,55,46,58184.8,47794,105978.8
430468,202001,117,68,49,70652,50911,121563
430469,202001,22,17,5,17663,5195,22858
430470,202001,1155,650,505,676699.97,524695,1201394.97
430471,202001,56,38,18,39482,18702,58184
430480,202001,102,65,37,67535,38443,105978
430485,202001,6,6,0,6234.7,0,6234.7
430490,202001,85,68,17,70652,18702,89354
430495,202001,32,25,7,25975,7273,33248
430500,202001,187,127,60,131953,62340,194293
430510,202001,3483,2278,1205,2372037.87,1254073,3626110.87
430511,202001,17,16,1,16624,1039,17663
430512,202001,147,102,45,107017,46755,153772
430513,202001,52,42,10,43638,10390,54028
430515,202001,31,29,2,30131,2078,32209
430517,202001,169,150,19,155850,19741,175591
430520,202001,356,248,108,257672,112212,369884
430530,202001,87,50,37,51950,38443,90393
430535,202001,457,313,144,325207,149616.19,474823.19
430537,202001,9,9,0,9351,0,9351
430540,202001,81,56,25,58184,25975,84159
430543,202001,347,110,237,114290,247282,361572
430544,202001,44,41,3,42599,3117,45716
430545,202001,373,195,178,202605,184942,387547
430550,202001,41,34,7,35326,7273,42599
430558,202001,3,2,1,2078,1039,3117
430560,202001,56,30,26,31170,27014,58184
430570,202001,106,40,66,42599,68574,111173
430580,202001,124,102,22,107017,22858.5,129875.5
430583,202001,14,14,0,14546,0,14546
430585,202001,12,5,7,5195,7273,12468
430587,202001,15,7,8,7273,8312,15585
430590,202001,145,120,25,124680,25975,150655
430593,202001,2,2,0,2078,0,2078
430595,202001,17,14,3,14546,3117,17663
430597,202001,48,26,22,27014,22858,49872
430600,202001,218,159,59,165201,61301,226502
430605,202001,158,101,57,104939,59223,164162
430607,202001,23,20,3,20780,3117,23897
430610,202001,1605,765,840,794835,872761.09,1667596.09
430613,202001,2,2,0,2078,0,2078
430620,202001,112,79,33,82081,34287,116368
430630,202001,49,42,7,43638,7273,50911
430632,202001,32,27,5,28053,5195,33248
430635,202001,35,32,3,33248,3117,36365
430637,202001,54,29,25,30131,25975,56106
430640,202001,181,104,77,108056,81042,189098
430642,202001,21,19,2,19741,2078,21819
430645,202001,37,30,7,31170,7273,38443
430650,202001,254,207,47,216112.7,48833,264945.7
430655,202001,2,2,0,2078,0,2078
430660,202001,974,483,491,502876,512227.7,1015103.7
430670,202001,76,52,24,55067,24936,80003
430673,202001,68,41,27,42599,28053,70652
430675,202001,11,9,2,9351,2078,11429
430676,202001,504,301,203,312739,211956,524695
430680,202001,242,169,73,176631.4,77925,254556.4
430690,202001,530,331,199,343909.39,207800.29,551709.68
430692,202001,9,6,3,6234,3117,9351
430693,202001,142,95,47,99744,48833,148577
430695,202001,71,59,12,61301,12468,73769
430697,202001,56,35,21,36365,21819,58184
430700,202001,1536,1065,471,1107575.05,489369,1596944.05
430705,202001,21,20,1,20780,1039,21819
430710,202001,254,161,93,167279,96627,263906
430720,202001,106,90,16,93510,16624,110134
430730,202001,135,117,18,121563,18702,140265
430740,202001,74,50,24,51950,24936,76886
430745,202001,30,23,7,23897,7273,31170
430750,202001,327,216,111,224424,115329,339753
430755,202001,84,47,37,48833,38443,87276
430760,202001,375,218,157,227542.72,163123.39,390666.11
430770,202001,1464,762,702,791718.7,729380.28,1521098.98
430780,202001,296,191,105,198449.39,109095.39,307544.78
430781,202001,26,22,4,22858,4156,27014
430783,202001,59,47,12,48833,12468,61301
430786,202001,5,3,2,3117,2078,5195
430790,202001,514,341,173,355338,180786.7,536124.7
430800,202001,154,129,25,134031.46,27014,161045.46
430805,202001,41,37,4,38443,4156,42599
430807,202001,43,24,19,24936,19741,44677
430810,202001,76,47,29,48833,30131,78964
430820,202001,146,87,59,90393,61301,151694
430825,202001,10,8,2,8312,2078,10390
430830,202001,239,221,18,229619.7,18702,248321.7
430840,202001,124,84,40,87276,41560,128836
430843,202001,6,4,2,4156,2078,6234
430845,202001,73,42,31,43638,32209,75847
430850,202001,592,414,178,431185,184943.17,616128.17
430860,202001,159,103,56,107017,58184,165201
430865,202001,70,41,29,42599,30131.39,72730.39
430870,202001,78,64,14,66496,14546,81042
430880,202001,153,116,37,120524,38443,158967
430885,202001,9,7,2,7273,2078,9351
430890,202001,346,210,136,219229,141304,360533
430900,202001,514,362,152,376118,157928,534046
430905,202001,115,50,65,52989,67535,120524
430910,202001,285,160,125,166240,129875.39,296115.39
430912,202001,5,5,0,5195,0,5195
430915,202001,34,29,5,30131,5195,35326
430920,202001,4257,2300,1957,2392819.4,2041635.39,4434454.79
430925,202001,5,4,1,4156,1039,5195
430930,202001,2085,1225,860,1275894.95,895618.38,2171513.33
430940,202001,261,171,90,177669,94549,272218
430950,202001,149,123,26,127797,27014,154811
430955,202001,24,13,11,13507,11429,24936
430957,202001,17,15,2,15585,2078,17663
430960,202001,243,165,78,171435,81042,252477
430965,202001,115,74,41,76886,42599,119485
430970,202001,83,69,14,71691,14546,86237
430975,202001,41,37,4,38443,4156,42599
430980,202001,45,29,16,30131,16624,46755
430990,202001,114,89,25,92471,25975,118446
430995,202001,116,110,6,114290,6234,120524
431000,202001,297,140,157,145461.3,163123,308584.3
431010,202001,356,206,150,214034,155850,369884
431020,202001,1877,1095,782,1140823.3,813537,1954360.3
431030,202001,42,34,8,35326,8312,43638
431033,202001,386,189,197,197410,204683,402093
431036,202001,13,8,5,8312,5195,13507
431040,202001,139,84,55,87276,57145,144421
431041,202001,41,27,14,28053.7,14546,42599.7
431043,202001,46,26,20,27014,20780,47794
431046,202001,11,7,4,7273,4156,11429
431050,202001,202,127,75,131953,77925,209878
431053,202001,73,43,30,44677,31170,75847
431055,202001,65,44,21,45716,21819,67535
431057,202001,18,18,0,18702,0,18702
431060,202001,1618,1051,567,1093031.61,592235.92,1685267.53
431065,202001,20,12,8,12468,8312,20780
431070,202001,63,57,6,59223,6234,65457
431075,202001,7,7,0,7273,0,7273
431080,202001,133,81,52,84159,54028,138187
431085,202001,32,29,3,30131,4156,34287
431087,202001,14,12,2,12468,2078,14546
431090,202001,54,42,12,43638,12468,56106
431100,202001,1199,725,474,755355.61,492486,1247841.61
431110,202001,230,142,88,147538,91432.7,238970.7
431112,202001,28,16,12,16624,12468,29092
431113,202001,35,26,9,27014,9351,36365
431115,202001,154,109,45,113251,46755,160006
431120,202001,597,359,238,373001.8,247282.78,620284.58
431123,202001,3,2,1,2078,1039,3117
431125,202001,96,87,9,90393,9351,99744
431127,202001,9,4,5,4156,5195,9351
431130,202001,698,455,243,474823,253516,728339
431140,202001,757,521,236,544436.7,246243,790679.7
431142,202001,32,26,6,27014.04,6234,33248.04
431150,202001,195,149,46,154811,47794,202605
431160,202001,53,48,5,49872,5195,55067
431162,202001,6,5,1,5195,1039,6234
431164,202001,5,5,0,5195,0,5195
431170,202001,108,85,23,88315,24936,113251
431171,202001,68,41,27,42599,28053,70652
431173,202001,1,1,0,1039,0,1039
431175,202001,199,103,96,107017.7,99744,206761.7
431177,202001,78,58,20,60262,20780,81042
431179,202001,14,12,2,12468,2078,14546
431180,202001,445,269,176,280530,182864.39,463394.39
431190,202001,80,62,18,64418,18702,83120
431198,202001,72,51,21,52989,21819,74808
431200,202001,21,17,4,17663,4156,21819
431205,202001,23,22,1,22858,1039,23897
431210,202001,90,55,35,57145,36365,93510
431213,202001,32,28,4,29092,4156,33248
431215,202001,21,18,3,18702,3117,21819
431217,202001,4,3,1,3117,1039,4156
431220,202001,66,58,8,60262.38,8312,68574.38
431225,202001,145,93,52,97666,54028,151694
431230,202001,103,90,13,93510,13507,107017
431235,202001,7,7,0,7273,0,7273
431237,202001,22,16,6,16624,6234,22858
431238,202001,10,7,3,7273.7,3117,10390.7
431240,202001,988,630,358,655609.6,371962,1027571.6
431242,202001,38,37,1,38443,1039,39482
431244,202001,13,9,4,9351,4156,13507
431245,202001,50,37,13,38443,13507,51950
431247,202001,11,8,3,8312,3117,11429
431250,202001,277,144,133,150655,138187,288842
431260,202001,60,46,14,47794,14546,62340
431261,202001,17,11,6,11429,6234,17663
431262,202001,18,17,1,17663,1039,18702
431265,202001,147,79,68,82081,70652,152733
431267,202001,15,14,1,14546,1039,15585
431270,202001,325,268,57,278452,60262,338714
431275,202001,39,36,3,37404,3117,40521
431280,202001,20,16,4,16624,4156,20780
431290,202001,23,20,3,20780,3117,23897
431295,202001,2,2,0,2078,0,2078
431300,202001,22,19,3,19741,3117,22858
431301,202001,6,6,0,6234,0,6234
431303,202001,59,39,20,40521,20780,61301
431306,202001,237,125,112,130729.05,116368,247097.05
431308,202001,7,5,2,5195,2078,7273
431310,202001,65,54,11,56106,11429,67535
431320,202001,142,84,58,89354,60262,149616
431330,202001,174,114,60,118446,62340,180786
431333,202001,26,22,4,22858,4156,27014
431335,202001,9,5,4,5195,4156,9351
431337,202001,346,155,191,161045,198449,359494
431339,202001,21,18,3,18702,3117,21819
431340,202001,3007,1670,1337,1736090.69,1392267.21,3128357.90
431342,202001,37,24,13,24936,14546,39482
431344,202001,17,17,0,17663,0,17663
431346,202001,5,5,0,5195,0,5195
431349,202001,35,31,4,32209,4156,36365
431350,202001,933,537,396,558983.64,412483.7,971467.34
431360,202001,47,41,6,42599,6234,48833
431365,202001,334,159,175,165201.7,181825,347026.7
431370,202001,1332,778,554,808342.7,575607.95,1383950.65
431380,202001,97,84,13,87276,13507,100783
431390,202001,510,275,235,285725,244165,529890
431395,202001,290,131,159,136109,166240,302349
431400,202001,43,30,13,31170,13507,44677
431402,202001,101,72,29,74808,30131,104939
431403,202001,24,14,10,14546,10390,24936
431405,202001,669,362,307,377157.75,320012.78,697170.53
431406,202001,31,27,4,28053,4156,32209
431407,202001,52,42,10,43638,10390,54028
431410,202001,3413,2093,1320,2180863.7,1372520.43,3553384.13
431413,202001,15,12,3,12468,3117,15585
431415,202001,69,50,19,51950,19741,71691
431417,202001,22,12,10,12468,10390,22858
431420,202001,317,214,103,222346,107017,329363
431430,202001,50,23,27,23897,28053,51950
431440,202001,8863,6207,2656,6453245.28,2760625.96,9213871.24
431442,202001,28,14,14,14546,14546,29092
431445,202001,21,19,2,19741,2078,21819
431446,202001,4,4,0,4156,0,4156
431447,202001,83,59,24,61301,24936,86237
431449,202001,55,47,8,48833,8312,57145
431450,202001,412,279,133,289881,139226,429107
431454,202001,0,,,,,0.0
431455,202001,54,42,12,43638,13507,57145
431460,202001,522,364,158,380274,164162,544436
431470,202001,118,91,27,94549,28053,122602
431475,202001,11,9,2,9351,2078,11429
431477,202001,39,26,13,27014,13507,40521
431478,202001,8,7,1,7273,1039,8312
431480,202001,501,307,194,320012,201566,521578
431490,202001,28479,16107,12372,16760126.13,12871143.85,29631269.98
431500,202001,76,59,17,61301,18702,80003
431505,202001,27,17,10,17663,10390,28053
431507,202001,11,9,2,9351,2078,11429
431510,202001,253,177,76,184942.55,78964,263906.55
431513,202001,24,21,3,21819,3117,24936
431514,202001,7,6,1,6234,1039,7273
431515,202001,84,70,14,72730,14546,87276
431517,202001,4,3,1,4156,1039,5195
431520,202001,39,34,5,35326,5195,40521
431530,202001,1487,675,812,702364,844707,1547071
431531,202001,25,23,2,23897,2078,25975
431532,202001,33,24,9,24936,9351,34287
431535,202001,26,16,10,16624,10390,27014
431540,202001,140,118,22,122602,22858,145460
431545,202001,13,11,2,11429,2078,13507
431550,202001,349,196,153,204683,160006,364689
431555,202001,12,12,0,12468,0,12468
431560,202001,4552,3138,1414,3267659.98,1473302,4740961.98
431570,202001,825,439,386,456122.4,401054,857176.4
431575,202001,38,22,16,22858,17663,40521
431580,202001,99,68,31,71691,32209,103900
431590,202001,148,126,22,130914,22858,153772
431595,202001,18,15,3,15585,3117,18702
431600,202001,236,134,102,139226,105978,245204
431610,202001,120,87,33,90393,34287,124680
431620,202001,45,38,7,39482,7273,46755
431630,202001,127,108,19,112212,19741,131953
431640,202001,1334,853,481,888345.7,500798.7,1389144.4
431642,202001,36,34,2,35326,2078,37404
431643,202001,45,21,24,21819,24936,46755
431645,202001,323,193,130,200527,136109,336636
431647,202001,8,8,0,8312,0,8312
431650,202001,34,24,10,24936,10390,35326
431660,202001,316,202,114,209878,119485,329363
431670,202001,229,107,122,112212,126758,238970
431673,202001,4,4,0,4156,0,4156
431675,202001,25,20,5,20780,5195,25975
431680,202001,1105,816,289,848863,301310,1150173
431690,202001,4696,2843,1853,2960115.22,1928386.57,4888501.79
431695,202001,22,16,6,16624,6234,22858
431697,202001,0,,,,,0.0
431700,202001,174,136,38,141304,39482,180786
431710,202001,3988,1773,2215,1848382.69,2301389.29,4149771.98
431720,202001,1327,818,509,851461.8,529890.39,1381352.19
431725,202001,0,0,0,0,0,0
431730,202001,1174,807,367,841593.38,381313,1222906.38
431740,202001,1342,667,675,694052,702365.09,1396417.09
431750,202001,1803,1182,621,1229139.1,647297.39,1876436.49
431755,202001,5,4,1,4156,1039,5195
431760,202001,1031,661,370,687820.4,385469,1073289.4
431770,202001,413,297,116,308583,120524,429107
431775,202001,30,22,8,22858,8312,31170
431780,202001,548,338,210,353260,219229,572489
431790,202001,167,130,37,135070,39482,174552
431795,202001,12,10,2,10390,2078,12468
431800,202001,3267,1728,1539,1795399.9,1602174.5,3397574.4
431805,202001,19,17,2,17663,2078,19741
431810,202001,603,403,200,420795,207800.39,628595.39
431820,202001,320,188,132,195332,137148,332480
431830,202001,2307,1387,920,1443171.4,960037.17,2403208.57
431840,202001,485,321,164,333519.8,170396,503915.8
431842,202001,36,29,7,30131,7273,37404
431843,202001,11,8,3,8312,3117,11429
431844,202001,17,13,4,13507,4156,17663
431845,202001,26,24,2,24936,2078,27014
431846,202001,26,22,4,22858,4156,27014
431848,202001,11,9,2,9351,2078,11429
431849,202001,9,7,2,7273,2078,9351
431850,202001,796,655,141,681584,146499,828083
431860,202001,111,76,35,78964,36365,115329
431861,202001,4,2,2,2078,2078,4156
431862,202001,55,38,17,39482,17663,57145
431870,202001,3452,2007,1445,2090471.44,1505513.73,3595985.17
431880,202001,923,680,243,706520,252477,958997
431890,202001,1285,785,500,817693.5,521578,1339271.5
431900,202001,184,132,52,137148,54028,191176
431910,202001,54,38,16,39482,16624,56106
431912,202001,41,24,17,24936,17663,42599
431915,202001,123,96,27,99744,28053,127797
431920,202001,151,110,41,115329,42599,157928
431930,202001,79,64,15,66496,15585,82081
431935,202001,3,3,0,3117,0,3117
431936,202001,13,12,1,12468,1039,13507
431937,202001,18,14,4,14546,4156,18702
431940,202001,463,312,151,324168,156889.75,481057.75
431950,202001,508,316,192,328325.09,200527.39,528852.48
431960,202001,721,401,320,416640.09,332480.39,749120.48
431970,202001,71,64,7,66496,7273,73769
431971,202001,3,3,0,3117,0,3117
431973,202001,22,18,4,18702,4156,22858
431975,202001,9,8,1,8312,1039,9351
431980,202001,214,135,79,140265,82081,222346
431990,202001,1178,626,552,650346.65,573528.78,1223875.43
432000,202001,1693,911,782,950688.05,813539.39,1764227.44
432010,202001,282,193,89,200527,92471,292998
432020,202001,171,143,28,148577,29092,177669
432023,202001,15,13,2,13507,2078,15585
432026,202001,67,62,5,64418,5195,69613
432030,202001,71,36,35,37404,36365,73769
432032,202001,20,16,4,16624,4156,20780
432035,202001,55,45,10,46755,10390,57145
432040,202001,96,67,29,69613,30131,99744
432045,202001,5,4,1,4156,1039,5195
432050,202001,84,50,34,51950,35326,87276
432055,202001,119,89,30,92471,31170,123641
432057,202001,5,4,1,4156.7,1039,5195.7
432060,202001,34,31,3,32209,3117,35326
432065,202001,32,28,4,29092,4156,33248
432067,202001,89,80,9,83120,9351,92471
432070,202001,391,301,90,312999.9,93510.39,406510.29
432080,202001,821,574,247,600542,256633,857175
432085,202001,11,8,3,8312,3117,11429
432090,202001,271,181,90,189098,93510,282608
432100,202001,176,118,58,122602,60262,182864
432110,202001,577,392,185,407288,193254,600542
432120,202001,934,555,379,576645,394820,971465
432130,202001,503,364,139,378196,144421,522617
432132,202001,23,20,3,21819,3117,24936
432135,202001,78,65,13,67535,13507,81042
432140,202001,260,207,53,215073,55067,270140
432143,202001,206,131,75,136109,77925,214034
432145,202001,278,191,87,199488,90393,289881
432146,202001,14,13,1,13507,1039,14546
432147,202001,103,56,47,58184,48833,107017
432149,202001,15,10,5,10390,5195,15585
432150,202001,865,531,334,552748.7,348065.39,900814.09
432160,202001,1447,743,704,771978.38,731456.39,1503434.77
432162,202001,4,3,1,3117,1039,4156
432163,202001,19,14,5,14546,5195,19741
432166,202001,118,87,31,90653.7,32209,122862.7
432170,202001,229,116,113,121563,117407,238970
432180,202001,543,339,204,352221,211956.7,564177.7
432183,202001,7,7,0,7273,0,7273
432185,202001,79,70,9,72730,9351,82081
432190,202001,477,284,193,296115,200527.39,496642.39
432195,202001,85,71,14,73769,14546,88315
432200,202001,398,257,141,267023,146499.39,413522.39
432210,202001,116,73,43,75847,44677,120524
432215,202001,48,44,4,45716,4156,49872
432218,202001,20,19,1,19741,1039,20780
432220,202001,678,353,325,366767,337676.46,704443.46
432225,202001,14,8,6,8312,6234,14546
432230,202001,138,96,42,99744,43638,143382
432232,202001,13,12,1,12468,1039,13507
432234,202001,4,3,1,3117,1039,4156
432235,202001,3,3,0,3117,0,3117
432237,202001,27,15,12,15585,12468,28053
432240,202001,4318,2438,1880,2537239.4,1956440.39,4493679.79
432250,202001,1111,721,390,749119,405210,1154329
432252,202001,43,40,3,41560,3117,44677
432253,202001,63,50,13,51950,13507,65457
432254,202001,30,14,16,14546,16624,31170
432255,202001,15,14,1,14546,1039,15585
432260,202001,830,652,178,677428.7,184942,862370.7
432270,202001,239,179,60,185981,62340,248321
432280,202001,145,110,35,114290.8,36365,150655.8
432285,202001,2,2,0,2078,0,2078
432290,202001,67,60,7,62340,7273,69613
432300,202001,4624,2569,2055,2671202.26,2140342.17,4811544.43
432310,202001,124,101,23,104939,23897,128836
432320,202001,22,17,5,17663,5195,22858
432330,202001,17,12,5,12468,5195,17663
432335,202001,7,6,1,6234,1039,7273
432340,202001,40,35,5,36365,5195,41560
432345,202001,99,68,31,70652,32209,102861
432350,202001,20,19,1,19741,1039,20780
432360,202001,6,5,1,5195,1039,6234
432370,202001,25,24,1,24936,1039,25975
432375,202001,33,30,3,31170,3117,34287
432377,202001,9,9,0,9351,0,9351
432380,202001,166,80,86,85198,89354,174552
500020,202001,241,135,106,140265,110134,250399
500025,202001,133,68,65,70652,67535,138187
500060,202001,1460,911,549,947568,571451.87,1519019.87
500070,202001,809,388,421,405210.07,438458.39,843668.46
500080,202001,131,104,27,108056,28053,136109
500085,202001,135,110,25,114290.7,25975,140265.7
500090,202001,342,157,185,163123,192215,355338
500100,202001,725,379,346,394820,360534.4,755354.4
500110,202001,2259,1049,1210,1094070.15,1259273.55,2353343.70
500124,202001,264,151,113,156889,117407,274296
500150,202001,336,136,200,141304,208840.17,350144.17
500190,202001,530,365,165,380274,171435.7,551709.7
500200,202001,188,164,24,170396.04,24936,195332.04
500210,202001,1526,542,984,564178.95,1023431.55,1587610.50
500215,202001,242,139,103,145460,107017,252477
500220,202001,753,490,263,509111.81,273257,782368.81
500230,202001,240,157,83,163123,86237,249360
500240,202001,691,477,214,495603.48,222346,717949.48
500260,202001,588,227,361,235853,375079.78,610932.78
500270,202001,29773,12793,16980,13304824.07,17673468.94,30978293.01
500280,202001,201,71,130,74808,135070,209878
500290,202001,1171,709,462,736651.7,481057.39,1217709.09
500295,202001,445,286,159,297154.7,165201.78,462356.48
500310,202001,71,23,48,23897,49872,73769
500315,202001,705,421,284,438458,296115,734573
500320,202001,3643,1817,1826,1894098.05,1905528.34,3799626.39
500325,202001,942,516,426,536125.59,444692.7,980818.29
500330,202001,1465,685,780,711715.7,810420.39,1522136.09
500345,202001,304,231,73,240010.09,75847,315857.09
500348,202001,244,148,96,153772,99744,253516
500350,202001,123,59,64,61301,66496,127797
500370,202001,5507,2478,3029,2575682.84,3153369.56,5729052.40
500375,202001,340,245,95,254555,99744,354299
500380,202001,591,341,250,355338,259750,615088
500390,202001,75,36,39,37404,40521,77925
500400,202001,215,146,69,151694,71691.39,223385.39
500410,202001,549,227,322,235853.97,335599.53,571453.50
500430,202001,522,376,146,390664,151694,542358
500440,202001,194,104,90,108056,93510,201566
500450,202001,398,173,225,180786,234814,415600
500460,202001,280,148,132,153772,138187,291959
500470,202001,430,343,87,356377.89,90393.39,446771.28
500480,202001,105,63,42,65457,43638,109095
500490,202001,111,48,63,49872,65457,115329
500500,202001,1428,520,908,541322.3,944460.09,1485782.39
500510,202001,44,35,9,36365,9351,45716
500515,202001,107,75,32,77925,33248.39,111173.39
500520,202001,334,180,154,188059.4,160006.89,348066.29
500525,202001,92,50,42,51950,43638,95588
500540,202001,891,377,514,392742.39,538203.28,930945.67
500560,202001,912,523,389,545475,405211.4,950686.4
500568,202001,987,565,422,588074,438459.48,1026533.48
500570,202001,1194,696,498,723154.08,517442.67,1240596.75
500580,202001,345,176,169,182864,175591.58,358455.58
500600,202001,322,162,160,169357,166240.78,335597.78
500620,202001,905,638,267,663922.2,278452,942374.2
500625,202001,79,63,16,65457,16624,82081
500627,202001,22,11,11,11429,11429,22858
500630,202001,1567,854,713,891462.65,742885.7,1634348.35
500635,202001,516,305,211,316895,221307,538202
500640,202001,388,205,183,212995.7,190137,403132.7
500660,202001,5466,2048,3418,2129950.7,3554421.49,5684372.19
500690,202001,584,206,378,214038.17,392751.36,606789.53
500710,202001,390,196,194,205722,201566.78,407288.78
500720,202001,967,555,412,577684.03,428068,1005752.03
500730,202001,196,119,77,124680,80003,204683
500740,202001,889,377,512,391703.95,534051.53,925755.48
500750,202001,148,47,101,48833,104939.39,153772.39
500755,202001,124,88,36,91432.7,37404,128836.7
500769,202001,749,413,336,429108.28,349104.39,778212.67
500770,202001,403,212,191,220268,200527,420795
500780,202001,157,103,54,107017,56106,163123
500790,202001,1082,557,525,580801,546515.75,1127316.75
500793,202001,272,150,122,155850,126759.09,282609.09
500795,202001,166,117,49,121563,50911.39,172474.39
500797,202001,52,37,15,38443,15585,54028
500800,202001,420,189,231,198449.39,241048,439497.39
500830,202001,2228,1253,975,1304984.9,1017181.8,2322166.7
500840,202001,138,103,35,107017,36365.39,143382.39
510010,202001,166,91,75,94549,77925,172474
510020,202001,494,221,273,232743.02,283659.48,516402.50
510025,202001,1685,963,722,1001600.68,752242.55,1753843.23
510030,202001,668,343,325,357417.17,337677.45,695094.62
510035,202001,126,61,65,63379.78,67535.39,130915.17
510040,202001,393,178,215,184942,223386.24,408328.24
510050,202001,397,216,181,224427.12,189101.79,413528.91
510060,202001,117,60,57,62340,60262,122602
510080,202001,227,87,140,90393.78,145460.39,235854.17
510100,202001,68,29,39,30131,40521,70652
510120,202001,37,23,14,23897,14546,38443
510125,202001,379,236,143,245204.39,149616.58,394820.97
510130,202001,561,327,234,339756.51,244168.99,583925.50
510140,202001,419,126,293,130914,304427.78,435341.78
510160,202001,109,39,70,40521,73769.39,114290.39
510170,202001,825,504,321,523663.01,333524.85,857187.86
510180,202001,2921,1392,1529,1446309.5,1592806.9,3039116.4
510185,202001,16,7,9,7273,9351,16624
510190,202001,229,85,144,88315,149616.78,237931.78
510250,202001,2583,1520,1063,1579283.43,1107575.98,2686859.41
510260,202001,175,129,46,134036.85,47794.39,181831.24
510263,202001,472,268,204,279492.68,211956.78,491449.46
510267,202001,684,382,302,396904.76,313786.58,710691.34
510268,202001,60,28,32,29092,33248,62340
510269,202001,73,34,39,35326.39,40521,75847.39
510270,202001,392,199,193,206762.56,201567.56,408330.12
510279,202001,213,160,53,166241.17,56106.7,222347.87
510285,202001,182,74,108,76886.39,112212,189098.39
510300,202001,512,274,238,285726.55,247284.34,533010.89
510305,202001,208,99,109,102861.58,113251.39,216112.97
510310,202001,102,54,48,56106,49872,105978
510320,202001,856,537,319,557945.34,331446.26,889391.60
510325,202001,403,171,232,177669,241048,418717
510330,202001,423,232,191,242087.97,199488,441575.97
510335,202001,629,357,272,370923.97,282611.9,653535.87
510336,202001,52,38,14,39482,14546,54028
510337,202001,106,45,61,46755,63379,110134
510340,202001,17295,7961,9334,8286107.24,9723074.08,18009181.32
510343,202001,64,45,19,46755,19741,66496
510345,202001,165,108,57,112212,59223.7,171435.7
510350,202001,651,366,285,380276.34,297155.87,677432.21
510360,202001,198,121,77,125719.39,80005.34,205724.73
510370,202001,147,72,75,74808,77926.17,152734.17
510380,202001,88,64,24,66496,24936.39,91432.39
510385,202001,60,26,34,27014,35326.39,62340.39
510390,202001,109,48,61,49872,64418,114290
510395,202001,46,33,13,34287,13507,47794
510410,202001,703,462,241,481057.38,250400.95,731458.33
510420,202001,564,276,288,286772.58,300283.48,587056.06
510450,202001,48,25,23,25975,23897,49872
510452,202001,49,25,24,25975,24936,50911
510454,202001,49,24,25,24936,25975,50911
510455,202001,129,76,53,78964,55067,134031
510460,202001,182,93,89,96629.02,92471.39,189100.41
510480,202001,736,431,305,447812.16,316902.41,764714.57
510490,202001,352,183,169,190140.51,175592.95,365733.46
510500,202001,235,175,60,181825,62340,244165
510510,202001,801,472,329,492487.87,342870,835357.87
510515,202001,1189,637,552,664962.34,573529.17,1238491.51
510517,202001,254,107,147,111173,152734.17,263907.17
510520,202001,228,150,78,155851.17,81044.34,236895.51
510523,202001,98,75,23,77925,24936,102861
510525,202001,818,484,334,504956.14,347028.34,851984.48
510530,202001,20,14,6,14546,6234,20780
510550,202001,250,112,138,116368.39,145460,261828.39
510558,202001,288,141,147,146499.39,152733,299232.39
510560,202001,407,245,162,256633.7,169357.78,425991.48
510562,202001,650,471,179,490408,185981.39,676389.39
510590,202001,764,398,366,413522.39,381313.97,794836.36
510600,202001,247,134,113,140265,117407.78,257672.78
510610,202001,205,85,120,88315,124680,212995
510615,202001,190,83,107,86237,111173,197410
510617,202001,20,12,8,12468,8312,20780
510618,202001,114,54,60,56106,63379,119485
510619,202001,100,70,30,72730.39,31170.39,103900.78
510620,202001,170,94,76,97666,78964,176630
510621,202001,182,121,61,126758.39,63379.78,190138.17
510622,202001,498,308,190,321053.73,197411.48,518465.21
510623,202001,338,234,104,245204.78,108056,353260.78
510624,202001,91,46,45,47794.39,46755,94549.39
510625,202001,538,332,206,344954.63,214038.97,558993.60
510626,202001,111,70,41,72730.39,43638,116368.39
510627,202001,68,47,21,48833,21819,70652
510628,202001,144,86,58,89354.39,60262,149616.39
510629,202001,257,163,94,170396,98705,269101
510630,202001,443,228,215,237932.56,224425.48,462358.04
510631,202001,12,3,9,3117,9351,12468
510637,202001,351,206,145,215073.97,151698.29,366772.26
510642,202001,973,537,436,561061.17,456122.56,1017183.73
510645,202001,0,,,,,0.0
510650,202001,1441,945,496,982899.76,517424.36,1500324.12
510665,202001,78,37,41,38444.56,42599,81043.56
510670,202001,61,35,26,36365,27014,63379
510675,202001,1145,729,416,758471.87,434302,1192773.87
510677,202001,348,179,169,187021.95,175593.34,362615.29
510680,202001,106,61,45,63379.78,46755.39,110135.17
510682,202001,206,101,105,104939,109095,214034
510685,202001,55,41,14,42599,14546,57145
510700,202001,600,344,256,357420.29,265987.7,623407.99
510704,202001,1137,604,533,627602.99,556944.95,1184547.94
510706,202001,135,68,67,70652,69613.39,140265.39
510710,202001,392,274,118,284688.34,122603.56,407291.90
510715,202001,59,44,15,45716,15585,61301
510718,202001,205,105,100,109096.17,103900,212996.17
510719,202001,40,18,22,18702,22858,41560
510720,202001,189,129,60,134031,62340,196371
510724,202001,88,35,53,36365,55067,91432
510726,202001,50,26,24,27014,24936.39,51950.39
510729,202001,68,30,38,31170,39482,70652
510730,202001,467,260,207,271179.78,215073.58,486253.36
510735,202001,112,46,66,47794,68574,116368
510740,202001,23,12,11,12468,11429,23897
510757,202001,17,13,4,13507,4156,17663
510760,202001,7111,3711,3400,3863029.77,3538915.51,7401945.28
510770,202001,687,325,362,337677.34,377162.07,714839.41
510774,202001,18,7,11,7273,11429,18702
510775,202001,107,82,25,86237,25975,112212
510776,202001,29,11,18,11429,18702,30131
510777,202001,190,82,108,85198,113251,198449
510779,202001,51,23,28,23897.39,29093.17,52990.56
510780,202001,285,158,127,164164.33,132994.92,297159.25
510785,202001,392,212,180,220268,187020,407288
510787,202001,189,93,96,97666.39,100783.58,198449.97
510788,202001,1,0,1,0,1039,1039
510790,202001,2463,1299,1164,1353838.73,1209429.93,2563268.66
510792,202001,1153,655,498,683666.29,517427.65,1201093.94
510794,202001,115,60,55,62340,57145.39,119485.39
510795,202001,2358,1361,997,1415122.4,1037965.12,2453087.52
510800,202001,176,108,68,112212,70652,182864
510805,202001,174,116,58,120524,60262.39,180786.39
510810,202001,97,42,55,43640.34,57145,100785.34
510820,202001,241,119,122,123643.16,129876.55,253519.71
510830,202001,69,44,25,45716,25975.39,71691.39
510835,202001,14,10,4,10390,4156,14546
510840,202001,9084,4370,4714,4554017.31,4918708.72,9472726.03
510850,202001,208,83,125,86237,129875.39,216112.39
510860,202001,377,169,208,175593.34,218194.99,393788.33
510880,202001,65,50,15,51950.39,15585,67535.39
510885,202001,74,41,33,42599.39,34287,76886.39
510890,202001,66,38,28,39482,29092,68574
510895,202001,183,108,75,113251,77926.28,191177.28
520005,202001,70,39,31,40521,32209,72730
520010,202001,277,122,155,127797,161045.9,288842.9
520013,202001,710,456,254,474823.39,265984,740807.39
520015,202001,54,39,15,40521,15585,56106
520017,202001,87,49,38,50911.7,39482,90393.7
520020,202001,22,11,11,11429,11429,22858
520025,202001,2166,1137,1029,1181345.2,1071209,2252554.2
520030,202001,789,419,370,437420.19,384430,821850.19
520050,202001,73,50,23,51950,23897,75847
520055,202001,48,28,20,29092,20780,49872
520060,202001,174,119,55,123641,57145,180786
520080,202001,571,409,162,425990,169357,595347
520082,202001,18,12,6,12468,6234,18702
520085,202001,93,70,23,72730,23897,96627
520090,202001,94,63,31,65457,32209,97666
520110,202001,9158,3953,5205,4114445.74,5416315.18,9530760.92
520120,202001,14,8,6,8312,6234,14546
520130,202001,790,557,233,578723.39,242087.7,820811.09
520140,202001,11940,6679,5261,6951960.07,5477617.47,12429577.54
520145,202001,50,31,19,33248,19741,52989
520150,202001,172,136,36,141304,37404,178708
520160,202001,37,28,9,29092,9351,38443
520170,202001,250,148,102,153773.36,108057.56,261830.92
520180,202001,153,76,77,78964,80003,158967
520215,202001,205,134,71,139226,73769,212995
520235,202001,77,59,18,61301,18702,80003
520250,202001,129,79,50,82081,52989,135070
520260,202001,116,74,42,76886,43638,120524
520280,202001,48,32,16,33248,16624,49872
520310,202001,40,26,14,27014,14546,41560
520320,202001,167,108,59,112212,61301,173513
520330,202001,784,421,363,437420.87,377157.78,814578.65
520340,202001,342,200,142,207800,148577.39,356377.39
520350,202001,514,240,274,250399,284686,535085
520355,202001,88,52,36,54028,37404,91432
520357,202001,25,19,6,19741,6234,25975
520360,202001,1,1,0,1039,0,1039
520380,202001,137,72,65,74808,67535,142343
520390,202001,264,111,153,115329.5,158967,274296.5
520393,202001,15,11,4,11429,4156,15585
520396,202001,82,50,32,51950,33248.39,85198.39
520400,202001,205,121,84,125719,87276,212995
520410,202001,194,97,97,100783.39,100783.39,201566.78
520420,202001,20,13,7,13507,7273,20780
520425,202001,290,144,146,149616,151695.7,301311.7
520430,202001,466,245,221,254650.58,230659.34,485309.92
520440,202001,670,476,194,495603,201566,697169
520450,202001,1939,863,1076,899774.39,1120044.34,2019818.73
520455,202001,55,37,18,38443,18702,57145
520460,202001,37,23,14,23897,14546,38443
520465,202001,33,29,4,30131,4156,34287
520470,202001,427,271,156,281569,162084.78,443653.78
520480,202001,80,49,31,50911.39,32211.34,83122.73
520485,202001,117,41,76,42599,78964.7,121563.7
520490,202001,412,304,108,317934.86,112212,430146.86
520495,202001,162,96,66,99744,69613,169357
520500,202001,182,139,43,144421,44677.78,189098.78
520505,202001,182,103,79,107017,82081,189098
520510,202001,1791,859,932,893557.61,968387.83,1861945.44
520520,202001,40,29,11,30131,11429,41560
520530,202001,234,177,57,183903,59223,243126
520540,202001,560,386,174,402093,180786,582879
520545,202001,136,84,52,87276,54028,141304
520547,202001,50,27,23,28053,23897,51950
520549,202001,1210,577,633,599503.26,657687,1257190.26
520551,202001,291,154,137,160006,142343.7,302349.7
520552,202001,40,27,13,28053,13507,41560
520570,202001,16,10,6,10390,6234,16624
520580,202001,284,176,108,182864,112212,295076
520590,202001,157,96,61,99744.39,63379,163123.39
520620,202001,1155,542,613,565217.09,638985.95,1204203.04
520630,202001,37,22,15,22858,15585,38443
520640,202001,394,231,163,240009,170396,410405
520650,202001,64,37,27,38443,28053,66496
520660,202001,43,22,21,22858,21819,44677
520670,202001,37,30,7,31170,7273,38443
520680,202001,53,35,18,36365,18702,55067
520690,202001,39,12,27,12468,28053.78,40521.78
520710,202001,33,30,3,31170,3117,34287
520725,202001,187,135,52,140265,54028,194293
520735,202001,56,38,18,39482,18702,58184
520740,202001,415,202,213,209878,221307.39,431185.39
520750,202001,33,26,7,27014,7273,34287
520753,202001,59,41,18,42599,18702,61301
520760,202001,106,72,34,74808,35326,110134
520780,202001,292,217,75,225463,78964,304427
520790,202001,154,85,69,88315,71691,160006
520800,202001,3420,1845,1575,1919036.07,1639542.84,3558578.91
520810,202001,162,121,41,125719,42599,168318
520815,202001,5,4,1,4156,1039,5195
520830,202001,147,103,44,107017,45716,152733
520840,202001,352,235,117,244165,122602,366767
520850,202001,103,65,38,67535.78,39482,107017.78
520860,202001,1717,1107,610,1150173.7,634829.7,1785003.4
520870,202001,31567,15121,16446,15729442.58,17114438.54,32843881.12
520880,202001,1154,623,531,647298.48,553788.87,1201087.35
520890,202001,786,474,312,492486.39,324168,816654.39
520910,202001,976,524,452,544438.37,471706,1016144.37
520915,202001,97,74,23,76886,23897,100783
520920,202001,405,202,203,209878,210917,420795
520929,202001,18,17,1,17663,1039,18702
520940,202001,73,49,24,50911,24936,75847
520945,202001,18,11,7,11429,7273,18702
520960,202001,45,30,15,31170,15585,46755
520970,202001,331,206,125,214034.39,129875,343909.39
520980,202001,94,68,26,70652,27014,97666
520990,202001,450,304,146,315856,151694,467550
520993,202001,130,62,68,64418,70652,135070
520995,202001,244,142,102,148542.99,105978.7,254521.69
521000,202001,1555,917,638,954841.8,662882.9,1617724.7
521010,202001,673,324,349,336637.56,362612.17,699249.73
521015,202001,14,9,5,9351,6234,15585
521020,202001,1422,996,426,1036922.39,445732.48,1482654.87
521030,202001,51,36,15,37404,15585,52989
521040,202001,944,597,347,621322.95,360533.7,981856.65
521056,202001,45,32,13,33248,13507,46755
521060,202001,129,85,44,88315,45716,134031
521080,202001,442,339,103,352222.09,108056,460278.09
521090,202001,530,335,195,348065,202605,550670
521100,202001,276,208,68,216112,70652,286764
521120,202001,1061,743,318,774056.48,330402.39,1104458.87
521130,202001,349,249,100,258711,103901.48,362612.48
521140,202001,180,97,83,100783,86237,187020
521150,202001,2678,1166,1512,1214592.48,1574085.78,2788678.26
521160,202001,29,15,14,15585,14546,30131
521170,202001,202,114,88,118446,91432,209878
521180,202001,1186,753,433,784445.6,449887.95,1234333.55
521190,202001,2533,1074,1459,1119003,1522136.48,2641139.48
521200,202001,54,40,14,41560,14546,56106
521205,202001,11,8,3,8312,3117,11429
521210,202001,127,74,53,76886,55067,131953
521220,202001,798,559,239,582879,249360.95,832239.95
521225,202001,35,24,11,24936,11429,36365
521230,202001,103,69,34,71691,36365,108056
521250,202001,6179,3515,2664,3655207.74,2769978.89,6425186.63
521260,202001,26,14,12,14546,12468,27014
521270,202001,141,109,32,113251,33248,146499
521280,202001,428,260,168,271179,174552,445731
521290,202001,26,11,15,11429,15585,27014
521295,202001,99,65,34,67535,35326,102861
521300,202001,218,116,102,120524.78,105979.87,226504.65
521305,202001,36,25,11,25975,11429,37404
521308,202001,1097,839,258,873802.12,270140.39,1143942.51
521310,202001,1328,770,558,800031.95,579762.87,1379794.82
521340,202001,21,16,5,16624,5195,21819
521350,202001,126,93,33,96627,34287,130914
521370,202001,174,122,52,126758,54028,180786
521375,202001,171,92,79,95588.78,82081,177669.78
521377,202001,45,34,11,35326,11429,46755
521380,202001,1058,675,383,701327.56,397937.7,1099265.26
521385,202001,14,8,6,8312,6234,14546
521390,202001,100,81,19,84159,19741,103900
521400,202001,331,223,108,232736,112212,344948
521405,202001,142,80,62,83120,64418,147538
521410,202001,64,43,21,44677,21819,66496
521440,202001,193,143,50,148577,51950,200527
521450,202001,731,410,321,427029,333519,760548
521460,202001,1162,744,418,773016,435341,1208357
521470,202001,12,8,4,8312,4156,12468
521480,202001,43,30,13,31171.17,13508.73,44679.90
521483,202001,311,181,130,188059.7,135070,323129.7
521486,202001,279,183,96,191176,100783.3,291959.3
521487,202001,22,10,12,10390,12468,22858
521490,202001,26,15,11,15585,11429,27014
521500,202001,114,73,41,75847,42599,118446
521520,202001,41,29,12,30131,12468,42599
521523,202001,704,423,281,439497,291959,731456
521525,202001,47,30,17,31170,17663,48833
521530,202001,246,133,113,138187,118446,256633
521540,202001,29,15,14,15585,14546,30131
521550,202001,86,38,48,40522.87,49873.95,90396.82
521560,202001,804,553,251,574567.7,261828.85,836396.55
521565,202001,57,37,20,38443,20780,59223
521570,202001,520,344,176,357416.7,182864.95,540281.65
521580,202001,58,34,24,35326,24936,60262
521590,202001,38,18,20,18702,20780,39482
521600,202001,22,13,9,13507,9351,22858
521630,202001,245,129,116,134031,120525.53,254556.53
521640,202001,298,160,138,166240,143382,309622
521645,202001,28,16,12,16624,12468,29092
521680,202001,227,141,86,146499,89354.8,235853.8
521690,202001,2,2,0,2078,0,2078
521710,202001,1146,551,595,575606,619245.17,1194851.17
521720,202001,538,371,167,385469,174552.87,560021.87
521730,202001,642,313,329,325208.8,341831,667039.8
521740,202001,908,383,525,397937.39,548594.26,946531.65
521760,202001,1846,981,865,1019260.22,899775.48,1919035.70
521770,202001,829,526,303,547553,315856,863409
521800,202001,2006,1279,727,1328888.48,756395.51,2085283.99
521805,202001,32,18,14,18702,14546,33248
521810,202001,86,54,32,56106,33248,89354
521830,202001,941,671,270,698208.58,280530.39,978738.97
521839,202001,86,53,33,55067,34287,89354
521850,202001,1084,580,504,604700.64,526779.36,1131480.00
521860,202001,347,218,129,227541,135070,362611
521870,202001,72,42,30,43638,31170,74808
521878,202001,34,17,17,17663,17663,35326
521880,202001,4695,2113,2582,2195411.9,2685821.15,4881233.05
521890,202001,594,427,167,443653,173513,617166
521900,202001,284,232,52,242087,54028,296115
521910,202001,157,112,45,116368,47794,164162
521920,202001,49,24,25,24936,25975,50911
521925,202001,50,26,24,27014,24936,51950
521930,202001,1145,639,506,666004.38,526778.77,1192783.15
521935,202001,36,26,10,27014,10390,37404
521940,202001,194,100,94,103900,98705,202605
521945,202001,16,14,2,14546,2078,16624
521950,202001,9,4,5,4156,5195,9351
521960,202001,71,53,18,55067,18702,73769
521970,202001,403,260,143,271179,148577,419756
521971,202001,94,48,46,49872,47794,97666
521973,202001,33,18,15,18702,15585,34287
521975,202001,1366,688,678,715871.75,706521.55,1422393.30
521980,202001,241,164,77,170396,80003,250399
521990,202001,78,55,23,58184,23897,82081
522000,202001,284,176,108,183540.38,112212,295752.38
522005,202001,20,11,9,11429,9351,20780
522010,202001,1134,640,494,667038.39,516383,1183421.39
522015,202001,63,39,24,40521.39,24936,65457.39
522020,202001,887,510,377,531968.55,391704.68,923673.23
522026,202001,21,13,8,13507,8312,21819
522028,202001,16,12,4,12468,4156,16624
522040,202001,783,321,462,333520.53,480019.56,813540.09
522045,202001,2313,1434,879,1491314.44,914324.88,2405639.32
522050,202001,162,81,81,84159,84159,168318
522060,202001,546,349,197,362611,204683,567294
522068,202001,120,81,39,84159,40521,124680
522070,202001,12,11,1,11429,1039,12468
522100,202001,40,22,18,22858,18702,41560
522108,202001,42,32,10,33248,10390,43638
522119,202001,54,28,26,29092,27014,56106
522130,202001,80,34,46,35326,47795.56,83121.56
522140,202001,4038,2093,1945,2179824.94,2029168.69,4208993.63
522145,202001,47,34,13,35326,13507,48833
522150,202001,86,63,23,65457,23897,89354
522155,202001,51,33,18,34287.39,18702.39,52989.78
522157,202001,6,3,3,3117,3117,6234
522160,202001,1697,1011,686,1051468,713793.39,1765261.39
522170,202001,395,269,126,279491,130914,410405
522180,202001,40,20,20,20780,20780,41560
522185,202001,2026,806,1220,837435.4,1273814.97,2111250.37
522190,202001,46,26,20,27014,20780,47794
522200,202001,293,174,119,181825,124680,306505
522205,202001,145,100,45,103900,46755,150655
522220,202001,155,110,45,114290,46755,161045
522230,202001,34,26,8,27014,8312,35326
530010,202001,54606,27799,26807,28919840.31,27894072.49,56813912.80
110001,202002,498,400,98,420090,103456.8,523546.8
110002,202002,2730,1682,1048,1779642.15,1105618.6,2885260.75
110003,202002,86,72,14,76285,15675,91960
110004,202002,1967,1279,688,1352235.1,730459.5,2082694.6
110005,202002,441,351,90,369933.2,95095,465028.2
110006,202002,439,340,99,359480.5,106590,466070.5
110007,202002,67,56,11,59565,11495,71060
110008,202002,233,131,102,138985,106590,245575
110009,202002,842,600,242,631182.7,261251.35,892434.05
110010,202002,1762,1078,684,1131739.05,729410.9,1861149.95
110011,202002,1769,1381,388,1469283.5,411733.6,1881017.1
110012,202002,4080,2367,1713,2523683.1,1813086.3,4336769.4
110013,202002,756,599,157,635369,165118.1,800487.1
110014,202002,373,324,49,339626.4,51205,390831.4
110015,202002,1372,1105,267,1165184.76,283197.7,1448382.46
110018,202002,1090,679,411,718963.6,435772.19,1154735.79
110020,202002,15414,8871,6543,9396692.15,6908568.97,16305261.12
110025,202002,615,456,159,478611.4,169293.15,647904.55
110026,202002,35,27,8,28215,8360,36575
110028,202002,1629,1183,446,1249824.9,473387.9,1723212.8
110029,202002,137,124,13,132715,13585,146300
110030,202002,2416,1620,796,1709457.04,837050.85,2546507.89
110032,202002,296,225,71,243486.07,74195.22,317681.29
110033,202002,655,485,170,512056.3,181831.35,693887.65
110034,202002,353,264,89,277971.57,95095.9,373067.47
110037,202002,96,84,12,89870,12540,102410
110040,202002,368,254,114,267520,121221.8,388741.8
110045,202002,911,627,284,660448.5,298877.3,959325.8
110050,202002,86,76,10,79420.5,10450,89870.5
110060,202002,69,39,30,41800.9,32395,74195.9
110070,202002,107,67,40,73150.9,41800.5,114951.4
110080,202002,434,244,190,257072.7,201685.9,458758.6
110090,202002,30,25,5,26125.9,5225,31350.9
110092,202002,97,50,47,55385,50160,105545
110094,202002,192,139,53,146301.8,55385.9,201687.7
110100,202002,33,26,7,27170,7315,34485
110110,202002,68,38,30,39710,32395,72105
110120,202002,67,56,11,60610,11495,72105
110130,202002,290,238,52,253936.8,54340.9,308277.7
110140,202002,240,163,77,172425.9,80465.9,252891.8
110143,202002,48,39,9,41800,9405,51205
110145,202002,25,20,5,20900.9,5225,26125.9
110146,202002,23,12,11,12540,11495,24035
110147,202002,34,25,9,27170,9405,36575
110148,202002,34,23,11,24035,11495,35530
110149,202002,303,212,91,226765,96142.7,322907.7
110150,202002,122,92,30,101365,32395,133760
110155,202002,10,8,2,8360,2090,10450
110160,202002,68,54,14,56430,14630,71060
110170,202002,212,170,42,178695.9,43890,222585.9
110175,202002,67,50,17,52250.9,17765,70015.9
110180,202002,92,78,14,81510,14630,96140
120001,202002,198,149,49,157797.7,52253.14,210050.84
120005,202002,194,111,83,118085.9,86736.8,204822.7
120010,202002,1077,677,400,710603.87,419046.35,1129650.22
120013,202002,143,97,46,103455.9,50160,153615.9
120017,202002,99,57,42,59565.9,43890.9,103456.8
120020,202002,3491,2810,681,2973030.68,718962.7,3691993.38
120025,202002,537,305,232,322912.92,242443.6,565356.52
120030,202002,1060,902,158,948864.06,170335.9,1119199.96
120032,202002,37,35,2,36575,2090,38665
120033,202002,213,188,25,199595,26125,225720
120034,202002,164,119,45,128535,48070,176605
120035,202002,36,29,7,30305,7315,37620
120038,202002,399,260,139,272748.6,148396.3,421144.9
120039,202002,27,26,1,27170,1045,28215
120040,202002,13903,9505,4398,10053357.01,4655575.17,14708932.18
120042,202002,43,38,5,39710,5225,44935
120043,202002,11,3,8,3135,8360,11495
120045,202002,542,349,193,376204.95,202734.05,578939.00
120050,202002,1270,971,299,1023059.29,315590.9,1338650.19
120060,202002,1454,1189,265,1252956.8,277970,1530926.8
120070,202002,443,313,130,332315.32,136895,469210.32
120080,202002,167,100,67,106592.7,71060,177652.7
130002,202002,148,106,42,112860,43890,156750
130006,202002,87,53,34,56430,35530,91960
130008,202002,133,72,61,75240,65835,141075
130010,202002,141,80,61,83600.9,63745,147345.9
130014,202002,263,191,72,200641.8,75240,275881.8
130020,202002,98,59,39,61655,41800,103455
130030,202002,940,561,379,594606.8,404415,999021.8
130040,202002,329,164,165,176605,176605.4,353210.4
130050,202002,563,292,271,309320,285285.9,594605.9
130060,202002,862,585,277,618640.9,289465,908105.9
130063,202002,588,336,252,351120,266475,617595
130068,202002,185,119,66,126445,68970,195415
130070,202002,1291,880,411,930052.25,431585.9,1361638.15
130080,202002,706,462,244,490107.7,257070,747177.7
130083,202002,68,38,30,39710,31350,71060
130090,202002,339,172,167,180785,176605,357390
130100,202002,1110,478,632,501600,664629,1166229
130110,202002,731,305,426,319770.9,453530,773300.9
130115,202002,159,66,93,70015,98230.9,168245.9
130120,202002,1617,1037,580,1093070,618640,1711710
130130,202002,601,411,190,431585,199595,631180
130140,202002,1494,1151,343,1212200,366795,1578995
130150,202002,417,364,53,381425,55385,436810
130160,202002,449,263,186,275880,196460,472340
130165,202002,27,21,6,21945,6270,28215
130170,202002,949,659,290,694860.82,304095,998955.82
130180,202002,183,124,59,130625,61655,192280
130185,202002,2329,1092,1237,1152637.7,1304168.1,2456805.8
130190,202002,3451,2148,1303,2269742.9,1367909.15,3637652.05
130195,202002,276,220,56,229900,58520,288420
130200,202002,183,84,99,87780,103455,191235
130210,202002,78,39,39,40755,40755,81510
130220,202002,179,124,55,131670,59565,191235
130230,202002,376,241,135,251845,141075,392920
130240,202002,1343,839,504,889297.02,535040,1424337.02
130250,202002,4711,3009,1702,3176822.5,1793231.7,4970054.2
130255,202002,427,207,220,217360.9,231990,449350.9
130260,202002,56572,26769,29803,28318431.92,31504829.32,59823261.24
130270,202002,1513,1020,493,1077489.05,522500,1599989.05
130280,202002,126,71,55,74195,58520,132715
130290,202002,2084,1473,611,1550783.6,640585,2191368.6
130300,202002,433,306,127,323950,133760,457710
130310,202002,911,477,434,499510,460845,960355
130320,202002,504,270,234,285285,245575,530860
130330,202002,743,467,276,493240.9,291555,784795.9
130340,202002,3488,2010,1478,2115083.7,1551834.1,3666917.8
130350,202002,434,280,154,300960,160930,461890
130353,202002,917,384,533,405460.9,560122.7,965583.6
130356,202002,809,369,440,393965,465027.7,858992.7
130360,202002,87,64,23,67925,25080,93005
130370,202002,710,546,164,578930,171380,750310
130380,202002,678,520,158,552805,171380,724185
130390,202002,493,398,95,421135,99275,520410
130395,202002,160,33,127,35530,132715,168245
130400,202002,66,45,21,47025,21945,68970
130406,202002,2080,1262,818,1332376.4,864215,2196591.4
130410,202002,435,198,237,212135,248710,460845
130420,202002,2971,2410,561,2548763.85,591474.5,3140238.35
130423,202002,154,79,75,82555,79420,161975
130426,202002,147,80,67,83600,71060,154660
130430,202002,400,256,144,269610,154660,424270
130440,202002,199,67,132,70015,140030,210045
140002,202002,30,10,20,10450,22990.9,33440.9
140005,202002,197,118,79,125400.9,82555.9,207956.8
140010,202002,10258,6604,3654,7007906.9,3862445.35,10870352.25
140015,202002,128,53,75,58520,78375.9,136895.9
140017,202002,119,77,42,80465.9,43891.8,124357.7
140020,202002,472,307,165,330220.9,172429.05,502649.95
140023,202002,49,22,27,24037.15,28215,52252.15
140028,202002,19,11,8,11495.9,8360,19855.9
140030,202002,344,244,100,254981.8,105545.9,360527.7
140040,202002,59,40,19,41800,19855,61655
140045,202002,242,98,144,103455,150480,253935
140047,202002,612,405,207,425325.65,217368.1,642693.75
140050,202002,151,93,58,98234.5,61656.8,159891.3
140060,202002,43,32,11,33441.8,12540.9,45982.7
140070,202002,32,30,2,31350.9,3135,34485.9
150010,202002,4580,2808,1772,2971993.1,1883094.5,4855087.6
150013,202002,156,110,46,114950.45,50160,165110.45
150020,202002,1052,561,491,593560.9,521455,1115015.9
150030,202002,669,277,392,291558.6,411733.6,703292.2
150034,202002,195,124,71,132715,74195.5,206910.5
150040,202002,1441,832,609,874667.7,638499.5,1513167.2
150050,202002,643,367,276,385605,292600,678205
150060,202002,4758,3032,1726,3213317,1818756.03,5032073.03
150070,202002,327,143,184,149435,193325.9,342760.9
150080,202002,14736,7077,7659,7513563.94,8124889.67,15638453.61
150085,202002,412,260,152,273792.7,160935.4,434728.1
150090,202002,720,606,114,648945.9,124355,773300.9
150095,202002,355,222,133,233035,140030,373065
150100,202002,61,38,23,40755,24035,64790
150110,202002,174,86,88,90915,91960,182875
150120,202002,408,299,109,317680.9,113905.9,431586.8
150125,202002,50,19,31,20900,33440,54340
150130,202002,1973,1052,921,1109795.4,976031.8,2085827.2
150140,202002,54003,24627,29376,26095770.51,31166117.99,57261888.50
150145,202002,190,103,87,108680.9,90915.9,199596.8
150150,202002,2901,1291,1610,1368951.8,1696040.5,3064992.3
150157,202002,387,274,113,290511.4,119132.7,409644.1
150160,202002,129,99,30,103455,31350,134805
150170,202002,3558,2655,903,2820456.8,960357.7,3780814.5
150172,202002,332,226,106,238262.7,110770.9,349033.6
150175,202002,77,46,31,50160,32395.9,82555.9
150178,202002,768,514,254,544446.8,268568.6,813015.4
150180,202002,3135,1537,1598,1627076.95,1687697.1,3314774.05
150190,202002,334,213,121,223630.9,127490,351120.9
150195,202002,105,54,51,56430.9,54340,110770.9
150200,202002,189,90,99,95095,106590,201685
150210,202002,3053,2457,596,2625045.4,644766.12,3269811.52
150215,202002,560,364,196,384563.6,207956.8,592520.4
150220,202002,3602,2425,1177,2563389.02,1249824.2,3813213.22
150230,202002,1170,942,228,993796.27,238260.9,1232057.17
150240,202002,6216,3578,2638,3776638.27,2790154.95,6566793.22
150250,202002,41,18,23,18810,24035,42845
150260,202002,84,53,31,55385,32395,87780
150270,202002,2234,1445,789,1524673.9,827654,2352327.9
150275,202002,519,326,193,347985,206912.7,554897.7
150276,202002,107,43,64,44935.9,66880.9,111816.8
150277,202002,752,330,422,346947.65,448313.1,795260.75
150280,202002,323,209,114,221540,123310,344850
150285,202002,96,49,47,52250,49115,101365
150290,202002,975,589,386,619686.8,406505.5,1026192.3
150293,202002,637,303,334,320817.7,353210.9,674028.6
150295,202002,477,218,259,231998.1,271708.5,503706.6
150300,202002,79,39,40,40755,41800,82555
150304,202002,173,107,66,111815,68970,180785
150307,202002,397,328,69,345895,72105,418000
150309,202002,574,412,162,432633.15,170337.15,602970.30
150310,202002,235,155,80,161975,83600,245575
150320,202002,1894,1324,570,1396120,599830,1995950
150330,202002,1952,1128,824,1217425.9,886163.6,2103589.5
150340,202002,194,131,63,137940,66880,204820
150345,202002,620,341,279,360525,293646.8,654171.8
150350,202002,405,315,90,331265.9,96140,427405.9
150360,202002,4644,2896,1748,3051418.97,1835031.7,4886450.67
150370,202002,811,562,249,591478.55,265438.55,856917.10
150375,202002,183,89,94,96140,100320,196460
150380,202002,1457,971,486,1019924.5,509966.3,1529890.8
150390,202002,790,456,334,483838.82,352169.5,836008.32
150400,202002,106,88,18,91960,18810,110770
150405,202002,1222,785,437,826598.6,459800.9,1286399.5
150410,202002,121,79,42,82555,43890,126445
150420,202002,7295,3977,3318,4200131.35,3508369.25,7708500.60
150430,202002,585,382,203,402327.7,215270.9,617598.6
150440,202002,551,334,217,351120,226765,577885
150442,202002,2264,1202,1062,1268631,1128601.8,2397232.8
150445,202002,536,343,193,363666.3,203776.8,567443.1
150450,202002,235,125,110,131670,115995,247665
150460,202002,721,540,181,572662.7,190190,762852.7
150470,202002,1295,777,518,820325.9,547582.7,1367908.6
150475,202002,226,173,53,183921.8,56430.9,240352.7
150480,202002,1298,903,395,947820.4,418000.9,1365821.3
150490,202002,589,325,264,342760,277970,620730
150495,202002,328,241,87,252890,91960,344850
150497,202002,287,197,90,206910.9,96141.8,303052.7
150500,202002,218,137,81,144210,84645,228855
150503,202002,1005,500,505,523554.5,536098.95,1059653.45
150506,202002,904,603,301,657310.4,326048.1,983358.5
150510,202002,1247,691,556,731505.9,587291.8,1318797.7
150520,202002,265,177,88,186010,95095,281105
150530,202002,1691,932,759,981266.15,800479.9,1781746.05
150540,202002,228,166,62,174515,65835,240350
150543,202002,790,424,366,444128.6,385611.3,829739.9
150548,202002,454,324,130,342762.7,138987.7,481750.4
150549,202002,59,42,17,43890,17765,61655
150550,202002,2888,1469,1419,1554963.85,1500628.6,3055592.45
150553,202002,3341,1927,1414,2046139.4,1490218.6,3536358.0
150555,202002,138,74,64,77330.9,67925,145255.9
150560,202002,30,13,17,13585,17765,31350
150563,202002,91,46,45,50160.9,47026.8,97187.7
150565,202002,176,106,70,112860.9,74195,187055.9
150570,202002,399,263,136,277970,144210,422180
150580,202002,1613,753,860,790020.9,901837.7,1691858.6
150590,202002,804,528,276,553850,288420.9,842270.9
150600,202002,460,278,182,294690,191235,485925
150610,202002,139,117,22,124355,22990,147345
150611,202002,120,83,37,86735,38665,125400
150613,202002,3180,1912,1268,2029413.4,1342860.15,3372273.55
150616,202002,509,300,209,315591.8,223630,539221.8
150618,202002,1306,699,607,736726.35,643722.7,1380449.05
150619,202002,389,297,92,313503.6,96140,409643.6
150620,202002,1229,724,505,767030.9,537130,1304160.9
150630,202002,294,187,107,200640,111815,312455
150635,202002,463,192,271,203775,287375.9,491150.9
150640,202002,53,27,26,28215,27170,55385
150650,202002,2334,1357,977,1430605.5,1038733.42,2469338.92
150655,202002,238,178,60,190190,64790,254980
150658,202002,90,48,42,51205.9,44937.7,96143.6
150660,202002,514,342,172,359482.7,180785,540267.7
150670,202002,1042,372,670,390837.65,702257.55,1093095.20
150680,202002,9922,5258,4664,5552145.39,4915753.85,10467899.24
150690,202002,15,9,6,9405,6270,15675
150700,202002,478,315,163,331265.9,173470.9,504736.8
150710,202002,275,151,124,158840,131670,290510
150715,202002,808,498,310,523546.35,325008.5,848554.85
150720,202002,402,310,92,329176.8,98230.9,427407.7
150730,202002,983,503,480,531910.4,505782.7,1037693.1
150740,202002,229,156,73,165110,76285,241395
150745,202002,793,436,357,457714.5,376210.8,833925.3
150746,202002,61,36,25,38665,26125.9,64790.9
150747,202002,228,176,52,188100,55385,243485
150750,202002,137,77,60,81510.9,62700.9,144211.8
150760,202002,1800,1168,632,1231011.52,666710,1897721.52
150770,202002,384,209,175,220495,184965,405460
150775,202002,94,46,48,48070,50160,98230
150780,202002,186,108,78,112860.9,83600.9,196461.8
150790,202002,827,454,373,478611.8,398145,876756.8
150795,202002,1502,894,608,940504.5,640587.7,1581092.2
150796,202002,355,206,149,216315,156750,373065
150797,202002,309,158,151,165110,159885,324995
150800,202002,1442,839,603,887205,641630,1528835
150803,202002,538,438,100,466072.7,104500,570572.7
150805,202002,196,121,75,126446.8,78375.22,204822.02
150808,202002,975,529,446,558037.2,473390.4,1031427.6
150810,202002,3239,2231,1008,2358574.52,1065914,3424488.52
150812,202002,430,224,206,236171.8,215270.9,451442.7
150815,202002,1004,628,376,661489.5,393965,1055454.5
150820,202002,1513,897,616,954085,648945,1603030
150830,202002,726,533,193,564304.5,205867.7,770172.2
150835,202002,202,117,85,122266.8,88825,211091.8
150840,202002,1357,843,514,885120.4,545499.9,1430620.3
160005,202002,51,32,19,33440,19855,53295
160010,202002,193,123,70,128535,73150,201685
160015,202002,114,68,46,73150.9,48070,121220.9
160020,202002,125,75,50,78375.9,54340.9,132716.8
160021,202002,55,27,28,28215,29260,57475
160023,202002,65,42,23,44935,24035,68970
160025,202002,25,10,15,10450.9,15675,26125.9
160027,202002,1505,854,651,900792.05,683432.7,1584224.75
160030,202002,15682,8070,7612,8539815.07,8042400.55,16582215.62
160040,202002,292,168,124,177650,130625,308275
160050,202002,713,353,360,375155,386651.8,761806.8
160053,202002,286,167,119,176606.4,124355.9,300962.3
160055,202002,28,19,9,19855,9405,29260
160060,202002,6546,3441,3105,3625141.57,3275070.32,6900211.89
160070,202002,171,103,68,108680,73150.9,181830.9
160080,202002,104,50,54,53295.9,56430,109725.9
170025,202002,26,14,12,15675,13585.9,29260.9
170030,202002,211,173,38,183920.62,41800,225720.62
170035,202002,230,109,121,113907.7,128535.9,242443.6
170040,202002,180,136,44,144210.08,45980,190190.08
170070,202002,314,194,120,202732.7,128537.7,331270.4
170100,202002,357,259,98,271705.4,103455,375160.4
170105,202002,56,45,11,47025,12540,59565
170110,202002,107,69,38,76285,40755,117040
170130,202002,65,31,34,33440.9,35530.5,68971.4
170190,202002,93,57,36,61655,37620,99275
170200,202002,368,255,113,271701.35,120175,391876.35
170210,202002,6007,3192,2815,3368048.58,2977247.88,6345296.46
170215,202002,118,47,71,49115,75242.7,124357.7
170220,202002,1382,1018,364,1078447.2,385609.5,1464056.7
170230,202002,146,96,50,102410,52250,154660
170240,202002,528,354,174,374110,182875,556985
170255,202002,1083,877,206,924831.3,221541.8,1146373.1
170270,202002,45,31,14,33440,14630,48070
170290,202002,114,77,37,80465,38665,119130
170300,202002,92,61,31,63745,32395,96140
170305,202002,49,38,11,39710,11495,51205
170307,202002,61,48,13,50160,14630,64790
170310,202002,109,61,48,63745,50160,113905
170320,202002,26,17,9,18810.9,9405,28215.9
170330,202002,23,21,2,21945,2090,24035
170360,202002,28,17,11,17765,11495,29260
170370,202002,96,46,50,49115,52250,101365
170380,202002,78,60,18,62700,18810,81510
170382,202002,43,36,7,37620,7315,44935
170384,202002,145,110,35,115995,36575,152570
170386,202002,63,26,37,27170,39710,66880
170388,202002,47,18,29,18810,30305.9,49115.9
170389,202002,26,21,5,21945,5225,27170
170390,202002,67,38,29,40755.45,30305,71060.45
170410,202002,32,24,8,25080,8360,33440
170460,202002,16,11,5,11495,5225,16720
170510,202002,35,27,8,28215,8360,36575
170550,202002,1529,892,637,938415.4,675087.1,1613502.5
170555,202002,114,80,34,83600,35530,119130
170560,202002,97,67,30,72105,31350,103455
170600,202002,34,16,18,17765,18810,36575
170610,202002,195,105,90,109726.8,94052.75,203779.55
170625,202002,37,21,16,21945,16720,38665
170650,202002,79,57,22,60610,22990,83600
170700,202002,572,436,136,459800.25,143165,602965.25
170710,202002,155,96,59,100320,63747.25,164067.25
170720,202002,87,69,18,74195,18810,93005
170730,202002,84,48,36,51205,37620,88825
170740,202002,83,60,23,62700,24035,86735
170755,202002,65,35,30,36576.8,31350.9,67927.7
170765,202002,138,73,65,78375.9,67925.9,146301.8
170770,202002,206,128,78,133760,81510.9,215270.9
170820,202002,591,392,199,415041.86,207955.5,622997.36
170825,202002,34,16,18,17765,18810,36575
170830,202002,80,66,14,71060,14630,85690
170900,202002,181,141,40,151525,44935,196460
170930,202002,896,471,425,500557.6,445174.1,945731.7
170950,202002,3098,1417,1681,1502714.95,1768158.88,3270873.83
170980,202002,17,10,7,10450,7315.9,17765.9
171050,202002,141,111,30,118085,31350,149435
171070,202002,34,29,5,31350,5225,36575
171090,202002,41,30,11,31350,11495,42845
171110,202002,22,15,7,15675.9,7315,22990.9
171150,202002,40,19,21,19855,21945,41800
171180,202002,26,13,13,13585,13585.9,27170.9
171190,202002,147,83,64,87781.8,67929.5,155711.3
171195,202002,66,56,10,58520,11495,70015
171200,202002,49,25,24,26125.9,25080.9,51206.8
171215,202002,4,3,1,3135,1045,4180
171240,202002,58,42,16,43890,16720,60610
171245,202002,58,49,9,51206.8,9405,60611.8
171250,202002,73,40,33,41800.9,34485,76285.9
171270,202002,14,10,4,10450,4180,14630
171280,202002,42,37,5,38665,5225,43890
171320,202002,962,566,396,599833.24,420094.5,1019927.74
171330,202002,423,211,212,221540,224675.9,446215.9
171360,202002,84,60,24,62700,25080.9,87780.9
171370,202002,33,16,17,16720.9,17765.9,34486.8
171380,202002,131,111,20,117040,21945,138985
171395,202002,51,32,19,33440,20900,54340
171420,202002,280,182,98,191235,103455.9,294690.9
171430,202002,74,60,14,63745.9,14630,78375.9
171488,202002,173,96,77,101365.9,82556.8,183922.7
171500,202002,56,32,24,33440,25080,58520
171510,202002,70,44,26,47025,29260,76285
171515,202002,41,34,7,35530,7315.5,42845.5
171525,202002,29,27,2,28215,2090,30305
171550,202002,13,9,4,9405.9,4180,13585.9
171570,202002,51,27,24,29260,26125,55385
171575,202002,308,199,109,214225,113905,328130
171610,202002,1755,893,862,939461.3,909167.55,1848628.85
171620,202002,134,92,42,96140,44935,141075
171630,202002,60,31,29,32395,30305,62700
171650,202002,280,187,93,197505.9,97186.8,294692.7
171660,202002,267,149,118,158840.9,124356.4,283197.3
171665,202002,61,42,19,43890,19855.9,63745.9
171670,202002,418,246,172,258117.95,181832.7,439950.65
171700,202002,65,59,6,61655,7315,68970
171720,202002,27,10,17,10450,17766.8,28216.8
171750,202002,100,53,47,56430,50160,106590
171780,202002,71,57,14,60610,15675,76285
171790,202002,78,67,11,71060,12540,83600
171800,202002,33,25,8,26125,8360,34485
171820,202002,2094,1206,888,1270724.06,934236.35,2204960.41
171830,202002,35,28,7,29260,8360,37620
171840,202002,62,40,22,41800,22990.9,64790.9
171845,202002,30,19,11,19855,11495,31350
171850,202002,38,28,10,29260,10450,39710
171855,202002,76,60,16,62700,16720,79420
171865,202002,7,6,1,6270,1045,7315
171870,202002,30,22,8,22990,9405.9,32395.9
171875,202002,76,53,23,55385,24035,79420
171880,202002,32,20,12,20900,12540,33440
171884,202002,50,27,23,28215,24035,52250
171886,202002,135,54,81,56430,84646.8,141076.8
171888,202002,25,19,6,20900.9,6270,27170.9
171889,202002,20,14,6,14630,6270,20900
171890,202002,55,47,8,49115,8360,57475
171900,202002,37,25,12,27170.9,12540,39710.9
172000,202002,41,32,9,35530,9405,44935
172010,202002,50,39,11,40755,11495,52250
172015,202002,28,18,10,18810.45,10450,29260.45
172020,202002,136,86,50,90915,52250,143165
172025,202002,34,21,13,21945,13585,35530
172030,202002,43,25,18,26125,18810.45,44935.45
172049,202002,79,51,28,54340,30305,84645
172065,202002,139,88,51,91961.8,53295,145256.8
172080,202002,105,70,35,73150,37621.8,110771.8
172085,202002,29,15,14,15675,14630,30305
172090,202002,417,322,95,340670.03,99275,439945.03
172093,202002,17,15,2,15675,2090,17765
172097,202002,19,12,7,12540,7315.4,19855.4
172100,202002,5015,2856,2159,3011711,2280243.6,5291954.6
172110,202002,76,47,29,51206.8,31350,82556.8
172120,202002,1641,1387,254,1463003.91,266475.9,1729479.81
172125,202002,5,4,1,4180,1045,5225
172130,202002,16,12,4,12540,4180.9,16720.9
172208,202002,195,120,75,127490,78375,205865
172210,202002,385,183,202,194370.9,213185,407555.9
210005,202002,2926,1843,1083,1949971.95,1147416.9,3097388.85
210010,202002,165,92,73,96140,76285,172425
210015,202002,39,29,10,30305,10450,40755
210020,202002,342,194,148,203775,155705,359480
210030,202002,321,211,110,222585,117040.45,339625.45
210040,202002,139,111,28,115995,29260,145255
210043,202002,249,185,64,195415,66880,262295
210047,202002,517,303,214,318725,231990,550715
210050,202002,288,209,79,220495,82555,303050
210055,202002,45,35,10,36575,10450,47025
210060,202002,547,438,109,459800,113905.9,573705.9
210070,202002,396,306,90,326040,96140,422180
210080,202002,116,105,11,109725,11495,121220
210083,202002,304,149,155,155705.5,161975,317680.5
210087,202002,2,1,1,1045,1045,2090
210090,202002,444,319,125,335445,134805,470250
210095,202002,440,335,105,352165.9,109725,461890.9
210100,202002,684,534,150,568480,157795,726275
210110,202002,126,79,47,82555,49115,131670
210120,202002,5017,3904,1113,4132979.56,1179806.47,5312786.03
210125,202002,198,120,78,126445,82555,209000
210130,202002,478,271,207,287375,218405.9,505780.9
210135,202002,28,19,9,19855,9405,29260
210140,202002,4315,3379,936,3580170.9,986480.9,4566651.8
210150,202002,374,239,135,254980,142120,397100
210160,202002,3227,2733,494,2901966.81,521455.9,3423422.71
210170,202002,1119,903,216,955130,233035,1188165
210173,202002,123,108,15,112860,16720,129580
210177,202002,366,204,162,215270,172425,387695
210180,202002,32,17,15,17765,15675,33440
210190,202002,416,279,137,292600,145255,437855
210193,202002,2,1,1,1045,1045,2090
210197,202002,78,56,22,58520,24035,82555
210200,202002,615,508,107,536085,115995,652080
210203,202002,228,152,76,163020,80465,243485
210207,202002,368,297,71,313500.9,74195,387695.9
210210,202002,746,691,55,729410,57475,786885
210215,202002,72,65,7,67925,7315,75240
210220,202002,390,331,59,347985,62700,410685
210230,202002,310,247,63,258115,66880,324995
210232,202002,1358,920,438,973940,462935,1436875
210235,202002,169,127,42,133760,44935,178695
210237,202002,36,22,14,22990,14630,37620
210240,202002,88,74,14,78375,14630,93005
210250,202002,181,155,26,163020,27170,190190
210255,202002,351,264,87,277970,91960,369930
210260,202002,391,270,121,284240,127490,411730
210270,202002,634,421,213,449350,226765,676115
210275,202002,71,54,17,57475,17765,75240
210280,202002,1043,687,356,724186.6,373065,1097251.6
210290,202002,531,357,174,377245,183920,561165
210300,202002,5261,3306,1955,3512245.93,2086865.67,5599111.60
210310,202002,110,76,34,79420,35530,114950
210312,202002,116,80,36,83600,38665,122265
210315,202002,102,81,21,84645,22990,107635
210317,202002,127,95,32,99275,33440,132715
210320,202002,2298,1947,351,2064920,375155,2440075
210325,202002,130,87,43,91960.5,44935.5,136896.0
210330,202002,4474,2561,1913,2722225.75,2052380,4774605.75
210340,202002,1248,929,319,980210,341716.84,1321926.84
210350,202002,606,513,93,539220,101365,640585
210355,202002,148,119,29,125400,30305,155705
210360,202002,2214,1519,695,1627065.59,752401.4,2379466.99
210370,202002,1212,591,621,619685,655215,1274900
210375,202002,182,94,88,99275.9,94050,193325.9
210380,202002,695,535,160,565345,170335.9,735680.9
210390,202002,188,161,27,170335,30305,200640
210400,202002,389,337,52,353210,54340,407550
210405,202002,970,677,293,720005,310365,1030370
210407,202002,51,41,10,43890,10450,54340
210408,202002,60,53,7,56430,7315,63745
210409,202002,322,278,44,293645,45980,339625
210410,202002,436,339,97,357390,101365,458755
210420,202002,194,159,35,169290,36575,205865
210430,202002,49,31,18,33440,18810,52250
210440,202002,326,218,108,231990,115995,347985
210450,202002,144,113,31,120175,32395,152570
210455,202002,225,120,105,127490.5,109725,237215.5
210460,202002,306,204,102,215270,107635,322905
210462,202002,63,52,11,55385,11495,66880
210465,202002,141,109,32,113905,35530,149435
210467,202002,521,385,136,402325,144210.45,546535.45
210470,202002,50,43,7,44935,7315,52250
210480,202002,1245,893,352,946770.9,372022.42,1318793.32
210490,202002,204,136,68,143165,72105,215270
210500,202002,499,303,196,318725,207955,526680
210510,202002,549,437,112,461890,121220,583110
210515,202002,366,228,138,240350,151525,391875
210520,202002,397,359,38,376200,43890,420090
210530,202002,9267,4918,4349,5229188.25,4590699.26,9819887.51
210535,202002,125,94,31,100320,35530,135850
210540,202002,1451,952,499,1002155,537130,1539285
210542,202002,1184,612,572,642676.8,598787.8,1241464.6
210545,202002,16,15,1,15675,1045,16720
210547,202002,129,112,17,119130,17765,136895
210550,202002,686,495,191,519365.45,201686.8,721052.25
210560,202002,159,140,19,146300,20900,167200
210565,202002,21,16,5,16720,5225,21945
210570,202002,1295,1040,255,1103521.01,267520,1371041.01
210580,202002,118,101,17,107635,17765,125400
210590,202002,722,591,131,627000,142120,769120
210592,202002,34,31,3,32395,3135,35530
210594,202002,104,89,15,94050,15675,109725
210596,202002,97,81,16,84645,16720,101365
210598,202002,129,94,35,100320,36575,136895
210600,202002,323,277,46,292600,48070,340670
210610,202002,253,238,15,250800.9,16720,267520.9
210620,202002,42,28,14,29260,14630,43890
210630,202002,72,69,3,72105,4180,76285
210632,202002,1012,706,306,741950,324995,1066945
210635,202002,22,19,3,19855,3135,22990
210637,202002,108,78,30,83600,31350,114950
210640,202002,579,510,69,536085,73150,609235
210650,202002,387,324,63,340670,66880,407550
210660,202002,383,295,88,314545,95095,409640
210663,202002,34,23,11,24035,11495,35530
210667,202002,95,36,59,37620,66880,104500
210670,202002,243,217,26,229900,29260,259160
210675,202002,532,297,235,314545,247665,562210
210680,202002,213,142,71,148390,75240,223630
210690,202002,613,508,105,536085,112860,648945
210700,202002,161,122,39,127490,40755,168245
210710,202002,252,159,93,166155,103455,269610
210720,202002,129,116,13,121220,13585,134805
210725,202002,67,59,8,61655,8360,70015
210730,202002,24,17,7,18810,7315,26125
210735,202002,281,197,84,207955,88825.5,296780.5
210740,202002,526,451,75,478610,80465,559075
210745,202002,153,115,38,120175,39710,159885
210750,202002,2334,1188,1146,1250865.25,1218471,2469336.25
210760,202002,250,190,60,201685,64790,266475
210770,202002,375,294,81,313500,86735,400235
210780,202002,439,322,117,342760,125400,468160
210790,202002,182,149,33,157795,34485,192280
210800,202002,170,129,41,134805,42845,177650
210805,202002,51,46,5,48070,5225,53295
210810,202002,455,364,91,390830.9,96140,486970.9
210820,202002,2114,1757,357,1854875.9,377245.9,2232121.8
210825,202002,154,90,64,94050,68970,163020
210830,202002,711,476,235,502645,252890,755535
210840,202002,196,137,59,144210,62700,206910
210845,202002,232,163,69,175560,76285,251845
210850,202002,755,515,240,540265,256025,796290
210860,202002,3665,2072,1593,2197635.25,1706485,3904120.25
210870,202002,432,338,94,361570.9,100320,461890.9
210880,202002,71,55,16,59565,16720,76285
210890,202002,310,267,43,282150.9,44935,327085.9
210900,202002,621,406,215,428450,226766.8,655216.8
210905,202002,63,32,31,33440,33440,66880
210910,202002,1935,1463,472,1549736.96,503690,2053426.96
210920,202002,170,63,107,66880,115995,182875
210923,202002,79,60,19,62700,20900,83600
210927,202002,398,185,213,194370,224675,419045
210930,202002,73,58,15,60610,16720,77330
210940,202002,83,65,18,67925,18810,86735
210945,202002,186,99,87,105545,94050,199595
210950,202002,523,384,139,404415,148390,552805
210955,202002,78,52,26,54340,27170,81510
210960,202002,2134,1071,1063,1133825,1142186.4,2276011.4
210970,202002,111,98,13,103455,13585,117040
210975,202002,80,74,6,78375,6270,84645
210980,202002,1059,512,547,540265,588335.5,1128600.5
210990,202002,4038,2655,1383,2801645.9,1470316.8,4271962.7
211000,202002,1309,1059,250,1116060.5,265430.9,1381491.4
211003,202002,994,704,290,747175,309320,1056495
211010,202002,484,432,52,458755,55385,514140
211020,202002,1421,600,821,635360.9,883025.9,1518386.8
211023,202002,31,29,2,30305,2090,32395
211027,202002,67,49,18,54340,19855,74195
211030,202002,364,256,108,269610,114950,384560
211040,202002,295,245,50,259160.5,52250,311410.5
211050,202002,1134,752,382,793155,410685.5,1203840.5
211060,202002,634,548,86,576840.5,93005.96,669846.46
211065,202002,23,18,5,18810,5225,24035
211070,202002,893,740,153,779571.15,163020,942591.15
211080,202002,85,81,4,85690,4180,89870
211085,202002,54,28,26,29260,27170,56430
211090,202002,89,73,16,76285,17765,94050
211100,202002,485,400,85,419045,88825.5,507870.5
211102,202002,243,170,73,180785,77330,258115
211105,202002,219,154,65,160930,67925,228855
211107,202002,130,81,49,84645,52250,136895
211110,202002,812,527,285,553850,299916.35,853766.35
211120,202002,5221,2596,2625,2759846.5,2808961.3,5568807.8
211125,202002,34,25,9,26125,9405,35530
211130,202002,41424,18955,22469,20042062.9,24009932.51,44051995.41
211140,202002,393,343,50,361570.22,54340,415910.22
211150,202002,1203,800,403,843315,429496.62,1272811.62
211153,202002,172,104,68,109725,71060,180785
211157,202002,64,51,13,53295,13585,66880
211160,202002,692,589,103,621775,107635,729410
211163,202002,0,,,,,0.0
211167,202002,10,9,1,9405,1045,10450
211170,202002,414,310,104,330220,110770,440990
211172,202002,116,79,37,83600,38665,122265
211174,202002,252,155,97,161975,102410,264385
211176,202002,485,359,126,380380.5,132715,513095.5
211178,202002,87,57,30,59565,31350,90915
211180,202002,202,162,40,173470,44935,218405
211190,202002,72,67,5,71060,5225,76285
211195,202002,34,24,10,25080,10450,35530
211200,202002,146,126,20,133760,21945,155705
211210,202002,437,321,116,340670,125400,466070
211220,202002,3992,2327,1665,2462022.97,1768142.62,4230165.59
211223,202002,95,91,4,96140,4180,100320
211227,202002,72,56,16,58520,16720,75240
211230,202002,732,605,127,644765,134806.8,779571.8
211240,202002,396,310,86,326040,91960,418000
211245,202002,184,87,97,93005,102410,195415
211250,202002,1541,1325,216,1400300.22,227810,1628110.22
211260,202002,797,658,139,692835.9,152570,845405.9
211270,202002,1941,1595,346,1680361.4,364705.5,2045066.9
211280,202002,1692,1088,604,1158905,647900,1806805
211285,202002,192,119,73,126445,78375,204820
211290,202002,662,467,195,493240,211090,704330
211300,202002,757,600,157,636405.9,165110,801515.9
211400,202002,1535,950,585,1002156.8,625955,1628111.8
220005,202002,15,14,1,14630,1045,15675
220010,202002,85,66,19,70015,19855,89870
220020,202002,686,544,142,579975,151525,731500
220025,202002,113,110,3,115995,3135,119130
220027,202002,42,34,8,35530,8360,43890
220030,202002,106,88,18,94050,18810,112860
220040,202002,1204,915,289,976030,306185,1282215
220045,202002,32,21,11,21945,11495,33440
220050,202002,671,566,105,598785.61,111815,710600.61
220060,202002,169,149,20,156750,20900,177650
220070,202002,109,100,9,106590,9405,115995
220080,202002,15,13,2,14630,2090,16720
220090,202002,31,26,5,27170,5225,32395
220095,202002,2,1,1,1045,1045,2090
220100,202002,21,16,5,16720,5225,21945
220105,202002,23,21,2,21945.5,2090,24035.5
220110,202002,216,199,17,207955,19855,227810
220115,202002,36,35,1,37620,1045,38665
220117,202002,20,19,1,19855,1045,20900
220120,202002,1456,1111,345,1173535,375155,1548690
220130,202002,31,30,1,31350,1045,32395
220140,202002,98,74,24,80465,25080,105545
220150,202002,484,355,129,373065,135850,508915
220155,202002,6,6,0,6270,0,6270
220157,202002,19,15,4,15675,4180,19855
220160,202002,88,76,12,79420,12540,91960
220170,202002,30,30,0,31350,0,31350
220173,202002,7,7,0,7315,0,7315
220177,202002,6,6,0,6270,0,6270
220180,202002,68,67,1,70015,1045,71060
220190,202002,1047,935,112,981255,117040,1098295
220191,202002,43,38,5,39710,5225,44935
220192,202002,78,75,3,80465,3135,83600
220194,202002,48,46,2,48070,2090,50160
220196,202002,97,81,16,84645,16720,101365
220198,202002,3,2,1,2090,1045,3135
220200,202002,410,341,69,360526.15,74195,434721.15
220202,202002,39,34,5,35530,5225,40755
220205,202002,48,43,5,44935,5225,50160
220207,202002,11,11,0,11495,0,11495
220208,202002,79,41,38,42845,39710,82555
220209,202002,29,26,3,28215,3135,31350
220210,202002,17,14,3,16720,3135,19855
220211,202002,28,26,2,27170,2090,29260
220213,202002,39,35,4,36575,4180.5,40755.5
220217,202002,40,32,8,33440,8360,41800
220220,202002,2153,1408,745,1485990,791066.75,2277056.75
220225,202002,9,4,5,4180,5225,9405
220230,202002,959,754,205,795245,217360,1012605
220240,202002,157,142,15,151525,15675,167200
220245,202002,33,30,3,31350.97,3135,34485.97
220250,202002,121,107,14,112860,14630,127490
220253,202002,42,35,7,36575,7315,43890
220255,202002,28,26,2,28215,2090,30305
220260,202002,691,515,176,542355,184965,727320
220265,202002,9,7,2,7315,2090,9405
220270,202002,742,668,74,706420,78375,784795
220271,202002,38,31,7,32395,7315,39710
220272,202002,24,24,0,25080,0,25080
220273,202002,17,15,2,15675,2090,17765
220275,202002,57,47,10,49115,10450,59565
220277,202002,14,12,2,12540,2090,14630
220280,202002,16,13,3,13585,3135,16720
220285,202002,44,41,3,42845,3135,45980
220290,202002,1454,1247,207,1317746,218405.25,1536151.25
220300,202002,33,32,1,36575,1045,37620
220310,202002,317,270,47,283195.22,49115,332310.22
220320,202002,444,411,33,430540.5,34485,465025.5
220323,202002,0,,,,,0.0
220325,202002,12,11,1,11495,1045,12540
220327,202002,13,11,2,11495,2090,13585
220330,202002,225,164,61,172425,63745,236170
220335,202002,137,120,17,125400,17765,143165
220340,202002,40,26,14,27170,14630,41800
220342,202002,57,50,7,52250,7315,59565
220345,202002,81,74,7,77330,7315,84645
220350,202002,438,383,55,400235,57475,457710
220360,202002,42,31,11,32395,12540,44935
220370,202002,1206,995,211,1047090,222585,1269675
220375,202002,21,19,2,19855,2090,21945
220380,202002,19,16,3,16720,3135,19855
220385,202002,15,13,2,13585,2090,15675
220390,202002,2309,1315,994,1379017.43,1048137.55,2427154.98
220400,202002,32,28,4,29260,4180,33440
220410,202002,19,17,2,17765,2090,19855
220415,202002,12,11,1,11495,1045,12540
220420,202002,125,105,20,109725,21945,131670
220430,202002,126,114,12,121220,12540,133760
220435,202002,23,16,7,16720,7315,24035
220440,202002,289,246,43,258115,44935,303050
220450,202002,326,167,159,177650,166155.9,343805.9
220455,202002,53,52,1,54340,1045,55385
220460,202002,20,19,1,20900,1045,21945
220465,202002,95,64,31,66880,32395,99275
220470,202002,238,209,29,221540,31350,252890
220480,202002,71,63,8,65835,8360,74195
220490,202002,88,75,13,79420,13585,93005
220500,202002,105,91,14,96140,14630,110770
220510,202002,416,324,92,343805,97185,440990
220515,202002,22,20,2,20900,2090,22990
220520,202002,366,329,37,358435.85,38665,397100.85
220525,202002,10,7,3,7315,3135,10450
220527,202002,19,13,6,13585,6270,19855
220530,202002,31,13,18,13585,18810,32395
220535,202002,4,4,0,4180,0,4180
220540,202002,64,53,11,56430,11495,67925
220545,202002,41,27,14,28215,14630,42845
220550,202002,680,538,142,566390,151525,717915
220551,202002,12,9,3,9405,3135,12540
220552,202002,14,14,0,14630,0,14630
220553,202002,53,48,5,50160,5225,55385
220554,202002,10,8,2,8360,2090,10450
220555,202002,32,29,3,30305,3135,33440
220556,202002,46,43,3,45980,3135,49115
220557,202002,56,53,3,55385,3135,58520
220558,202002,8,3,5,3135,5225,8360
220559,202002,2,2,0,2090,0,2090
220560,202002,67,45,22,47025,22990,70015
220570,202002,750,459,291,489060.5,311410,800470.5
220580,202002,545,503,42,527725,44935,572660
220585,202002,7,6,1,6270,1045,7315
220590,202002,14,14,0,14630,0,14630
220595,202002,62,47,15,49115,15675,64790
220600,202002,18,11,7,12540,7315,19855
220605,202002,25,23,2,24035,2090,26125
220610,202002,73,64,9,66880,9405,76285
220620,202002,546,451,95,476520,101365.9,577885.9
220630,202002,5,4,1,4180,1045,5225
220635,202002,36,32,4,33440,4180,37620
220640,202002,105,87,18,90915,19855,110770
220650,202002,112,107,5,111815,5225,117040
220660,202002,50,39,11,40755,11495,52250
220665,202002,4,4,0,4180,0,4180
220667,202002,19,17,2,17765,2090,19855
220669,202002,27,24,3,25080,3135,28215
220670,202002,63,51,12,53295,12540,65835
220672,202002,65,43,22,48070,22990,71060
220675,202002,34,27,7,28215,7315,35530
220680,202002,37,31,6,34485,6270,40755
220690,202002,46,43,3,44935,3135,48070
220695,202002,35,18,17,18810,17765,36575
220700,202002,1682,1306,376,1378355,396055,1774410
220710,202002,4,3,1,3135,1045,4180
220720,202002,104,87,17,93005,17765,110770
220730,202002,15,15,0,15675,0,15675
220735,202002,5,1,4,1045,4180,5225
220740,202002,47,43,4,45980,4180,50160
220750,202002,109,92,17,97185,18810,115995
220755,202002,14,13,1,13585,1045,14630
220760,202002,65,60,5,63745,5225,68970
220770,202002,5481,2983,2498,3145452.26,2641760.94,5787213.20
220775,202002,17,10,7,10450,7315,17765
220777,202002,18,17,1,17765,1045,18810
220779,202002,0,0,0,0,0,0
220780,202002,887,760,127,795245,132715.5,927960.5
220785,202002,4,1,3,1045,3135,4180
220790,202002,1070,854,216,902880.05,229900,1132780.05
220793,202002,7,6,1,6270,1045,7315
220795,202002,14,13,1,13585,1045,14630
220800,202002,3967,3044,923,3208151.25,981256.12,4189407.37
220810,202002,65,58,7,60610.5,7315,67925.5
220820,202002,238,217,21,229900,21945,251845
220830,202002,1202,1036,166,1096205,176605,1272810
220840,202002,2380,1661,719,1766052.09,764940.95,2530993.04
220850,202002,53,43,10,44935,10450,55385
220855,202002,8,5,3,5225,3135,8360
220860,202002,14,12,2,12540,2090,14630
220865,202002,31,29,2,31350,2090,33440
220870,202002,73,65,8,68970,8360,77330
220880,202002,311,247,64,264385,67925,332310
220885,202002,33,30,3,31350,3135,34485
220887,202002,12,12,0,12540,0,12540
220890,202002,96,85,11,89870,11495,101365
220900,202002,19,12,7,12540,7315,19855
220910,202002,53,45,8,47025,8360,55385
220915,202002,10,9,1,9405,2090,11495
220920,202002,51,47,4,49115,4180,53295
220930,202002,41,40,1,41800,1045,42845
220935,202002,15,15,0,15675,0,15675
220937,202002,35,34,1,35530,1045,36575
220940,202002,56,52,4,54340,4180,58520
220945,202002,1,1,0,1045,0,1045
220950,202002,44,38,6,39710,6270,45980
220955,202002,22,21,1,21945,1045,22990
220960,202002,12,11,1,11495,1045,12540
220965,202002,37,33,4,34485,4180,38665
220970,202002,58,48,10,50160,11495,61655
220975,202002,13,10,3,10450,3135,13585
220980,202002,28,26,2,29260,2090,31350
220985,202002,64,57,7,59565,7315,66880
220987,202002,29,27,2,28215,2090,30305
220990,202002,18,17,1,17765,1045,18810
220995,202002,18,14,4,14630,4180,18810
220997,202002,62,51,11,54340,11495,65835
221000,202002,1170,1058,112,1110835,119130,1229965
221005,202002,53,47,6,51205,6270,57475
221010,202002,16,12,4,12540,4180,16720
221020,202002,39,37,2,38665,2090,40755
221030,202002,35,28,7,29260,7315,36575
221035,202002,23,23,0,24035,0,24035
221037,202002,12,8,4,8360,4180,12540
221038,202002,25,22,3,22990,3135,26125
221039,202002,21,21,0,21945,0,21945
221040,202002,246,213,33,228855.9,34485,263340.9
221050,202002,226,193,33,204820,35530,240350
221060,202002,1847,1618,229,1698125,240350,1938475
221062,202002,33,33,0,34485,0,34485
221063,202002,13,9,4,9405,4180,13585
221065,202002,56,46,10,48070,10450,58520
221070,202002,139,120,19,126445,19855,146300
221080,202002,373,323,50,340670,52250.9,392920.9
221090,202002,28,26,2,27170,2090,29260
221093,202002,49,33,16,34485,16720,51205
221095,202002,7,7,0,7315,0,7315
221097,202002,13,10,3,10450,3135,13585
221100,202002,24806,14708,10098,15542293.31,10681993.6,26224286.91
221110,202002,1060,798,262,843315,277970,1121285
221120,202002,523,386,137,410685.5,144210,554895.5
221130,202002,961,785,176,826595,184965,1011560
221135,202002,34,31,3,32395,3135,35530
221140,202002,42,36,6,37620,6270,43890
221150,202002,12,10,2,10450,3135,13585
221160,202002,13,13,0,13585,0,13585
221170,202002,15,15,0,15675,0,15675
230010,202002,164,150,14,156750,14630,171380
230015,202002,124,101,23,107635,25080,132715
230020,202002,1614,1370,244,1437920.5,259164.69,1697085.19
230030,202002,1674,1205,469,1267586.45,491150,1758736.45
230040,202002,217,187,30,195415.5,31350,226765.5
230050,202002,225,167,58,176605,60610,237215
230060,202002,160,129,31,135850,33440,169290
230070,202002,292,254,38,266475,39710,306185
230075,202002,829,718,111,758671.5,115995,874666.5
230080,202002,196,168,28,175560,29260,204820
230090,202002,122,86,36,93005,37620,130625
230100,202002,2101,1213,888,1284306,934230,2218536
230110,202002,2811,1821,990,1922801,1046045.5,2968846.5
230120,202002,971,765,206,813010,217360,1030370
230125,202002,151,127,24,133760,26125,159885
230130,202002,471,424,47,446215,51205,497420
230140,202002,220,184,36,195415,38665,234080
230150,202002,148,114,34,120175,36575,156750
230160,202002,935,794,141,837045.5,147345,984390.5
230170,202002,601,546,55,574750.5,57475,632225.5
230180,202002,74,69,5,72105,5225,77330
230185,202002,401,345,56,361570,58520,420090
230190,202002,2290,1832,458,1931160.37,483835,2414995.37
230195,202002,486,424,62,444125,64790,508915
230200,202002,390,334,56,351120,59565,410685
230205,202002,395,262,133,273790,141075,414865
230210,202002,1346,1049,297,1102475.38,311410,1413885.38
230220,202002,1536,1043,493,1099340.5,523545,1622885.5
230230,202002,902,775,127,815100,133760,948860
230240,202002,1715,1480,235,1556268.25,247665,1803933.25
230250,202002,1788,1476,312,1552870.45,328130,1881000.45
230260,202002,3175,1982,1193,2078505,1264450,3342955
230270,202002,1353,1098,255,1155771.38,268566.4,1424337.78
230280,202002,2715,2043,672,2153745,710600.5,2864345.5
230290,202002,404,361,43,377245.72,45980,423225.72
230300,202002,509,378,131,399190,138985,538175
230310,202002,420,315,105,334400,109725,444125
230320,202002,920,789,131,828686,138985,967671
230330,202002,310,250,60,261250,62700,323950
230340,202002,444,361,83,381425,86735,468160
230350,202002,3119,1978,1141,2084775,1199660,3284435
230360,202002,275,222,53,233035,55385,288420
230365,202002,133,111,22,118085,22990,141075
230370,202002,9976,4878,5098,5137224.36,5381751.22,10518975.58
230380,202002,469,405,64,426360.5,68970,495330.5
230390,202002,535,301,234,315590,245575,561165
230393,202002,243,201,42,215270,43890,259160
230395,202002,353,283,70,298870.7,74195,373065.7
230400,202002,606,482,124,511005,129580,640585
230410,202002,2698,1685,1013,1779635.97,1070080.5,2849716.47
230420,202002,6261,4165,2096,4383777.82,2205996.9,6589774.72
230423,202002,325,284,41,298870,42845,341715
230425,202002,415,341,74,357390.85,78375,435765.85
230426,202002,120,97,23,102410,24035,126445
230427,202002,76,74,2,78375,2090,80465
230428,202002,1476,745,731,790020.9,770165,1560185.9
230430,202002,456,373,83,391875.22,86735,478610.22
230435,202002,887,634,253,663575,265430.77,929005.77
230440,202002,87760,38975,48785,41150028.95,51496575.92,92646604.87
230445,202002,304,214,90,225720,94050,319770
230450,202002,542,432,110,453530,114950,568480
230460,202002,64,51,13,55385,14630,70015
230465,202002,309,253,56,265430,59565,324995
230470,202002,1980,1566,414,1642740,433675.25,2076415.25
230480,202002,160,151,9,158840,9405,168245
230490,202002,297,236,61,247665,63745,311410
230495,202002,448,331,117,347985,123310,471295
230500,202002,1009,746,263,782705,275880,1058585
230510,202002,59,46,13,48070,13585,61655
230520,202002,377,299,78,314545,82555,397100
230523,202002,2282,1437,845,1510025,890340.5,2400365.5
230526,202002,266,226,40,237215,42845,280060
230530,202002,678,507,171,536085,178695,714780
230533,202002,197,185,12,194370,13585,207955
230535,202002,367,273,94,290510,98230,388740
230540,202002,1793,1583,210,1665730,223630,1889360
230550,202002,3776,2435,1341,2555027.66,1415975.67,3971003.33
230560,202002,580,440,140,461890,146300,608190
230565,202002,226,165,61,173470,63745,237215
230570,202002,285,252,33,267520,34485,302005
230580,202002,1154,847,307,896610,322905,1219515
230590,202002,990,776,214,817190.25,224675,1041865.25
230600,202002,242,219,23,230945,24035,254980
230610,202002,370,286,84,299915,87780,387695
230620,202002,181,151,30,159885.5,31350,191235.5
230625,202002,753,530,223,561165.25,235125,796290.25
230630,202002,1329,1045,284,1103520,299915,1403435
230640,202002,3708,3178,530,3354451,556987.07,3911438.07
230650,202002,447,385,62,403370.67,65835,469205.67
230655,202002,676,579,97,609235.67,102411.79,711647.46
230660,202002,358,299,59,315590,61655,377245
230670,202002,433,377,56,393965,58520,452485
230680,202002,203,185,18,193325,19855,213180
230690,202002,906,773,133,813010,138985,951995
230700,202002,813,684,129,720005,134805.5,854810.5
230710,202002,691,658,33,702240,35530,737770
230720,202002,153,135,18,141075,19855,160930
230725,202002,259,212,47,223630,49115.45,272745.45
230730,202002,12077,6597,5480,6945073.27,5789305.16,12734378.43
230740,202002,674,544,130,573705.5,135850.5,709556.0
230750,202002,817,690,127,730455,133760,864215
230760,202002,1394,1198,196,1259225.9,204820,1464045.9
230763,202002,322,267,55,280060,57475,337535
230765,202002,7336,3387,3949,3581215.51,4176866.75,7758082.26
230770,202002,5089,2579,2510,2707597.09,2640716.17,5348313.26
230780,202002,714,625,89,658350.5,93005,751355.5
230790,202002,273,230,43,240350,45980,286330
230800,202002,1123,815,308,864215,323950,1188165
230810,202002,1339,1185,154,1255045,163020,1418065
230820,202002,355,247,108,260205.5,112860,373065.5
230830,202002,955,821,134,862125,142120,1004245
230835,202002,274,240,34,250800,35530,286330
230837,202002,162,137,25,146300,29260,175560
230840,202002,909,722,187,757625.5,196460.5,954086.0
230850,202002,1472,1279,193,1348050,202730,1550780
230860,202002,295,221,74,230945,77330,308275
230870,202002,1802,1539,263,1627065,277970,1905035
230880,202002,62,46,16,48070,16720,64790
230890,202002,534,493,41,518320,43890.67,562210.67
230900,202002,280,208,72,218405,75240.31,293645.31
230910,202002,213,168,45,180785,47025,227810
230920,202002,429,339,90,356345,94050,450395
230930,202002,964,682,282,725230.2,295735,1020965.2
230940,202002,850,666,184,704330,194370,898700
230945,202002,511,422,89,440990.5,95095,536085.5
230950,202002,408,353,55,375155,58520,433675
230960,202002,2641,1776,865,1871595.45,915421.4,2787016.85
230970,202002,1723,960,763,1010515.9,808830,1819345.9
230980,202002,204,169,35,178695,36575,215270
230990,202002,138,113,25,119130,26125,145255
231000,202002,207,188,19,197505,19855,217360
231010,202002,145,110,35,114950,36575,151525
231020,202002,1333,929,404,982300.75,430540,1412840.75
231025,202002,1054,787,267,825550,282150.5,1107700.5
231030,202002,1094,915,179,965581.12,188100,1153681.12
231040,202002,136,94,42,98230,44935,143165
231050,202002,947,840,107,883025,112860,995885
231060,202002,152,127,25,134805,26125,160930
231070,202002,1477,1030,447,1085756.65,468160,1553916.65
231080,202002,256,238,18,250800,19855,270655
231085,202002,603,363,240,381425,251845,633270
231090,202002,242,199,43,207955,45980,253935
231095,202002,166,130,36,137940,37620,175560
231100,202002,144,122,22,127490,24035,151525
231110,202002,361,311,50,326040,52250,378290
231120,202002,269,228,41,240350,42845,283195
231123,202002,148,141,7,147345,7315,154660
231126,202002,329,257,72,270655.5,75240,345895.5
231130,202002,4583,3579,1004,3769315.5,1058586.17,4827901.67
231135,202002,209,181,28,190190,29260,219450
231140,202002,3047,2242,805,2363790,844360,3208150
231150,202002,363,345,18,361570,18810,380380
231160,202002,1188,940,248,988570,263340,1251910
231170,202002,518,358,160,378290,170335,548625
231180,202002,1654,1413,241,1499575,257070,1756645
231190,202002,205,172,33,180785,34485,215270
231195,202002,212,182,30,194370,31350,225720
231200,202002,798,653,145,688655.9,152570,841225.9
231210,202002,576,484,92,511005,97185,608190
231220,202002,1040,762,278,801515.75,291555,1093070.75
231230,202002,1452,1152,300,1209065,313500,1522565
231240,202002,1445,1035,410,1092025,432630,1524655
231250,202002,111,102,9,107635,9405,117040
231260,202002,273,179,94,189145,100320,289465
231270,202002,1002,821,181,869441.04,190190,1059631.04
231280,202002,73,56,17,58520,18810,77330
231290,202002,7528,4218,3310,4448565.66,3501796.44,7950362.10
231300,202002,606,562,44,594605,45980,640585
231310,202002,740,685,55,716870.56,57475.9,774346.46
231320,202002,581,440,141,465026.5,148390,613416.5
231325,202002,95,84,11,88825,11495,100320
231330,202002,2002,1554,448,1634644.9,472340.5,2106985.4
231335,202002,250,222,28,236170,29260,265430
231340,202002,1709,1260,449,1324015,471295,1795310
231350,202002,1280,1051,229,1107700,242441,1350141
231355,202002,434,372,62,389785,64790,454575
231360,202002,504,374,130,392920.86,135850,528770.86
231370,202002,88,76,12,79420,12540,91960
231375,202002,285,207,78,219450,81510,300960
231380,202002,483,392,91,411730,95095,506825
231390,202002,200,159,41,167200,43890,211090
231395,202002,729,454,275,476520,288420,764940
231400,202002,1113,925,188,974986.59,197506.84,1172493.43
231410,202002,1302,1068,234,1127555,244530,1372085
240010,202002,391,174,217,181830.67,226765.45,408596.12
240020,202002,2275,1827,448,1923846.68,472340.67,2396187.35
240030,202002,116,99,17,104500,17765,122265
240040,202002,31,31,0,32395,0,32395
240050,202002,529,454,75,477565,79420,556985
240060,202002,63,58,5,61655,5225,66880
240070,202002,216,168,48,177650,50160,227810
240080,202002,507,345,162,363660.22,171380.01,535040.23
240090,202002,106,95,11,99275,11495,110770
240100,202002,1496,1417,79,1489125.25,82555,1571680.25
240110,202002,1046,688,358,722096.85,378290.75,1100387.60
240120,202002,126,104,22,108680,24035,132715
240130,202002,276,255,21,269610,21945,291555
240140,202002,76,57,19,59565,19855,79420
240145,202002,729,652,77,684475,81510,765985
240150,202002,22,16,6,16720,6270,22990
240160,202002,40,35,5,36575,5225,41800
240165,202002,34,26,8,27170.25,8360,35530.25
240170,202002,99,75,24,78375,25080,103455
240180,202002,84,69,15,73150,15675,88825
240185,202002,41,38,3,39710,3135,42845
240190,202002,15,13,2,13585,2090,15675
240200,202002,3065,1716,1349,1812032.5,1421200.5,3233233.0
240210,202002,170,133,37,138985,38665,177650
240220,202002,1105,803,302,842270.75,318725,1160995.75
240230,202002,841,776,65,818236.65,68970,887206.65
240240,202002,71,51,20,53295,20900,74195
240250,202002,88,76,12,80465,12540,93005
240260,202002,1790,1332,458,1407615,486970,1894585
240270,202002,186,164,22,172425,22990,195415
240280,202002,42,34,8,35530,8360,43890
240290,202002,50,49,1,51205,1045,52250
240300,202002,167,96,71,103455,76285,179740
240310,202002,2295,1275,1020,1340735.98,1077395.85,2418131.83
240320,202002,186,176,10,187055,10450,197505
240325,202002,4440,2668,1772,2814187.53,1870550.92,4684738.45
240330,202002,70,66,4,71060,4180,75240
240340,202002,65,41,24,42845,25080,67925
240350,202002,99,87,12,91960,12540,104500
240360,202002,539,345,194,362615,204820,567435
240370,202002,49,45,4,47025,4180,51205
240375,202002,66,39,27,40755,28215,68970
240380,202002,225,187,38,197505,39710.5,237215.5
240390,202002,12,11,1,12540,1045,13585
240400,202002,82,76,6,81510,6270,87780
240410,202002,11,7,4,7315,5225,12540
240420,202002,978,726,252,765985,264385,1030370
240430,202002,259,242,17,256025,17765,273790
240440,202002,112,63,49,65835,51205,117040
240450,202002,218,150,68,157795.5,72105,229900.5
240460,202002,63,47,16,51205,16720,67925
240470,202002,233,206,27,216315,28215,244530
240480,202002,15,13,2,13585,2090,15675
240485,202002,78,65,13,67925,13585,81510
240490,202002,45,43,2,45980,2090,48070
240500,202002,82,63,19,65835,19855,85690
240510,202002,43,32,11,33440,11495,44935
240520,202002,115,111,4,117040,5225,122265
240530,202002,51,46,5,50160,5225,55385
240540,202002,77,65,12,68970,12540,81510
240550,202002,13,12,1,12540,1045,13585
240560,202002,372,271,101,286330.5,105545,391875.5
240570,202002,447,285,162,298870,170335.5,469205.5
240580,202002,1284,1021,263,1075305.25,274835.22,1350140.47
240590,202002,29,27,2,29260,2090,31350
240600,202002,108,104,4,108680,4180,112860
240610,202002,513,432,81,452486.4,84645,537131.4
240615,202002,19,18,1,18810,1045,19855
240620,202002,88,84,4,87780,4180,91960
240630,202002,38,33,5,34485,5225,39710
240640,202002,24,20,4,20900,4180,25080
240650,202002,237,198,39,209000,41800,250800
240660,202002,107,93,14,97185,14630,111815
240670,202002,300,176,124,184965.75,129580,314545.75
240680,202002,50,38,12,39710,12540,52250
240690,202002,46,43,3,45980,3135,49115
240700,202002,181,151,30,159885,33440,193325
240710,202002,1987,1241,746,1310430.75,790020,2100450.75
240720,202002,1058,786,272,829730,285285,1115015
240725,202002,64,59,5,61655,5225,66880
240730,202002,143,125,18,131670,18810,150480
240740,202002,232,199,33,209000,34485.85,243485.85
240750,202002,49,25,24,26125,26125,52250
240760,202002,45,41,4,44935,4180,49115
240770,202002,145,111,34,117040,35530,152570
240780,202002,683,558,125,599830,133760.9,733590.9
240790,202002,40,38,2,40755,2090,42845
240800,202002,9121,6210,2911,6555294.05,3067079.1,9622373.15
240810,202002,20156,10976,9180,11581750.13,9694475.1,21276225.23
240820,202002,235,139,96,146300.99,100320,246620.99
240830,202002,1628,1338,290,1405525.75,306185,1711710.75
240840,202002,77,68,9,73150,9405,82555
240850,202002,86,76,10,79420,10450,89870
240860,202002,108,103,5,107635,5225,112860
240870,202002,59,51,8,53295,8360,61655
240880,202002,31,27,4,28215,4180,32395
240890,202002,1108,645,463,677160.4,489060.22,1166220.62
240895,202002,57,36,21,38665,21945,60610
240910,202002,158,142,16,150480,16720,167200
240920,202002,13,10,3,10450,3135,13585
240930,202002,413,370,43,387695,44935,432630
240933,202002,41,29,12,30305,12540,42845
240940,202002,2391,2122,269,2234210.45,282150.9,2516361.35
240950,202002,44,41,3,42845,3135,45980
240960,202002,26,22,4,22990,4180,27170
240970,202002,111,83,28,86735,30305,117040
240980,202002,195,156,39,165110,40755,205865
240990,202002,126,84,42,88825,43890,132715
241000,202002,61,57,4,59565,4180,63745
241010,202002,68,54,14,56430,14630,71060
241020,202002,114,106,8,110770,8360,119130
241025,202002,10,4,6,4180,6270,10450
241030,202002,106,87,19,91960,20900,112860
241040,202002,42,30,12,31350,12540,43890
241050,202002,81,73,8,76285,8360,84645
241060,202002,29,24,5,25080,5225,30305
241070,202002,16,16,0,16720,0,16720
241080,202002,61,54,7,56430,7315,63745
241090,202002,57,47,10,49115.67,11495.67,60611.34
241100,202002,74,63,11,65835,11495,77330
241105,202002,5,1,4,1045,4180,5225
241110,202002,45,43,2,44935,2090,47025
241120,202002,1464,1116,348,1172491.4,365750,1538241.4
241140,202002,218,181,37,190190.5,39710,229900.5
241142,202002,40,35,5,36575,5225,41800
241150,202002,1171,1028,143,1083665,151525,1235190
241160,202002,20,18,2,20900,2090,22990
241170,202002,43,37,6,38665,6270,44935
241180,202002,43,37,6,38665,6270,44935
241190,202002,37,36,1,37620,1045,38665
241200,202002,3815,2006,1809,2119262.06,1905035.22,4024297.28
241210,202002,69,59,10,61655,10450,72105
241220,202002,1408,954,454,1005291.57,481746.57,1487038.14
241230,202002,238,201,37,212135.9,39710,251845.9
241240,202002,53,43,10,44935,11495,56430
241250,202002,1144,1051,93,1109791.4,98230,1208021.4
241255,202002,51,41,10,42845,10450,53295
241260,202002,667,521,146,545490,153615,699105
241270,202002,60,40,20,41800,20900,62700
241280,202002,94,82,12,86735,13585,100320
241290,202002,121,87,34,91960,35530,127490
241300,202002,75,55,20,57475,21945,79420
241310,202002,51,37,14,38665.75,14630,53295.75
241320,202002,28,16,12,16720,12540,29260
241330,202002,59,55,4,57475,4180,61655
241335,202002,72,64,8,66880,8360,75240
241340,202002,179,133,46,140030,49115,189145
241350,202002,59,50,9,52250,9405,61655
241355,202002,48,42,6,43890,6270,50160
241360,202002,51,50,1,53295,1045,54340
241370,202002,49,41,8,42845,8360,51205
241380,202002,37,33,4,34485,4180,38665
241390,202002,82,64,18,68970,18810,87780
241400,202002,217,176,41,187055,42845,229900
241410,202002,185,167,18,175560,19855,195415
241415,202002,101,81,20,84645,20900,105545
241420,202002,103,73,30,76285,31350.1,107635.1
241430,202002,28,25,3,26125,3135,29260
241440,202002,535,432,103,454579.27,108680,563259.27
241445,202002,34,32,2,34485,2090,36575
241450,202002,283,233,50,245575,52250,297825
241460,202002,138,124,14,129580.25,14630,144210.25
241470,202002,39,33,6,34485,6270,40755
241475,202002,56,53,3,55385,3135,58520
241480,202002,87,63,24,67925,25080,93005
241490,202002,11,10,1,10450,1045,11495
241500,202002,46,35,11,36575,11495,48070
250010,202002,99,84,15,88825,16720,105545
250020,202002,32,29,3,31350,3135,34485
250030,202002,849,640,209,676115,218405,894520
250040,202002,363,298,65,315590,70015,385605
250050,202002,249,204,45,214225.22,47025,261250.22
250053,202002,53,39,14,42845,14630,57475
250057,202002,1,1,0,1045,0,1045
250060,202002,551,403,148,423225,155705,578930
250070,202002,699,557,142,589380.1,149435,738815.1
250073,202002,8,8,0,8360,0,8360
250077,202002,183,140,43,146300,44935,191235
250080,202002,425,331,94,349030.3,100320,449350.3
250090,202002,211,137,74,143165,77330,220495
250100,202002,510,421,89,447260,95095,542355
250110,202002,592,456,136,480700,142120,622820
250115,202002,21,7,14,7315,14630,21945
250120,202002,120,85,35,89870,36575,126445
250130,202002,566,465,101,486970,108680,595650
250135,202002,18,11,7,11495,7315,18810
250140,202002,83,74,9,77330,9405,86735
250150,202002,585,423,162,448305,169290,617595
250153,202002,9,6,3,6270,3135,9405
250157,202002,30,23,7,24035,7315,31350
250160,202002,226,176,50,183920,52250,236170
250170,202002,63,40,23,41800,24035,65835
250180,202002,4158,2846,1312,3007511.9,1386716.12,4394228.02
250190,202002,838,550,288,581020,302005.25,883025.25
250200,202002,48,41,7,42845,7315,50160
250205,202002,23,20,3,20900,3135,24035
250210,202002,85,75,10,79420,10450,89870
250215,202002,64,53,11,57475,11495,68970
250220,202002,24,18,6,18810,6270,25080
250230,202002,77,71,6,74195.22,6270,80465.22
250240,202002,230,191,39,201685,40755,242440
250250,202002,389,337,52,362615,55385,418000
250260,202002,43,37,6,38665,6270,44935
250270,202002,66,48,18,51205,18810,70015
250280,202002,383,317,66,335445,71060,406505
250290,202002,90,82,8,86735,8360,95095
250300,202002,549,373,176,392920,187055.67,579975.67
250310,202002,47,43,4,44935,4180,49115
250320,202002,1927,1309,618,1386716.3,656260.95,2042977.25
250330,202002,97,82,15,85690,15675,101365
250340,202002,25,23,2,24035,2090,26125
250350,202002,162,106,56,110770,58520,169290
250355,202002,32,24,8,25080,8360,33440
250360,202002,200,163,37,171380,39710,211090
250370,202002,2339,1571,768,1672000,810920,2482920
250375,202002,9,5,4,5225,4180,9405
250380,202002,58,42,16,43890,16720,60610
250390,202002,43,33,10,34485,10450,44935
250400,202002,16149,8168,7981,8632733.26,8427927.85,17060661.11
250403,202002,327,268,59,282150,61655,343805
250407,202002,58,48,10,50160,10450,60610
250410,202002,30,26,4,27170,4180,31350
250415,202002,37,25,12,26125,13585,39710
250420,202002,44,38,6,39710,6270,45980
250430,202002,1451,1250,201,1314871.25,211090,1525961.25
250435,202002,17,13,4,13585,5225,18810
250440,202002,672,562,110,592515,114950,707465
250450,202002,82,68,14,71060,15675,86735
250460,202002,459,309,150,326040,158840,484880
250470,202002,90,64,26,66880,28215,95095
250480,202002,322,258,64,270655,68970,339625
250485,202002,1,1,0,1045,0,1045
250490,202002,226,182,44,192280,45980,238260
250500,202002,86,65,21,67925,21945,89870
250510,202002,744,590,154,620730,160930,781660
250520,202002,178,121,57,128535,59565,188100
250523,202002,113,92,21,97185,21945,119130
250527,202002,100,79,21,84645,21945,106590
250530,202002,9,5,4,5225,4180,9405
250535,202002,28,21,7,21945,7315,29260
250540,202002,132,103,29,108680,30305,138985
250550,202002,72,69,3,72105,3135,75240
250560,202002,48,35,13,37620,13585,51205
250570,202002,162,134,28,141075,29260,170335
250580,202002,109,84,25,88892,27170,116062
250590,202002,23,15,8,15675,9405,25080
250600,202002,1357,898,459,947816.46,482790,1430606.46
250610,202002,155,130,25,136895,26125,163020
250620,202002,23,18,5,18810,5225,24035
250625,202002,71,52,19,54340,19855,74195
250630,202002,2990,1910,1080,2021034.74,1146366.76,3167401.50
250640,202002,215,172,43,181830,44935,226765
250650,202002,28,20,8,20900,8360,29260
250660,202002,49,38,11,39710,11495,51205
250670,202002,63,42,21,44935,21945,66880
250680,202002,395,322,73,341715,77330,419045
250690,202002,1983,1371,612,1437922.97,643720,2081642.97
250700,202002,936,814,122,857945.25,128535,986480.25
250710,202002,431,338,93,353210,97185,450395
250720,202002,112,85,27,88825,28215,117040
250730,202002,380,318,62,333355,64790,398145
250740,202002,52,48,4,50160,4180,54340
250750,202002,21761,13164,8597,13919295.79,9129122.74,23048418.53
250760,202002,92,75,17,78375,17765,96140
250770,202002,355,231,124,245575.6,130625,376200.6
250780,202002,65,45,20,47025,20900,67925
250790,202002,456,300,156,316635,166155,482790
250800,202002,148,136,12,142120,12540,154660
250810,202002,79,60,19,62700,19855,82555
250820,202002,151,127,24,132715,26125,158840
250830,202002,428,292,136,309320.5,145255,454575.5
250840,202002,53,48,5,50160,5225,55385
250850,202002,57,48,9,50160,9405,59565
250855,202002,13,11,2,11495,2090,13585
250860,202002,203,140,63,148390,67925,216315
250870,202002,28,24,4,26125,4180,30305
250880,202002,78,59,19,64790,19855,84645
250890,202002,2764,2074,690,2185095,726275,2911370
250900,202002,49,41,8,42845,8360,51205
250905,202002,117,91,26,96140,27170,123310
250910,202002,1132,822,310,863170.22,326040,1189210.22
250915,202002,105,75,30,78375,31350,109725
250920,202002,135,100,35,105545,36575,142120
250930,202002,161,97,64,102410,67925,170335
250933,202002,3,2,1,2090,1045,3135
250937,202002,9,8,1,8360,1045,9405
250939,202002,35,26,9,27170,9405,36575
250940,202002,104,79,25,83600,26125,109725
250950,202002,70,48,22,50160,24035,74195
250960,202002,86,47,39,51205,40755,91960
250970,202002,1222,867,355,913330.9,375155,1288485.9
250980,202002,101,69,32,73150,33440,106590
250990,202002,165,126,39,133760,40755,174515
251000,202002,74,68,6,72105,6270,78375
251010,202002,111,83,28,86735.22,29260,115995.22
251020,202002,76,62,14,66880,14630,81510
251030,202002,44,34,10,35530,11495,47025
251040,202002,53,37,16,40755,16720,57475
251050,202002,23,21,2,21945,2090,24035
251060,202002,50,39,11,40755,11495,52250
251065,202002,4,4,0,4180,0,4180
251070,202002,20,16,4,16720.45,4180,20900.45
251080,202002,4941,2373,2568,2503829.75,2709688.14,5213517.89
251090,202002,188,162,26,173470,28215,201685
251100,202002,18,18,0,18810,0,18810
251110,202002,45,36,9,37620,9405,47025
251120,202002,1853,1139,714,1195482.5,750310.2,1945792.7
251130,202002,391,318,73,333355,76285,409640
251140,202002,554,360,194,379335,203775,583110
251150,202002,329,283,46,296780.45,48070,344850.45
251160,202002,93,75,18,79420.22,18810,98230.22
251170,202002,102,82,20,86735.22,20900,107635.22
251180,202002,287,175,112,183920.22,117040.22,300960.44
251190,202002,198,130,68,135850,71060,206910
251200,202002,263,216,47,229900,49115,279015
251203,202002,35,33,2,34485,2090,36575
251207,202002,90,73,17,76285,17765,94050
251210,202002,1468,1074,394,1133825,415910,1549735
251220,202002,48,36,12,37620,12540,50160
251230,202002,592,500,92,524590.9,96140,620730.9
251240,202002,98,67,31,72105,32395,104500
251250,202002,1388,984,404,1045000.75,424270.75,1469271.50
251260,202002,13,7,6,7315,6270,13585
251270,202002,324,247,77,259160,80465,339625
251272,202002,64,57,7,59565,7315,66880
251274,202002,29,22,7,22990,7315,30305
251275,202002,34,20,14,20900,14630,35530
251276,202002,11,9,2,9405,2090,11495
251278,202002,11,9,2,9405,2090,11495
251280,202002,100,96,4,100320,4180,104500
251290,202002,761,560,201,589380,211090,800470
251300,202002,14,12,2,12540,2090,14630
251310,202002,372,267,105,280060.22,111815,391875.22
251315,202002,30,27,3,28215,3135,31350
251320,202002,60,47,13,49115,13585,62700
251330,202002,75,66,9,70015,9405,79420
251335,202002,14,9,5,9405,5225,14630
251340,202002,718,425,293,447260,308275,755535
251350,202002,34,33,1,34485,1045,35530
251360,202002,80,69,11,72105,11495,83600
251365,202002,15,15,0,15675,0,15675
251370,202002,5466,3695,1771,3906211.32,1877865,5784076.32
251380,202002,45,37,8,38665,8360,47025
251385,202002,3,3,0,3135,0,3135
251390,202002,778,592,186,622820.9,196460.5,819281.4
251392,202002,15,8,7,8360,7315,15675
251394,202002,11,11,0,11495,0,11495
251396,202002,12,8,4,8360,4180,12540
251398,202002,16,14,2,14630,2090,16720
251400,202002,37,32,5,33440,5225,38665
251410,202002,37,30,7,31350,7315,38665
251420,202002,101,73,28,77330,29260,106590
251430,202002,40,37,3,39710,3135,42845
251440,202002,37,23,14,24035,14630,38665
251445,202002,48,42,6,45980.25,6270,52250.25
251450,202002,395,344,51,364705,53295,418000
251455,202002,3,2,1,2090,2090,4180
251460,202002,16,14,2,14630,2090,16720
251465,202002,4,2,2,2090,2090,4180
251470,202002,47,38,9,39710,9405,49115
251480,202002,26,21,5,21945,5225,27170
251490,202002,120,82,38,86735,39710.5,126445.5
251500,202002,124,101,23,107635,24035,131670
251510,202002,42,30,12,31350,12540,43890
251520,202002,27,27,0,29260,0,29260
251530,202002,4478,3142,1336,3312650.5,1404480,4717130.5
251540,202002,75,63,12,65835,13585,79420
251550,202002,405,312,93,328130,99275.75,427405.75
251560,202002,23,15,8,15675,8360,24035
251570,202002,19,18,1,18810,1045,19855
251580,202002,131,103,28,110770,29260,140030
251590,202002,115,83,32,89022.5,33440,122462.5
251593,202002,26,16,10,16720,10450,27170
251597,202002,73,56,17,58520,17765,76285
251600,202002,1092,776,316,820332.02,335445,1155777.02
251610,202002,233,180,53,188100,55385,243485
251615,202002,6,6,0,6270,0,6270
251620,202002,4197,2751,1446,2897786.6,1519431.5,4417218.1
251630,202002,456,336,120,352165,126445.45,478610.45
251640,202002,144,103,41,107635,42845,150480
251650,202002,273,199,74,207955.75,77330,285285.75
251660,202002,188,169,19,176605,19855,196460
251670,202002,363,283,80,299915,83600,383515
251675,202002,6,6,0,6270,0,6270
251680,202002,93,86,7,90915,7315,98230
251690,202002,331,273,58,291555,60610,352165
251700,202002,277,239,38,258115.9,39710,297825.9
251710,202002,24,16,8,16720,8360,25080
251720,202002,23,15,8,15675,8360.5,24035.5
251740,202002,10,8,2,8360,2090,10450
260005,202002,3195,1772,1423,1873689.21,1505847.7,3379536.91
260010,202002,1584,1162,422,1223696.45,446215.1,1669911.55
260020,202002,412,364,48,382470,50160,432630
260030,202002,606,427,179,450395,187055,637450
260040,202002,805,502,303,527725,318725,846450
260050,202002,1167,836,331,884070,346941,1231011
260060,202002,383,350,33,365750,34485,400235
260070,202002,1371,847,524,894520.75,550715.3,1445236.05
260080,202002,729,567,162,596695,171380,768075
260090,202002,504,325,179,344850.9,188100,532950.9
260100,202002,213,148,65,155705,70015,225720
260105,202002,225,126,99,133760,103455,237215
260110,202002,2854,2106,748,2216446.45,786885.72,3003332.17
260120,202002,2815,1448,1367,1527791.8,1438965.75,2966757.55
260130,202002,165,113,52,118085,54340,172425
260140,202002,2115,1370,745,1453600.85,783750.45,2237351.30
260150,202002,215,138,77,145255,81510,226765
260160,202002,326,274,52,289465,54340,343805
260170,202002,3350,2031,1319,2142251.2,1395075.5,3537326.7
260180,202002,152,123,29,133760,30305,164065
260190,202002,2291,1580,711,1668865,752400,2421265
260200,202002,964,778,186,815100.29,197505.5,1012605.79
260210,202002,1426,1022,404,1075305,427405.45,1502710.45
260220,202002,699,628,71,665665.5,74195,739860.5
260230,202002,1196,900,296,943635.3,314545,1258180.3
260240,202002,220,165,55,175560,57475,233035
260250,202002,92,69,23,72105,24035,96140
260260,202002,1041,741,300,783750,314545,1098295
260270,202002,415,329,86,349030,89870,438900
260280,202002,1294,907,387,956175,407550.5,1363725.5
260290,202002,6485,3510,2975,3705573.35,3144409.03,6849982.38
260300,202002,945,822,123,863170.5,130625,993795.5
260310,202002,514,406,108,425315,113905,539220
260320,202002,867,638,229,670890.9,239305,910195.9
260330,202002,61,43,18,44935,18810,63745
260340,202002,76,56,20,58520,20900,79420
260345,202002,5509,3015,2494,3195611.88,2629221.8,5824833.68
260350,202002,479,348,131,367840.5,141075.45,508915.95
260360,202002,268,146,122,152570,130625,283195
260370,202002,714,471,243,494285.25,253935.22,748220.47
260380,202002,586,430,156,451440.9,164065.47,615506.37
260390,202002,295,250,45,264385,49115,313500
260392,202002,104,91,13,95095,13585,108680
260400,202002,4091,2351,1740,2480831.97,1832930,4313761.97
260410,202002,14661,7694,6967,8110247.22,7341126.2,15451373.42
260415,202002,134,117,17,123310,17765,141075
260420,202002,1728,1053,675,1116061.77,712690,1828751.77
260430,202002,189,173,16,182876.02,16720,199596.02
260440,202002,201,144,57,150480.45,61655,212135.45
260450,202002,430,319,111,335445.96,120175,455620.96
260460,202002,823,432,391,457710,409640,867350
260470,202002,353,216,137,227810,143165.5,370975.5
260480,202002,229,148,81,154660,84645,239305
260490,202002,215,177,38,184965,39710,224675
260500,202002,1120,752,368,792110,387695,1179805
260510,202002,774,621,153,654170,160930,815100
260515,202002,245,222,23,233035,24035,257070
260520,202002,3242,1983,1259,2086865.22,1326105.95,3412971.17
260530,202002,802,661,141,699105,147345,846450
260540,202002,557,437,120,459800,126445,586245
260545,202002,11,9,2,9405,2090,11495
260550,202002,325,203,122,214225,127490,341715
260560,202002,527,397,130,415910.5,136895,552805.5
260570,202002,976,795,181,837045.06,190190,1027235.06
260580,202002,242,213,29,229900,30305,260205
260590,202002,631,362,269,382470,281105.5,663575.5
260600,202002,7929,4310,3619,4549932.84,3821566.4,8371499.24
260610,202002,483,321,162,336490,171380,507870
260620,202002,3659,1919,1740,2030437.55,1849651.98,3880089.53
260630,202002,86,81,5,84645,5225,89870
260640,202002,3539,1972,1567,2084776.75,1656325.9,3741102.65
260650,202002,329,240,89,250800,94050,344850
260660,202002,549,371,178,391875,188100,579975
260670,202002,106,78,28,81510,29260,110770
260680,202002,3681,2068,1613,2183006.57,1697081.4,3880087.97
260690,202002,126,91,35,97185,36575,133760
260700,202002,308,204,104,217360,111815,329175
260710,202002,41,36,5,37620,5225,42845
260720,202002,2377,1410,967,1493306,1017830,2511136
260730,202002,685,517,168,546535,176605,723140
260740,202002,61,57,4,60610,4180,64790
260750,202002,596,430,166,452485,177650,630135
260760,202002,643,343,300,361570.23,318725,680295.23
260765,202002,971,496,475,522500.22,500555,1023055.22
260770,202002,221,163,58,173452,60610,234062
260775,202002,788,446,342,475476.25,364705.45,840181.70
260780,202002,254,163,91,170335,96140,266475
260790,202002,12787,6742,6045,7131085.13,6398538.17,13529623.30
260795,202002,165,110,55,115995,57475,173470
260800,202002,282,237,45,248710.5,48070,296780.5
260805,202002,168,112,56,119130,59565,178695
260810,202002,735,638,97,676115,104500,780615
260820,202002,283,181,102,192280.85,108680,300960.85
260825,202002,206,147,59,154660,62700,217360
260830,202002,277,174,103,181830,107635,289465
260840,202002,233,173,60,181830,63745,245575
260845,202002,173,121,52,128535,55385,183920
260850,202002,442,327,115,349030,126445,475475
260860,202002,251,189,62,197505,65835,263340
260870,202002,365,276,89,289465,96140,385605
260875,202002,720,512,208,543400,217360,760760
260880,202002,1579,1008,571,1058585,602965,1661550
260890,202002,2365,1671,694,1766051,736725,2502776
260900,202002,974,689,285,723140,305140,1028280
260910,202002,260,205,55,214225,58520,272745
260915,202002,290,213,77,224675,82555,307230
260920,202002,174,95,79,99275,82555,181830
260930,202002,398,341,57,357391.34,59565.67,416957.01
260940,202002,2711,1474,1237,1557051.4,1298936,2855987.4
260950,202002,2007,1153,854,1218470.75,894520,2112990.75
260960,202002,13702,6991,6711,7404880.85,7092420.77,14497301.62
260970,202002,417,350,67,372020,71060,443080
260980,202002,190,170,20,178695,22990,201685
260990,202002,2593,2103,490,2212266.35,515185,2727451.35
261000,202002,4285,2572,1713,2708641.2,1809940,4518581.2
261010,202002,167,126,41,131670,43890,175560
261020,202002,601,451,150,474430.99,158840,633270.99
261030,202002,238,177,61,186010,63745,249755
261040,202002,370,324,46,338580,49115,387695
261050,202002,501,436,65,457710,68970,526680
261060,202002,1378,888,490,934230.25,514140,1448370.25
261070,202002,8638,4327,4311,4581296.87,4568780.47,9150077.34
261080,202002,376,289,87,305140,94050,399190
261090,202002,2215,1697,518,1790089.7,544445.83,2334535.53
261100,202002,1132,797,335,840180.75,354255,1194435.75
261110,202002,8541,5234,3307,5517600.75,3488212.85,9005813.60
261120,202002,258,221,37,233035,38665,271700
261130,202002,579,341,238,358435,248710.55,607145.55
261140,202002,192,122,70,127490,73150,200640
261150,202002,676,417,259,440990.03,273790,714780.03
261153,202002,65,61,4,63745,4180,67925
261160,202002,75583,37710,37873,39944119.05,40098760.6,80042879.65
261170,202002,470,359,111,375155,118085,493240
261180,202002,1781,1103,678,1160995.45,716870,1877865.45
261190,202002,618,432,186,454576.8,196460.45,651037.25
261200,202002,219,187,32,196460,33440,229900
261210,202002,35,29,6,30305,6270,36575
261220,202002,2692,1896,796,2000131.12,843315.67,2843446.79
261230,202002,341,255,86,268565,90915,359480
261240,202002,460,404,56,424270,60610,484880
261245,202002,229,191,38,201685,40755,242440
261247,202002,169,134,35,141075,36575,177650
261250,202002,3054,1512,1542,1593625.75,1620795,3214420.75
261255,202002,244,222,22,235125,22990,258115
261260,202002,853,742,111,780615.29,118085,898700.29
261270,202002,198,142,56,149435,58520,207955
261280,202002,175,143,32,149435,34485,183920
261290,202002,119,87,32,90915,33440,124355
261300,202002,1282,934,348,988570,369930,1358500
261310,202002,812,546,266,573705,281105,854810
261320,202002,557,381,176,406505,186010.45,592515.45
261330,202002,982,750,232,792110,243485.29,1035595.29
261340,202002,289,162,127,170335,132715,303050
261350,202002,841,601,240,631180.5,250800,881980.5
261360,202002,1283,841,442,885115,466070,1351185
261370,202002,4800,2900,1900,3058717.57,2003266.45,5061984.02
261380,202002,547,416,131,435765.69,141075.5,576841.19
261390,202002,3587,2420,1167,2555025.5,1226830.75,3781856.25
261400,202002,286,261,25,274835,26125,300960
261410,202002,1100,734,366,773300,384560,1157860
261420,202002,867,536,331,569526.95,346940,916466.95
261430,202002,331,299,32,313500,35530,349030
261440,202002,119,110,9,114950,9405,124355
261450,202002,2502,2042,460,2155837.19,492195.5,2648032.69
261460,202002,708,568,140,597740.85,149435,747175.85
261470,202002,242,192,50,202730,53295,256025
261480,202002,441,343,98,364705,102363.22,467068.22
261485,202002,345,207,138,217360,145255,362615
261500,202002,596,411,185,432630.86,197505,630135.86
261510,202002,51,33,18,34485,18810,53295
261520,202002,112,100,12,104500,12540,117040
261530,202002,4115,2602,1513,2737901.23,1599895.75,4337796.98
261540,202002,1314,784,530,824505,555940,1380445
261550,202002,265,134,131,141075.5,137940,279015.5
261560,202002,840,556,284,582066.75,297826.45,879893.20
261570,202002,396,311,85,327085,88825,415910
261580,202002,373,292,81,307230,85690,392920
261590,202002,189,154,35,161975,37620,199595
261600,202002,291,234,57,245575,59565.5,305140.5
261610,202002,90,76,14,80465,14630,95095
261618,202002,76,61,15,63745,15675,79420
261620,202002,207,127,80,133760,84645,218405
261630,202002,560,438,122,465025,128535,593560
261640,202002,6354,3375,2979,3560317.59,3147540.75,6707858.34
261650,202002,483,304,179,318725,188100,506825
270010,202002,520,462,58,486970,62700,549670
270020,202002,283,228,55,240350.22,59565,299915.22
270030,202002,8565,5526,3039,5940908.51,3259370.35,9200278.86
270040,202002,1974,1234,740,1293710,774345,2068055
270050,202002,150,112,38,118085,39710,157795
270060,202002,111,61,50,64790,52250,117040
270070,202002,865,634,231,670890,243485.45,914375.45
270080,202002,38,31,7,32395,7315,39710
270090,202002,20,15,5,15675,5225,20900
270100,202002,1219,815,404,860035.45,427405,1287440.45
270110,202002,124,96,28,103455,30305,133760
270120,202002,220,181,39,190190,41800,231990
270130,202002,246,171,75,179740,78375,258115
270135,202002,114,71,43,75240,44935,120175
270140,202002,1362,859,503,900791.62,532950.45,1433742.07
270150,202002,255,200,55,213180,57475,270655
270160,202002,509,396,113,416955,119130,536085
270170,202002,793,519,274,547580,287375,834955
270180,202002,70,55,15,57475,15675,73150
270190,202002,89,78,11,81510,11495,93005
270200,202002,102,89,13,93005,13585,106590
270210,202002,492,276,216,292600,226765,519365
270220,202002,178,141,37,149435,39710,189145
270230,202002,2076,1274,802,1353276.1,845405.45,2198681.55
270235,202002,688,537,151,570573.15,160932.25,731505.40
270240,202002,3040,2409,631,2547711.42,665665.85,3213377.27
270250,202002,157,114,43,120175,44935,165110
270255,202002,209,178,31,187055,33440,220495
270260,202002,364,296,68,311410,71060,382470
270270,202002,94,42,52,43890.45,56430,100320.45
270280,202002,235,130,105,135850,111815,247665
270290,202002,1163,888,275,941545,288420.45,1229965.45
270300,202002,303,207,96,217360,100320,317680
270310,202002,840,691,149,730457.7,158840.45,889298.15
270320,202002,822,702,120,745086.24,126445,871531.24
270330,202002,282,240,42,253935,44935,298870
270340,202002,60,47,13,49115,13585,62700
270350,202002,90,48,42,50160,43890,94050
270360,202002,60,34,26,35530,27170,62700
270370,202002,53,45,8,47025,8360,55385
270375,202002,73,47,26,49115,27170,76285
270380,202002,1002,625,377,653125,401280,1054405
270390,202002,187,112,75,117040,78375,195415
270400,202002,699,516,183,545492.59,194370,739862.59
270410,202002,653,482,171,508915,182875,691790
270420,202002,399,275,124,289465,130625.9,420090.9
270430,202002,32497,23367,9130,24690719.61,9672525.58,34363245.19
270440,202002,483,383,100,403370,106590,509960
270450,202002,786,440,346,462935,364705,827640
270460,202002,191,153,38,160930,39710,200640
270470,202002,1416,984,432,1039775,457710,1497485
270480,202002,532,436,96,459800.5,100320,560120.5
270490,202002,24,19,5,19855,5225,25080
270500,202002,485,404,81,423225,84645,507870
270510,202002,789,489,300,516230,315590,831820
270520,202002,293,189,104,200640,113905,314545
270530,202002,66,57,9,59565,9405,68970
270540,202002,109,85,24,89870,25080,114950
270550,202002,1746,1340,406,1418065.44,430540,1848605.44
270560,202002,268,139,129,146300,136895,283195
270570,202002,505,356,149,372020,157795,529815
270580,202002,93,70,23,74195,24035,98230
270590,202002,68,54,14,56430,15675,72105
270600,202002,178,147,31,154660,32395,187055
270610,202002,208,174,34,181830,35530,217360
270620,202002,29,28,1,29260,1045,30305
270630,202002,3717,2834,883,2991871.73,932140.9,3924012.63
270640,202002,870,645,225,678205,236172.25,914377.25
270642,202002,219,186,33,194370,34485,228855
270644,202002,243,159,84,168245.45,89870,258115.45
270650,202002,318,186,132,199595,138985,338580
270660,202002,247,205,42,216315,45980,262295
270670,202002,3021,2311,710,2446069.88,748220,3194289.88
270680,202002,445,262,183,276925,192280,469205
270690,202002,1151,748,403,793155.95,422180,1215335.95
270700,202002,28,23,5,24035,5225,29260
270710,202002,867,671,196,708510,212136.8,920646.8
270720,202002,244,193,51,202730,53295,256025
270730,202002,1836,1105,731,1168310.5,772255.7,1940566.2
270740,202002,40,27,13,28215,13585,41800
270750,202002,626,472,154,501600,164065,665665
270760,202002,293,215,78,225720,82555,308275
270770,202002,2731,1792,939,1889362.15,997975.9,2887338.05
270780,202002,77,50,27,52250,28215.22,80465.22
270790,202002,258,171,87,178695,91960,270655
270800,202002,1965,1579,386,1660505.22,408595,2069100.22
270810,202002,277,220,57,234080,59565,293645
270820,202002,145,98,47,102410,50160.5,152570.5
270830,202002,787,584,203,613415.44,214225.22,827640.66
270840,202002,1374,1043,331,1106655,347985.85,1454640.85
270850,202002,1501,931,570,989615.5,604010,1593625.5
270860,202002,2491,1650,841,1740971.13,883025.67,2623996.80
270870,202002,124,67,57,70015,60610,130625
270880,202002,887,688,199,725235.85,213183.15,938419.00
270890,202002,292,214,78,227810,84645,312455
270895,202002,62,53,9,56430,9405,65835
270900,202002,93,72,21,75240,21945,97185
270910,202002,305,249,56,261250,60610,321860
270915,202002,1901,1192,709,1254012,745091,1999103
270920,202002,466,391,75,410685,78375,489060
270930,202002,5919,4426,1493,4655479.47,1580043.39,6235522.86
270940,202002,2307,1796,511,1895630,543400,2439030
280010,202002,39,33,6,34485,6270,40755
280020,202002,461,403,58,424270.84,61655,485925.84
280030,202002,20103,13009,7094,13710427.19,7488478.54,21198905.73
280040,202002,325,213,112,223630,118085,341715
280050,202002,390,299,91,313500,95095,408595
280060,202002,351,225,126,236170.7,132715,368885.7
280067,202002,1047,753,294,790020.63,309320.62,1099341.25
280070,202002,118,96,22,102410,22990,125400
280100,202002,622,488,134,511005.5,140030,651035.5
280110,202002,74,69,5,72105,5225,77330
280120,202002,629,517,112,542355.52,117040,659395.52
280130,202002,1680,1094,586,1152635,616550.5,1769185.5
280140,202002,475,390,85,408595,88825,497420
280150,202002,381,277,104,291555,110770,402325
280160,202002,96,82,14,85690,15675,101365
280170,202002,400,273,127,285285,133760,419045
280190,202002,28,27,1,28215,1045,29260
280200,202002,27,23,4,24035,4180,28215
280210,202002,2894,2091,803,2200648.17,849585.5,3050233.67
280220,202002,39,31,8,32395,9405,41800
280230,202002,326,268,58,280060,60610,340670
280240,202002,113,108,5,113905,5225,119130
280250,202002,16,10,6,10450,6270,16720
280260,202002,83,74,9,77330,9405,86735
280270,202002,145,114,31,121220,33440,154660
280280,202002,188,118,70,125400.37,73150,198550.37
280290,202002,3318,2412,906,2538239.16,958265.1,3496504.26
280300,202002,1584,1233,351,1291620.5,370975,1662595.5
280310,202002,99,95,4,99275.5,4180,103455.5
280320,202002,662,463,199,486970,209000,695970
280330,202002,332,239,93,251845,99275,351120
280340,202002,397,323,74,340670,77330,418000
280350,202002,3611,2806,805,2957352.71,849585.75,3806938.46
280360,202002,454,299,155,317680,164065,481745
280370,202002,97,86,11,89870.15,11495,101365.15
280380,202002,54,42,12,43890,12540,56430
280390,202002,170,147,23,153615,25080,178695
280400,202002,353,242,111,253936.4,117040,370976.4
280410,202002,284,233,51,245575,54340,299915
280420,202002,169,142,27,150480,28215,178695
280430,202002,35,26,9,27170,9405,36575
280440,202002,690,541,149,568480.65,157795,726275.65
280445,202002,116,107,9,113905,9405,123310
280450,202002,1180,1018,162,1067990,169290,1237280
280460,202002,612,447,165,471296.63,172425,643721.63
280470,202002,188,175,13,183920,13585.75,197505.75
280480,202002,2540,1786,754,1886228.21,796290.54,2682518.75
280490,202002,266,251,15,265431.56,16720,282151.56
280500,202002,38,35,3,36575,3135,39710
280510,202002,140,113,27,118085,28215.5,146300.5
280520,202002,54,40,14,41800,15675,57475
280530,202002,72,47,25,49115,26125,75240
280540,202002,526,438,88,458755,94050,552805
280550,202002,718,665,53,702241.71,56430.5,758672.21
280560,202002,492,434,58,457710,61655,519365
280570,202002,2196,1718,478,1805761.45,503690,2309451.45
280580,202002,594,462,132,484880.22,141075.5,625955.72
280590,202002,193,118,75,123310,78375,201685
280600,202002,386,323,63,339625,66880,406505
280610,202002,119,91,28,95095,29260,124355
280620,202002,544,448,96,468160,100320,568480
280630,202002,146,121,25,127490,26125,153615
280640,202002,189,151,38,158840.9,39710,198550.9
280650,202002,89,61,28,64790,30305,95095
280660,202002,141,107,34,112860,35530,148390
280670,202002,1783,1128,655,1193393.08,691790.3,1885183.38
280680,202002,172,149,23,155705.22,24035,179740.22
280690,202002,80,71,9,75240,9405,84645
280700,202002,22,22,0,22990,0,22990
280710,202002,1454,1123,331,1177715,349030.5,1526745.5
280720,202002,110,70,40,74195,41800,115995
280730,202002,26,21,5,21945,5225,27170
280740,202002,2511,1875,636,1972960.79,670890,2643850.79
280750,202002,228,200,28,209000,30305,239305
280760,202002,748,515,233,541310,245575,786885
290010,202002,200,140,60,147345,62700,210045
290020,202002,181,164,17,172425,17765,190190
290030,202002,618,398,220,419045,229900,648945
290035,202002,127,102,25,107635,26125,133760
290040,202002,302,205,97,214225,101365,315590
290050,202002,86,66,20,68970,20900,89870
290060,202002,260,119,141,124355,149435,273790
290070,202002,5678,2783,2895,2938541.1,3046177.76,5984718.86
290080,202002,460,208,252,223630.9,267520.9,491151.8
290090,202002,388,176,212,183920,222585,406505
290100,202002,1623,1064,559,1123375,587291,1710666
290110,202002,814,478,336,505780.97,352165.22,857946.19
290115,202002,197,182,15,193325,15675,209000
290120,202002,754,497,257,527725.29,270655,798380.29
290130,202002,425,262,163,274835,171380,446215
290135,202002,297,226,71,236170,74195,310365
290140,202002,315,258,57,271700,59565,331265
290150,202002,135,99,36,103455,37620,141075
290160,202002,238,182,56,190190,58520,248710
290170,202002,91,66,25,70015,26125,96140
290180,202002,177,132,45,138985,48070,187055
290190,202002,432,353,79,372020,82555,454575
290195,202002,311,201,110,210045,114950,324995
290200,202002,272,221,51,231990,53295,285285
290205,202002,149,91,58,95095,60610,155705
290210,202002,1154,851,303,892430.5,318725,1211155.5
290220,202002,221,123,98,128535,102410,230945
290225,202002,287,111,176,117040,183920,300960
290230,202002,73,48,25,50160,26125,76285
290240,202002,342,134,208,142120,220495,362615
290250,202002,255,235,20,245575,20900,266475
290260,202002,311,255,56,267520.5,60610,328130.5
290265,202002,184,158,26,167200,28215.9,195415.9
290270,202002,1422,1180,242,1243550.25,253936.4,1497486.65
290280,202002,473,336,137,353210.45,144210,497420.45
290290,202002,1282,761,521,802561.03,550715.5,1353276.53
290300,202002,439,374,65,392920.5,68970,461890.5
290310,202002,298,136,162,142120,173470,315590
290320,202002,4023,2499,1524,2638625.3,1606165.1,4244790.4
290323,202002,189,164,25,176605,26125,202730
290327,202002,162,129,33,134805,34485,169290
290330,202002,98,56,42,58520,44935,103455
290340,202002,844,348,496,365750,526680,892430
290350,202002,605,369,236,393965,252890,646855
290360,202002,352,272,80,285286.64,86735,372021.64
290370,202002,916,391,525,408595.75,553850.67,962446.42
290380,202002,315,196,119,205865,124355,330220
290390,202002,2432,1529,903,1616616.75,951995.9,2568612.65
290395,202002,251,146,105,152570.25,110770,263340.25
290400,202002,274,203,71,215270.5,74195,289465.5
290405,202002,246,212,34,225720,35530,261250
290410,202002,624,522,102,550715.53,108680,659395.53
290420,202002,252,204,48,215270,50160,265430
290430,202002,473,306,167,323950,176605,500555
290440,202002,75,67,8,70015,8360,78375
290450,202002,207,160,47,167200,50160,217360
290460,202002,1923,1164,759,1232059.5,799426.6,2031486.1
290470,202002,1404,601,803,631184.5,847502.65,1478687.15
290475,202002,559,523,36,549670.2,38665,588335.2
290480,202002,285,159,126,166155,132715,298870
290485,202002,239,221,18,234080,18810,252890
290490,202002,1204,870,334,917510,354255,1271765
290500,202002,722,374,348,395010,367840,762850
290510,202002,225,174,51,183920,53295,237215
290515,202002,147,91,56,95095,58520,153615
290520,202002,1419,946,473,1000065.85,504737.34,1504803.19
290530,202002,297,274,23,291555,24035,315590
290540,202002,105,58,47,60610,49115,109725
290550,202002,156,131,25,136895,26125,163020
290560,202002,3194,1351,1843,1424335.9,1945792.7,3370128.6
290570,202002,6090,2993,3097,3160082.96,3272942.83,6433025.79
290580,202002,1280,767,513,806740.9,543400,1350140.9
290590,202002,564,468,96,490105,101365,591470
290600,202002,1738,1196,542,1263405.98,570570,1833975.98
290610,202002,209,188,21,196460.35,21945,218405.35
290620,202002,350,312,38,330220,39710,369930
290630,202002,1996,853,1143,898700,1200706.85,2099406.85
290640,202002,151,122,29,128535,30305,158840
290650,202002,1724,800,924,847495.84,984390,1831885.84
290660,202002,274,222,52,234080,55385,289465
290670,202002,929,482,447,506826,473385,980211
290680,202002,1231,987,244,1038730,256025,1294755
290682,202002,306,231,75,243486.25,80465,323951.25
290685,202002,234,152,82,159885,86735,246620
290687,202002,1024,659,365,694050.1,387695,1081745.1
290689,202002,139,76,63,80465.67,65835,146300.67
290690,202002,608,257,351,271700.45,368888.6,640589.05
290700,202002,246,120,126,125400,133760,259160
290710,202002,718,490,228,513095,241395,754490
290720,202002,1021,829,192,876755,200640,1077395
290730,202002,1157,668,489,703285.75,512050,1215335.75
290740,202002,16,14,2,14630,2090,16720
290750,202002,1412,627,785,661485,823461.99,1484946.99
290755,202002,72,65,7,67925,7315,75240
290760,202002,297,258,39,269610,40755,310365
290770,202002,185,174,11,186010,11495.5,197505.5
290780,202002,1087,829,258,872577.35,270655,1143232.35
290790,202002,361,253,108,265430,113905.5,379335.5
290800,202002,2521,1017,1504,1072170.95,1583175,2655345.95
290810,202002,466,323,143,339625,150480,490105
290820,202002,395,231,164,246620,172425,419045
290830,202002,409,294,115,308275,121220,429495
290840,202002,1730,1079,651,1144276.7,689700.5,1833977.2
290850,202002,821,442,379,471295,399190,870485
290860,202002,628,288,340,303050,359480.5,662530.5
290870,202002,638,453,185,474430.6,197505.6,671936.2
290880,202002,121,66,55,68970,57475,126445
290890,202002,380,260,120,273790,125400,399190
290900,202002,164,127,37,134805,39710,174515
290910,202002,383,298,85,314545,89870,404415
290920,202002,213,183,30,193325,31350,224675
290930,202002,826,627,199,660440.5,210045.9,870486.4
290940,202002,246,204,42,213180,43890,257070
290950,202002,151,92,59,98230,61655,159885
290960,202002,467,325,142,342760,150480,493240
290970,202002,249,219,30,230945,32395,263340
290980,202002,1607,1140,467,1205930.7,492196,1698126.7
290990,202002,386,328,58,351121.35,60611.8,411733.15
291000,202002,861,249,612,263340,641630,904970
291005,202002,2287,1018,1269,1070080.5,1339690,2409770.5
291010,202002,152,139,13,147345,14630,161975
291020,202002,101,80,21,83600,22990,106590
291030,202002,95,70,25,73150,27170,100320
291040,202002,596,329,267,344850,280060,624910
291050,202002,1413,778,635,821370.9,671935,1493305.9
291060,202002,1521,843,678,887205,715825,1603030
291070,202002,1961,1452,509,1528836.45,536085.12,2064921.57
291072,202002,7210,2695,4515,2848671.55,4763112.9,7611784.45
291075,202002,233,191,42,199595,43890,243485
291077,202002,55,38,17,39710,17765,57475
291080,202002,20052,8820,11232,9330808.51,11849258.39,21180066.90
291085,202002,296,242,54,256025,57475,313500
291090,202002,303,123,180,128535.5,190190,318725.5
291100,202002,655,197,458,206910,481745,688655
291110,202002,418,321,97,336490,102410,438900
291120,202002,2416,1192,1224,1261315.75,1295800.22,2557115.97
291125,202002,65,31,34,32395,35530,67925
291130,202002,206,183,23,191235,24035,215270
291140,202002,141,113,28,119130,29260.5,148390.5
291150,202002,382,147,235,154660,247665,402325
291160,202002,384,314,70,330220.25,74195,404415.25
291165,202002,36,30,6,31350,6270,37620
291170,202002,3092,1554,1538,1638562.42,1616615.5,3255177.92
291180,202002,1262,499,763,525636.21,800472.7,1326108.91
291185,202002,87,82,5,85690,5225,90915
291190,202002,1353,599,754,629090.25,792110,1421200.25
291200,202002,165,124,41,133760,42845,176605
291210,202002,2254,900,1354,959311.16,1433740.5,2393051.66
291220,202002,273,207,66,219450,70015,289465
291230,202002,983,346,637,364705.5,667755,1032460.5
291240,202002,416,391,25,418000.5,26125,444125.5
291250,202002,448,362,86,379335,89870,469205
291260,202002,55,45,10,47025,10450,57475
291270,202002,1154,482,672,507870,705375,1213245
291280,202002,362,172,190,181830,201685,383515
291290,202002,1721,883,838,933185.5,883025.5,1816211.0
291300,202002,232,184,48,192280,51205,243485
291310,202002,221,201,20,215270,20900,236170
291320,202002,1363,965,398,1018875,418000,1436875
291330,202002,128,110,18,117040,19855,136895
291340,202002,205,117,88,123310,91960,215270
291345,202002,135,94,41,98230,43890,142120
291350,202002,1631,573,1058,610280,1109790.75,1720070.75
291360,202002,8418,4093,4325,4334662.15,4560383.05,8895045.20
291370,202002,1121,638,483,669845.5,512050.45,1181895.95
291380,202002,258,206,52,216315,54340,270655
291390,202002,3875,1707,2168,1806806.6,2282281,4089087.6
291400,202002,2071,1479,592,1557050,620730.84,2177780.84
291410,202002,185,163,22,173470,22990,196460
291420,202002,119,87,32,91960,33440,125400
291430,202002,163,89,74,93005,77330.02,170335.02
291440,202002,513,420,93,445171,99275,544446
291450,202002,904,581,323,609235.25,342760,951995.25
291460,202002,1824,1492,332,1571681.5,350075.5,1921757.0
291465,202002,2160,1024,1136,1083676.75,1197579.9,2281256.65
291470,202002,2842,1431,1411,1515251.93,1489125.5,3004377.43
291480,202002,11791,5247,6544,5534334.42,6898102.11,12432436.53
291490,202002,592,239,353,253935,375155,629090
291500,202002,375,217,158,227810,165110,392920
291510,202002,1227,479,748,502645,788975,1291620
291520,202002,932,425,507,446215,537130,983345
291530,202002,940,254,686,268565,720005,988570
291535,202002,123,101,22,106590,22990,129580
291540,202002,339,100,239,104500.5,249755,354255.5
291550,202002,1224,573,651,605055,687610.95,1292665.95
291560,202002,5267,2667,2600,2819479.75,2739073.12,5558552.87
291570,202002,197,103,94,108680,98230,206910
291580,202002,1203,745,458,783750.27,484880,1268630.27
291590,202002,84,35,49,37620,51205.5,88825.5
291600,202002,1139,568,571,595650,604010.9,1199660.9
291610,202002,1443,705,738,746130,781661.35,1527791.35
291620,202002,575,267,308,279015,322905,601920
291630,202002,483,149,334,157795,349030,506825
291640,202002,3918,2001,1917,2112994,2023126,4136120
291650,202002,416,289,127,302006.12,134805,436811.12
291660,202002,398,159,239,167200.29,249755,416955.29
291670,202002,221,135,86,142120,89870,231990
291680,202002,659,392,267,411730,281105.5,692835.5
291685,202002,588,328,260,343805,272745,616550
291690,202002,535,314,221,329175,235125.72,564300.72
291700,202002,962,753,209,795245,220495,1015740
291710,202002,1651,792,859,838090.25,901835,1739925.25
291720,202002,419,279,140,295735,146300,442035
291730,202002,935,552,383,583110,406505,989615
291733,202002,282,192,90,201685,94050,295735
291735,202002,74,55,19,58520,19855,78375
291740,202002,354,276,78,289465,82555,372020
291750,202002,2107,1369,738,1444190.38,776435,2220625.38
291760,202002,2989,1651,1338,1736790,1407615,3144405
291770,202002,785,532,253,555943.07,267520,823463.07
291780,202002,58,36,22,37620,22990,60610
291790,202002,161,81,80,85690,85690,171380
291800,202002,9987,4117,5870,4346157.59,6179087.2,10525244.79
291810,202002,1094,815,279,866305.5,295735.9,1162041.4
291820,202002,277,199,78,209000,81510,290510
291830,202002,1081,435,646,460846.46,683430.45,1144276.91
291835,202002,578,536,42,565345,43890,609235
291840,202002,4800,2435,2365,2574881.21,2497551,5072432.21
291845,202002,267,88,179,96140,190190,286330
291850,202002,324,287,37,300960,38665,339625
291855,202002,260,101,159,106590,167200,273790
291860,202002,167,107,60,111815,62700,174515
291870,202002,83,33,50,34485,52250,86735
291875,202002,178,165,13,174515,13585,188100
291880,202002,456,365,91,384560,96140,480700
291890,202002,240,77,163,80465,170335.5,250800.5
291900,202002,55,32,23,33440,25080,58520
291905,202002,127,93,34,97185.5,35530,132715.5
291910,202002,161,131,30,137940,31350,169290
291915,202002,426,377,49,397100.25,51205,448305.25
291920,202002,5018,2552,2466,2708641.35,2609365.5,5318006.85
291930,202002,172,104,68,108680.55,75240,183920.55
291940,202002,353,202,151,213180.5,160930,374110.5
291950,202002,1137,919,218,973941,227810.5,1201751.5
291955,202002,1233,741,492,785840,522500,1308340
291960,202002,188,136,52,142120,54340,196460
291970,202002,760,581,179,609235,189145,798380
291980,202002,1508,1337,171,1404481.23,179740.5,1584221.73
291990,202002,134,124,10,130625,10450,141075
291992,202002,168,87,81,91960,86735,178695
291995,202002,167,110,57,114950,59565,174515
292000,202002,390,302,88,316635.5,93005,409640.5
292010,202002,301,211,90,221540,95095,316635
292020,202002,288,211,77,221540,82555,304095
292030,202002,145,112,33,119130,34485,153615
292040,202002,631,316,315,333355,329175,662530
292045,202002,104,96,8,101365,8360,109725
292050,202002,936,684,252,721050,264385.5,985435.5
292060,202002,909,756,153,795245.65,159885,955130.65
292070,202002,53,20,33,20900,34485,55385
292080,202002,140,97,43,102410,44935,147345
292090,202002,525,185,340,194370,358435,552805
292100,202002,1466,630,836,669845,877800.45,1547645.45
292105,202002,191,168,23,176605,26125,202730
292110,202002,2249,832,1417,878845,1487038.15,2365883.15
292120,202002,683,540,143,571615,150480,722095
292130,202002,437,253,184,265430,196460.5,461890.5
292140,202002,207,167,40,174515,41800,216315
292145,202002,160,87,73,91960.5,77330,169290.5
292150,202002,1473,1199,274,1258180,288420,1546600
292160,202002,170,139,31,147345,32395,179740
292170,202002,1212,1051,161,1109790,168245,1278035
292180,202002,215,156,59,164065,61655,225720
292190,202002,161,104,57,109725,60610,170335
292200,202002,1317,487,830,508915.9,876755.5,1385671.4
292205,202002,125,111,14,117040,14630,131670
292210,202002,362,255,107,268565,112860.25,381425.25
292220,202002,27,21,6,21945,6270,28215
292225,202002,39,34,5,35530,5225,40755
292230,202002,969,773,196,816145.75,207955,1024100.75
292240,202002,617,442,175,467115.75,183920,651035.75
292250,202002,1734,1144,590,1205930,618640,1824570
292260,202002,407,246,161,258115,173470,431585
292265,202002,249,178,71,187055,75240,262295
292270,202002,730,335,395,354255,414865,769120
292273,202002,195,110,85,114950,89870,204820
292275,202002,173,86,87,89870,91960,181830
292280,202002,139,98,41,103455,42845,146300
292285,202002,72,61,11,63745,11495,75240
292290,202002,568,388,180,405460,188100.5,593560.5
292300,202002,1661,631,1030,666710,1082620.3,1749330.3
292303,202002,108,71,37,76285,38665,114950
292305,202002,112,83,29,87780,31350,119130
292310,202002,914,603,311,635361.1,326040.9,961402.0
292320,202002,598,455,143,477565,151525,629090
292330,202002,171,100,71,105545,76285,181830
292335,202002,278,216,62,226765,64790,291555
292340,202002,572,403,169,423225.5,176605,599830.5
292350,202002,267,143,124,150480,130625,281105
292360,202002,709,540,169,566390.9,178695,745085.9
292370,202002,738,569,169,602965,177650,780615
292380,202002,643,517,126,545490.35,133760,679250.35
292390,202002,479,188,291,200640,304095,504735
292400,202002,3563,2197,1366,2324083.11,1449416,3773499.11
292405,202002,259,171,88,179740,91960,271700
292410,202002,142,87,55,90915,57475,148390
292420,202002,292,252,40,264385,41800,306185
292430,202002,532,408,124,430540,130625,561165
292440,202002,583,505,78,530860.16,82555,613415.16
292450,202002,252,196,56,204820,58520,263340
292460,202002,551,411,140,431585.95,146300,577885.95
292465,202002,211,176,35,184965,36575,221540
292467,202002,114,70,44,74195,48070,122265
292470,202002,286,195,91,204820,95095,299915
292480,202002,361,246,115,258115,121220.5,379335.5
292490,202002,235,165,70,174515,74195,248710
292500,202002,862,387,475,407550.82,500555,908105.82
292510,202002,3411,1586,1825,1664685.6,1916530,3581215.6
292520,202002,1072,506,566,539220.22,600875.45,1140095.67
292525,202002,393,274,119,293645,125400,419045
292530,202002,4302,1738,2564,1850696.71,2710734.25,4561430.96
292540,202002,461,261,200,274835,211090,485925
292550,202002,1073,575,498,606110.8,521463.55,1127574.35
292560,202002,328,309,19,324995,19855,344850
292570,202002,307,239,68,250800,72105,322905
292575,202002,494,325,169,341715.5,177650.5,519366.0
292580,202002,980,652,328,684475,344850.5,1029325.5
292590,202002,558,484,74,509960,77330,587290
292593,202002,141,112,29,117040,30305,147345
292595,202002,196,153,43,159885,45980,205865
292600,202002,1250,910,340,955130.29,360525,1315655.29
292610,202002,134,104,30,108680,31350,140030
292620,202002,518,439,79,463980.5,84645,548625.5
292630,202002,1407,796,611,839135.42,643720.25,1482855.67
292640,202002,800,549,251,578930,265430,844360
292650,202002,182,152,30,160930.5,31350,192280.5
292660,202002,2012,1448,564,1529880,594605.42,2124485.42
292665,202002,140,99,41,105545,42845,148390
292670,202002,383,311,72,336490.22,75240,411730.22
292680,202002,248,189,59,199595,61655.5,261250.5
292690,202002,189,143,46,150480,49115,199595
292700,202002,956,633,323,665665,340670,1006335
292710,202002,111,98,13,102410,13585,115995
292720,202002,914,522,392,547580,412775,960355
292730,202002,194,89,105,96140,109725,205865
292740,202002,67442,33139,34303,35403506.71,36706692.74,72110199.45
292750,202002,386,276,110,289465.95,115995,405460.95
292760,202002,329,275,54,289466.45,58520,347986.45
292770,202002,794,342,452,362615.5,476520,839135.5
292780,202002,403,158,245,166155,258115,424270
292790,202002,761,391,370,408595,387695,796290
292800,202002,1240,746,494,780615,518320,1298935
292805,202002,396,117,279,124355,293645,418000
292810,202002,1483,844,639,892431.5,671935,1564366.5
292820,202002,715,592,123,622820.75,129580.45,752401.20
292830,202002,108,89,19,93005,20900,113905
292840,202002,687,566,121,593560,127490,721050
292850,202002,139,94,45,98230,47025,145255
292860,202002,2164,1266,898,1330285.5,945725,2276010.5
292870,202002,3433,2302,1131,2430671.57,1192345.5,3623017.07
292880,202002,1491,983,508,1032460.05,535040,1567500.05
292890,202002,518,441,77,467116.34,80465,547581.34
292895,202002,141,93,48,97185,51205,148390
292900,202002,391,278,113,293646.16,120175,413821.16
292905,202002,468,238,230,250800,240350,491150
292910,202002,445,336,109,355300.75,115995,471295.75
292920,202002,512,225,287,238260,302005,540265
292925,202002,480,442,38,467115,40755,507870
292930,202002,599,364,235,383515,247665,631180
292935,202002,282,121,161,127490,170335.45,297825.45
292937,202002,227,162,65,169290,71060,240350
292940,202002,193,149,44,158840,45980,204820
292950,202002,1148,580,568,611325.75,595650.6,1206976.35
292960,202002,585,416,169,436810,179740,616550
292970,202002,243,173,70,181830,74195,256025
292975,202002,122,69,53,73150,55385,128535
292980,202002,282,190,92,199595.52,96140,295735.52
292990,202002,1327,987,340,1037687.3,358435,1396122.3
293000,202002,109,76,33,79420,34485,113905
293010,202002,2771,1668,1103,1755600.75,1158906.62,2914507.37
293015,202002,639,519,120,546535,125400,671935
293020,202002,325,266,59,283195,62700.27,345895.27
293030,202002,593,517,76,544445,79420,623865
293040,202002,349,280,69,293645,72105,365750
293050,202002,2846,1691,1155,1779635.5,1212200.95,2991836.45
293060,202002,257,208,49,221540.6,51205,272745.6
293070,202002,3428,1737,1691,1851741.77,1787996.7,3639738.47
293075,202002,91,61,30,64790,32395,97185
293076,202002,71,50,21,52250,21945,74195
293077,202002,499,295,204,310365.5,216315,526680.5
293080,202002,434,390,44,409641.35,47025,456666.35
293090,202002,132,117,15,125400,16720,142120
293100,202002,521,367,154,385605,161975,547580
293105,202002,344,248,96,259160,101365,360525
293110,202002,168,120,48,125400,50160,175560
293120,202002,316,215,101,228855.37,106590,335445.37
293130,202002,241,168,73,177650,79420,257070
293135,202002,7961,3142,4819,3314753.95,5087103.65,8401857.60
293140,202002,208,135,73,141075,76285,217360
293150,202002,329,284,45,299915,48070,347985
293160,202002,419,245,174,256025,182875,438900
293170,202002,173,122,51,127490,54340,181830
293180,202002,493,352,141,369930.5,149435,519365.5
293190,202002,1328,923,405,971850.61,426360,1398210.61
293200,202002,543,483,60,506825,62700.9,569525.9
293210,202002,389,298,91,312455,95095,407550
293220,202002,2492,1046,1446,1107700,1522565,2630265
293230,202002,1704,631,1073,663575.94,1135915,1799490.94
293240,202002,229,211,18,221540,18810,240350
293245,202002,124,105,19,109725,19855,129580
293250,202002,707,254,453,265430.9,474430,739860.9
293260,202002,297,247,50,258115.9,53295,311410.9
293270,202002,1154,539,615,569525.65,645810,1215335.65
293280,202002,263,144,119,154660,124355,279015
293290,202002,3014,1973,1041,2086865,1104566.57,3191431.57
293300,202002,722,515,207,541311.42,216315,757626.42
293305,202002,184,149,35,158840,36575,195415
293310,202002,147,111,36,115995,37620,153615
293315,202002,163,127,36,132715,37620,170335
293317,202002,90,64,26,70015,27170,97185
293320,202002,1026,579,447,610280.28,472340,1082620.28
293325,202002,181,67,114,70015,120175,190190
293330,202002,13414,6306,7108,6652472.91,7491610.05,14144082.96
293340,202002,263,189,74,198550,78375,276925
293345,202002,245,201,44,211090,45980,257070
293350,202002,610,350,260,367840.5,273790,641630.5
293360,202002,1529,1097,432,1157860,457710,1615570
310010,202002,135,75,60,78375,62700.5,141075.5
310020,202002,1007,563,444,596695,472340,1069035
310030,202002,334,268,66,281105,70015,351120
310040,202002,41,29,12,30305,12540,42845
310050,202002,184,116,68,122265,72105.5,194370.5
310060,202002,239,168,71,180785.5,74195,254980.5
310070,202002,13,8,5,8360,5225,13585
310080,202002,42,25,17,26125,17765,43890
310090,202002,1002,527,475,551762,498466,1050228
310100,202002,294,221,73,235125,77330,312455
310110,202002,708,388,320,408595,336490,745085
310120,202002,369,217,152,230945,161975,392920
310130,202002,30,19,11,19855,12540,32395
310140,202002,25,13,12,13585,12540,26125
310150,202002,1216,830,386,876755.5,407551,1284306.5
310160,202002,2035,1014,1021,1072171.25,1079486,2151657.25
310163,202002,86,51,35,53295,37620,90915
310170,202002,2528,1127,1401,1190256.35,1481812,2672068.35
310180,202002,138,51,87,54340.5,91960,146300.5
310190,202002,471,330,141,346940,150480,497420
310200,202002,489,312,177,330220.5,186010,516230.5
310205,202002,53,37,16,38665,16720,55385
310210,202002,282,228,54,239305,57475,296780
310220,202002,60,34,26,35530,27170,62700
310230,202002,270,187,83,197505,86735,284240
310240,202002,105,94,11,98230,11495,109725
310250,202002,95,79,16,84645,16720,101365
310260,202002,765,408,357,435766.17,375155,810921.17
310270,202002,267,176,91,183920.6,96140,280060.6
310280,202002,376,278,98,290510,104500,395010
310285,202002,210,152,58,158840,60610,219450
310290,202002,247,134,113,143165,120175,263340
310300,202002,153,127,26,133760,28215,161975
310310,202002,10,8,2,8360,2090,10450
310320,202002,30,13,17,13585,17765,31350
310330,202002,36,25,11,26125,11495,37620
310340,202002,1738,1152,586,1213247,621775.5,1835022.5
310350,202002,2781,1494,1287,1580040,1353275,2933315
310360,202002,41,34,7,35530,7315,42845
310370,202002,116,97,19,101365,19855.5,121220.5
310375,202002,104,38,66,40755,68970.9,109725.9
310380,202002,48,27,21,28215,21945,50160
310390,202002,90,62,28,65835,30305,96140
310400,202002,2349,1528,821,1616616,869440,2486056
310410,202002,127,72,55,75240,58520,133760
310420,202002,669,353,316,370975,333355,704330
310430,202002,311,200,111,211090,115995,327085
310440,202002,77,45,32,47025,33440,80465
310445,202002,80,67,13,70015,13585,83600
310450,202002,628,384,244,403371.8,258115.9,661487.7
310460,202002,256,180,76,190190,79420,269610
310470,202002,497,315,182,336490,193325,529815
310480,202002,73,52,21,55385,21945,77330
310490,202002,533,255,278,267520,291555,559075
310500,202002,130,52,78,54340,81510,135850
310510,202002,601,414,187,436810,195415.45,632225.45
310520,202002,128,90,38,96140,39710,135850
310530,202002,101,42,59,43890,61655,105545
310540,202002,451,269,182,285285,193325,478610
310550,202002,79,50,29,53295,30305,83600
310560,202002,2962,2043,919,2163151,970805,3133956
310570,202002,101,68,33,71060,35530,106590
310590,202002,366,233,133,245575.25,140030,385605.25
310600,202002,148,80,68,83600.5,72105,155705.5
310610,202002,59,23,36,24035,37620,61655
310620,202002,46670,22400,24270,23727714.41,25730002.78,49457717.19
310630,202002,631,401,230,427405,249755.5,677160.5
310640,202002,127,98,29,110770,30305,141075
310650,202002,161,144,17,151525,18810,170335
310660,202002,99,63,36,65835,37620,103455
310665,202002,59,44,15,45980,15675,61655
310670,202002,6564,2877,3687,3046179.25,3900997.25,6947176.50
310680,202002,56,35,21,37620,21945,59565
310690,202002,603,423,180,444125.25,190190,634315.25
310700,202002,58,39,19,40755,19855,60610
310710,202002,1308,893,415,955130.95,437855.5,1392986.45
310720,202002,123,35,88,36575,91960,128535
310730,202002,1425,995,430,1050226.25,453530.5,1503756.75
310740,202002,974,541,433,567436,456665.25,1024101.25
310750,202002,242,145,97,153615.65,102410,256025.65
310760,202002,60,43,17,45980,17765.5,63745.5
310770,202002,101,49,52,51205,54340,105545
310780,202002,366,297,69,312455.45,72105,384560.45
310790,202002,99,81,18,84645,18810,103455
310800,202002,451,217,234,230945.25,246620,477565.25
310810,202002,168,121,47,127491.17,50160,177651.17
310820,202002,344,272,72,288420,76285,364705
310825,202002,193,165,28,172425,30305,202730
310830,202002,466,226,240,238260.5,253935,492195.5
310840,202002,363,213,150,224675,156750,381425
310850,202002,103,84,19,88825,20900,109725
310855,202002,396,313,83,327085,88825,415910
310860,202002,1585,1172,413,1240417.5,435766.25,1676183.75
310870,202002,52,43,9,44935,9405,54340
310880,202002,79,62,17,65835,17765,83600
310890,202002,300,177,123,187055,129580,316635
310900,202002,646,303,343,318734.86,362628.86,681363.72
310910,202002,235,161,74,169290.5,78375,247665.5
310920,202002,454,269,185,282151.7,196460.5,478612.2
310925,202002,37,31,6,32395,6270,38665
310930,202002,1312,824,488,867353.3,514142.2,1381495.5
310940,202002,678,344,334,361570,352165,713735
310945,202002,122,76,46,79420,48070,127490
310950,202002,238,192,46,202730,49115,251845
310960,202002,79,26,53,28215,56430.22,84645.22
310970,202002,159,100,59,104500,62700.5,167200.5
310980,202002,48,31,17,33440,17765,51205
310990,202002,154,79,75,84645,79420,164065
311000,202002,795,400,395,425316.49,415910.95,841227.44
311010,202002,43,38,5,39710,6270,45980
311020,202002,44,27,17,28215,17765,45980
311030,202002,385,226,159,237215.5,169290,406505.5
311040,202002,43,33,10,35530,10450,45980
311050,202002,481,193,288,202730,303050,505780
311060,202002,781,434,347,457710,365750.5,823460.5
311070,202002,342,157,185,166155,196460,362615
311080,202002,109,60,49,62700,51205,113905
311090,202002,338,159,179,167200,190190,357390
311100,202002,593,357,236,377245,247665,624910
311110,202002,690,481,209,505780,219450,725230
311115,202002,77,55,22,58520,22990,81510
311120,202002,1080,578,502,605055.5,529815,1134870.5
311130,202002,358,218,140,227810,150480,378290
311140,202002,168,90,78,94050,81510,175560
311150,202002,350,230,120,244530,126445,370975
311160,202002,688,491,197,524590.5,209000,733590.5
311170,202002,84,67,17,70015,17765,87780
311180,202002,320,218,102,230945,109725.5,340670.5
311190,202002,39,20,19,20900,19855,40755
311200,202002,324,228,96,240350,100320,340670
311205,202002,34,23,11,24035,11495,35530
311210,202002,45,40,5,42845.5,5225,48070.5
311220,202002,23,20,3,20900,3135,24035
311230,202002,1627,1070,557,1126510.5,585200,1711710.5
311240,202002,181,117,64,122265,67925,190190
311250,202002,95,28,67,29260,70015,99275
311260,202002,552,345,207,360525,217360,577885
311265,202002,122,82,40,85690,41800,127490
311270,202002,282,192,90,203775,97185,300960
311280,202002,212,98,114,102410,119130,221540
311290,202002,103,85,18,90915,18810,109725
311300,202002,582,368,214,387695,227810,615505
311310,202002,22,17,5,17765,5225,22990
311320,202002,659,489,170,513095,179740,692835
311330,202002,1096,810,286,853765.9,302005.5,1155771.4
311340,202002,2614,1856,758,1957286,800470.45,2757756.45
311350,202002,276,214,62,224675,65835,290510
311360,202002,171,107,64,114950,70015,184965
311370,202002,1204,497,707,522500.25,746130,1268630.25
311380,202002,7,6,1,6270,1045,7315
311390,202002,261,143,118,149435,124355,273790
311400,202002,137,88,49,93005,51205,144210
311410,202002,105,57,48,59565,51205,110770
311420,202002,304,167,137,175560,144210,319770
311430,202002,845,566,279,596695.25,298870.5,895565.75
311440,202002,463,328,135,344850,143165,488015
311450,202002,315,195,120,209000,125400,334400
311455,202002,278,190,88,198550,97185,295735
311460,202002,141,61,80,64790,84645,149435
311470,202002,22,12,10,12540,10450,22990
311480,202002,47,21,26,21945,27170,49115
311490,202002,13,9,4,9405,4180,13585
311500,202002,24,11,13,11495,13585,25080
311510,202002,636,438,198,465025,206910,671935
311520,202002,41,33,8,34485,8360,42845
311530,202002,1794,1327,467,1399256.7,493240,1892496.7
311535,202002,67,47,20,50160,20900,71060
311540,202002,34,30,4,31350,4180,35530
311545,202002,179,134,45,140030,48070,188100
311547,202002,36,30,6,31350,7315,38665
311550,202002,685,319,366,337535,386650.45,724185.45
311560,202002,43,29,14,30305,14630,44935
311570,202002,282,191,91,200640,97185,297825
311580,202002,333,201,132,210045,138985,349030
311590,202002,33,30,3,31350,3135,34485
311600,202002,103,79,24,85690,25080,110770
311610,202002,249,214,35,229900.25,36575,266475.25
311615,202002,71,58,13,60610,13585,74195
311620,202002,25,14,11,14630,12540,27170
311630,202002,83,69,14,72105,14630,86735
311640,202002,131,65,66,67925,68970,136895
311650,202002,125,88,37,91960,38665,130625
311660,202002,405,198,207,209000,218405,427405
311670,202002,151,101,50,105546.41,53295,158841.41
311680,202002,203,150,53,160930,56430,217360
311690,202002,15,11,4,11495,4180,15675
311700,202002,195,139,56,145255,60610,205865
311710,202002,199,131,68,137940,73150,211090
311720,202002,39,29,10,30305.5,10450,40755.5
311730,202002,577,386,191,409640,199595,609235
311740,202002,35,25,10,27170,10450,37620
311750,202002,718,484,234,507870.76,246620,754490.76
311760,202002,64,30,34,31350,35530,66880
311770,202002,391,197,194,207956.35,205865,413821.35
311780,202002,174,92,82,98230.5,85690,183920.5
311783,202002,86,77,9,80465,9405,89870
311787,202002,36,13,23,13585,24035,37620
311790,202002,258,114,144,125400,151525,276925
311800,202002,668,448,220,470250.95,236170,706420.95
311810,202002,49,41,8,42845,8360,51205
311820,202002,120,99,21,103455,21945,125400
311830,202002,1898,1183,715,1259226.25,754490,2013716.25
311840,202002,1004,558,446,594606,472340.25,1066946.25
311850,202002,10,6,4,6270,4180,10450
311860,202002,9517,4199,5318,4446477.25,5621058.51,10067535.76
311870,202002,129,65,64,67925,66880,134805
311880,202002,924,673,251,708510.5,264385.5,972896.0
311890,202002,210,103,107,108594,113905,222499
311900,202002,75,30,45,31350,47025,78375
311910,202002,1392,881,511,933185.75,542355.5,1475541.25
311920,202002,225,149,76,157795,81510,239305
311930,202002,898,514,384,540265.5,407550,947815.5
311940,202002,2471,1300,1171,1379400,1237280.15,2616680.15
311950,202002,56,43,13,45980,13585,59565
311960,202002,59,43,16,44935,16720,61655
311970,202002,23,14,9,15675,9405,25080
311980,202002,44,35,9,37620,9405,47025
311990,202002,38,30,8,31350,8360,39710
311995,202002,54,36,18,37620,19855,57475
312000,202002,29,22,7,22990,7315,30305
312010,202002,75,61,14,63745,16720,80465
312015,202002,78,61,17,63745,17765,81510
312020,202002,128,83,45,87780,47025,134805
312030,202002,55,41,14,43890,14630,58520
312040,202002,87,52,35,55385,36575,91960
312050,202002,205,114,91,121220,95095,216315
312060,202002,24,13,11,13585,11495,25080
312070,202002,77,50,27,52250,29260,81510
312080,202002,535,242,293,253935,308275,562210
312083,202002,57,38,19,40755,19855,60610
312087,202002,107,84,23,89870,25080,114950
312090,202002,3140,1894,1246,1991773.1,1309385.5,3301158.6
312100,202002,150,106,44,110530.15,45980,156510.15
312110,202002,113,68,45,73150,47025,120175
312120,202002,143,105,38,109726.14,40755,150481.14
312125,202002,89,48,41,51205,42845,94050
312130,202002,124,83,41,87780,44935,132715
312140,202002,134,106,28,111815,29260,141075
312150,202002,43,33,10,36575,10450,47025
312160,202002,1553,1025,528,1077492,554895.5,1632387.5
312170,202002,11,10,1,10450,1045,11495
312180,202002,113,66,47,71060,49115.5,120175.5
312190,202002,34,30,4,31350,4180,35530
312200,202002,758,646,112,680295.5,118085,798380.5
312210,202002,109,60,49,62700,51205,113905
312220,202002,135,100,35,104500.25,36575,141075.25
312230,202002,3581,1701,1880,1803671.3,1988639.15,3792310.45
312235,202002,168,113,55,118085,57475,175560
312240,202002,97,69,28,72105,29260,101365
312245,202002,185,128,57,133760.22,60610,194370.22
312247,202002,70,49,21,51205,21945,73150
312250,202002,176,85,91,90915,96140,187055
312260,202002,111,73,38,76285,40755,117040
312270,202002,128,75,53,79420,56430,135850
312280,202002,26,12,14,12540,14630,27170
312290,202002,148,106,42,110770,44935,155705
312300,202002,205,131,74,136895,77330,214225
312310,202002,59,54,5,56430,6270,62700
312320,202002,427,271,156,284240,166155.75,450395.75
312330,202002,89,78,11,82555,11495,94050
312340,202002,37,17,20,17765,20900,38665
312350,202002,18,11,7,11495,7315,18810
312352,202002,94,69,25,74195,26125,100320
312360,202002,573,253,320,265430,334400,599830
312370,202002,297,168,129,178695,134805.5,313500.5
312380,202002,144,95,49,100320,51205,151525
312385,202002,167,133,34,140030,36575,176605
312390,202002,307,190,117,199595,122265,321860
312400,202002,375,284,91,299915,95095.5,395010.5
312410,202002,976,315,661,331265,694925.22,1026190.22
312420,202002,622,479,143,506825.5,151525,658350.5
312430,202002,864,637,227,671936.11,237215,909151.11
312440,202002,42,32,10,33440,10450,43890
312450,202002,209,131,78,136895,81510,218405
312460,202002,33,16,17,16720,17765,34485
312470,202002,48,32,16,33440,16720,50160
312480,202002,191,118,73,125400,77330,202730
312490,202002,269,188,81,198550,84645,283195
312500,202002,33,18,15,19855,15675,35530
312510,202002,522,209,313,219450,329175.9,548625.9
312520,202002,31,9,22,10450,22990,33440
312530,202002,48,33,15,35530,15675,51205
312540,202002,98,87,11,90915,12540,103455
312550,202002,36,29,7,30305,8360,38665
312560,202002,216,167,49,174515.5,51205,225720.5
312570,202002,436,265,171,279015,180785,459800
312580,202002,89,47,42,49115,43890,93005
312590,202002,249,199,50,207955,53295,261250
312595,202002,134,121,13,126445,13585,140030
312600,202002,68,38,30,40755.25,31350,72105.25
312610,202002,1568,813,755,854812,796291.48,1651103.48
312620,202002,201,144,57,153615,60610,214225
312630,202002,62,53,9,55385,9405,64790
312640,202002,45,13,32,14630,33440,48070
312650,202002,146,121,25,130625.5,26125,156750.5
312660,202002,85,62,23,64790.75,24035,88825.75
312670,202002,915,595,320,627000,336490,963490
312675,202002,32,25,7,27170,7315,34485
312680,202002,77,50,27,52250,28215,80465
312690,202002,249,129,120,134805,126445,261250
312695,202002,37,31,6,32395,6270,38665
312700,202002,229,132,97,137940,105545,243485
312705,202002,83,68,15,71060,15675,86735
312707,202002,128,91,37,97185.3,38665,135850.3
312710,202002,1879,1004,875,1053361.41,925870,1979231.41
312720,202002,60,31,29,32395,30305,62700
312730,202002,277,162,115,169290,121220,290510
312733,202002,53,45,8,48070,8360,56430
312735,202002,23,14,9,14630,9405,24035
312737,202002,67,36,31,38665,32395,71060
312738,202002,56,40,16,41800,16720,58520
312740,202002,81,53,28,55385,29260,84645
312750,202002,75,54,21,56430,21945,78375
312760,202002,287,206,81,217360,84645,302005
312770,202002,7741,3578,4163,3778726.05,4397363.15,8176089.20
312780,202002,420,320,100,336490,106590,443080
312790,202002,21,16,5,16720,5225,21945
312800,202002,1571,1097,474,1155771.65,502645.15,1658416.80
312810,202002,371,235,136,246620,142120,388740
312820,202002,185,141,44,149435,47025,196460
312825,202002,25,16,9,17765,9405,27170
312830,202002,239,137,102,143165.15,106590,249755.15
312840,202002,158,109,49,114950,51205,166155
312850,202002,43,39,4,41800,4180,45980
312860,202002,152,95,57,102410,59565,161975
312870,202002,1041,542,499,570570.75,525635,1096205.75
312880,202002,129,90,39,94050,40755,134805
312890,202002,158,114,44,119130,45980,165110
312900,202002,195,146,49,153615,51205,204820
312910,202002,177,92,85,96140,88825,184965
312920,202002,155,87,68,91960,71060,163020
312930,202002,327,230,97,242440,101365,343805
312940,202002,110,78,32,83600,33440,117040
312950,202002,694,471,223,494285,236170,730455
312960,202002,174,130,44,136895.4,47025,183920.4
312965,202002,73,63,10,65835,10450,76285
312970,202002,266,217,49,234080.25,53295,287375.25
312980,202002,2432,1228,1204,1304161.45,1267586.25,2571747.70
312990,202002,42,23,19,24035,19855,43890
313000,202002,49,28,21,29260,22990,52250
313005,202002,173,135,38,141075,40755.5,181830.5
313010,202002,905,362,543,387695.02,572660.45,960355.47
313020,202002,186,100,86,105545,90915,196460
313030,202002,194,130,64,135850.35,67925,203775.35
313040,202002,74,24,50,26125,52250,78375
313050,202002,183,130,53,136895,55385,192280
313055,202002,40,31,9,32395,9405,41800
313060,202002,128,89,39,93005,40755,133760
313065,202002,61,44,17,45980,17765,63745
313070,202002,132,68,64,72105,66880,138985
313080,202002,40,17,23,17765,24035,41800
313090,202002,646,427,219,453530,230945,684475
313100,202002,172,64,108,67925,117040,184965
313110,202002,136,73,63,76285,65835,142120
313115,202002,201,114,87,120175,91960,212135
313120,202002,790,446,344,473385.5,362616,836001.5
313130,202002,5601,3069,2532,3232188.2,2686696.75,5918884.95
313140,202002,142,75,67,78375,71060,149435
313150,202002,303,243,60,256025,62700,318725
313160,202002,188,138,50,145255.5,52250,197505.5
313170,202002,1369,941,428,991705.5,454575.45,1446280.95
313180,202002,297,174,123,183920.5,128535,312455.5
313190,202002,743,448,295,473385.5,311410,784795.5
313200,202002,28,25,3,26125,3135,29260
313210,202002,990,840,150,887207.55,156750,1043957.55
313220,202002,260,170,90,177650,95095.5,272745.5
313230,202002,262,200,62,212135.87,64790,276925.87
313240,202002,2099,1095,1004,1157863.47,1055450,2213313.47
313250,202002,1254,951,303,997976,321860.8,1319836.8
313260,202002,90,48,42,51205,43890,95095
313270,202002,963,562,401,594605.75,424271,1018876.75
313280,202002,52,44,8,45980,8360,54340
313290,202002,217,174,43,184965,44935,229900
313300,202002,347,182,165,190190,173470,363660
313310,202002,248,122,126,127490,132715,260205
313320,202002,374,282,92,295735,96140,391875
313330,202002,1396,866,530,908105,556985,1465090
313340,202002,324,229,95,240350,99275,339625
313350,202002,501,335,166,351120,174515,525635
313360,202002,126,68,58,72105,60610.5,132715.5
313370,202002,203,68,135,71060,142120,213180
313375,202002,278,167,111,176605,117040,293645
313380,202002,1348,711,637,750310.5,669845.22,1420155.72
313390,202002,52,46,6,48070,6270,54340
313400,202002,401,273,128,288420,134806,423226
313410,202002,22,12,10,12540,11495,24035
313420,202002,4581,2455,2126,2593691,2238390.5,4832081.5
313430,202002,137,67,70,71060,73150,144210
313440,202002,1432,982,450,1033507.71,472342,1505849.71
313450,202002,65,26,39,28215,40755,68970
313460,202002,379,169,210,179740.5,221540,401280.5
313470,202002,527,249,278,262295.78,294691,556986.78
313480,202002,146,108,38,114950.5,40755,155705.5
313490,202002,513,239,274,251845.5,288420.25,540265.75
313500,202002,24,13,11,13585,11495,25080
313505,202002,1008,796,212,839135,224675,1063810
313507,202002,99,55,44,59565,45980,105545
313510,202002,2776,1765,1011,1856966,1069035.5,2926001.5
313520,202002,3436,2677,759,2828818.11,803605.89,3632424.00
313530,202002,34,23,11,24035,11495,35530
313535,202002,59,47,12,50160,12540,62700
313540,202002,68,51,17,54340,17765.5,72105.5
313545,202002,112,94,18,99275,18810,118085
313550,202002,228,194,34,203775,36575.5,240350.5
313560,202002,332,166,166,173470,176605,350075
313570,202002,65,28,37,29260,38665,67925
313580,202002,1304,733,571,771211.25,604011.5,1375222.75
313590,202002,67,37,30,39710,31350,71060
313600,202002,678,413,265,437855,277970.5,715825.5
313610,202002,58,47,11,49115.1,11495,60610.1
313620,202002,1369,700,669,739861,713735,1453596
313630,202002,1606,1238,368,1303116,389785.9,1692901.9
313640,202002,120,74,46,77330,49115,126445
313650,202002,232,110,122,117040,128535.5,245575.5
313652,202002,17,17,0,17765,0,17765
313655,202002,62,40,22,41800,22990,64790
313657,202002,49,45,4,47025,4180,51205
313660,202002,134,93,41,98230,43908.81,142138.81
313665,202002,644,307,337,323950.75,355300,679250.75
313670,202002,10296,7067,3229,7488474.37,3407747,10896221.37
313680,202002,43,32,11,34485,11495.95,45980.95
313690,202002,145,110,35,115995,36575,152570
313695,202002,75,58,17,61655,17765,79420
313700,202002,304,245,59,258115.5,62700,320815.5
313710,202002,141,98,43,104500,47025,151525
313720,202002,1104,530,574,560120.5,608191.5,1168312.0
313730,202002,69,43,26,44935,28215,73150
313740,202002,149,119,30,125400,31350,156750
313750,202002,427,311,116,326040,122265,448305
313753,202002,238,177,61,186010,64790,250800
313760,202002,1282,466,816,492195,857946.25,1350141.25
313770,202002,372,272,100,287375.25,105545,392920.25
313780,202002,755,401,354,429495,376200,805695
313790,202002,26,26,0,27170,1045,28215
313800,202002,132,81,51,84645,53295,137940
313810,202002,76,43,33,44935,35530,80465
313820,202002,1303,631,672,670891,706420.62,1377311.62
313830,202002,58,42,16,44935,16720,61655
313835,202002,61,51,10,54340,10450,64790
313840,202002,1646,1001,645,1054406.5,679251,1733657.5
313850,202002,203,73,130,76285,135850,212135
313860,202002,477,363,114,381425.5,119130,500555.5
313862,202002,166,110,56,114950,58520,173470
313865,202002,115,85,30,88825,31350,120175
313867,202002,46,37,9,38665,9405,48070
313868,202002,32,20,12,20900,12540,33440
313870,202002,120,63,57,65835,59565,125400
313880,202002,370,230,140,245575,146300,391875
313890,202002,331,178,153,186010,160930,346940
313900,202002,889,482,407,505780.25,427405.25,933185.50
313910,202002,134,100,34,106590,36575,143165
313920,202002,629,448,181,470250,195415.44,665665.44
313925,202002,31,28,3,29260,3135,32395
313930,202002,856,669,187,703285,196460.12,899745.12
313940,202002,1832,1154,678,1215335,722095,1937430
313950,202002,881,553,328,583110,344850,927960
313960,202002,1384,787,597,828685.9,630137,1458822.9
313970,202002,138,93,45,98230,47025,145255
313980,202002,206,128,78,135850.25,82555,218405.25
313990,202002,234,158,76,167200,79420,246620
314000,202002,903,601,302,640585.85,319770,960355.85
314010,202002,82,53,29,55385,30305,85690
314015,202002,64,18,46,18810,48070,66880
314020,202002,56,37,19,38665,19855,58520
314030,202002,73,36,37,38665,39710,78375
314040,202002,41,24,17,25080,17765,42845
314050,202002,281,166,115,176605,121220,297825
314053,202002,98,63,35,66880,37620,104500
314055,202002,297,185,112,196460,119130.22,315590.22
314060,202002,136,118,18,124355.04,18810,143165.04
314070,202002,1053,554,499,582065,525635,1107700
314080,202002,204,132,72,143165,78375.4,221540.4
314085,202002,140,95,45,100320,47025,147345
314090,202002,370,268,102,284240.25,108680,392920.25
314100,202002,482,390,92,412775.75,97185.9,509961.65
314110,202002,733,386,347,408595.5,370975,779570.5
314120,202002,90,53,37,55385,38665,94050
314130,202002,22,12,10,12540,10450,22990
314140,202002,1089,673,416,712690,438900,1151590
314150,202002,169,106,63,112860,65835,178695
314160,202002,333,255,78,268565,81510,350075
314170,202002,80,63,17,65835,17765,83600
314180,202002,722,641,81,680295.5,84645.25,764940.75
314190,202002,98,60,38,62700,39710,102410
314200,202002,482,329,153,344850.5,159885,504735.5
314210,202002,250,193,57,205865,59565.5,265430.5
314220,202002,305,226,79,238260.5,84645,322905.5
314225,202002,64,47,17,49115,18810,67925
314230,202002,117,54,63,56430,66880,123310
314240,202002,143,109,34,113905,35530,149435
314250,202002,52,30,22,31350,22990,54340
314260,202002,213,106,107,110770,113905,224675
314270,202002,353,276,77,291555,81510,373065
314280,202002,703,389,314,409640.45,329175,738815.45
314290,202002,539,436,103,461890,107635,569525
314300,202002,362,261,101,272745.75,106590.25,379336.00
314310,202002,1370,925,445,979427.57,470250.94,1449678.51
314315,202002,31,25,6,26125,6270,32395
314320,202002,590,389,201,410685.5,211090,621775.5
314330,202002,10914,5371,5543,5674353.15,5852002.46,11526355.61
314340,202002,597,277,320,289465,336491,625956
314345,202002,44,30,14,32395,14630,47025
314350,202002,183,116,67,122265,70015,192280
314360,202002,65,40,25,41800,26125,67925
314370,202002,65,47,18,50160,18810,68970
314380,202002,92,60,32,62700,34485,97185
314390,202002,3318,2144,1174,2262426.35,1241460,3503886.35
314400,202002,679,487,192,512051.75,202730,714781.75
314410,202002,470,307,163,321860,171380,493240
314420,202002,15,7,8,7315,8360,15675
314430,202002,2420,895,1525,946771.76,1614525.5,2561297.26
314435,202002,205,128,77,134805,80465,215270
314437,202002,28,22,6,22990,6270,29260
314440,202002,95,69,26,72105,28215,100320
314450,202002,154,108,46,112860,49115,161975
314460,202002,638,299,339,317680,356345,674025
314465,202002,90,60,30,62700,31350,94050
314467,202002,69,57,12,59565,13585,73150
314470,202002,413,208,205,217361.95,215270,432631.95
314480,202002,1057,506,551,538175,579975,1118150
314490,202002,48,34,14,35530,14630,50160
314500,202002,286,194,92,206910,98230,305140
314505,202002,119,79,40,84645,41800,126445
314510,202002,237,195,42,203775,43890,247665
314520,202002,1282,684,598,722102,632226.5,1354328.5
314530,202002,738,594,144,622821.01,154660.9,777481.91
314535,202002,191,118,73,123310,77330,200640
314537,202002,61,36,25,38665,26125,64790
314540,202002,15,10,5,10450,5225,15675
314545,202002,52,34,18,35530,18810,54340
314550,202002,80,42,38,43890,39710,83600
314560,202002,868,478,390,504735.5,408595,913330.5
314570,202002,20,16,4,16720,4180,20900
314580,202002,13,5,8,5225,8360,13585
314585,202002,26,19,7,19855,7315,27170
314587,202002,85,73,12,76285,12540,88825
314590,202002,561,406,155,430540.75,163020,593560.75
314600,202002,930,605,325,637451,340671.69,978122.69
314610,202002,934,490,444,523546.25,469205,992751.25
314620,202002,140,105,35,109725,36575.5,146300.5
314625,202002,94,69,25,72105.5,26125,98230.5
314630,202002,1167,621,546,651035,578930,1229965
314640,202002,80,53,27,55385,28215.5,83600.5
314650,202002,181,104,77,109725,81510,191235
314655,202002,67,49,18,51205,18810,70015
314660,202002,17,14,3,14630,3135,17765
314670,202002,201,154,47,160930.5,50160,211090.5
314675,202002,211,126,85,131670,90915,222585
314690,202002,583,312,271,328130,284240,612370
314700,202002,2284,1241,1043,1310432,1101430,2411862
314710,202002,1677,988,689,1037686.75,728365.5,1766052.25
314720,202002,383,229,154,245575,164065,409640
314730,202002,502,263,239,280061,252890.45,532951.45
314740,202002,696,340,356,361570,374110,735680
314750,202002,22,19,3,19855,3135,22990
314760,202002,334,158,176,165110,184965,350075
314770,202002,105,74,31,77330,32395,109725
314780,202002,17,6,11,6270,11495,17765
314790,202002,2344,1478,866,1557051.45,921690,2478741.45
314795,202002,49,39,10,42845,10450,53295
314800,202002,2917,1706,1211,1794268.12,1278035,3072303.12
314810,202002,1523,868,655,917510,689700,1607210
314820,202002,109,60,49,63745,51205,114950
314830,202002,212,170,42,178695,43890,222585
314840,202002,84,50,34,52250,36575,88825
314850,202002,371,187,184,198550.5,195415,393965.5
314860,202002,676,515,161,543400.5,170335,713735.5
314870,202002,1507,796,711,840180.5,749265,1589445.5
314875,202002,55,47,8,51205,8360,59565
314880,202002,43,29,14,30305,14630,44935
314890,202002,56,33,23,34485,24035,58520
314900,202002,30,23,7,24035,7315,31350
314910,202002,242,161,81,170335,84645,254980
314915,202002,144,127,17,133760,17765,151525
314920,202002,102,63,39,66880,41800,108680
314930,202002,1056,519,537,550715.5,567435,1118150.5
314940,202002,48,38,10,39710,10450,50160
314950,202002,33,23,10,24035,10450,34485
314960,202002,38,30,8,31350,8360,39710
314970,202002,148,71,77,76285,80465,156750
314980,202002,301,195,106,206910,111815,318725
314990,202002,439,242,197,254980,207955,462935
314995,202002,202,67,135,70015,142120,212135
315000,202002,91,69,22,72105,22990,95095
315010,202002,44,28,16,29260,16720,45980
315015,202002,168,135,33,142120,34485,176605
315020,202002,71,58,13,60610,13585,74195
315030,202002,114,88,26,91960.5,27170,119130.5
315040,202002,71,50,21,52250,21945,74195
315050,202002,181,108,73,112860,76285,189145
315053,202002,44,37,7,38665,7315,45980
315057,202002,100,79,21,82555,22990,105545
315060,202002,73,63,10,65835.8,10450,76285.8
315070,202002,103,57,46,59565,49115,108680
315080,202002,372,301,71,314545,75240,389785
315090,202002,98,59,39,61655,41800,103455
315100,202002,82,41,41,43890,42845,86735
315110,202002,271,145,126,153615,132715,286330
315120,202002,1694,842,852,886160,896610.2,1782770.2
315130,202002,346,250,96,261250,100320,361570
315140,202002,516,300,216,313500.5,226765.5,540266.0
315150,202002,959,458,501,483835,529815.5,1013650.5
315160,202002,216,108,108,115995,112860.9,228855.9
315170,202002,311,205,106,216315.5,110770,327085.5
315180,202002,3267,1360,1907,1450462.54,2019986.25,3470448.79
315190,202002,323,191,132,200640,138985,339625
315200,202002,1230,727,503,765985,532950,1298935
315210,202002,1642,942,700,996930,737770,1734700
315213,202002,40,23,17,24035,17765,41800
315217,202002,213,169,44,177650,45980,223630
315220,202002,1563,1183,380,1245640.95,399190,1644830.95
315230,202002,172,123,49,131670.5,51205,182875.5
315240,202002,421,269,152,284240,158840.95,443080.95
315250,202002,2540,1265,1275,1332375,1343870.5,2676245.5
315260,202002,142,82,60,86735,62700,149435
315270,202002,126,89,37,94050,38665,132715
315280,202002,651,422,229,444125,242440,686565
315290,202002,193,119,74,124355,79420,203775
315300,202002,73,55,18,57475,18810,76285
315310,202002,73,66,7,68970,7315,76285
315320,202002,168,99,69,103455,72105,175560
315330,202002,56,47,9,49115,9405,58520
315340,202002,388,282,106,295735,111815,407550
315350,202002,150,91,59,97185,63745,160930
315360,202002,90,47,43,49115,44935,94050
315370,202002,54,35,19,36575,20900,57475
315380,202002,11,8,3,8360,3135,11495
315390,202002,65,16,49,17765,52250.5,70015.5
315400,202002,844,629,215,663575.5,224675,888250.5
315410,202002,325,191,134,205865.5,141076.5,346942.0
315415,202002,58,43,15,44935,15675,60610
315420,202002,197,146,51,155705.5,53295,209000.5
315430,202002,658,374,284,396055.5,297825,693880.5
315440,202002,94,67,27,70015,28215,98230
315445,202002,233,191,42,205865,45980,251845
315450,202002,181,139,42,145255,43890,189145
315460,202002,3908,1926,1982,2042975.95,2101495.45,4144471.40
315470,202002,41,16,25,16720,26125,42845
315480,202002,64,22,42,24035,43890,67925
315490,202002,651,409,242,431585,258115,689700
315500,202002,18,12,6,12540,7315,19855
315510,202002,150,101,49,105545,52250,157795
315520,202002,68,61,7,64790,7315,72105
315530,202002,47,26,21,27170,22990,50160
315540,202002,237,163,74,172425,78375,250800
315550,202002,177,142,35,149435,36575,186010
315560,202002,730,589,141,621775.5,149435,771210.5
315570,202002,309,163,146,171381.4,155705,327086.4
315580,202002,703,472,231,494285,245575,739860
315590,202002,198,104,94,110770,98230,209000
315600,202002,307,231,76,242440,79420,321860
315610,202002,98,52,46,54340,48070,102410
315620,202002,35,28,7,29260,7315,36575
315630,202002,129,86,43,91960,45980,137940
315640,202002,70,43,27,44935,28215,73150
315645,202002,46,32,14,33440,14630,48070
315650,202002,171,123,48,130626,51205,181831
315660,202002,460,204,256,213180.5,267520,480700.5
315670,202002,2375,1154,1221,1216382,1288485.9,2504867.9
315680,202002,842,588,254,617595,267520,885115
315690,202002,675,467,208,490107.08,221540,711647.08
315700,202002,1883,994,889,1047091.21,935275,1982366.21
315710,202002,342,101,241,105545,254980,360525
315720,202002,445,276,169,293645.5,176605,470250.5
315725,202002,190,153,37,160930.5,39710,200640.5
315727,202002,49,23,26,24035,27170,51205
315730,202002,48,46,2,50160,2090,52250
315733,202002,87,60,27,63745,28215,91960
315737,202002,50,37,13,38665,13585,52250
315740,202002,32,25,7,27170,7315,34485
315750,202002,159,118,41,124355,42845,167200
315760,202002,41,31,10,34485,10450,44935
315765,202002,123,74,49,77330,51205,128535
315770,202002,217,135,82,146300,86735.5,233035.5
315780,202002,3427,1733,1694,1835020.75,1797401.49,3632422.24
315790,202002,222,174,48,183920,50160,234080
315800,202002,289,205,84,215270,87780,303050
315810,202002,95,57,38,59565,40755.5,100320.5
315820,202002,742,538,204,567435.5,216315,783750.5
315830,202002,128,78,50,81510,52250,133760
315840,202002,87,58,29,61655,30305,91960
315850,202002,252,182,70,191235.25,73150,264385.25
315860,202002,14,5,9,5225,9405,14630
315870,202002,37,27,10,28215,10450,38665
315880,202002,106,67,39,71060,40755,111815
315890,202002,90,67,23,70015,24035,94050
315895,202002,439,295,144,311410.25,153616,465026.25
315900,202002,70,33,37,34485,38665,73150
315910,202002,39,24,15,25080,15675,40755
315920,202002,165,108,57,113905,61655.75,175560.75
315930,202002,47,17,30,18810,31350,50160
315935,202002,129,100,29,104500.5,30305.45,134805.95
315940,202002,99,73,26,76285,27170,103455
315950,202002,41,30,11,32395,11495,43890
315960,202002,531,255,276,269610,294690.5,564300.5
315970,202002,33,27,6,28215,6270,34485
315980,202002,689,339,350,356345,369930,726275
315990,202002,250,145,105,154660,109725.95,264385.95
316000,202002,50,32,18,34485,18810,53295
316010,202002,78,68,10,71060,10450,81510
316020,202002,116,99,17,103455,17765,121220
316030,202002,390,218,172,228855.5,181830.75,410686.25
316040,202002,522,220,302,230945.5,318725.5,549671.0
316045,202002,62,56,6,58520,6270,64790
316050,202002,13,11,2,11495,2090,13585
316060,202002,95,63,32,66880,33440,100320
316070,202002,1087,700,387,737770.75,409640,1147410.75
316080,202002,102,67,35,70015,36575,106590
316090,202002,38,20,18,21945,19855,41800
316095,202002,102,84,18,88825,18810,107635
316100,202002,307,179,128,187055.25,136895,323950.25
316105,202002,37,24,13,25080,13585,38665
316110,202002,1860,1488,372,1564366.52,392920,1957286.52
316120,202002,80,59,21,61655,21945,83600
316130,202002,122,92,30,97185.5,31350,128535.5
316140,202002,33,22,11,22990,11495,34485
316150,202002,203,140,63,146300,65835,212135
316160,202002,79,45,34,47025,35530,82555
316165,202002,63,48,15,50160,15675,65835
316170,202002,186,124,62,129580,64790,194370
316180,202002,197,85,112,89870,118085.5,207955.5
316190,202002,138,100,38,106590,39710,146300
316200,202002,653,364,289,384560,306185,690745
316210,202002,768,513,255,540444.74,268565,809009.74
316220,202002,114,75,39,78375,40755,119130
316225,202002,24,14,10,15675,12540,28215
316230,202002,32,18,14,19855,14630,34485
316240,202002,654,525,129,553850,136895,690745
316245,202002,125,109,16,114950,16720,131670
316250,202002,1518,1040,478,1102475.95,509960.45,1612436.40
316255,202002,121,97,24,101365,26125,127490
316257,202002,181,94,87,99275,91960,191235
316260,202002,196,140,56,147345.25,59565.5,206910.75
316265,202002,27,18,9,18810,9405,28215
316270,202002,683,480,203,505780.5,214225.6,720006.1
316280,202002,546,343,203,360525.29,213181,573706.29
316290,202002,744,495,249,518320.65,263340,781660.65
316292,202002,504,202,302,212135,320815.9,532950.9
316294,202002,99,60,39,62700,41800,104500
316295,202002,302,132,170,138986.35,181830,320816.35
316300,202002,102,70,32,73150,34485,107635
316310,202002,30,16,14,16720,15675,32395
316320,202002,46,26,20,27170,20900,48070
316330,202002,161,110,51,114950.25,53295,168245.25
316340,202002,138,96,42,100320,43890,144210
316350,202002,190,136,54,143165.74,58520,201685.74
316360,202002,19,13,6,13585,6270,19855
316370,202002,1101,574,527,608191.25,561165,1169356.25
316380,202002,118,89,29,93005,30305,123310
316390,202002,117,86,31,89870,32395,122265
316400,202002,132,101,31,105545,32395,137940
316410,202002,286,207,79,217360,85690,303050
316420,202002,204,139,65,148390,67925,216315
316430,202002,151,81,70,84645,74195,158840
316440,202002,87,42,45,44935,47025,91960
316443,202002,41,39,2,40755,2090,42845
316447,202002,54,41,13,42845,13585,56430
316450,202002,227,174,53,181830,55385,237215
316460,202002,76,27,49,28215,51205,79420
316470,202002,1661,1224,437,1292657.76,457710,1750367.76
316480,202002,11,8,3,9405,3135,12540
316490,202002,18,7,11,7315,11495,18810
316500,202002,149,100,49,105545,51205,156750
316510,202002,157,121,36,126445,37620,164065
316520,202002,190,119,71,125400,76285,201685
316530,202002,159,108,51,112860,53295,166155
316540,202002,141,76,65,79420,68970,148390
316550,202002,128,86,42,90915,43890,134805
316553,202002,294,136,158,143165,167200.72,310365.72
316555,202002,38,32,6,33440,6270,39710
316556,202002,12,9,3,9405,3135,12540
316557,202002,19,17,2,17765,2090,19855
316560,202002,66,47,19,49115,19855,68970
316570,202002,220,200,20,215270,21945,237215
316580,202002,17,14,3,14630,3135,17765
316590,202002,103,87,16,91960,16720,108680
316600,202002,179,148,31,157795.5,32395,190190.5
316610,202002,66,50,16,52250,16720,68970
316620,202002,138,105,33,110770,35530,146300
316630,202002,43,34,9,35530,9405,44935
316640,202002,22,14,8,15675,8360,24035
316650,202002,75,62,13,64790,13585,78375
316660,202002,8,3,5,3135,5225,8360
316670,202002,432,151,281,160930.9,297825,458755.9
316680,202002,159,110,49,114950,51205,166155
316690,202002,189,118,71,124355,74195,198550
316695,202002,64,55,9,58520,9405,67925
316700,202002,16,10,6,10450,6270,16720
316710,202002,767,576,191,605055.25,202730,807785.25
316720,202002,4935,2426,2509,2559208.98,2643851.22,5203060.20
316730,202002,16,16,0,16720,0,16720
316740,202002,139,89,50,94050,53295,147345
316750,202002,17,10,7,11495,7315,18810
316760,202002,324,258,66,274835,68970,343805
316770,202002,153,79,74,82555,77330,159885
316780,202002,69,42,27,44935,28215,73150
316790,202002,51,38,13,40755,13585,54340
316800,202002,1742,1086,656,1142185,690745.5,1832930.5
316805,202002,22,14,8,14630,8360,22990
316810,202002,68,44,24,45980,25080,71060
316820,202002,42,21,21,21945,21945,43890
316830,202002,93,44,49,45980,52250,98230
316840,202002,526,303,223,318725,234080,552805
316850,202002,331,221,110,233035,117040,350075
316860,202002,5908,2632,3276,2781794.15,3457905.75,6239699.90
316870,202002,1518,984,534,1041867.25,560120,1601987.25
316880,202002,123,62,61,68970,65835,134805
316890,202002,239,164,75,171380,81510,252890
316900,202002,418,297,121,313500.65,128535,442035.65
316905,202002,22,10,12,10450,12540,22990
316910,202002,64,28,36,30305,37620,67925
316920,202002,132,106,26,112860,28215,141075
316930,202002,1886,972,914,1028281.5,960355.75,1988637.25
316935,202002,906,555,351,582065.1,368885.5,950950.6
316940,202002,1080,619,461,654170.5,488015.5,1142186.0
316950,202002,178,88,90,94050.08,95095,189145.08
316960,202002,1105,624,481,655216.5,509960,1165176.5
316970,202002,652,517,135,542355.5,144210,686565.5
316980,202002,76,44,32,45980,33440,79420
316990,202002,2166,1454,712,1536150.85,750310.75,2286461.60
317000,202002,329,252,77,264385,80465,344850
317005,202002,238,167,71,176605,74195,250800
317010,202002,6337,3513,2824,3724385.23,2983476,6707861.23
317020,202002,15934,6983,8951,7423696.05,9459348.87,16883044.92
317030,202002,80,31,49,32395,52250,84645
317040,202002,3050,1900,1150,2014761.5,1208020,3222781.5
317043,202002,75,55,20,58520,21945,80465
317047,202002,30,17,13,17765,13585.22,31350.22
317050,202002,157,117,40,126445,41800,168245
317052,202002,132,99,33,103455,34485,137940
317057,202002,168,129,39,136895,40755,177650
317060,202002,65,41,24,42845,25080,67925
317065,202002,54,44,10,45980,11495,57475
317070,202002,1944,906,1038,960355.5,1103521,2063876.5
317075,202002,107,59,48,61655,50160,111815
317080,202002,896,466,430,488015.75,452485,940500.75
317090,202002,639,514,125,542355,132715,675070
317100,202002,421,318,103,336490,108680,445170
317103,202002,96,78,18,83600,19855,103455
317107,202002,45,39,6,41800,6270,48070
317110,202002,113,48,65,50160,67925,118085
317115,202002,39,34,5,35530,5225,40755
317120,202002,1893,926,967,981256.5,1023055.5,2004312.0
317130,202002,1963,1310,653,1378356.5,687610,2065966.5
317140,202002,10,8,2,8360,2090,10450
317150,202002,262,157,105,167200.5,109725,276925.5
317160,202002,319,238,81,249755.79,86735,336490.79
317170,202002,215,148,67,157795,70015,227810
317180,202002,437,306,131,327085,140030,467115
317190,202002,261,183,78,191235,82555,273790
317200,202002,813,569,244,600878.85,257070,857948.85
317210,202002,187,102,85,107635,88825,196460
317220,202002,24,13,11,13585,11495,25080
320010,202002,607,444,163,467115.25,172425,639540.25
320013,202002,121,88,33,91960,34485,126445
320016,202002,272,170,102,177650,107635,285285
320020,202002,708,412,296,436811.87,312455,749266.87
320030,202002,146,103,43,107635,45980.25,153615.25
320035,202002,140,105,35,109725,37620,147345
320040,202002,486,246,240,263340,253935,517275
320050,202002,101,75,26,78375,27170,105545
320060,202002,1631,781,850,829731.15,896613.1,1726344.25
320070,202002,101,65,36,71060,37620,108680
320080,202002,795,457,338,485925.75,357390,843315.75
320090,202002,1223,834,389,881980,409640,1291620
320100,202002,326,189,137,197505,146300,343805
320110,202002,118,78,40,81511.25,41800,123311.25
320115,202002,109,89,20,94050,20900,114950
320120,202002,3395,1852,1543,1958332.65,1639605.5,3597938.15
320130,202002,7380,3374,4006,3573908.41,4232267.02,7806175.43
320140,202002,438,290,148,305140,157795.91,462935.91
320150,202002,2038,1160,878,1223697.12,927960,2151657.12
320160,202002,646,292,354,311410.22,374110.72,685520.94
320170,202002,109,86,23,90915,24035,114950
320180,202002,51,30,21,32395,22990,55385
320190,202002,242,158,84,167200,87780.5,254980.5
320200,202002,57,44,13,45980,13585,59565
320210,202002,900,499,401,524591,420091.9,944682.9
320220,202002,302,108,194,114950.45,203775,318725.45
320225,202002,88,69,19,73150,19855,93005
320230,202002,596,379,217,401280,229900,631180
320240,202002,3199,1570,1629,1650057,1717980.95,3368037.95
320245,202002,469,317,152,332310.5,160930,493240.5
320250,202002,226,116,110,122265,114950,237215
320255,202002,145,113,32,118085,33440,151525
320260,202002,200,139,61,146300,63745,210045
320265,202002,164,131,33,136895,34485,171380
320270,202002,154,122,32,130625,33440,164065
320280,202002,988,569,419,606101.07,442035,1048136.07
320290,202002,58,50,8,52250,8360,60610
320300,202002,572,395,177,413821.35,186011.6,599832.95
320305,202002,673,367,306,386650,323950.5,710600.5
320310,202002,203,119,84,125400.9,89870,215270.9
320313,202002,325,164,161,172425.25,168245.5,340670.75
320316,202002,112,87,25,93005,26125,119130
320320,202002,3408,1538,1870,1642740.6,1975117.1,3617857.7
320330,202002,258,195,63,205865,66880,272745
320332,202002,843,514,329,541311.5,349031.13,890342.63
320334,202002,237,146,91,156750.5,98230,254980.5
320335,202002,149,103,46,107635,48070,155705
320340,202002,549,380,169,401280.75,181830,583110.75
320350,202002,975,417,558,438900.97,588336,1027236.97
320360,202002,165,91,74,95095,80465,175560
320370,202002,244,184,60,195415.9,62700.5,258116.4
320380,202002,273,192,81,201685.5,86735,288420.5
320390,202002,1135,688,447,729410.3,470250.5,1199660.8
320400,202002,309,228,81,242441,86735,329176
320405,202002,945,398,547,420090.47,574750.72,994841.19
320410,202002,982,502,480,527725.9,503690.25,1031416.15
320420,202002,495,241,254,258115.75,268565,526680.75
320425,202002,186,99,87,104500,91960,196460
320430,202002,381,210,171,223630.88,178695,402325.88
320435,202002,157,105,52,110770,55385,166155
320440,202002,195,115,80,123310,84645,207955
320450,202002,123,67,56,70015,60610,130625
320455,202002,247,201,46,212135.5,48070,260205.5
320460,202002,268,164,104,175560,109725,285285
320465,202002,115,77,38,82555,39710,122265
320470,202002,683,426,257,450395.72,272745.22,723140.94
320480,202002,195,124,71,130625,74195,204820
320490,202002,3036,1498,1538,1578998.06,1623937.08,3202935.14
320495,202002,109,68,41,71060,42846,113906
320500,202002,9586,4722,4864,5003467.87,5149768.57,10153236.44
320501,202002,552,280,272,297825,285285,583110
320503,202002,286,199,87,207955,91960,299915
320506,202002,261,184,77,196460,80465,276925
320510,202002,1003,451,552,478610,579975.45,1058585.45
320515,202002,86,69,17,73150,17765,90915
320517,202002,208,150,58,160930,61655,222585
320520,202002,6852,2973,3879,3153812.74,4112079.12,7265891.86
320530,202002,6033,2995,3038,3184120.71,3203972.92,6388093.63
330010,202002,3070,1573,1497,1663642.5,1586310.9,3249953.4
330015,202002,159,70,89,73150.9,96140,169290.9
330020,202002,3590,1559,2031,1652146.1,2164195.5,3816341.6
330022,202002,242,123,119,132715,125400.5,258115.5
330023,202002,583,193,390,205865,415910,621775
330025,202002,558,109,449,115995,478610,594605
330030,202002,1914,1222,692,1291620.84,734635.5,2026256.34
330040,202002,2420,1256,1164,1326105.75,1235190.75,2561296.50
330045,202002,8644,2675,5969,2840311.45,6352555.5,9192866.95
330050,202002,891,571,320,604010,337535,941545
330060,202002,978,588,390,625956.25,413820.5,1039776.75
330070,202002,3546,1292,2254,1378355.85,2397232,3775587.85
330080,202002,1572,705,867,746131.29,914375,1660506.29
330090,202002,376,222,154,236170,161975.02,398145.02
330093,202002,261,118,143,124355,151525.6,275880.6
330095,202002,82,45,37,47025,38665,85690
330100,202002,9645,4865,4780,5150807.67,5050486.25,10201293.92
330110,202002,466,200,266,212135.75,283195,495330.75
330115,202002,531,279,252,291555,266475,558030
330120,202002,368,191,177,204820,186011,390831
330130,202002,1515,381,1134,401280,1200705.85,1601985.85
330140,202002,597,313,284,337535.3,300960,638495.3
330150,202002,502,290,212,309320,223630,532950
330160,202002,211,127,84,134805,87780,222585
330170,202002,26494,9048,17446,9599373.95,18536220.15,28135594.10
330180,202002,241,145,96,151525,101365,252890
330185,202002,933,329,604,350075.45,636405.45,986480.90
330187,202002,349,106,243,111815,260205,372020
330190,202002,5700,2176,3524,2309452.15,3731695.5,6041147.65
330200,202002,4637,1382,3255,1461956.81,3446410.5,4908367.31
330205,202002,430,251,179,265430,190190.5,455620.5
330210,202002,978,605,373,639540,393966.45,1033506.45
330220,202002,2619,1568,1051,1662595.2,1110835.5,2773430.7
330225,202002,553,284,269,305140,289465,594605
330227,202002,2354,720,1634,763895,1740970.25,2504865.25
330230,202002,233,136,97,142120,101365,243485
330240,202002,3740,1867,1873,1988637.8,1992831.02,3981468.82
330245,202002,147,67,80,73150.1,84645,157795.1
330250,202002,6610,3385,3225,3577036.76,3433872.52,7010909.28
330260,202002,570,152,418,161975,439945,601920
330270,202002,3488,1199,2289,1272810,2441121,3713931
330280,202002,449,288,161,304095.5,168245.45,472340.95
330285,202002,6966,2201,4765,2343935.75,5068252.5,7412188.25
330290,202002,639,235,404,246620.25,428450,675070.25
330300,202002,760,492,268,522500.75,281105.3,803606.05
330310,202002,443,250,193,264385.75,207955,472340.75
330320,202002,7825,2918,4907,3120371.49,5221867,8342238.49
330330,202002,8765,3378,5387,3606296.75,5764225.85,9370522.60
330340,202002,2669,1575,1094,1673045,1159950,2832995
330350,202002,18117,7039,11078,7461305.65,11789697.99,19251003.64
330360,202002,2263,1093,1170,1158906,1245640.45,2404546.45
330370,202002,1022,510,512,543402,541310,1084712
330380,202002,867,373,494,396055,520410.01,916465.01
330385,202002,630,324,306,339625.25,321860,661485.25
330390,202002,5380,2905,2475,3085886,2627130.5,5713016.5
330395,202002,309,189,120,199595,126445.75,326040.75
330400,202002,704,374,330,393965,344850,738815
330410,202002,506,370,136,389785.25,144210.5,533995.75
330411,202002,249,134,115,140030.55,123310,263340.55
330412,202002,241,97,144,102410.5,150480,252890.5
330414,202002,5340,2165,3175,2303182.7,3378486,5681668.7
330415,202002,586,260,326,273791.5,347985,621776.5
330420,202002,2199,1136,1063,1205931.55,1132780.95,2338712.50
330430,202002,1768,815,953,854811,1016787.5,1871598.5
330440,202002,276,136,140,144210,147345,291555
330450,202002,123,53,70,55385,73150,128535
330452,202002,1948,864,1084,914375.75,1156815.5,2071191.25
330455,202002,109460,38873,70587,41313133.67,75258837.08,116571970.75
330460,202002,262,110,152,115995,159885.3,275880.3
330470,202002,1211,661,550,695971.75,584157.51,1280129.26
330475,202002,1485,391,1094,409640,1149500,1559140
330480,202002,809,427,382,450395,402325,852720
330490,202002,14059,4632,9427,4934491.25,10033049.2,14967540.45
330500,202002,1402,600,802,633270,849585.14,1482855.14
330510,202002,10607,3648,6959,3905167.15,7480112.75,11385279.90
330513,202002,104,52,52,54340,54340,108680
330515,202002,815,336,479,354256.25,504735.5,858991.75
330520,202002,2458,877,1581,933185.35,1666775,2599960.35
330530,202002,206,115,91,120175.25,95095,215270.25
330540,202002,373,182,191,191235.5,200640.5,391876.0
330550,202002,2849,1012,1837,1065900.7,1951016,3016916.7
330555,202002,804,310,494,331265,522500.9,853765.9
330560,202002,669,220,449,233035,477565.3,710600.3
330570,202002,263,189,74,200640,78375,279015
330575,202002,782,298,484,314545,509961.75,824506.75
330580,202002,3316,1857,1459,1970872.12,1543466,3514338.12
330590,202002,290,149,141,156750.09,147345.45,304095.54
330600,202002,1148,726,422,770166,447260,1217426
330610,202002,1578,849,729,898702.4,770166.5,1668868.9
330615,202002,206,162,44,169290,45980,215270
330620,202002,1054,422,632,448305,672980,1121285
330630,202002,4038,2545,1493,2686695.94,1572726.25,4259422.19
350010,202002,590,396,194,423226.37,204820,628046.37
350020,202002,51,23,28,24035,30305,54340
350030,202002,518,325,193,342760.5,201685.5,544446.0
350040,202002,125,50,75,52250,79420,131670
350050,202002,299,162,137,170335,146300,316635
350055,202002,92,50,42,52250,44935,97185
350060,202002,85,31,54,32395,58520,90915
350070,202002,801,474,327,500555.49,346940.5,847495.99
350075,202002,69,47,22,50160,22990,73150
350080,202002,52,29,23,30305,25080,55385
350090,202002,83,49,34,51205,35530,86735
350100,202002,284,175,109,183920,113905,297825
350110,202002,60,41,19,42845,19855,62700
350115,202002,150,90,60,94050,62700,156750
350120,202002,104,67,37,70015,38665,108680
350130,202002,360,165,195,175560.03,205865.45,381425.48
350140,202002,41,27,14,29260,14630,43890
350150,202002,73,55,18,57475,18810,76285
350160,202002,2437,952,1485,1014697.13,1572726.54,2587423.67
350170,202002,386,230,156,243486.85,165110.5,408597.35
350180,202002,172,98,74,103455,79420.5,182875.5
350190,202002,998,526,472,559075.79,496376.4,1055452.19
350200,202002,68,24,44,26125,45980,72105
350210,202002,1301,729,572,772256.5,611325.29,1383581.79
350220,202002,664,553,111,581020.29,115995,697015.29
350230,202002,71,51,20,54340,20900,75240
350240,202002,60,41,19,44935,19855,64790
350250,202002,1134,542,592,573706,621776.25,1195482.25
350260,202002,91,68,23,72105.5,24035,96140.5
350270,202002,850,570,280,599831,295735.5,895566.5
350275,202002,296,123,173,128535,182875,311410
350280,202002,4586,2337,2249,2471429.62,2372151.1,4843580.72
350290,202002,438,201,237,212135,249755.5,461890.5
350300,202002,54,28,26,29260,27170,56430
350310,202002,88,55,33,58520,34485,93005
350315,202002,47,26,21,27170,21945,49115
350320,202002,3279,1604,1675,1699170,1773365.44,3472535.44
350330,202002,1665,897,768,944682.62,809876.5,1754559.12
350335,202002,17,12,5,12540,5225,17765
350340,202002,124,57,67,59565,71060.75,130625.75
350350,202002,85,43,42,45980,44935,90915
350360,202002,118,78,40,82555.22,42845,125400.22
350370,202002,87,50,37,55385.29,39710,95095.29
350380,202002,776,327,449,345895,472341,818236
350390,202002,1528,593,935,630135.82,984390.5,1614526.32
350395,202002,25,20,5,20900,5225,26125
350400,202002,1696,870,826,914377.12,868395.51,1782772.63
350410,202002,2576,1133,1443,1193390,1533016.19,2726406.19
350420,202002,247,148,99,158840.79,103455,262295.79
350430,202002,73,44,29,47025,31350,78375
350440,202002,149,107,42,112860.5,43890,156750.5
350450,202002,1614,968,646,1026191.35,684476,1710667.35
350460,202002,380,128,252,135850,269610,405460
350470,202002,19,11,8,11495,8360,19855
350480,202002,173,96,77,100320,81510,181830
350490,202002,229,113,116,120175,124355,244530
350500,202002,46,19,27,19855,30305,50160
350510,202002,162,108,54,113905,56430,170335
350520,202002,456,226,230,241395.29,242440,483835.29
350530,202002,441,207,234,219450,248710,468160
350535,202002,79,64,15,67925,15675,83600
350540,202002,379,191,188,199595,199595,399190
350550,202002,2726,1623,1103,1721117.17,1176672.19,2897789.36
350560,202002,622,430,192,462935,203775,666710
350570,202002,4132,1713,2419,1823526.69,2552939.1,4376465.79
350580,202002,369,177,192,184965,201685.22,386650.22
350590,202002,911,498,413,522500.5,435765,958265.5
350600,202002,6049,2937,3112,3119328.7,3286526.16,6405854.86
350610,202002,1516,784,732,834955.58,775390.45,1610346.03
350620,202002,31,20,11,21945,11495,33440
350630,202002,244,138,106,145255.29,112860.29,258115.58
350635,202002,941,372,569,397101.35,599830.5,996931.85
350640,202002,126,94,32,98230,34485,132715
350650,202002,1878,1244,634,1315655.95,671935.45,1987591.40
350660,202002,741,314,427,331265,453530.22,784795.22
350670,202002,310,151,159,159885,167200,327085
350680,202002,179,95,84,99275,89871,189146
350690,202002,198,99,99,104500,103455,207955
350700,202002,765,365,400,387696,423225.36,810921.36
350710,202002,366,136,230,144210,242440,386650
350715,202002,54,43,11,44935,12540,57475
350720,202002,16,11,5,11495,6270,17765
350730,202002,43,27,16,28215,16720,44935
350740,202002,215,124,91,129580,95095,224675
350745,202002,21,10,11,10450,11495,21945
350750,202002,2174,1348,826,1427471.2,873620,2301091.2
350760,202002,3706,1612,2094,1710665.59,2219580,3930245.59
350770,202002,61,44,17,47025,17765,64790
350775,202002,44,33,11,35530,11495.45,47025.45
350780,202002,432,222,210,234080,223630.5,457710.5
350790,202002,368,154,214,164065,225720,389785
350800,202002,464,274,190,286330,198550,484880
350810,202002,517,416,101,438900.75,105545,544445.75
350820,202002,91,55,36,57475,37620,95095
350830,202002,79,41,38,42845,40755,83600
350840,202002,750,305,445,323950.5,477565.95,801516.45
350850,202002,1726,970,756,1029325.75,796291.62,1825617.37
350860,202002,587,330,257,350075.75,272745,622820.75
350870,202002,422,284,138,298870,146300,445170
350880,202002,286,159,127,167200.25,134805,302005.25
350890,202002,41,27,14,28215,15675,43890
350900,202002,1448,454,994,481745.75,1049180.29,1530926.04
350910,202002,28,16,12,16720,12540,29260
350920,202002,664,352,312,377245,329175,706420
350925,202002,1199,640,559,674025.95,590427.39,1264453.34
350930,202002,98,60,38,64790,39710,104500
350940,202002,705,392,313,416955,331265,748220
350945,202002,108,78,30,81510,31350,112860
350950,202002,16088,7590,8498,8070540.49,9027759.94,17098300.43
350960,202002,1329,615,714,648945,756580.22,1405525.22
350970,202002,1101,576,525,612259.19,551761,1164020.19
350980,202002,96,66,30,68970,31350,100320
350990,202002,372,133,239,141075,250800,391875
350995,202002,36,16,20,16720,20900,37620
351000,202002,636,435,201,457710.58,211090,668800.58
351010,202002,51,31,20,33440,20900,54340
351015,202002,49,35,14,36575,14630,51205
351020,202002,1575,949,626,1002155.72,663575,1665730.72
351030,202002,342,227,115,240350,121220,361570
351040,202002,882,457,425,489060.2,448305.89,937366.09
351050,202002,3292,1494,1798,1591539.2,1901902.68,3493441.88
351060,202002,5186,2031,3155,2161062.15,3338775.66,5499837.81
351070,202002,405,254,151,268566.64,160930,429496.64
351080,202002,751,549,202,577885.5,215270,793155.5
351090,202002,54,24,30,25080,31350,56430
351100,202002,434,248,186,261250.7,194370,455620.7
351110,202002,2019,966,1053,1024104.91,1127564.95,2151669.86
351120,202002,65,32,33,35530,35530,71060
351130,202002,184,60,124,62700,130625,193325
351140,202002,323,220,103,234080,107635,341715
351150,202002,435,226,209,239305.75,220495.5,459801.25
351160,202002,267,181,86,192280.5,93005,285285.5
351170,202002,185,95,90,101365,94050,195415
351190,202002,87,60,27,62700,28215,90915
351200,202002,362,245,117,259160.5,124355,383515.5
351210,202002,118,60,58,63745,60610,124355
351220,202002,532,319,213,339626.91,223630,563256.91
351230,202002,274,189,85,201685,88825,290510
351240,202002,231,114,117,121220,126445,247665
351250,202002,80,58,22,60610.57,24035,84645.57
351260,202002,149,112,37,119130,39710,158840
351270,202002,45,19,26,19855,27170,47025
351280,202002,986,449,537,481745.29,567436.24,1049181.53
351290,202002,243,105,138,110770,144210.5,254980.5
351300,202002,3718,1656,2062,1761789.61,2189275.51,3951065.12
351310,202002,755,379,376,405460,399190.45,804650.45
351320,202002,116,68,48,71060.29,50160,121220.29
351330,202002,42,27,15,28215,15675,43890
351340,202002,1233,727,506,772256,529816.12,1302072.12
351350,202002,2408,1390,1018,1471362.4,1079486.16,2550848.56
351360,202002,767,372,395,393965,415910,809875
351370,202002,392,197,195,210045.5,206910,416955.5
351380,202002,8966,4064,4902,4308541.07,5205147.96,9513689.03
351385,202002,27,17,10,17765,10450,28215
351390,202002,272,204,68,217360.35,72105,289465.35
351400,202002,66,43,23,45980,25081.35,71061.35
351410,202002,433,278,155,291555.77,164065,455620.77
351420,202002,66,52,14,54340,14630,68970
351430,202002,65,35,30,37620,34485,72105
351440,202002,792,554,238,588337.54,252890,841227.54
351450,202002,263,130,133,135850,140030,275880
351460,202002,124,57,67,60610,70015,130625
351470,202002,145,78,67,81510,71060,152570
351480,202002,500,284,216,298871.12,226765,525636.12
351490,202002,284,103,181,108680,195415,304095
351492,202002,28,21,7,21945,7315,29260
351495,202002,24,18,6,18810,6270,25080
351500,202002,3538,1487,2051,1580041.35,2176736.9,3756778.25
351510,202002,1876,738,1138,783751,1200705.5,1984456.5
351512,202002,20,15,5,15675,5225,20900
351515,202002,191,108,83,115995,88825.9,204820.9
351518,202002,750,470,280,494285.22,295735,790020.22
351519,202002,75,46,29,48070,30305,78375
351520,202002,149,90,59,98230,62700,160930
351530,202002,22,14,8,14630,8360,22990
351535,202002,133,78,55,81510,57475,138985
351540,202002,452,326,126,342760.05,132715,475475.05
351550,202002,1399,828,571,879892.58,599830,1479722.58
351560,202002,71,40,31,42845,32395,75240
351565,202002,9,7,2,7315,2090,9405
351570,202002,2668,1317,1351,1389850.94,1428515.66,2818366.60
351580,202002,38,34,4,35530,4180,39710
351590,202002,62,40,22,43890,22990,66880
351600,202002,184,134,50,142120,52250,194370
351610,202002,47,21,26,21945,27170,49115
351620,202002,5809,3267,2542,3467313.54,2691920.75,6159234.29
351630,202002,2760,1376,1384,1460910.75,1467180,2928090.75
351640,202002,1971,931,1040,988570.02,1106656.29,2095226.31
351650,202002,27,23,4,25080,4180,29260
351660,202002,140,92,48,96140,51205,147345
351670,202002,706,442,264,467116,284240,751356
351680,202002,72,60,12,62700,12540,75240
351685,202002,27,15,12,15675,12540,28215
351690,202002,297,206,91,221540.37,95095,316635.37
351700,202002,161,112,49,118085.5,52250,170335.5
351710,202002,69,45,24,47025,25080,72105
351720,202002,130,74,56,77330,58520,135850
351730,202002,105,69,36,74195,37620.29,111815.29
351740,202002,733,479,254,506826.18,267520,774346.18
351750,202002,348,144,204,151525,218405,369930
351760,202002,764,578,186,610280,197505,807785
351770,202002,312,265,47,281105.29,50160,331265.29
351780,202002,157,93,64,97185.45,66880,164065.45
351790,202002,255,135,120,141075,127490.75,268565.75
351800,202002,41,27,14,28215,14630,42845
351810,202002,120,80,40,85690,41800,127490
351820,202002,819,589,230,625955.5,242440.72,868396.22
351830,202002,533,188,345,198550,365750,564300
351840,202002,1900,949,951,1002156.58,1005290.66,2007447.24
351850,202002,239,171,68,182875,72105,254980
351860,202002,674,463,211,488015.45,223630,711645.45
351870,202002,5518,2584,2934,2770297.6,3121416.07,5891713.67
351880,202002,19147,7889,11258,8374635.69,11954821.28,20329456.97
351885,202002,85,55,30,58520,33440,91960
351890,202002,71,60,11,64790,11495,76285
351900,202002,223,131,92,136895,96140,233035
351905,202002,77,32,45,33440,47025,80465
351907,202002,3381,1399,1982,1491216.35,2095227.12,3586443.47
351910,202002,180,74,106,78375,110770,189145
351920,202002,121,69,52,73150,55385.44,128535.44
351925,202002,91,59,32,61655,33440,95095
351930,202002,389,252,137,268565,144210,412775
351940,202002,238,104,134,110770,141075,251845
351950,202002,132,73,59,76285,63745,140030
351960,202002,901,446,455,469532.37,481745.5,951277.87
351970,202002,1848,969,879,1033505.5,934231.54,1967737.04
351980,202002,154,77,77,81510,80465,161975
351990,202002,256,168,88,178696,91960,270656
352000,202002,347,217,130,228855.87,136895,365750.87
352010,202002,393,247,146,260205,152570.5,412775.5
352020,202002,189,68,121,71060,126445,197505
352030,202002,1063,541,522,569525,554895,1124420
352040,202002,572,239,333,250800,353210,604010
352042,202002,282,86,196,89870,206911,296781
352044,202002,353,215,138,227810,145255,373065
352050,202002,3204,1256,1948,1330287.14,2064920.5,3395207.64
352060,202002,104,65,39,67925,40755,108680
352070,202002,92,68,24,72105.58,26125,98230.58
352080,202002,66,43,23,44935,24035,68970
352090,202002,158,105,53,112860,56430,169290
352100,202002,285,141,144,148390.72,152570.94,300961.66
352110,202002,113,33,80,34485,83600,118085
352115,202002,60,21,39,21945,42845,64790
352120,202002,84,58,26,61655.29,27170,88825.29
352130,202002,215,179,36,189145,37620,226765
352140,202002,186,86,100,91960,104500,196460
352150,202002,116,62,54,64790,57475,122265
352160,202002,138,88,50,91960,52250,144210
352170,202002,382,264,118,277970,124355,402325
352180,202002,616,399,217,420090.29,228855.22,648945.51
352190,202002,246,97,149,102410,158840,261250
352200,202002,31,16,15,16720,15675,32395
352210,202002,4026,1650,2376,1744107.22,2517405.79,4261513.01
352215,202002,56,32,24,33440,25080,58520
352220,202002,6726,2548,4178,2707597,4444389.2,7151986.2
352230,202002,3301,2134,1167,2261384.12,1233104.53,3494488.65
352240,202002,2358,1353,1005,1431650.5,1060675.5,2492326.0
352250,202002,2720,1309,1411,1391942.16,1500621.17,2892563.33
352260,202002,956,488,468,517275.5,492195.5,1009471.0
352265,202002,55,25,30,26125,31350,57475
352270,202002,400,233,167,245575,176605.7,422180.7
352280,202002,439,277,162,290510.58,171380,461890.58
352290,202002,171,102,69,106590,74195,180785
352300,202002,93,66,27,70015,28215,98230
352310,202002,6243,2797,3446,2962578.11,3634510.52,6597088.63
352320,202002,1012,528,484,560120.5,511005,1071125.5
352330,202002,522,255,267,268565,280060.5,548625.5
352340,202002,1343,623,720,662532,763896.95,1426428.95
352350,202002,339,205,134,216315,140030.5,356345.5
352360,202002,219,100,119,106590,126445,233035
352370,202002,102,68,34,71060,35530,106590
352380,202002,115,73,42,77330,43890,121220
352390,202002,2408,1032,1376,1096205.5,1453596.05,2549801.55
352400,202002,486,215,271,227810,290510.5,518320.5
352410,202002,826,585,241,619685.29,254980,874665.29
352420,202002,99,67,32,70015,33440,103455
352430,202002,1691,781,910,826596.95,969761.03,1796357.98
352440,202002,3170,1578,1592,1674091.6,1682451.4,3356543.0
352450,202002,200,166,34,173470,35530,209000
352460,202002,611,314,297,333355.22,311410,644765.22
352470,202002,651,221,430,234080,455620,689700
352480,202002,1386,768,618,813010.9,651035.5,1464046.4
352490,202002,62,22,40,24035,42845,66880
352500,202002,1198,508,690,543401.07,727320.95,1270722.02
352510,202002,721,391,330,416955.58,352165,769120.58
352520,202002,645,308,337,329175.75,355300,684475.75
352530,202002,1727,905,822,961400,868395.5,1829795.5
352540,202002,76,48,28,50160,29260,79420
352550,202002,185,111,74,115995,77330,193325
352560,202002,47,38,9,39710,9405,49115
352570,202002,668,341,327,362615.29,342760,705375.29
352580,202002,53,40,13,42845,13585,56430
352585,202002,20,6,14,6270,14630,20900
352590,202002,4376,2194,2182,2325125.29,2330351.9,4655477.19
352600,202002,346,249,97,264385,101365,365750
352610,202002,940,426,514,447260.67,539220,986480.67
352620,202002,1013,404,609,424270,641630,1065900
352630,202002,175,63,112,65835,118085,183920
352640,202002,519,351,168,369930.9,178695,548625.9
352650,202002,84,61,23,64790,25080,89870
352660,202002,69,41,28,42845,29260,72105
352670,202002,1639,878,761,939456.54,800471.76,1739928.30
352680,202002,927,578,349,613415.22,367840,981255.22
352690,202002,4510,2038,2472,2153747.38,2619815.74,4773563.12
352700,202002,104,63,41,67925.5,44935,112860.5
352710,202002,1367,728,639,771210,669845,1441055
352720,202002,1336,617,719,652080,758670.5,1410750.5
352725,202002,23,19,4,20900,4180,25080
352730,202002,395,202,193,214225,203775,418000
352740,202002,409,262,147,275881.4,155705.11,431586.51
352750,202002,19,12,7,12540,7315,19855
352760,202002,174,114,60,122265,62700,184965
352770,202002,85,65,20,67925,20900,88825
352780,202002,75,41,34,42845,35530,78375
352790,202002,25,21,4,21945,4180,26125
352800,202002,235,171,64,180785,66880,247665
352810,202002,153,95,58,101365.79,60610,161975.79
352820,202002,63,50,13,54340,13585,67925
352830,202002,80,54,26,57475,27170,84645
352840,202002,654,327,327,346940,343805,690745
352850,202002,1485,499,986,526680,1053360,1580040
352860,202002,119,76,43,80465,45980,126445
352870,202002,42,28,14,29260,15675.83,44935.83
352880,202002,183,121,62,128535,64790,193325
352885,202002,32,22,10,24035,10450,34485
352890,202002,52,35,17,36575,17765.5,54340.5
352900,202002,4776,2328,2448,2473518.09,2601007.89,5074525.98
352910,202002,36,29,7,31350,7315,38665
352920,202002,656,397,259,418000,274835,692835
352930,202002,1213,576,637,612376.35,675089.65,1287466.00
352940,202002,6087,2541,3546,2717002.24,3780813.47,6497815.71
352950,202002,104,40,64,41800,66880,108680
352960,202002,58,39,19,40755,19855,60610
352965,202002,19,9,10,9405,10450,19855
352970,202002,510,386,124,409640.23,129580.45,539220.68
352980,202002,158,87,71,90915,74195,165110
352990,202002,973,442,531,465025,556985,1022010
353000,202002,65,31,34,32395,36575,68970
353010,202002,539,332,207,354255,217360,571615
353020,202002,293,212,81,225720,86735,312455
353030,202002,1244,572,672,601921.35,712690.45,1314611.80
353040,202002,86,54,32,57475,33440,90915
353050,202002,1328,862,466,909151.19,490105,1399256.19
353060,202002,8296,3634,4662,3850830.56,4918817.66,8769648.22
353070,202002,1733,1080,653,1150581.16,691603.99,1842185.15
353080,202002,1265,680,585,727320.47,625955,1353275.47
353090,202002,56,31,25,32395,26125,58520
353100,202002,50,42,8,43890,8360,52250
353110,202002,2058,623,1435,659396.4,1517340.97,2176737.37
353120,202002,94,48,46,51205,48070,99275
353130,202002,837,414,423,446216.47,450396.35,896612.82
353140,202002,552,226,326,238260.29,345895,584155.29
353150,202002,336,191,145,202730.29,154660,357390.29
353160,202002,93,76,17,79420,17765,97185
353170,202002,214,69,145,73150,152570.9,225720.9
353180,202002,1034,476,558,504735,592516.7,1097251.7
353190,202002,496,363,133,383515,138985.5,522500.5
353200,202002,212,107,105,112860,111815,224675
353205,202002,20,13,7,14630,7315,21945
353210,202002,72,41,31,48070,32395,80465
353215,202002,46,27,19,28215,19855,48070
353220,202002,79,45,34,48070,35530,83600
353230,202002,159,61,98,63745,103455,167200
353240,202002,322,165,157,175560,165110,340670
353250,202002,210,106,104,112860,110770,223630
353260,202002,459,321,138,338581.25,145255,483836.25
353270,202002,69,53,16,55385,16720,72105
353280,202002,104,53,51,55385,53295,108680
353282,202002,127,89,38,93005,40755,133760
353284,202002,23,17,6,17765,7315,25080
353286,202002,1,0,1,0,1045,1045
353290,202002,71,42,29,44935,31350,76285
353300,202002,443,240,203,253936.33,213180,467116.33
353310,202002,46,40,6,41800,6270,48070
353320,202002,56,32,24,34485,25080,59565
353325,202002,53,31,22,32395,24036.4,56431.4
353330,202002,62,43,19,44935.75,19855,64790.75
353340,202002,628,224,404,239305,431585.5,670890.5
353350,202002,886,429,457,452485.9,486971.4,939457.3
353360,202002,102,83,19,86735,20900,107635
353370,202002,113,62,51,65835,54340,120175
353380,202002,32,18,14,18810.22,14630,33440.22
353390,202002,1111,537,574,565345,613415,1178760
353400,202002,44,25,19,26125,19855,45980
353410,202002,107,66,41,70015,42845.25,112860.25
353420,202002,61,27,34,29260,35530,64790
353430,202002,586,395,191,419045.91,200640,619685.91
353440,202002,10661,4643,6018,4929267.56,6384954.19,11314221.75
353450,202002,58,31,27,32395,28215,60610
353460,202002,599,325,274,343805.75,286330,630135.75
353470,202002,2116,1115,1001,1174581.03,1056495.88,2231076.91
353475,202002,238,160,78,168245.95,81510,249755.95
353480,202002,188,155,33,161975,34485,196460
353490,202002,238,147,91,155705,95095.5,250800.5
353500,202002,199,117,82,122265.29,85690,207955.29
353510,202002,97,67,30,73150,32395,105545
353520,202002,205,145,60,153615,64790,218405
353530,202002,464,253,211,267520,224675,492195
353540,202002,367,244,123,261250,128535,389785
353550,202002,707,463,244,489061.47,260205,749266.47
353560,202002,590,239,351,249755,374110,623865
353570,202002,67,37,30,38665.5,31350,70015.5
353580,202002,356,267,89,282151.35,93005,375156.35
353590,202002,92,65,27,67925,28215,96140
353600,202002,277,160,117,168245.29,123310,291555.29
353610,202002,127,70,57,73150,62700,135850
353620,202002,598,314,284,330220,300960,631180
353625,202002,48,27,21,28215,22990,51205
353630,202002,231,170,61,179740.45,65835,245575.45
353640,202002,122,83,39,88825,40755,129580
353650,202002,914,350,564,373065,594605,967670
353657,202002,22,17,5,17765,5225,22990
353660,202002,272,146,126,152570,132715,285285
353670,202002,758,454,304,477565.79,321860.5,799426.29
353680,202002,103,74,29,77330.25,32395,109725.25
353690,202002,41,31,10,33440,10450,43890
353700,202002,274,197,77,212135,82555,294690
353710,202002,462,220,242,233035,252890.5,485925.5
353715,202002,46,33,13,34485,13585,48070
353720,202002,346,157,189,167200.95,200640,367840.95
353730,202002,1094,677,417,711646,440991.75,1152637.75
353740,202002,619,339,280,360525.5,294690,655215.5
353750,202002,82,49,33,51205,34485,85690
353760,202002,2898,1093,1805,1149500.65,1907127.79,3056628.44
353770,202002,89,72,17,76285,17765,94050
353780,202002,1194,569,625,600875.29,658350,1259225.29
353790,202002,505,306,199,320816.4,211090.5,531906.9
353800,202002,3329,1627,1702,1715910.97,1792248.11,3508159.08
353810,202002,233,135,98,141075.45,106590.9,247666.35
353820,202002,206,96,110,101365,115995.5,217360.5
353830,202002,48,42,6,43890,7315,51205
353850,202002,178,82,96,86735,100320,187055
353860,202002,495,223,272,239305,286330,525635
353870,202002,5289,2695,2594,2834045.29,2742081.75,5576127.04
353880,202002,685,480,205,505781.39,216315,722096.39
353890,202002,566,323,243,340670.5,257070.61,597741.11
353900,202002,131,71,60,75240,64790,140030
353910,202002,168,74,94,79420,100320,179740
353920,202002,431,239,192,251845.75,202730,454575.75
353930,202002,988,581,407,611325,426361.35,1037686.35
353940,202002,190,97,93,103455,98230,201685
353950,202002,504,309,195,327085,207955,535040
353960,202002,73,60,13,63745,13585,77330
353970,202002,57,34,23,35530,25080,60610
353980,202002,1656,770,886,816145,935276.16,1751421.16
353990,202002,69,42,27,44935,29260,74195
354000,202002,377,182,195,194370,205865.22,400235.22
354010,202002,88,47,41,49115,42845.5,91960.5
354020,202002,519,331,188,351120,199595,550715
354025,202002,51,43,8,45980,9405,55385
354030,202002,51,32,19,33440,19855,53295
354040,202002,99,76,23,79420,26125,105545
354050,202002,178,98,80,102410.79,83600,186010.79
354060,202002,765,374,391,399190,414865,814055
354070,202002,909,524,385,549670.86,410685.45,960356.31
354075,202002,218,106,112,111815,120175,231990
354080,202002,310,133,177,140030,186010,326040
354085,202002,20,13,7,13585,7315,20900
354090,202002,291,165,126,176517,131670,308187
354100,202002,5498,2272,3226,2409771.53,3425512.8,5835284.33
354105,202002,90,44,46,45980,49115,95095
354110,202002,46,22,24,25080,25080,50160
354120,202002,134,96,38,101365.45,40755,142120.45
354130,202002,709,449,260,472340.45,273790.95,746131.40
354140,202002,3134,1444,1690,1528836.02,1780680,3309516.02
354150,202002,617,375,242,400061.23,260205,660266.23
354160,202002,657,420,237,442035,249756.39,691791.39
354165,202002,16,14,2,14630,3135,17765
354170,202002,173,118,55,124355,59565,183920
354180,202002,62,37,25,38665.59,27170,65835.59
354190,202002,191,84,107,88825,117040,205865
354200,202002,118,62,56,64790,58520,123310
354210,202002,56,24,32,25080,33440,58520
354220,202002,643,402,241,426360.79,252890,679250.79
354230,202002,173,73,100,77330,105545,182875
354240,202002,333,214,119,224675.62,125400,350075.62
354250,202002,82,51,31,54340,33440,87780
354260,202002,2020,952,1068,1002157.32,1128601.6,2130758.92
354270,202002,92,68,24,71060,27170,98230
354280,202002,42,22,20,22990,20900,43890
354290,202002,143,100,43,106590,44935,151525
354300,202002,381,266,115,279015.29,122265,401280.29
354310,202002,89,64,25,68970.5,26125,95095.5
354320,202002,200,101,99,105545,104500,210045
354323,202002,11,10,1,10450,1045,11495
354325,202002,115,68,47,71060.83,49115,120175.83
354330,202002,2455,817,1638,864066.5,1738880.95,2602947.45
354340,202002,10279,4971,5308,5302332.8,5617923.37,10920256.17
354350,202002,122,81,41,84645,42845,127490
354360,202002,76,43,33,45980,34485,80465
354370,202002,242,130,112,137940,119130,257070
354380,202002,186,110,76,117040,80465,197505
354390,202002,2673,970,1703,1040820.22,1803670.95,2844491.17
354400,202002,310,171,139,180785,149435,330220
354410,202002,615,298,317,317680.91,332310.5,649991.41
354420,202002,275,173,102,181830,107635,289465
354425,202002,302,181,121,194419,127490,321909
354430,202002,176,102,74,109725,79420,189145
354440,202002,37,28,9,29260,9405,38665
354450,202002,53,38,15,39710,15675.5,55385.5
354460,202002,101,58,43,60610,45980,106590
354470,202002,37,21,16,21945,16720,38665
354480,202002,112,60,52,62700,54340,117040
354490,202002,145,90,55,94050,57475,151525
354500,202002,374,181,193,191235,204820,396055
354510,202002,97,66,31,73150,32395,105545
354515,202002,36,12,24,12540,25080,37620
354520,202002,1582,675,907,718811.75,967670.5,1686482.25
354530,202002,735,371,364,393965.72,388740,782705.72
354540,202002,270,148,122,154660,127490,282150
354550,202002,40,23,17,24035,17765,41800
354560,202002,148,78,70,83600,73150,156750
354570,202002,137,89,48,93005.25,51205,144210.25
354580,202002,1876,886,990,945726.22,1041865.5,1987591.72
354600,202002,249,138,111,147345,117040,264385
354610,202002,74,62,12,65835.15,12540.45,78375.60
354620,202002,63,20,43,20900,44935,65835
354625,202002,15,10,5,10450,5225.22,15675.22
354630,202002,313,202,111,213180.45,117040,330220.45
354640,202002,800,511,289,542356.15,307230,849586.15
354650,202002,70,41,29,44935,31350.45,76285.45
354660,202002,791,586,205,618640.29,215270,833910.29
354670,202002,240,90,150,95095,161975,257070
354680,202002,1245,464,781,491150,829730,1320880
354690,202002,81,58,23,60610.5,26125,86735.5
354700,202002,66,47,19,50160,19855,70015
354710,202002,46,34,12,35530,12540,48070
354720,202002,20,20,0,20900,0,20900
354730,202002,1725,719,1006,757626.45,1071125.5,1828751.95
354740,202002,70,50,20,52250,20900,73150
354750,202002,434,248,186,261250.45,196460,457710.45
354760,202002,468,285,183,306186.25,193325.5,499511.75
354765,202002,10,5,5,5225,5225,10450
354770,202002,344,226,118,239305.5,123310,362615.5
354780,202002,8102,3241,4861,3447462.71,5183210.46,8630673.17
354790,202002,99,56,43,58520,44935,103455
354800,202002,453,249,204,261250,213180.5,474430.5
354805,202002,99,45,54,49115.5,57475,106590.5
354810,202002,103,63,40,65835,42845,108680
354820,202002,204,84,120,87780.9,125400,213180.9
354830,202002,41,23,18,24035,18810,42845
354840,202002,60,42,18,45980,18810,64790
354850,202002,4462,1985,2477,2105676,2645941.93,4751617.93
354860,202002,326,157,169,166155,178695.04,344850.04
354870,202002,12111,5432,6679,5769453.58,7099735.82,12869189.40
354880,202002,2790,1040,1750,1105611.82,1883091.41,2988703.23
354890,202002,2863,1546,1317,1637516.75,1409705,3047221.75
354900,202002,62,42,20,44935,20900,65835
354910,202002,1235,654,581,690746,618640,1309386
354920,202002,45,37,8,38665,8360,47025
354925,202002,12,6,6,6270,6270,12540
354930,202002,33,30,3,33440.78,3135,36575.78
354940,202002,796,579,217,612633.04,233035,845668.04
354950,202002,201,133,68,140030.25,71060,211090.25
354960,202002,153,58,95,62700,100320,163020
354970,202002,933,618,315,657306.64,331265.5,988572.14
354980,202002,8664,3151,5513,3330419.85,5819610.29,9150030.14
354990,202002,9076,4201,4875,4444390.52,5159187.97,9603578.49
354995,202002,534,178,356,191235,379335,570570
355000,202002,462,159,303,169290,317680,486970
355010,202002,601,376,225,400235.5,237215.79,637451.29
355020,202002,753,476,277,498465.3,294690.72,793156.02
355030,202002,204313,79502,124811,84495168.35,133116401.82,217611570.17
355040,202002,744,353,391,372020.5,415910,787930.5
355050,202002,150,96,54,101365,56430,157795
355060,202002,1588,805,783,847496.5,831820,1679316.5
355070,202002,1433,681,752,724186.22,794200.74,1518386.96
355080,202002,199,120,79,125400,83600,209000
355090,202002,288,173,115,180785,120175.19,300960.19
355100,202002,4922,2346,2576,2493269.54,2733721.22,5226990.76
355110,202002,263,176,87,183920.72,91960,275880.72
355120,202002,78,56,22,59565,22990.45,82555.45
355130,202002,50,29,21,30305,22990,53295
355140,202002,181,111,70,118085,73150,191235
355150,202002,671,404,267,429496.22,282150,711646.22
355160,202002,463,226,237,238260.29,249755.5,488015.79
355170,202002,2043,1075,968,1143230,1023055,2166285
355180,202002,674,289,385,302005,407550,709555
355190,202002,200,139,61,147345,64790,212135
355200,202002,110,63,47,66880,49115,115995
355210,202002,687,392,295,411730,311410.45,723140.45
355220,202002,7054,3684,3370,3898899.17,3567633.85,7466533.02
355230,202002,97,57,40,59565,41800,101365
355240,202002,4411,1857,2554,1974007.66,2699235.67,4673243.33
355250,202002,5708,2590,3118,2750459.98,3298022.26,6048482.24
355255,202002,46,27,19,29260,19855,49115
355260,202002,181,110,71,115995.5,74195.9,190191.4
355270,202002,165,105,60,115995,64790,180785
355280,202002,6227,2527,3700,2676247.9,3929201.45,6605449.35
355290,202002,73,59,14,61655,14630,76285
355300,202002,194,122,72,129580,75240.5,204820.5
355310,202002,106,57,49,60610,51205,111815
355320,202002,88,46,42,48070,43890,91960
355330,202002,279,159,120,169290,126445,295735
355340,202002,1507,514,993,541310.77,1049180,1590490.77
355350,202002,132,69,63,72105,66880,138985
355360,202002,165,110,55,114950,61655,176605
355365,202002,22,18,4,18810,4180,22990
355370,202002,1035,603,432,640592.38,457713.6,1098305.98
355380,202002,805,521,284,548625,297825,846450
355385,202002,70,48,22,50160,22990,73150
355390,202002,108,63,45,65835,48070,113905
355395,202002,192,111,81,119130.92,84645,203775.92
355400,202002,1622,984,638,1045961.75,676115.29,1722077.04
355410,202002,4822,2299,2523,2439033.22,2683562.31,5122595.53
355420,202002,48,36,12,37620,13585,51205
355430,202002,364,222,142,236171.4,149435,385606.4
355440,202002,76,43,33,47025,34485,81510
355450,202002,455,225,230,242441.2,242440.75,484881.95
355460,202002,63,47,16,49115.35,16720,65835.35
355465,202002,45,28,17,31350,17765,49115
355470,202002,173,71,102,74195.75,110770,184965.75
355475,202002,11,7,4,8360,4180,12540
355480,202002,512,221,291,231990,305140,537130
355490,202002,117,83,34,88825,35530,124355
355495,202002,59,26,33,28215,34485,62700
355500,202002,1573,880,693,935277.27,731501.17,1666778.44
355510,202002,265,197,68,209000.29,71060,280060.29
355520,202002,34,24,10,25080.5,10450,35530.5
355530,202002,20,13,7,14630,7315,21945
355535,202002,76,35,41,36575,42845,79420
355540,202002,2423,966,1457,1019022.84,1545556.24,2564579.08
355550,202002,56,36,20,37620,20900,58520
355560,202002,248,115,133,122265,141075,263340
355570,202002,24,16,8,16720,8360,25080
355580,202002,241,169,72,177650,76285.72,253935.72
355590,202002,17,11,6,12540,6270,18810
355600,202002,272,140,132,148390,141075,289465
355610,202002,228,152,76,160930,80465,241395
355620,202002,1312,602,710,640585.5,756580.22,1397165.72
355630,202002,445,327,118,343805,124355.29,468160.29
355635,202002,118,54,64,56430,68970.67,125400.67
355640,202002,555,315,240,334400,256025,590425
355645,202002,837,338,499,357390,530861.5,888251.5
355650,202002,1981,841,1140,896611.85,1204885.45,2101497.30
355660,202002,250,130,120,144210,125400,269610
355670,202002,549,221,328,235125,350075,585200
355680,202002,209,122,87,129580,91960,221540
355690,202002,92,43,49,44935,51205.66,96140.66
355695,202002,16,10,6,10450,6270,16720
355700,202002,1150,605,545,641630.65,572661,1214291.65
355710,202002,2215,1215,1000,1292666.82,1056495.45,2349162.27
355715,202002,19,15,4,15675,4180,19855
355720,202002,219,132,87,138985.6,91960,230945.6
355730,202002,100,58,42,62700,43890,106590
410010,202002,131,108,23,115995,24035,140030
410020,202002,111,87,24,93005,25080,118085
410030,202002,162,101,61,107635.5,63745,171380.5
410040,202002,1125,560,565,598785,597740.79,1196525.79
410045,202002,36,29,7,30305,7315,37620
410050,202002,478,270,208,282150,220495,502645
410060,202002,277,209,68,221540,71060,292600
410070,202002,299,250,49,262295,51205,313500
410080,202002,166,105,61,110770,63745,174515
410090,202002,81,71,10,74195.9,10450,84645.9
410100,202002,288,204,84,215270,89870,305140
410105,202002,48,30,18,31350,18810,50160
410110,202002,320,193,127,204820,132715,337535
410115,202002,31,23,8,24035,8360,32395
410120,202002,410,207,203,221540,214225,435765
410130,202002,48,29,19,31350,19855,51205
410140,202002,3095,1503,1592,1595718.52,1676183.5,3271902.02
410150,202002,2669,1050,1619,1115016.35,1710666,2825682.35
410160,202002,503,310,193,326040,203775,529815
410165,202002,68,43,25,44935,26125,71060
410170,202002,170,114,56,121220.5,59565,180785.5
410180,202002,2227,1244,983,1333420.5,1048135.22,2381555.72
410185,202002,37,32,5,33440,5225,38665
410190,202002,485,319,166,335445.89,179740,515185.89
410200,202002,943,694,249,732545,262295,994840
410210,202002,594,311,283,328130,298870.5,627000.5
410220,202002,44,22,22,22990,22990,45980
410230,202002,149,70,79,73150,84645,157795
410240,202002,752,490,262,517276.75,277970,795246.75
410250,202002,375,272,103,286330,108680,395010
410260,202002,291,162,129,169290,141075,310365
410270,202002,28,20,8,20900,8360,29260
410275,202002,56,44,12,45980,12540,58520
410280,202002,320,188,132,197505,140030,337535
410290,202002,247,154,93,160930,97185,258115
410300,202002,75,52,23,56430,24035,80465
410302,202002,17,11,6,12540,7315,19855
410304,202002,43,29,14,30305,14630,44935
410305,202002,213,114,99,121220,105545,226765
410310,202002,218,129,89,136895,93005,229900
410315,202002,50,34,16,36575,16720,53295
410320,202002,133,93,40,97185,41800,138985
410322,202002,34,22,12,22990,13585,36575
410330,202002,175,122,53,127490,55385,182875
410335,202002,99,56,43,59565,45980,105545
410337,202002,40,32,8,34485,8360,42845
410340,202002,32,28,4,29260,4180,33440
410345,202002,217,126,91,132715,96140,228855
410347,202002,51,39,12,40755,12540,53295
410350,202002,235,145,90,154660,95095,249755
410360,202002,467,294,173,311411,182876,494287
410370,202002,2348,996,1352,1054405.7,1427471.35,2481877.05
410380,202002,206,128,78,134805,82555,217360
410390,202002,380,267,113,282150,119130,401280
410395,202002,37,24,13,25080,13585,38665
410400,202002,820,387,433,411730.27,456075.25,867805.52
410405,202002,94,70,24,73150,25080,98230
410410,202002,33,25,8,27170,8360,35530
410420,202002,1648,786,862,831727.71,914375.85,1746103.56
410425,202002,166,70,96,77330,102410,179740
410430,202002,2261,1284,977,1353275,1025146.15,2378421.15
410440,202002,370,271,99,284240,105545,389785
410442,202002,353,236,117,247665,123310,370975
410445,202002,419,295,124,311410.5,129580,440990.5
410450,202002,392,199,193,207955,203775,411730
410460,202002,491,256,235,268565,245575,514140
410465,202002,212,133,79,142120,83600,225720
410470,202002,231,145,86,153615,91960,245575
410480,202002,6143,2992,3151,3162177.94,3316835.04,6479012.98
410490,202002,1414,874,540,927960.51,565345.5,1493306.01
410500,202002,256,148,108,155705,112860,268565
410510,202002,164,122,42,129580,44935.45,174515.45
410520,202002,247,183,64,194370,67925,262295
410530,202002,263,99,164,105545,173470.22,279015.22
410540,202002,314,232,82,245575.22,85690,331265.22
410550,202002,1656,718,938,763895.34,991706.45,1755601.79
410560,202002,142,101,41,109725,43890,153615
410570,202002,431,289,142,305141.3,151525,456666.3
410580,202002,3401,1496,1905,1581087.2,2009535.5,3590622.7
410590,202002,407,281,126,298852,133760,432612
410600,202002,196,168,28,177650,29260,206910
410610,202002,53,44,9,45980,9405,55385
410620,202002,248,171,77,179740.82,81510,261250.82
410630,202002,439,253,186,268565,196460,465025
410640,202002,1013,633,380,671935.75,404415.22,1076350.97
410645,202002,106,78,28,83600,29260,112860
410650,202002,354,231,123,242440,128535.9,370975.9
410655,202002,86,62,24,64790,25080,89870
410657,202002,23,8,15,9405,15675,25080
410660,202002,599,419,180,440990.52,192280,633270.52
410670,202002,74,63,11,66880,11495,78375
410680,202002,212,171,41,179740,42845,222585
410685,202002,19,11,8,11495,8360,19855
410690,202002,28133,12013,16120,12762706.17,17105613.54,29868319.71
410700,202002,335,245,90,262295.5,95095,357390.5
410710,202002,124,102,22,107635,22990,130625
410712,202002,30,23,7,24035,7315,31350
410715,202002,90,68,22,71060,22990,94050
410720,202002,701,399,302,420090,315590.45,735680.45
410725,202002,180,130,50,136895,53295,190190
410730,202002,93,49,44,51205,45980,97185
410740,202002,108,77,31,81510,32395,113905
410750,202002,254,169,85,180785,89870,270655
410752,202002,25,15,10,15675,10450,26125
410753,202002,52,23,29,24035,30305,54340
410754,202002,45,25,20,27170.5,20900,48070.5
410755,202002,81,51,30,54340,32395,86735
410760,202002,761,418,343,437855.5,359480,797335.5
410765,202002,1726,812,914,863170.75,964536.9,1827707.65
410770,202002,105,83,22,87780,24035,111815
410773,202002,55,40,15,41800,15675,57475
410775,202002,186,139,47,147345,49115,196460
410780,202002,85,46,39,49115,40755,89870
410785,202002,57,45,12,48070,13585,61655
410790,202002,72,34,38,35530,40755,76285
410800,202002,280,174,106,184965,111815.5,296780.5
410810,202002,21,17,4,17765,4180.5,21945.5
410820,202002,174,127,47,134805,50160,184965
410830,202002,8545,3729,4816,3937564.29,5097513.96,9035078.25
410832,202002,102,72,30,75240,31350,106590
410840,202002,1434,798,636,839137.34,668801.15,1507938.49
410845,202002,69,43,26,44935,27170,72105
410850,202002,194,136,58,144210,60610,204820
410855,202002,57,46,11,49115,11495,60610
410860,202002,716,404,312,432630.5,330220.9,762851.4
410865,202002,99,76,23,80465,24035,104500
410870,202002,150,129,21,136895,22990,159885
410880,202002,1099,567,532,599832.75,563256.35,1163089.10
410890,202002,88,63,25,65835,28215,94050
410895,202002,72,56,16,58520,16720,75240
410900,202002,24,18,6,18810,7315,26125
410910,202002,16,13,3,13585,3135,16720
410920,202002,39,27,12,28215,12540,40755
410930,202002,513,319,194,335445,204820,540265
410940,202002,4340,2451,1889,2585331.57,1984455.5,4569787.07
410950,202002,104,77,27,83600,28215,111815
410960,202002,806,341,465,358435,489060,847495
410965,202002,63,48,15,51205,15675,66880
410970,202002,623,445,178,472340,193325,665665
410975,202002,119,72,47,75240.91,50160,125400.91
410980,202002,1615,730,885,771210,933185.22,1704395.22
410990,202002,268,186,82,194370,86735,281105
411000,202002,66,41,25,42845,26125.5,68970.5
411005,202002,25,21,4,21945,4180,26125
411007,202002,260,154,106,161975,113905,275880
411010,202002,597,406,191,429495,199595,629090
411020,202002,289,200,89,210045.85,94050,304095.85
411030,202002,17,10,7,10450,7315,17765
411040,202002,56,39,17,41800,18810,60610
411050,202002,206,161,45,169290,48070,217360
411060,202002,514,345,169,363660.45,177650,541310.45
411065,202002,55,48,7,54340,7315,61655
411070,202002,1238,768,470,807785,493240,1301025
411080,202002,238,168,70,175560,73150,248710
411090,202002,100,75,25,78375,27170,105545
411095,202002,283,110,173,114950,181830,296780
411100,202002,116,95,21,99275,21945,121220
411110,202002,127,83,44,86735,47025,133760
411120,202002,198,140,58,148390,60610,209000
411125,202002,238,103,135,108680,142120,250800
411130,202002,127,110,17,117040,17765,134805
411140,202002,210,139,71,145255,74195,219450
411150,202002,1216,799,417,852720,442035.29,1294755.29
411155,202002,119,81,38,85690,41800,127490
411160,202002,23,11,12,12540,13585,26125
411170,202002,51,46,5,48070,5225,53295
411180,202002,954,633,321,669845,337535,1007380
411190,202002,321,192,129,204820,137940,342760
411200,202002,667,417,250,445170.29,263340,708510.29
411210,202002,686,365,321,390830,336490.45,727320.45
411220,202002,150,110,40,114950,41800,156750
411230,202002,40,34,6,35530,6270,41800
411240,202002,122,77,45,82555,47025,129580
411250,202002,433,320,113,336490,119130,455620
411260,202002,18,12,6,13585,6270.9,19855.9
411270,202002,278,145,133,152570,141075,293645
411275,202002,189,167,22,175560,24035,199595
411280,202002,214,152,62,159885.29,64790,224675.29
411290,202002,60,47,13,49115,13585,62700
411295,202002,138,108,30,113905,32395,146300
411300,202002,76,35,41,36575,42845,79420
411310,202002,89,70,19,74195,19855,94050
411320,202002,767,522,245,549670,259160,808830
411325,202002,60,41,19,43890,19855,63745
411330,202002,900,573,327,602965.5,343805.99,946771.49
411340,202002,28,20,8,20900,8360,29260
411342,202002,64,49,15,51205,16720,67925
411345,202002,119,59,60,61655,62700,124355
411350,202002,479,372,107,389785.45,111815.5,501600.95
411360,202002,53,34,19,36575,19855,56430
411370,202002,14110,5770,8340,6104895.46,8844884.51,14949779.97
411373,202002,173,126,47,131670,49115,180785
411375,202002,72,58,14,61655,14630,76285
411380,202002,91,68,23,73150,24035,97185
411390,202002,118,78,40,82555,41800,124355
411400,202002,365,275,90,290510.45,94050,384560.45
411410,202002,432,217,215,235125,229900.5,465025.5
411420,202002,991,440,551,468160,584155,1052315
411430,202002,456,269,187,283195,197505.45,480700.45
411435,202002,32,21,11,21945,11495,33440
411440,202002,452,358,94,380380,98230,478610
411450,202002,414,352,62,369930,65835,435765
411460,202002,747,285,462,306185,485926.47,792111.47
411470,202002,86,64,22,66880,24035,90915
411480,202002,669,375,294,393965.5,309320,703285.5
411490,202002,288,188,100,196460,106590.9,303050.9
411500,202002,100,84,16,88825,16720,105545
411510,202002,219,175,44,182875,45980,228855
411520,202002,5946,2252,3694,2388871.22,3914575.45,6303446.67
411530,202002,120,83,37,86735,38665,125400
411535,202002,48,18,30,18810,31350,50160
411540,202002,349,241,108,252890,113905.9,366795.9
411545,202002,55,41,14,42845,14630,57475
411550,202002,74,57,17,60610,17765,78375
411560,202002,387,169,218,176605,230945,407550
411570,202002,809,297,512,313500.65,541310,854810.65
411573,202002,24,15,9,15675,9405,25080
411575,202002,293,186,107,195415,111815,307230
411580,202002,1280,474,806,502645,846450,1349095
411585,202002,75,36,39,37620,41800,79420
411590,202002,26,18,8,18810,8360,27170
411600,202002,25,11,14,11495,14630,26125
411605,202002,241,98,143,103455,149435,252890
411610,202002,204,134,70,143165,74195,217360
411620,202002,360,193,167,203775,176605,380380
411630,202002,54,38,16,40755,16720,57475
411640,202002,33,24,9,25080,9405,34485
411650,202002,12,7,5,7315,5225,12540
411660,202002,35,24,11,26125,11495,37620
411670,202002,237,174,63,184965,65835,250800
411680,202002,162,132,30,140030,31350,171380
411690,202002,585,313,272,331265,288420,619685
411695,202002,58,42,16,43890,16720,60610
411700,202002,138,116,22,122265,22990,145255
411705,202002,103,68,35,72105,36575,108680
411710,202002,301,206,95,217360,102410,319770
411720,202002,126,84,42,87780,44935,132715
411721,202002,67,56,11,58520,11495,70015
411722,202002,97,41,56,42845,58520,101365
411725,202002,156,117,39,123310.5,40755,164065.5
411727,202002,83,64,19,67925,19855,87780
411729,202002,38,30,8,33440,9405,42845
411730,202002,550,351,199,369930,207955,577885
411740,202002,38,24,14,26125,15675,41800
411745,202002,66,46,20,48070,20900,68970
411750,202002,857,390,467,419045.5,491150,910195.5
411760,202002,1182,879,303,926915.6,319770.45,1246686.05
411770,202002,453,302,151,316635,159885,476520
411780,202002,331,221,110,233035,115995,349030
411790,202002,521,292,229,310365.67,240350,550715.67
411800,202002,155,119,36,127490,37620,165110
411810,202002,177,133,44,138985,45980,184965
411820,202002,2149,959,1190,1026191.7,1258180,2284371.7
411830,202002,12,11,1,11495,1045,12540
411840,202002,2004,1238,766,1304160,806741,2110901
411845,202002,53,20,33,20900,35530,56430
411850,202002,1210,665,545,703285.72,574751.65,1278037.37
411860,202002,48,33,15,34485.5,15675,50160.5
411870,202002,72,49,23,52250,24035,76285
411880,202002,416,270,146,284240.67,153615,437855.67
411885,202002,105,68,37,71060,39710,110770
411890,202002,310,200,110,213181.49,115995,329176.49
411900,202002,76,57,19,59565.5,19855,79420.5
411910,202002,182,146,36,152570,37620,190190
411915,202002,2133,884,1249,939455,1318790.55,2258245.55
411920,202002,116,93,23,97185,24035,121220
411925,202002,12,8,4,8360,4180,12540
411930,202002,804,590,214,622821.35,227810,850631.35
411940,202002,580,397,183,416955.85,194370,611325.85
411950,202002,967,469,498,499510.76,527725,1027235.76
411960,202002,1028,702,326,736725.75,344850,1081575.75
411965,202002,20,14,6,14630,6270,20900
411970,202002,81,72,9,76285,9405,85690
411980,202002,168,109,59,117040,62700.9,179740.9
411990,202002,5131,2952,2179,3123512.96,2305272.25,5428785.21
411995,202002,469,170,299,179740,316635,496375
412000,202002,315,205,110,214225,117040,331265
412010,202002,48,31,17,34485,17765,52250
412015,202002,40,29,11,30305,11495,41800
412020,202002,31,25,6,27170,6270,33440
412030,202002,49,46,3,48070,3135,51205
412033,202002,48,32,16,35530,17765,53295
412035,202002,67,45,22,47025,24035,71060
412040,202002,41,23,18,24035.5,18810,42845.5
412050,202002,199,152,47,159885,51205,211090
412060,202002,775,586,189,618640,198550,817190
412065,202002,48,31,17,32395,17765,50160
412070,202002,163,111,52,118085,54340.5,172425.5
412080,202002,289,149,140,156750,146300,303050
412085,202002,34,16,18,16720,18810,35530
412090,202002,798,501,297,528770.25,315590.9,844361.15
412100,202002,241,204,37,216315,38665,254980
412110,202002,69,54,15,56430.4,15675,72105.4
412120,202002,323,194,129,204820,137940.9,342760.9
412125,202002,84,49,35,51205,36575,87780
412130,202002,38,25,13,26125.4,13585,39710.4
412135,202002,29,17,12,17765,13585,31350
412140,202002,330,224,106,240350,114950,355300
412150,202002,257,169,88,177650,91960,269610
412160,202002,91,53,38,55385,39710,95095
412170,202002,676,474,202,499510.5,215270,714780.5
412175,202002,38,28,10,29260,10450,39710
412180,202002,192,150,42,157795,43890,201685
412190,202002,337,268,69,282150,74195,356345
412200,202002,185,118,67,123310,74195,197505
412210,202002,72,57,15,59565,16720,76285
412215,202002,222,156,66,163020,70015,233035
412217,202002,67,53,14,55385,14630,70015
412220,202002,821,588,233,623865,243485,867350
412230,202002,327,200,127,210045,133760.9,343805.9
412240,202002,1347,676,671,715825.9,710600,1426425.9
412250,202002,401,253,148,265430,155705,421135
412260,202002,104,75,29,80465,30305,110770
412265,202002,173,138,35,145255,37620,182875
412270,202002,83,54,29,56430,31350,87780
412280,202002,89,72,17,75240,17765,93005
412290,202002,94,65,29,67925,30305,98230
412300,202002,204,135,69,144210,74195,218405
412310,202002,47,41,6,42845,6270,49115
412320,202002,97,80,17,83600,18810,102410
412330,202002,188,160,28,168245,29260,197505
412340,202002,151,106,45,110770,47025.5,157795.5
412350,202002,616,300,316,317680,336490,654170
412360,202002,26,22,4,24035,4180,28215
412370,202002,155,135,20,146300.3,22990,169290.3
412380,202002,261,194,67,204820,70015.45,274835.45
412382,202002,61,32,29,33440,30305,63745
412385,202002,147,108,39,113905,41800,155705
412390,202002,278,213,65,226765,67925,294690
412395,202002,71,58,13,60610,13585,74195
412400,202002,85,58,27,60610,29260,89870
412402,202002,234,115,119,120175.5,129580,249755.5
412405,202002,851,315,536,333355,569525,902880
412410,202002,965,592,373,625955.5,398145,1024100.5
412420,202002,11,10,1,10450,1045,11495
412430,202002,19,14,5,15675,5225,20900
412440,202002,611,332,279,351120,294690,645810
412450,202002,76,66,10,70015,10450,80465
412460,202002,91,69,22,73150,22990,96140
412470,202002,216,174,42,186010,43890,229900
412480,202002,143,106,37,112860.75,40755,153615.75
412490,202002,160,142,18,149435,18810,168245
412500,202002,433,355,78,377245.06,81510,458755.06
412510,202002,178,148,30,155705.5,32395,188100.5
412520,202002,89,60,29,62700,31350,94050
412530,202002,104,56,48,58520,51205,109725
412535,202002,91,68,23,71060.9,24035,95095.9
412540,202002,81,38,43,39710,44935,84645
412545,202002,95,66,29,68970,30305,99275
412550,202002,3734,1631,2103,1733935.06,2218535.9,3952470.96
412555,202002,13,9,4,10450,4180,14630
412560,202002,603,433,170,457711.5,181830.75,639542.25
412570,202002,753,395,358,415910,380380,796290
412575,202002,88,61,27,63745,29260,93005
412580,202002,175,115,60,121220,62700,183920
412590,202002,37,32,5,33440,5225,38665
412600,202002,164,122,42,128535.85,43890,172425.85
412610,202002,35,17,18,18810,18810,37620
412620,202002,147,125,22,130625,22990,153615
412625,202002,2141,1125,1016,1192346.04,1084712.07,2277058.11
412627,202002,69,52,17,55385,17765,73150
412630,202002,414,273,141,285285,148390,433675
412635,202002,64,17,47,17765,49115,66880
412640,202002,107,74,33,78375,35530,113905
412650,202002,344,220,124,233035,130625,363660
412660,202002,474,290,184,310365,193325,503690
412665,202002,45,40,5,42845,5225,48070
412667,202002,292,200,92,211090,96140,307230
412670,202002,66,55,11,57475,12540,70015
412680,202002,292,229,63,241395,66880.7,308275.7
412690,202002,100,67,33,72105,35530.5,107635.5
412700,202002,161,109,52,113905,54340,168245
412710,202002,1393,847,546,900791.25,576840,1477631.25
412720,202002,228,146,82,155705,85690,241395
412730,202002,189,158,31,169290,33440,202730
412740,202002,427,227,200,240350,211090,451440
412750,202002,438,250,188,265430,197505,462935
412760,202002,276,145,131,153615,138985,292600
412770,202002,2106,1164,942,1233100.29,1004246.45,2237346.74
412780,202002,142,109,33,117040,34485,151525
412785,202002,278,139,139,147345,145255,292600
412788,202002,35,21,14,21945,14630,36575
412790,202002,126,107,19,111815,19855,131670
412795,202002,151,110,41,114950,42845,157795
412796,202002,317,211,106,223630,111815,335445
412800,202002,607,373,234,395010.25,245575.45,640585.70
412810,202002,2919,1596,1323,1692903.15,1404480,3097383.15
412820,202002,934,592,342,628047.25,359480.45,987527.70
412830,202002,14,11,3,11495,3135,14630
412840,202002,223,161,62,169290.5,65835,235125.5
412850,202002,761,497,264,525635,280060,805695
412853,202002,169,87,82,90915,85690.27,176605.27
412855,202002,194,106,88,112860.09,91960,204820.09
412860,202002,96,64,32,66880,33440,100320
412862,202002,56,42,14,43890,14630,58520
412863,202002,6,5,1,5225,1045,6270
412865,202002,42,30,12,33440,12540,45980
412870,202002,109,67,42,70015,43890,113905
412880,202002,95,71,24,75240.5,26125,101365.5
420005,202002,45,40,5,41800,5225,47025
420010,202002,361,235,126,252890.75,132715,385605.75
420020,202002,83,70,13,74195,13585,87780
420030,202002,23,21,2,21945,2090,24035
420040,202002,104,81,23,87780,24035,111815
420050,202002,56,34,22,35530,22990,58520
420055,202002,18,18,0,18810,0,18810
420060,202002,27,21,6,22990,7315,30305
420070,202002,100,83,17,89870,17765,107635
420075,202002,13,13,0,13585,0,13585
420080,202002,43,38,5,40755,5225,45980
420090,202002,34,32,2,34485,2090,36575
420100,202002,148,126,22,132715.5,22990,155705.5
420110,202002,20,20,0,21945,0,21945
420120,202002,62,46,16,50160,16720,66880
420125,202002,78,61,17,67925,17765,85690
420127,202002,30,26,4,28215,4180,32395
420130,202002,414,253,161,269610,171380,440990
420140,202002,1283,712,571,758671.45,605055,1363726.45
420150,202002,45,38,7,41800,7315,49115
420160,202002,34,32,2,36575,2090,38665
420165,202002,18,12,6,12540,6270,18810
420170,202002,75,49,26,52250,29260,81510
420180,202002,22,19,3,19855,3135,22990
420190,202002,27,23,4,24035,4180,28215
420195,202002,128,64,64,66880,66880,133760
420200,202002,1268,558,710,593560.5,761807.7,1355368.2
420205,202002,77,45,32,47025,33440,80465
420207,202002,119,64,55,66880,57475,124355
420208,202002,19,15,4,15675,4180,19855
420209,202002,19,16,3,16720,3135,19855
420210,202002,498,237,261,252890,276925.45,529815.45
420213,202002,46,36,10,37620,11495,49115
420215,202002,26,23,3,25080,3135,28215
420220,202002,69,47,22,50160,22990,73150
420230,202002,822,467,355,497420.45,378291.4,875711.85
420240,202002,2257,1493,764,1589446.35,811965.9,2401412.25
420243,202002,41,32,9,33440,9405,42845
420245,202002,142,73,69,76285,72105,148390
420250,202002,62,41,21,42845,22990,65835
420253,202002,36,28,8,30305,8360,38665
420257,202002,14,11,3,11495,3135,14630
420260,202002,98,83,15,88825,16720,105545
420270,202002,31,26,5,27170.22,5225,32395.22
420280,202002,288,217,71,227812.1,75241.65,303053.75
420285,202002,20,11,9,12540,9405,21945
420287,202002,47,32,15,33440,15675,49115
420290,202002,972,677,295,732545.94,313500.66,1046046.60
420300,202002,1424,1135,289,1201752.35,305140.65,1506893.00
420310,202002,46,31,15,33440,15675,49115
420315,202002,35,28,7,29260,7315,36575
420320,202002,882,444,438,473385.1,468160.22,941545.32
420325,202002,0,,,,,0.0
420330,202002,119,79,40,84645,41800,126445
420340,202002,156,101,55,110770.45,57475,168245.45
420350,202002,247,181,66,190190,70015,260205
420360,202002,748,572,176,604010.45,188101.15,792111.60
420370,202002,118,71,47,76285,50160.5,126445.5
420380,202002,1163,810,353,853765.7,372022.3,1225788.0
420390,202002,251,175,76,182875,80465,263340
420395,202002,194,140,54,149435,56430,205865
420400,202002,246,185,61,194370.65,63745,258115.65
420410,202002,60,45,15,48070,15675,63745
420415,202002,32,28,4,29260,4180,33440
420417,202002,51,40,11,41800,11495,53295
420419,202002,11,11,0,11495,0,11495
420420,202002,2827,1755,1072,1852789.14,1132781.85,2985570.99
420425,202002,69,56,13,59565,13585.45,73150.45
420430,202002,1182,852,330,907060.66,356345.45,1263406.11
420435,202002,14,12,2,14630,2090,16720
420440,202002,97,67,30,70015.5,31350,101365.5
420445,202002,22,21,1,21945,1045,22990
420450,202002,77,40,37,41800,39710,81510
420455,202002,213,164,49,174516.35,51206.35,225722.70
420460,202002,2285,1492,793,1591538.8,844364.1,2435902.9
420470,202002,108,76,32,79420,33440,112860
420475,202002,7,7,0,7315,0,7315
420480,202002,862,652,210,688656,223630.5,912286.5
420490,202002,106,77,29,81510,30305,111815
420500,202002,458,243,215,263341.56,247665,511006.56
420510,202002,17,16,1,17765,1045,18810
420515,202002,24,18,6,19855,7315,27170
420517,202002,10,10,0,10450,0,10450
420519,202002,0,,,,,0.0
420520,202002,67,50,17,54340,18810,73150
420530,202002,164,110,54,117040.75,58520,175560.75
420535,202002,20,18,2,18810,2090,20900
420540,202002,5442,3253,2189,3465487.8,2343936.4,5809424.2
420543,202002,24,23,1,24035,1045,25080
420545,202002,203,144,59,153615.45,61655.9,215271.35
420550,202002,840,694,146,738816.4,159886.8,898703.2
420555,202002,37,27,10,28215,10450,38665
420560,202002,63,53,10,55385,11495,66880
420570,202002,153,89,64,94050,67925,161975
420580,202002,274,128,146,136895,154660.5,291555.5
420590,202002,517,350,167,374110,174515,548625
420600,202002,112,61,51,63745,53295,117040
420610,202002,39,35,4,37620,4180,41800
420620,202002,84,66,18,68970,18810,87780
420630,202002,150,105,45,111815.22,47025.66,158840.88
420640,202002,81,71,10,76285,10450,86735
420650,202002,243,125,118,134805,124355,259160
420660,202002,50,39,11,40755.5,11495,52250.5
420665,202002,37,28,9,29260,9405,38665
420670,202002,306,235,71,247665,75240.45,322905.45
420675,202002,12,11,1,11495,1045,12540
420680,202002,38,27,11,28215,11495,39710
420690,202002,171,132,39,145255,40755,186010
420700,202002,685,469,216,507873.16,234084.05,741957.21
420710,202002,146,85,61,89870,63745,153615
420720,202002,109,89,20,94050.45,21945,115995.45
420730,202002,592,375,217,395012.19,228857.3,623869.49
420740,202002,51,50,1,53295,1045,54340
420750,202002,502,340,162,364705,172425,537130
420757,202002,17,15,2,15675,2090,17765
420760,202002,37,29,8,30305,8360,38665
420765,202002,77,60,17,63745,17765,81510
420768,202002,48,44,4,48070,4180,52250
420770,202002,73,63,10,65835,11495,77330
420775,202002,41,38,3,41800,3135,44935
420780,202002,230,182,48,193325,50160,243485
420785,202002,12,10,2,10450,2090,12540
420790,202002,159,132,27,140031.35,28215.9,168247.25
420800,202002,65,48,17,51205,17765,68970
420810,202002,254,213,41,225720,42845,268565
420820,202002,2316,1333,983,1423290.95,1045001.67,2468292.62
420830,202002,586,320,266,344850.5,280060,624910.5
420840,202002,151,111,40,115995,41800,157795
420845,202002,411,178,233,189145,246620.5,435765.5
420850,202002,258,199,59,212135,63745,275880
420860,202002,62,52,10,54340,10450,64790
420870,202002,125,89,36,96140,37620,133760
420880,202002,178,116,62,125400,64790.45,190190.45
420890,202002,938,470,468,500555.25,496375,996930.25
420895,202002,9,9,0,9405,0,9405
420900,202002,409,327,82,345895,86735.45,432630.45
420910,202002,5840,3256,2584,3462090.22,2736856.55,6198946.77
420915,202002,69,64,5,68970,5225,74195
420917,202002,21,14,7,14630,7315,21945
420920,202002,23,16,7,16720,7315,24035
420930,202002,2777,1735,1042,1848563.35,1104640.4,2953203.75
420940,202002,595,438,157,461891,164067.47,625958.47
420945,202002,9,7,2,7315,2090,9405
420950,202002,58,51,7,54340,7315,61655
420960,202002,109,87,22,91960.9,24035.45,115996.35
420970,202002,294,237,57,249757.8,60610.45,310368.25
420980,202002,23,22,1,24035,1045,25080
420985,202002,56,50,6,53295,6270,59565
420990,202002,83,63,20,65835,20900,86735
421000,202002,38,24,14,25080,14630,39710
421003,202002,56,38,18,41800,19855.45,61655.45
421005,202002,6,3,3,3135,3135,6270
421010,202002,762,526,236,558030,247666.5,805696.5
421020,202002,25,20,5,20900,5225,26125
421030,202002,123,103,20,108680.75,20900,129580.75
421040,202002,72,55,17,57475,17765,75240
421050,202002,332,231,101,244531,107635,352166
421055,202002,21,17,4,17765,4180,21945
421060,202002,86,50,36,53295,37620,90915
421070,202002,50,44,6,45980.5,6270,52250.5
421080,202002,34,30,4,31350,4180,35530
421085,202002,21,16,5,16720,5225,21945
421090,202002,38,28,10,30305,10450,40755
421100,202002,121,88,33,94050,34485,128535
421105,202002,204,168,36,178695.45,37620.45,216315.90
421110,202002,111,89,22,93005,22990,115995
421120,202002,163,120,43,127491.1,44935,172426.1
421125,202002,17,12,5,12540,5225,17765
421130,202002,809,513,296,545490,315590.5,861080.5
421140,202002,30,20,10,21945,10450,32395
421145,202002,41,33,8,34485,8360,42845
421150,202002,102,73,29,78375,30305,108680
421160,202002,69,48,21,51205,21945,73150
421165,202002,16,15,1,16720,1045,17765
421170,202002,175,147,28,160013.3,31350.45,191363.75
421175,202002,165,113,52,118085,55385,173470
421180,202002,51,33,18,34485.1,18810,53295.1
421185,202002,17,14,3,14630,3135,17765
421187,202002,0,0,0,0,0,0
421189,202002,45,31,14,32395,14630,47025
421190,202002,1645,1035,610,1101430,645811.24,1747241.24
421200,202002,93,69,24,72105,25080,97185
421205,202002,27,17,10,18810,10450,29260
421210,202002,171,119,52,124355,54340,178695
421220,202002,279,216,63,226765,66880,293645
421223,202002,47,38,9,40755,9405,50160
421225,202002,68,42,26,44935,27170,72105
421227,202002,85,66,19,68970,19855,88825
421230,202002,53,37,16,38665,16720,55385
421240,202002,19,19,0,19855,0,19855
421250,202002,366,220,146,234080.5,155705,389785.5
421260,202002,24,20,4,20900,4180,25080
421265,202002,2,2,0,2090,0,2090
421270,202002,46,41,5,43890,5225,49115
421280,202002,336,186,150,199595,158840,358435
421290,202002,330,222,108,235125,114950,350075
421300,202002,23,18,5,18810,5225,24035
421310,202002,45,32,13,33440,13585,47025
421315,202002,31,20,11,20900,11495,32395
421320,202002,129,82,47,91960,50160,142120
421330,202002,105,77,28,80465,29260.45,109725.45
421335,202002,39,27,12,28215,12540,40755
421340,202002,241,154,87,161975.25,90915,252890.25
421350,202002,186,107,79,112860.82,83600,196460.82
421360,202002,644,481,163,511005.7,170335.45,681341.15
421370,202002,202,153,49,165110,51205,216315
421380,202002,123,98,25,104500,26125,130625
421390,202002,19,13,6,13585,6270,19855
421400,202002,125,107,18,115995,18810,134805
421410,202002,18,16,2,16720,2090,18810
421415,202002,21,20,1,20900,1045,21945
421420,202002,134,113,21,120175,22990,143165
421430,202002,17,12,5,12540,5225,17765
421440,202002,57,48,9,50160,9405,59565
421450,202002,92,76,16,81510,17765,99275
421460,202002,58,46,12,49115,12540,61655
421470,202002,69,44,25,48070,26125,74195
421480,202002,714,542,172,573705,183920.45,757625.45
421490,202002,24,23,1,24035.45,1045,25080.45
421500,202002,488,313,175,329176.85,182883.35,512060.20
421505,202002,25,18,7,19855,7315,27170
421507,202002,30,23,7,24035,8360,32395
421510,202002,70,45,25,49115,26125,75240
421520,202002,56,47,9,49115,9405,58520
421530,202002,51,44,7,45980,7315,53295
421535,202002,27,25,2,26125,2090,28215
421540,202002,53,47,6,49115,7315,56430
421545,202002,99,73,26,78375.45,27170,105545.45
421550,202002,288,209,79,218405,83600,302005
421555,202002,21,17,4,17765,4180.5,21945.5
421560,202002,8,7,1,7315,1045,8360
421565,202002,124,84,40,87780,41800,129580
421567,202002,29,24,5,25080,5225,30305
421568,202002,30,27,3,28215,3135,31350
421569,202002,10,10,0,10450,0,10450
421570,202002,193,132,61,140030,63745,203775
421575,202002,27,22,5,22990,5225,28215
421580,202002,710,423,287,448373.45,304095,752468.45
421590,202002,20,19,1,20900,1045,21945
421600,202002,148,98,50,103455,52250.5,155705.5
421605,202002,111,76,35,80465.75,38665,119130.75
421610,202002,189,144,45,151525,47025,198550
421620,202002,1028,600,428,637450.45,452485,1089935.45
421625,202002,22,19,3,19855,3135,22990
421630,202002,302,189,113,201685.25,119132,320817.25
421635,202002,18,9,9,10450,9405,19855
421640,202002,100,85,15,88825,15675,104500
421650,202002,300,180,120,189145,127490.67,316635.67
421660,202002,2167,1309,858,1397166.45,920647.12,2317813.57
421670,202002,185,133,52,141075,54340,195415
421680,202002,175,158,17,166155,18810,184965
421690,202002,342,243,99,260206.4,104501.05,364707.45
421700,202002,58,38,20,39710,20900,60610
421710,202002,24,23,1,25080,1045,26125
421715,202002,7,6,1,6270,1045,7315
421720,202002,615,434,181,460846.25,192280,653126.25
421725,202002,16,6,10,6270,10450,16720
421730,202002,35,25,10,26125,10450,36575
421740,202002,88,36,52,40755,56430,97185
421750,202002,213,159,54,168245,57475,225720
421755,202002,24,22,2,25080,2090,27170
421760,202002,100,69,31,72105,32395,104500
421770,202002,636,413,223,436815.35,236171.8,672987.15
421775,202002,29,18,11,18810,11495,30305
421780,202002,194,152,42,161975.5,47025,209000.5
421790,202002,152,128,24,138985,25080,164065
421795,202002,19,16,3,16720,4180,20900
421800,202002,508,326,182,344850,193325.25,538175.25
421810,202002,71,58,13,63745,13585,77330
421820,202002,322,211,111,231990.5,117040,349030.5
421825,202002,130,111,19,117040,20900,137940
421830,202002,134,94,40,100320,42845,143165
421835,202002,4,4,0,4180,0,4180
421840,202002,52,44,8,45980.45,8360,54340.45
421850,202002,79,68,11,71060,11495.22,82555.22
421860,202002,37,30,7,31350,7315,38665
421870,202002,980,732,248,777506.52,263344.84,1040851.36
421875,202002,54,44,10,45980,10450,56430
421880,202002,161,114,47,120175,50160.5,170335.5
421885,202002,21,17,4,18810,4180,22990
421890,202002,133,93,40,98230,41800.45,140030.45
421895,202002,46,40,6,44935,6270,51205
421900,202002,153,119,34,124355.9,36576.8,160932.7
421910,202002,67,40,27,42845,28215,71060
421915,202002,30,25,5,27170,6270,33440
421917,202002,37,28,9,30305,11495,41800
421920,202002,41,37,4,38665,4180,42845
421930,202002,689,549,140,587290.87,147346.35,734637.22
421935,202002,48,42,6,43890,6270,50160
421940,202002,42,37,5,39710,5225,44935
421950,202002,852,574,278,604010.5,293645.45,897655.95
421960,202002,46,40,6,41800.5,6270,48070.5
421970,202002,355,229,126,246620.5,132715.45,379335.95
421985,202002,27,17,10,18810,10450,29260
422000,202002,0,,,,,0.0
430003,202002,181,56,125,59565,134805,194370
430005,202002,37,27,10,29260,10450,39710
430010,202002,261,189,72,198550,77330,275880
430020,202002,143,96,47,100320.5,50160,150480.5
430030,202002,119,97,22,102410,26125,128535
430040,202002,2901,1709,1192,1805762,1255046.85,3060808.85
430045,202002,69,58,11,60610,11495,72105
430047,202002,7,6,1,6270,1045,7315
430050,202002,79,67,12,72105,12540,84645
430055,202002,13,11,2,11495,2090,13585
430057,202002,5,4,1,4180,1045,5225
430060,202002,3633,2129,1504,2265562.65,1607210.9,3872773.55
430063,202002,51,47,4,51205,4180,55385
430064,202002,152,123,29,129580,30305,159885
430066,202002,5,2,3,2090,3135,5225
430070,202002,44,32,12,33440,12540,45980
430080,202002,69,47,22,49115,22990,72105
430085,202002,32,10,22,10450,22990,33440
430087,202002,27,21,6,22990.75,6270,29260.75
430090,202002,71,64,7,68970,7315,76285
430100,202002,122,82,40,87780,43890,131670
430105,202002,149,82,67,85690,72105,157795
430107,202002,18,12,6,13585,6270,19855
430110,202002,433,251,182,263340,191235,454575
430120,202002,151,140,11,146300,11495,157795
430130,202002,791,486,305,514140.5,327085,841225.5
430140,202002,124,117,7,125400,7315,132715
430150,202002,107,69,38,74195,40755,114950
430155,202002,34,30,4,32395,4180,36575
430160,202002,3602,2116,1486,2233167.75,1575860.5,3809028.25
430163,202002,357,162,195,169290,211090,380380
430165,202002,31,21,10,21945,10450,32395
430170,202002,92,78,14,81510,14630,96140
430175,202002,77,60,17,63745,17765,81510
430180,202002,103,84,19,87780,19855,107635
430185,202002,33,23,10,24035,10450,34485
430187,202002,80,37,43,39710,48070,87780
430190,202002,221,120,101,128535,106590,235125
430192,202002,13,11,2,11495,2090,13585
430195,202002,16,11,5,11495,6270,17765
430200,202002,165,143,22,149435,22990,172425
430205,202002,21,20,1,20900,1045,21945
430210,202002,688,532,156,562210.5,166155.5,728366.0
430215,202002,12,10,2,10450,2090,12540
430220,202002,72,50,22,54340,22990,77330
430222,202002,12,6,6,6270,6270,12540
430223,202002,14,7,7,7315,8360,15675
430225,202002,2,1,1,1045,1045,2090
430230,202002,319,187,132,197505,137940,335445
430235,202002,56,42,14,43890,14630,58520
430237,202002,24,19,5,19855,5225,25080
430240,202002,129,86,43,90915.5,45980,136895.5
430245,202002,70,55,15,58520,15675,74195
430250,202002,189,113,76,119130,80465,199595
430258,202002,9,8,1,8360,1045,9405
430260,202002,32,28,4,30305,4180,34485
430265,202002,36,31,5,32395,5225,37620
430270,202002,511,380,131,403371.25,141076.8,544448.05
430280,202002,1027,632,395,669845,416955,1086800
430290,202002,392,217,175,229900,183920,413820
430300,202002,2054,1138,916,1217425.5,970807.3,2188232.8
430310,202002,1961,998,963,1065900.5,1025147.16,2091047.66
430320,202002,56,45,11,47025,11495,58520
430330,202002,97,86,11,89870,11495,101365
430340,202002,73,59,14,62700,14630,77330
430350,202002,1655,1125,530,1188166,556985.45,1745151.45
430355,202002,20,18,2,18810,2090,20900
430360,202002,89,46,43,48070,44935,93005
430367,202002,36,27,9,28215,9405,37620
430370,202002,54,47,7,49115,7315,56430
430380,202002,137,103,34,109725,36575,146300
430390,202002,581,361,220,382470,231990,614460
430400,202002,135,101,34,109725.5,35530,145255.5
430410,202002,56,44,12,47025,12540,59565
430420,202002,502,335,167,356345.85,176605,532950.85
430430,202002,53,52,1,54689.03,1045,55734.03
430435,202002,152,113,39,120175,41800,161975
430440,202002,492,323,169,344850,179740,524590
430450,202002,1152,946,206,1001110,221540,1222650
430460,202002,5138,2719,2419,2898831.65,2563395.69,5462227.34
430461,202002,16,15,1,15675,1045,16720
430462,202002,10,6,4,6270,4180,10450
430463,202002,1062,574,488,604010,514140.9,1118150.9
430465,202002,23,13,10,13585,10450,24035
430466,202002,668,478,190,509960.5,202730,712690.5
430467,202002,104,56,48,59565,50160,109725
430468,202002,114,69,45,73150,50160,123310
430469,202002,22,17,5,17765,5225,22990
430470,202002,1146,644,502,676427.12,530860,1207287.12
430471,202002,55,37,18,38665,18810,57475
430480,202002,100,63,37,66880,38665,105545
430485,202002,6,6,0,6270.5,0,6270.5
430490,202002,81,64,17,71060,17765,88825
430495,202002,32,25,7,26125,7315,33440
430500,202002,186,126,60,131670,63745,195415
430510,202002,3443,2245,1198,2374240.13,1266540,3640780.13
430511,202002,16,15,1,16720,1045,17765
430512,202002,148,102,46,106590,48070,154660
430513,202002,52,42,10,43890,10450,54340
430515,202002,27,25,2,29260,2090,31350
430517,202002,164,145,19,153615,19855,173470
430520,202002,349,244,105,256025,111815,367840
430530,202002,87,50,37,52250,38665,90915
430535,202002,458,309,149,327085,156750.22,483835.22
430537,202002,9,9,0,9405,0,9405
430540,202002,81,56,25,58520,26125,84645
430543,202002,342,110,232,114950,248710,363660
430544,202002,43,40,3,41800,3135,44935
430545,202002,364,189,175,202730,187055,389785
430550,202002,41,34,7,35530,7315,42845
430558,202002,3,2,1,2090,1045,3135
430560,202002,56,30,26,31350,27170,58520
430570,202002,105,40,65,42845,68970,111815
430580,202002,128,105,23,109725,24035.04,133760.04
430583,202002,13,13,0,14630,0,14630
430585,202002,11,5,6,5225,7315,12540
430587,202002,15,7,8,7315,8360,15675
430590,202002,141,116,25,123310,26125,149435
430593,202002,2,2,0,2090,0,2090
430595,202002,17,14,3,14630,3135,17765
430597,202002,47,25,22,26125,22990,49115
430600,202002,220,161,59,168245,61655,229900
430605,202002,157,100,57,104500,59565,164065
430607,202002,23,20,3,20900,3135,24035
430610,202002,1600,757,843,802560,891385.95,1693945.95
430613,202002,2,2,0,2090,0,2090
430620,202002,110,78,32,82555,34485,117040
430630,202002,48,42,6,43890,6270,50160
430632,202002,32,27,5,28215,5225,33440
430635,202002,34,31,3,32395,3135,35530
430637,202002,55,30,25,31350,26125,57475
430640,202002,179,102,77,106590,81510,188100
430642,202002,20,18,2,18810,2090,20900
430645,202002,37,30,7,31350,7315,38665
430650,202002,248,202,46,214225.5,49115,263340.5
430655,202002,2,2,0,2090,0,2090
430660,202002,967,480,487,505780,516230.5,1022010.5
430670,202002,74,51,23,54340,24035,78375
430673,202002,67,40,27,41800,28215,70015
430675,202002,11,9,2,9405,2090,11495
430676,202002,502,298,204,314545,215270,529815
430680,202002,240,166,74,178696,77330,256026
430690,202002,527,330,197,347985.45,209000.29,556985.74
430692,202002,8,6,2,6270,2090,8360
430693,202002,138,92,46,97185,50160,147345
430695,202002,69,57,12,60610,12540,73150
430697,202002,56,35,21,36575,22990,59565
430700,202002,1515,1055,460,1116060.9,489060,1605120.9
430705,202002,21,20,1,21945,1045,22990
430710,202002,252,161,91,169290,97185,266475
430720,202002,106,90,16,94050,16720,110770
430730,202002,137,118,19,124355,19855,144210
430740,202002,70,47,23,49115,25080,74195
430745,202002,30,23,7,24035,7315,31350
430750,202002,321,212,109,224675,114950,339625
430755,202002,84,47,37,49115,38665,87780
430760,202002,376,219,157,229900.6,166155.45,396056.05
430770,202002,1470,767,703,806740.5,745086.4,1551826.9
430780,202002,295,188,107,197505.45,113905.45,311410.90
430781,202002,26,22,4,22990,4180,27170
430783,202002,59,47,12,49115,12540,61655
430786,202002,5,3,2,3135,2090,5225
430790,202002,513,341,172,360525,182875.5,543400.5
430800,202002,151,125,26,134805.76,27170,161975.76
430805,202002,41,37,4,38665,4180,42845
430807,202002,42,23,19,24035,19855,43890
430810,202002,74,46,28,48070,30305,78375
430820,202002,144,86,58,90915,61655,152570
430825,202002,10,8,2,8360,2090,10450
430830,202002,237,218,19,229900.5,19855,249755.5
430840,202002,124,84,40,88825,41800,130625
430843,202002,6,4,2,4180,2090,6270
430845,202002,71,40,31,41800,32395,74195
430850,202002,580,408,172,432630,181831.35,614461.35
430860,202002,158,102,56,106590,58520,165110
430865,202002,70,40,30,42845,31350.45,74195.45
430870,202002,77,63,14,65835,14630,80465
430880,202002,153,116,37,121220,38665,159885
430885,202002,9,7,2,7315,2090,9405
430890,202002,347,208,139,218405,145255,363660
430900,202002,502,353,149,376200,159885,536085
430905,202002,111,48,63,52250,66880,119130
430910,202002,280,155,125,165110,131670.45,296780.45
430912,202002,5,5,0,5225,0,5225
430915,202002,33,28,5,30305,5225,35530
430920,202002,4218,2272,1946,2422310,2070145.45,4492455.45
430925,202002,4,3,1,4180,1045,5225
430930,202002,2072,1212,860,1280127.25,912285.44,2192412.69
430940,202002,258,167,91,180785,95095,275880
430950,202002,147,121,26,128535,27170,155705
430955,202002,24,13,11,13585,11495,25080
430957,202002,17,15,2,15675,2090,17765
430960,202002,243,164,79,174515,82555,257070
430965,202002,113,71,42,74195,43890,118085
430970,202002,84,70,14,74195,14630,88825
430975,202002,39,35,4,38665,4180,42845
430980,202002,45,28,17,30305,17765,48070
430990,202002,111,87,24,90915,26125,117040
430995,202002,114,108,6,112860,6270,119130
431000,202002,298,140,158,148391.1,166155,314546.1
431010,202002,350,200,150,215270,158840,374110
431020,202002,1853,1077,776,1141140.5,817190,1958330.5
431030,202002,41,34,7,35530,8360,43890
431033,202002,391,192,199,202730,210045,412775
431036,202002,14,8,6,8360,6270,14630
431040,202002,138,83,55,87780,57475,145255
431041,202002,40,27,13,28215.5,13585,41800.5
431043,202002,46,26,20,27170,20900,48070
431046,202002,11,7,4,7315,4180,11495
431050,202002,200,126,74,134805,77330,212135
431053,202002,69,41,28,44935,30305,75240
431055,202002,62,42,20,44935,20900,65835
431057,202002,18,18,0,18810,0,18810
431060,202002,1610,1046,564,1102476.84,597746.6,1700223.44
431065,202002,20,11,9,12540,9405,21945
431070,202002,63,57,6,59565,6270,65835
431075,202002,7,7,0,7315,0,7315
431080,202002,132,81,51,84645,54340,138985
431085,202002,32,29,3,30305,3135,33440
431087,202002,14,12,2,12540,2090,14630
431090,202002,55,43,12,44935,12540,57475
431100,202002,1190,723,467,761806.55,500555,1262361.55
431110,202002,229,140,89,146300,94050.5,240350.5
431112,202002,28,16,12,16720,12540,29260
431113,202002,33,24,9,27170,9405,36575
431115,202002,153,108,45,113905,47025,160930
431120,202002,600,359,241,376200,253935.9,630135.9
431123,202002,3,2,1,2090,1045,3135
431125,202002,96,87,9,90915,9405,100320
431127,202002,9,4,5,4180,5225,9405
431130,202002,692,454,238,476520,253935,730455
431140,202002,744,515,229,546535.5,247665,794200.5
431142,202002,27,23,4,24035.67,4180,28215.67
431150,202002,195,149,46,155705,48070,203775
431160,202002,51,46,5,50160,5225,55385
431162,202002,5,4,1,5225,1045,6270
431164,202002,5,5,0,5225,0,5225
431170,202002,106,84,22,87780,24035,111815
431171,202002,67,40,27,42845,29260,72105
431173,202002,1,1,0,1045,0,1045
431175,202002,194,99,95,107635.5,102410,210045.5
431177,202002,77,56,21,59565,22990,82555
431179,202002,13,11,2,12540,2090,14630
431180,202002,436,263,173,281105,183920.45,465025.45
431190,202002,79,61,18,64790,18810,83600
431198,202002,73,52,21,54340,21945,76285
431200,202002,21,17,4,17765,4180,21945
431205,202002,20,19,1,21945,1045,22990
431210,202002,92,56,36,58520,37620,96140
431213,202002,31,27,4,28215,4180,32395
431215,202002,21,18,3,18810,3135,21945
431217,202002,4,3,1,3135,1045,4180
431220,202002,66,57,9,60610.37,10450,71060.37
431225,202002,143,92,51,96140,53295,149435
431230,202002,101,87,14,93005,14630,107635
431235,202002,7,7,0,7315,0,7315
431237,202002,22,16,6,16720,6270,22990
431238,202002,9,6,3,6270,3135,9405
431240,202002,987,626,361,658350,379335,1037685
431242,202002,37,36,1,38665,1045,39710
431244,202002,12,8,4,8360,4180,12540
431245,202002,49,36,13,37620,13585,51205
431247,202002,10,7,3,8360,3135,11495
431250,202002,279,143,136,149435,142120,291555
431260,202002,59,46,13,48070,14630,62700
431261,202002,17,11,6,11495,6270,17765
431262,202002,18,17,1,17765,1045,18810
431265,202002,148,80,68,83600,71060,154660
431267,202002,15,14,1,14630,1045,15675
431270,202002,319,262,57,276925,59565,336490
431275,202002,37,34,3,37620,3135,40755
431280,202002,19,15,4,15675,4180,19855
431290,202002,23,20,3,20900,3135,24035
431295,202002,2,2,0,2090,0,2090
431300,202002,20,17,3,18810,3135,21945
431301,202002,6,6,0,6270,0,6270
431303,202002,57,38,19,39710,20900,60610
431306,202002,234,125,109,131483.99,115995,247478.99
431308,202002,7,5,2,5225,2090,7315
431310,202002,64,53,11,56430,11495,67925
431320,202002,142,85,57,90915,60610,151525
431330,202002,171,110,61,117040,65835,182875
431333,202002,24,20,4,20900,4180,25080
431335,202002,9,5,4,5225,4180,9405
431337,202002,347,157,190,167200,202730,369930
431339,202002,21,18,3,18810,3135,21945
431340,202002,2983,1650,1333,1752385.14,1407622.55,3160007.69
431342,202002,34,23,11,25080,13585,38665
431344,202002,18,18,0,18810,0,18810
431346,202002,5,5,0,5225,0,5225
431349,202002,35,31,4,32395,4180,36575
431350,202002,919,534,385,564301.2,408595.5,972896.7
431360,202002,46,40,6,41800,6270,48070
431365,202002,324,156,168,165110,181830,346940
431370,202002,1326,776,550,816145.5,579977.25,1396122.75
431380,202002,96,83,13,87780,13585,101365
431390,202002,498,268,230,287375,246620,533995
431395,202002,287,128,159,134805,166155,300960
431400,202002,42,29,13,30305,13585,43890
431402,202002,100,72,28,76285,30305,106590
431403,202002,25,14,11,15675,11495,27170
431405,202002,658,357,301,377245.25,318725.9,695971.15
431406,202002,29,25,4,27170,4180,31350
431407,202002,54,43,11,44935,11495,56430
431410,202002,3381,2070,1311,2188230.5,1386716.65,3574947.15
431413,202002,15,12,3,12540,3135,15675
431415,202002,69,49,20,53295,20900,74195
431417,202002,23,12,11,12540,11495,24035
431420,202002,314,212,102,224675,107635,332310
431430,202002,48,22,26,22990,27170,50160
431440,202002,8741,6111,2630,6496774.4,2789106.76,9285881.16
431442,202002,29,14,15,14630,15675,30305
431445,202002,23,21,2,21945,2090,24035
431446,202002,4,4,0,4180,0,4180
431447,202002,83,59,24,61655,25080,86735
431449,202002,53,46,7,48070,8360,56430
431450,202002,405,274,131,292600,137940,430540
431454,202002,0,,,,,0.0
431455,202002,53,41,12,42845,12540,55385
431460,202002,518,359,159,380380,167200,547580
431470,202002,117,89,28,93005,29260,122265
431475,202002,11,9,2,9405,2090,11495
431477,202002,38,26,12,27170,13585,40755
431478,202002,8,7,1,7315,1045,8360
431480,202002,491,302,189,318725,204820,523545
431490,202002,27997,15828,12169,16869446.26,12995628.84,29865075.10
431500,202002,76,61,15,63745,17765,81510
431505,202002,26,16,10,17765,10450,28215
431507,202002,10,8,2,9405,2090,11495
431510,202002,253,178,75,186010.25,80465,266475.25
431513,202002,24,21,3,21945,3135,25080
431514,202002,6,5,1,5225,1045,6270
431515,202002,82,68,14,72105,14630,86735
431517,202002,4,3,1,3135,1045,4180
431520,202002,39,34,5,35530,5225,40755
431530,202002,1464,666,798,704330,850630,1554960
431531,202002,25,23,2,24035,2090,26125
431532,202002,33,24,9,25080,9405,34485
431535,202002,26,16,10,16720,10450,27170
431540,202002,136,115,21,123310,21945,145255
431545,202002,15,13,2,13585,2090,15675
431550,202002,346,191,155,204820,161975,366795
431555,202002,12,12,0,12540,0,12540
431560,202002,4506,3098,1408,3281304.54,1490170,4771474.54
431570,202002,807,424,383,456666,406505,863171
431575,202002,37,22,15,24035,16720,40755
431580,202002,96,64,32,70015,33440,103455
431590,202002,144,122,22,128535,22990,151525
431595,202002,18,15,3,15675,3135,18810
431600,202002,238,138,100,146300,109725,256025
431610,202002,116,84,32,88825,34485,123310
431620,202002,45,38,7,39710,7315,47025
431630,202002,126,107,19,111815,19855,131670
431640,202002,1317,845,472,895565.5,503690.5,1399256.0
431642,202002,35,33,2,35530,2090,37620
431643,202002,44,21,23,21945,24035,45980
431645,202002,318,189,129,199595,136895,336490
431647,202002,8,8,0,8360,0,8360
431650,202002,33,23,10,24035,10450,34485
431660,202002,313,202,111,214225,118085,332310
431670,202002,224,103,121,109725,130625,240350
431673,202002,3,3,0,3135,0,3135
431675,202002,25,20,5,21945,5225,27170
431680,202002,1098,808,290,858990,307230,1166220
431690,202002,4641,2811,1830,2986613.1,1948926.9,4935540.0
431695,202002,22,16,6,16720,6270,22990
431697,202002,0,0,0,0,0,0
431700,202002,174,136,38,144210,39710,183920
431710,202002,3946,1747,2199,1846515.95,2331399.95,4177915.90
431720,202002,1308,807,501,859513,536085,1395598
431725,202002,0,0,0,0,0,0
431730,202002,1156,795,361,841227.9,383515,1224742.9
431740,202002,1333,660,673,697015,712690.95,1409705.95
431750,202002,1783,1167,616,1245640.55,657305.45,1902946.00
431755,202002,5,4,1,4180,1045,5225
431760,202002,1022,654,368,687612,388740,1076352
431770,202002,408,295,113,311410,120175,431585
431775,202002,30,22,8,22990,8360,31350
431780,202002,540,332,208,352165,218405,570570
431790,202002,164,128,36,135850,38665,174515
431795,202002,12,10,2,10450,2090,12540
431800,202002,3229,1706,1523,1798452.25,1616656.5,3415108.75
431805,202002,18,16,2,16720,2090,18810
431810,202002,598,398,200,416955,209000.45,625955.45
431820,202002,321,190,131,201685,137940,339625
431830,202002,2304,1382,922,1456730,967671.35,2424401.35
431840,202002,480,315,165,335445,174515,509960
431842,202002,36,29,7,30305,7315,37620
431843,202002,10,8,2,8360,2090,10450
431844,202002,16,13,3,13585,4180,17765
431845,202002,26,24,2,25080,2090,27170
431846,202002,26,22,4,22990,4180,27170
431848,202002,10,8,2,8360,2090,10450
431849,202002,8,6,2,6270,2090,8360
431850,202002,789,648,141,685520,149435,834955
431860,202002,109,74,35,77330,36575,113905
431861,202002,5,2,3,2090,3135,5225
431862,202002,57,38,19,39710,19855,59565
431870,202002,3426,1990,1436,2116126.2,1525703.15,3641829.35
431880,202002,915,673,242,711645,256025,967670
431890,202002,1275,774,501,822415.5,536085,1358500.5
431900,202002,181,129,52,137940,54340,192280
431910,202002,53,38,15,39710,15675,55385
431912,202002,41,24,17,25080,17765,42845
431915,202002,121,94,27,100320,28215,128535
431920,202002,150,109,41,113905,44935,158840
431930,202002,78,63,15,66880,15675,82555
431935,202002,3,3,0,3135,0,3135
431936,202002,13,12,1,12540,1045,13585
431937,202002,18,14,4,14630,4180,18810
431940,202002,458,307,151,326040,158840.25,484880.25
431950,202002,504,314,190,332310.95,200640.45,532951.40
431960,202002,719,399,320,421136.4,336490.45,757626.85
431970,202002,70,63,7,66880,7315,74195
431971,202002,3,3,0,3135,0,3135
431973,202002,21,17,4,17765,4180,21945
431975,202002,9,8,1,8360,1045,9405
431980,202002,212,133,79,138985,82555,221540
431990,202002,1150,615,535,655147.52,572660.9,1227808.42
432000,202002,1672,890,782,948861.75,830777.07,1779638.82
432010,202002,280,193,87,203775,91960,295735
432020,202002,169,141,28,148390,29260,177650
432023,202002,15,13,2,13585,2090,15675
432026,202002,68,63,5,65835,5225,71060
432030,202002,70,35,35,37620,36575,74195
432032,202002,20,16,4,16720,4180,20900
432035,202002,54,44,10,48070,10450,58520
432040,202002,94,65,29,70015,31350,101365
432045,202002,5,4,1,4180,1045,5225
432050,202002,83,49,34,52250,35530,87780
432055,202002,118,87,31,94050,32395,126445
432057,202002,5,4,1,4180.5,1045,5225.5
432060,202002,33,30,3,31350,3135,34485
432065,202002,32,28,4,29260,4180,33440
432067,202002,89,80,9,83600,9405,93005
432070,202002,389,300,89,315852.5,94050.45,409902.95
432080,202002,811,563,248,598785,261250,860035
432085,202002,11,8,3,8360,3135,11495
432090,202002,267,181,86,190190,93005,283195
432100,202002,176,115,61,121220,63745,184965
432110,202002,568,384,184,409640,195415,605055
432120,202002,931,549,382,582065,405460,987525
432130,202002,501,363,138,381425,146300,527725
432132,202002,22,19,3,20900,3135,24035
432135,202002,78,65,13,67925,13585,81510
432140,202002,258,204,54,214225,57475,271700
432143,202002,202,127,75,136895,79420,216315
432145,202002,277,193,84,202730,89870,292600
432146,202002,14,13,1,13585,1045,14630
432147,202002,96,55,41,58520,49115,107635
432149,202002,15,10,5,10450,5225,15675
432150,202002,857,523,334,556985.5,356345.45,913330.95
432160,202002,1443,742,701,783750.67,737770,1521520.67
432162,202002,4,3,1,3135,1045,4180
432163,202002,20,14,6,14630,6270,20900
432166,202002,115,84,31,91177.5,33440,124617.5
432170,202002,226,115,111,122265,115995,238260
432180,202002,538,336,202,355300,212135.5,567435.5
432183,202002,7,7,0,7315,0,7315
432185,202002,77,68,9,71060,9405,80465
432190,202002,472,280,192,300960,202730.45,503690.45
432195,202002,85,71,14,74195,14630,88825
432200,202002,396,254,142,266475,150480.45,416955.45
432210,202002,116,73,43,76285,44935,121220
432215,202002,45,41,4,44935,4180,49115
432218,202002,20,19,1,19855,1045,20900
432220,202002,671,350,321,369930,341716.64,711646.64
432225,202002,14,8,6,8360,6270,14630
432230,202002,135,94,41,101365,43890,145255
432232,202002,13,12,1,12540,1045,13585
432234,202002,4,3,1,3135,1045,4180
432235,202002,3,3,0,3135,0,3135
432237,202002,27,15,12,15675,12540,28215
432240,202002,4261,2404,1857,2539351,1979231.95,4518582.95
432250,202002,1098,716,382,756580,408595,1165175
432252,202002,44,41,3,42845,3135,45980
432253,202002,61,49,12,52250,13585,65835
432254,202002,27,13,14,14630,15675,30305
432255,202002,13,12,1,13585,1045,14630
432260,202002,812,642,170,677160.5,181830,858990.5
432270,202002,239,180,59,188100,62700,250800
432280,202002,140,105,35,112860,36575,149435
432285,202002,2,2,0,2090,0,2090
432290,202002,67,59,8,61655,8360,70015
432300,202002,4570,2525,2045,2684537.07,2171511.72,4856048.79
432310,202002,124,100,24,105545,25080,130625
432320,202002,22,17,5,17765,5225,22990
432330,202002,16,12,4,12540,4180,16720
432335,202002,8,6,2,6270,2090,8360
432340,202002,37,32,5,35530,5225,40755
432345,202002,100,69,31,72105,32395,104500
432350,202002,20,19,1,19855,1045,20900
432360,202002,6,5,1,5225,1045,6270
432370,202002,25,24,1,26125,1045,27170
432375,202002,30,27,3,28215,3135,31350
432377,202002,9,9,0,9405,0,9405
432380,202002,165,77,88,84645,93005,177650
500020,202002,236,131,105,140030,113905,253935
500025,202002,133,68,65,73150,67925,141075
500060,202002,1440,904,536,954085,571616.85,1525701.85
500070,202002,799,382,417,403370.29,438900.45,842270.74
500080,202002,133,104,29,109725,30305,140030
500085,202002,136,112,24,118085.5,26125,144210.5
500090,202002,340,155,185,164065,195415,359480
500100,202002,721,375,346,395010,363661,758671
500110,202002,2242,1037,1205,1096208.02,1266546.15,2362754.17
500124,202002,259,149,110,157795,115995,273790
500150,202002,334,134,200,140030,212136.35,352166.35
500190,202002,518,353,165,377245,172425.5,549670.5
500200,202002,187,161,26,171380.2,27170,198550.2
500210,202002,1520,541,979,568482.25,1036658.25,1605140.50
500215,202002,239,137,102,145255,108680,253935
500220,202002,744,481,263,509961.67,275880,785841.67
500230,202002,234,153,81,160930,85690,246620
500240,202002,683,471,212,498465.4,225720,724185.4
500260,202002,583,222,361,234080,379335.9,613415.9
500270,202002,29636,12701,16935,13395240.24,17896757.46,31291997.70
500280,202002,202,70,132,73150,137940,211090
500290,202002,1165,703,462,747175.5,483835.45,1231010.95
500295,202002,442,284,158,300960.5,165110.9,466071.4
500310,202002,73,24,49,25080,52250,77330
500315,202002,710,420,290,440990,306185,747175
500320,202002,3602,1785,1817,1892495.99,1926982.7,3819478.69
500325,202002,934,510,424,541311.45,449350.95,990662.40
500330,202002,1468,683,785,720005.5,823460.45,1543465.95
500345,202002,306,232,74,244530.95,77330,321860.95
500348,202002,240,146,94,154660,98230,252890
500350,202002,118,55,63,60610,67925,128535
500370,202002,5491,2477,3014,2618771.9,3197703.75,5816475.65
500375,202002,341,242,99,254980,103455,358435
500380,202002,587,338,249,357390,262295,619685
500390,202002,75,36,39,37620,40755,78375
500400,202002,213,143,70,151525,73150.45,224675.45
500410,202002,541,223,318,237216.12,336492.92,573709.04
500430,202002,518,368,150,395010,158840,553850
500440,202002,193,103,90,109725,95095,204820
500450,202002,392,171,221,183920,236170,420090
500460,202002,272,145,127,154660.5,134805,289465.5
500470,202002,427,339,88,357390.72,94050.45,451441.17
500480,202002,104,62,42,65835,43890,109725
500490,202002,111,47,64,49115,66880,115995
500500,202002,1427,519,908,544448.81,955141.4,1499590.21
500510,202002,44,35,9,36575,9405,45980
500515,202002,103,72,31,77330,32395,109725
500520,202002,325,172,153,182875,160930.72,343805.72
500525,202002,89,48,41,52250,45980,98230
500540,202002,881,373,508,397100.45,540266.4,937366.85
500560,202002,908,520,388,549670,407551,957221
500568,202002,979,557,422,591470,448306.4,1039776.4
500570,202002,1186,686,500,727330.4,524614.75,1251945.15
500580,202002,337,172,165,182875,175560.67,358435.67
500600,202002,315,157,158,167200,169290.45,336490.45
500620,202002,895,631,264,670890.4,282150,953040.4
500625,202002,77,60,17,62700,17765,80465
500627,202002,22,11,11,11495,11495,22990
500630,202002,1566,854,712,897656.54,752400.5,1650057.04
500635,202002,515,306,209,320815,220495,541310
500640,202002,383,203,180,215270.5,191235,406505.5
500660,202002,5417,2011,3406,2143296.4,3614657.4,5757953.8
500690,202002,584,206,378,217364.81,399200.8,616565.61
500710,202002,392,196,196,204820,205865.9,410685.9
500720,202002,957,548,409,582065.73,433675,1015740.73
500730,202002,194,117,77,124355,81510,205865
500740,202002,886,376,510,395011.32,539226.4,934237.72
500750,202002,138,44,94,47025,104500.45,151525.45
500755,202002,126,89,37,93006.4,38665,131671.4
500769,202002,741,408,333,430541.17,353210.45,783751.62
500770,202002,396,211,185,222585,201685,424270
500780,202002,154,102,52,107635,54340,161975
500790,202002,1065,542,523,579975,556987.02,1136962.02
500793,202002,272,148,124,156750,129580.95,286330.95
500795,202002,163,114,49,122265,51205.45,173470.45
500797,202002,51,36,15,38665,15675,54340
500800,202002,417,186,231,197505.45,246620,444125.45
500830,202002,2207,1236,971,1310431.4,1029325.9,2339757.3
500840,202002,136,101,35,107635,36575.45,144210.45
510010,202002,168,91,77,95095,80465,175560
510020,202002,494,220,274,230953.1,288434.4,519387.5
510025,202002,1674,960,714,1012610.37,753452.7,1766063.07
510030,202002,660,342,318,360526.35,337537.52,698063.87
510035,202002,124,61,63,63745.9,66880.45,130626.35
510040,202002,394,177,217,184965,227811.2,412776.2
510050,202002,401,218,183,227813.6,192283.2,420096.8
510060,202002,119,59,60,62700,62700,125400
510080,202002,228,87,141,90915.9,148390.45,239306.35
510100,202002,67,29,38,30305,39710,70015
510120,202002,37,23,14,24035,14630,38665
510125,202002,375,233,142,246620.45,148390.67,395011.12
510130,202002,555,318,237,339629.05,248715.45,588344.50
510140,202002,422,124,298,131670,312456.8,444126.8
510160,202002,110,37,73,40755,76285.45,117040.45
510170,202002,809,493,316,529823.58,335451.75,865275.33
510180,202002,2896,1377,1519,1463023.72,1603051.95,3066075.67
510185,202002,19,8,11,8360,11495,19855
510190,202002,231,85,146,89870,154660.9,244530.9
510250,202002,2546,1496,1050,1582899.53,1117106.9,2700006.43
510260,202002,170,125,45,134811.75,48070.45,182882.20
510263,202002,470,264,206,281106.4,216315.9,497422.3
510267,202002,677,377,300,401286.8,317689.9,718976.7
510268,202002,61,28,33,30305,34485,64790
510269,202002,71,33,38,34485.45,40755,75240.45
510270,202002,388,195,193,206911.8,204821.8,411733.6
510279,202002,212,157,55,167200.9,57475.5,224676.4
510285,202002,182,74,108,77330.45,113905,191235.45
510300,202002,514,271,243,286331.79,257073.6,543405.39
510305,202002,207,99,108,104500.67,114950.45,219451.12
510310,202002,101,53,48,56430,51205,107635
510320,202002,841,525,316,554897.7,337541.97,892439.67
510325,202002,392,171,221,178695,238260,416955
510330,202002,420,231,189,242441.12,200640,443081.12
510335,202002,625,356,269,375156.12,286334.5,661490.62
510336,202002,53,38,15,39710,15675,55385
510337,202002,108,46,62,48070,64790.9,112860.9
510340,202002,17166,7872,9294,8367410.35,9861796.91,18229207.26
510343,202002,65,47,18,49115,19855,68970
510345,202002,164,106,58,111815,60610.5,172425.5
510350,202002,637,359,278,379337.7,292601.85,671939.55
510360,202002,197,119,78,126445.45,82557.7,209003.15
510370,202002,149,72,77,75240,80466.35,155706.35
510380,202002,86,64,22,66880,22990.45,89870.45
510385,202002,59,24,35,26125,36575.45,62700.45
510390,202002,106,47,59,49115,63745,112860
510395,202002,46,33,13,34485,13585,48070
510410,202002,703,457,246,480701.34,261252.25,741953.59
510420,202002,567,276,291,289474.45,305154.4,594628.85
510450,202002,48,25,23,26125,24035,50160
510452,202002,49,23,26,26125,27170,53295
510454,202002,50,24,26,25080,27170,52250
510455,202002,129,76,53,79420,56430,135850
510460,202002,178,93,85,97187.1,88825.45,186012.55
510480,202002,714,419,295,450398.8,314553.55,764952.35
510490,202002,351,180,171,188104.05,178697.25,366801.30
510500,202002,233,172,61,181830,63745,245575
510510,202002,783,462,321,490106.85,341715.5,831822.35
510515,202002,1181,632,549,662532.7,581022.25,1243554.95
510517,202002,249,106,143,111815.45,153616.35,265431.80
510520,202002,226,148,78,156751.35,82557.7,239309.05
510523,202002,98,74,24,79420,25080,104500
510525,202002,808,479,329,511007.47,350077.7,861085.17
510530,202002,19,14,5,14630,6270,20900
510550,202002,248,111,137,115995.45,144210,260205.45
510558,202002,289,140,149,147345.45,157795,305140.45
510560,202002,407,243,164,259161.4,171380.9,430542.3
510562,202002,643,468,175,496375.22,186010.45,682385.67
510590,202002,747,391,356,412775.45,380381.12,793156.57
510600,202002,243,130,113,138985,119130.9,258115.9
510610,202002,205,84,121,87780,128535,216315
510615,202002,180,80,100,85690,109725,195415
510617,202002,18,11,7,11495,8360,19855
510618,202002,116,55,61,57475,63745,121220
510619,202002,99,69,30,73150.45,31350.45,104500.90
510620,202002,170,94,76,99275,79420,178695
510621,202002,182,120,62,125400.45,64790.9,190191.35
510622,202002,497,308,189,326043.15,199596.4,525639.55
510623,202002,327,224,103,240350.9,109725,350075.9
510624,202002,89,45,44,48070.45,48070,96140.45
510625,202002,529,326,203,345902.65,213185.24,559087.89
510626,202002,110,69,41,73150.45,42845,115995.45
510627,202002,69,48,21,50160,22990,73150
510628,202002,145,86,59,89870.45,63745,153615.45
510629,202002,258,164,94,172425.45,100320,272745.45
510630,202002,439,225,214,237216.8,224676.4,461893.2
510631,202002,12,3,9,3135,9405,12540
510637,202002,350,203,147,214226.12,153619.5,367845.62
510642,202002,965,528,437,563257.25,460846.8,1024104.05
510645,202002,1,0,1,0,1045,1045
510650,202002,1420,936,484,987531.34,518322.73,1505854.07
510665,202002,78,37,41,38666.8,42845,81511.8
510670,202002,60,34,26,36575,27170,63745
510675,202002,1135,719,416,763896.85,436810.9,1200707.75
510677,202002,344,177,167,184967.25,176608.6,361575.85
510680,202002,104,60,44,62700.9,45980.45,108681.35
510682,202002,203,101,102,105545,109725,215270
510685,202002,52,39,13,41800,13585,55385
510700,202002,592,335,257,356349.95,274839.72,631189.67
510704,202002,1130,601,529,638549,559121.35,1197670.35
510706,202002,130,66,64,71060,71060.45,142120.45
510710,202002,385,268,117,284242.7,124356.8,408599.5
510715,202002,59,43,16,45980,16720,62700
510718,202002,206,104,102,108681.35,108680,217361.35
510719,202002,38,17,21,17765,21945,39710
510720,202002,188,128,60,136895,62700,199595
510724,202002,90,35,55,36575,57475,94050
510726,202002,49,25,24,26125,26125.45,52250.45
510729,202002,67,30,37,31350,40755,72105
510730,202002,465,260,205,273790.9,219450.67,493241.57
510735,202002,113,47,66,49115,68970,118085
510740,202002,22,11,11,11495,11495,22990
510757,202002,16,13,3,13585,4180,17765
510760,202002,7098,3678,3420,3880114.23,3595937.15,7476051.38
510770,202002,682,324,358,340672.7,378294.95,718967.65
510774,202002,18,7,11,7315,11495,18810
510775,202002,104,79,25,84645,26125,110770
510776,202002,29,10,19,11495,19855,31350
510777,202002,189,81,108,85690,114950,200640
510779,202002,50,23,27,24035.45,29261.35,53296.80
510780,202002,284,160,124,167202.69,130628.37,297831.06
510785,202002,391,211,180,221540,189145,410685
510787,202002,193,95,98,100320.45,102410.67,202731.12
510788,202002,2,0,2,0,2090,2090
510790,202002,2453,1292,1161,1373155.25,1228960.5,2602115.75
510792,202002,1139,643,496,682389.95,523551.52,1205941.47
510794,202002,113,59,54,62700,57475,120175
510795,202002,2347,1356,991,1431654.6,1050230.04,2481884.64
510800,202002,174,106,68,113905,72105,186010
510805,202002,178,117,61,122265,63745.45,186010.45
510810,202002,98,43,55,44937.7,57475,102412.7
510820,202002,238,118,120,124356.8,128535.57,252892.37
510830,202002,70,43,27,45980,28215.45,74195.45
510835,202002,14,10,4,10450,4180,14630
510840,202002,9058,4345,4713,4590774.99,4984746.05,9575521.04
510850,202002,209,82,127,87780,132715.45,220495.45
510860,202002,380,171,209,180787.7,219455.45,400243.15
510880,202002,66,51,15,53295.45,15675,68970.45
510885,202002,74,41,33,43890.45,34485,78375.45
510890,202002,64,39,25,40755,28215,68970
510895,202002,182,106,76,112860,79421.17,192281.17
520005,202002,75,39,36,40755,37620,78375
520010,202002,274,123,151,129580,161975.5,291555.5
520013,202002,699,449,250,474430.45,263340,737770.45
520015,202002,54,39,15,40755,15675,56430
520017,202002,86,48,38,51205.5,39710,90915.5
520020,202002,19,10,9,10450,10450,20900
520025,202002,2157,1129,1028,1194436,1089935.9,2284371.9
520030,202002,783,412,371,438900.45,389785,828685.45
520050,202002,71,50,21,52250,24035,76285
520055,202002,47,28,19,29260,19855,49115
520060,202002,168,114,54,125400,58520,183920
520080,202002,573,409,164,432630,171380,604010
520082,202002,19,13,6,13585,6270,19855
520085,202002,92,69,23,72105,24035,96140
520090,202002,92,63,29,65835,30305,96140
520110,202002,9078,3894,5184,4132599.68,5481034.7,9613634.38
520120,202002,14,8,6,8360,6270,14630
520130,202002,792,556,236,583110.45,247665.5,830775.95
520140,202002,11801,6582,5219,6978520.15,5525972.95,12504493.10
520145,202002,52,32,20,33440,20900,54340
520150,202002,168,134,34,143165,36575,179740
520160,202002,36,26,10,29260,10450,39710
520170,202002,249,143,106,151526.57,111817.25,263343.82
520180,202002,154,74,80,79420,83600,163020
520215,202002,202,132,70,137940,73150,211090
520235,202002,76,57,19,61655,19855,81510
520250,202002,127,77,50,82555,52250,134805
520260,202002,116,73,43,76285,44935,121220
520280,202002,48,32,16,33440,16720,50160
520310,202002,39,26,13,27170,14630,41800
520320,202002,167,108,59,112860,61655,174515
520330,202002,781,413,368,437856.35,385606.8,823463.15
520340,202002,341,197,144,207955,150480.45,358435.45
520350,202002,511,236,275,248710,289465,538175
520355,202002,88,52,36,54340,37620,91960
520357,202002,24,19,5,19855,6270,26125
520360,202002,1,1,0,1045,0,1045
520380,202002,140,74,66,77330,68970,146300
520390,202002,260,109,151,114950.5,159885,274835.5
520393,202002,15,11,4,11495,4180,15675
520396,202002,79,48,31,50160,32395.45,82555.45
520400,202002,204,121,83,128535,88825,217360
520410,202002,189,92,97,99275.45,102410.45,201685.90
520420,202002,20,13,7,13585,7315,20900
520425,202002,286,140,146,149435,153615.5,303050.5
520430,202002,469,244,225,259256.14,239305.7,498561.84
520440,202002,659,468,191,496375,200640,697015
520450,202002,1929,855,1074,909150.45,1128602.7,2037753.15
520455,202002,53,35,18,36575,19855,56430
520460,202002,35,21,14,22990,15675,38665
520465,202002,31,27,4,29260,4180,33440
520470,202002,422,267,155,284240,164065.9,448305.9
520480,202002,80,49,31,51205.45,33442.25,84647.70
520485,202002,117,40,77,41800,80465.5,122265.5
520490,202002,408,301,107,319770,112860,432630
520495,202002,162,97,65,101365,68970,170335
520500,202002,182,140,42,146300,43890.9,190190.9
520505,202002,181,103,78,109725,81510,191235
520510,202002,1774,847,927,903944.1,982342.75,1886286.85
520520,202002,39,29,10,30305,10450,40755
520530,202002,227,173,54,183920,58520.9,242440.9
520540,202002,564,390,174,408595,183920,592515
520545,202002,132,82,50,85690,54340,140030
520547,202002,54,31,23,32395,24035,56430
520549,202002,1202,571,631,605055.3,664620,1269675.3
520551,202002,292,155,137,161975,148390.5,310365.5
520552,202002,39,26,13,28215,13585,41800
520570,202002,16,10,6,10450,6270,16720
520580,202002,282,174,108,182875,115995,298870
520590,202002,153,95,58,99275.45,61655,160930.45
520620,202002,1142,533,609,563255.95,642675.25,1205931.20
520630,202002,37,22,15,22990,15675,38665
520640,202002,385,223,162,238260,173470,411730
520650,202002,67,37,30,38665,31350,70015
520660,202002,43,22,21,22990,21945,44935
520670,202002,35,29,6,30305,6270,36575
520680,202002,51,34,17,36575,17765,54340
520690,202002,39,12,27,12540,28215.9,40755.9
520710,202002,33,30,3,32395,3135,35530
520725,202002,182,133,49,142120,52250,194370
520735,202002,55,37,18,38665,18810,57475
520740,202002,412,200,212,211090,223630.45,434720.45
520750,202002,32,25,7,27170,7315,34485
520753,202002,59,41,18,42845,18810,61655
520760,202002,102,68,34,73150,35530,108680
520780,202002,286,212,74,226765,78375,305140
520790,202002,155,86,69,90915,73150,164065
520800,202002,3388,1818,1570,1932206.62,1661550.2,3593756.82
520810,202002,160,121,39,128535,41800,170335
520815,202002,5,4,1,4180,1045,5225
520830,202002,147,102,45,107635,47025,154660
520840,202002,343,228,115,245575,124355,369930
520850,202002,103,63,40,66880.9,41800,108680.9
520860,202002,1707,1096,611,1160995.5,644767.3,1805762.8
520870,202002,31304,14919,16385,15832992.56,17350170.45,33183163.01
520880,202002,1151,618,533,649991.4,563256.85,1213248.25
520890,202002,782,471,311,495330.45,328130,823460.45
520910,202002,969,517,452,547581.83,476520.45,1024102.28
520915,202002,97,73,24,77330,25080,102410
520920,202002,406,197,209,212135,218406.8,430541.8
520929,202002,18,17,1,17765,1045,18810
520940,202002,72,49,23,51205,24035,75240
520945,202002,17,11,6,11495,7315,18810
520960,202002,45,29,16,31350,16720,48070
520970,202002,333,205,128,215270.45,134805,350075.45
520980,202002,95,68,27,72105,29260,101365
520990,202002,448,306,142,319770,151525,471295
520993,202002,129,61,68,64790,71060,135850
520995,202002,243,142,101,148390.65,106590.5,254981.15
521000,202002,1541,903,638,963490,674025.5,1637515.5
521010,202002,669,322,347,339626.8,366796.35,706423.15
521015,202002,14,9,5,9405,5225,14630
521020,202002,1415,994,421,1045000.45,447261.4,1492261.85
521030,202002,48,33,15,37620,15675,53295
521040,202002,943,592,351,622820.25,373065.5,995885.75
521056,202002,45,32,13,33440,13585,47025
521060,202002,128,84,44,87780,45980,133760
521080,202002,434,333,101,352165.95,107635,459800.95
521090,202002,524,331,193,352165,202730,554895
521100,202002,271,203,68,214225,71060,285285
521120,202002,1059,739,320,781661.4,338580.45,1120241.85
521130,202002,348,248,100,261250,104501.4,365751.4
521140,202002,179,96,83,102410,87780,190190
521150,202002,2638,1144,1494,1213246.4,1588400.9,2801647.3
521160,202002,28,15,13,15675,14630,30305
521170,202002,205,113,92,119130.9,97185,216315.9
521180,202002,1176,748,428,787930,450395.25,1238325.25
521190,202002,2516,1063,1453,1121285,1533016.4,2654301.4
521200,202002,54,40,14,42845,15675,58520
521205,202002,11,8,3,8360,3135,11495
521210,202002,122,72,50,76285,55385,131670
521220,202002,791,552,239,579975,253935.25,833910.25
521225,202002,34,23,11,25080,11495,36575
521230,202002,106,70,36,75240,37620,112860
521250,202002,6141,3480,2661,3687810.25,2812098.95,6499909.20
521260,202002,27,14,13,14630,13585,28215
521270,202002,141,109,32,113905,33440,147345
521280,202002,424,256,168,273790,175560,449350
521290,202002,27,12,15,12540,15675,28215
521295,202002,97,64,33,70015,34485,104500
521300,202002,215,115,100,124355.9,106591.85,230947.75
521305,202002,35,25,10,26125,10450,36575
521308,202002,1081,826,255,872578.6,268566.35,1141144.95
521310,202002,1323,758,565,799427.25,594605.85,1394033.10
521340,202002,20,16,4,16720,4180,20900
521350,202002,125,93,32,98230,33440,131670
521370,202002,170,119,51,126445,54340,180785
521375,202002,168,90,78,95095.9,81510,176605.9
521377,202002,45,34,11,35530,11495,47025
521380,202002,1045,666,379,704331.81,401280,1105611.81
521385,202002,13,8,5,8360,5225,13585
521390,202002,100,81,19,85690,19855,105545
521400,202002,333,221,112,235125.9,117040,352165.9
521405,202002,139,77,62,83600,65835,149435
521410,202002,63,43,20,44935,21945,66880
521440,202002,192,142,50,149435,52250,201685
521450,202002,723,403,320,429495.9,335445,764940.9
521460,202002,1146,735,411,776435,438900.9,1215335.9
521470,202002,12,8,4,8360,4180,12540
521480,202002,43,30,13,31351.35,13586.15,44937.50
521483,202002,309,180,129,189145.5,135850,324995.5
521486,202002,278,182,96,193325,100320,293645
521487,202002,22,10,12,10450,12540,22990
521490,202002,26,15,11,15675,11495,27170
521500,202002,113,74,39,78375,41800,120175
521520,202002,42,30,12,31350,12540,43890
521523,202002,701,418,283,447260,299915,747175
521525,202002,47,30,17,31350,17765,49115
521530,202002,243,130,113,137940,119130,257070
521540,202002,26,13,13,14630,13585,28215
521550,202002,86,38,48,39711.35,50162.25,89873.60
521560,202002,803,548,255,577885.5,267520.75,845406.25
521565,202002,56,36,20,38665,20900,59565
521570,202002,519,342,177,359480.5,186010.25,545490.75
521580,202002,58,34,24,36575,25080,61655
521590,202002,37,18,19,18810,20900,39710
521600,202002,22,12,10,13585,10450,24035
521630,202002,242,128,114,134805,121221.15,256026.15
521640,202002,294,158,136,167200,144210,311410
521645,202002,28,16,12,16720,12540,29260
521680,202002,230,141,89,147345,93005,240350
521690,202002,2,2,0,2090,0,2090
521710,202002,1144,548,596,575795,629091.35,1204886.35
521720,202002,533,368,165,388740,174515.85,563255.85
521730,202002,633,307,326,324996,343805,668801
521740,202002,902,381,521,401280,549672.3,950952.3
521760,202002,1843,970,873,1026190.95,919601.4,1945792.35
521770,202002,818,516,302,549670,317680,867350
521800,202002,1980,1263,717,1335064.96,757629.95,2092694.91
521805,202002,32,18,14,18810,14630,33440
521810,202002,86,54,32,56430,33440,89870
521830,202002,940,672,268,710600.09,281105.45,991705.54
521839,202002,84,52,32,54340,33440,87780
521850,202002,1081,574,507,607146.71,534001.8,1141148.51
521860,202002,337,209,128,223630,134805,358435
521870,202002,72,42,30,44935,31350,76285
521878,202002,34,17,17,17765,17765,35530
521880,202002,4671,2096,2575,2216449.2,2713871.82,4930321.02
521890,202002,592,423,169,446215,177650,623865
521900,202002,281,230,51,241395,55385,296780
521910,202002,160,113,47,118085,49115,167200
521920,202002,46,22,24,24035,25080,49115
521925,202002,49,26,23,27170,25080,52250
521930,202002,1153,637,516,669850.9,540271.8,1210122.7
521935,202002,35,25,10,27170,10450,37620
521940,202002,196,99,97,103455,101365,204820
521945,202002,16,14,2,14630,2090,16720
521950,202002,9,5,4,5225,4180,9405
521960,202002,68,51,17,54340,18810,73150
521970,202002,391,251,140,270655,148390,419045
521971,202002,93,47,46,50160,48070,98230
521973,202002,32,18,14,18810,15675,34485
521975,202002,1371,683,688,725230.41,725231.47,1450461.88
521980,202002,237,159,78,170335,82555,252890
521990,202002,76,53,23,57475,24035,81510
522000,202002,286,178,108,185645.29,112860,298505.29
522005,202002,20,11,9,11495,9405,20900
522010,202002,1122,633,489,668800.45,513095.9,1181896.35
522015,202002,62,38,24,39710.45,25080,64790.45
522020,202002,875,499,376,527725.25,393966.4,921691.65
522026,202002,21,13,8,13585,8360,21945
522028,202002,16,12,4,12540,4180,16720
522040,202002,781,317,464,334401.15,489061.8,823462.95
522045,202002,2306,1423,883,1507938.05,927966.2,2435904.25
522050,202002,162,81,81,84645,84645,169290
522060,202002,535,342,193,363660,203775,567435
522068,202002,116,80,36,84645,39710,124355
522070,202002,10,10,0,10450,0,10450
522100,202002,38,20,18,22990,18810,41800
522108,202002,41,31,10,32395,10450,42845
522119,202002,52,27,25,28215,27170,55385
522130,202002,79,33,46,35530,48071.8,83601.8
522140,202002,3999,2060,1939,2191368.35,2045066.85,4236435.20
522145,202002,47,33,14,34485,14630,49115
522150,202002,88,64,24,67925,25080,93005
522155,202002,51,33,18,35530.45,18810.45,54340.90
522157,202002,6,3,3,3135,3135,6270
522160,202002,1679,998,681,1057540.9,722096.35,1779637.25
522170,202002,390,264,126,280060,132715,412775
522180,202002,39,19,20,19855,20900,40755
522185,202002,2026,803,1223,852721,1290577.02,2143298.02
522190,202002,46,25,21,28215,21945,50160
522200,202002,291,173,118,183920,126445,310365
522205,202002,143,98,45,104500,47025,151525
522220,202002,154,109,45,114950,47025,161975
522230,202002,33,25,8,26125,8360,34485
530010,202002,53644,27210,26434,29086063.3,28218169.49,57304232.79
110001,202003,502,402,100,421135,104500,525635
110002,202003,2748,1686,1062,1767095.5,1112925.5,2880021.0
110003,202003,87,73,14,76285,14630,90915
110004,202003,1982,1295,687,1357456.5,722095,2079551.5
110005,202003,444,353,91,368885.5,95095,463980.5
110006,202003,437,338,99,354255.5,103455,457710.5
110007,202003,67,56,11,58520,11495,70015
110008,202003,232,131,101,136895,105545,242440
110009,202003,850,607,243,635360,253935,889295
110010,202003,1769,1075,694,1125465,728365,1853830
110011,202003,1762,1370,392,1436875,410685,1847560
110012,202003,4093,2372,1721,2483965,1805760.5,4289725.5
110013,202003,765,608,157,637450,164065,801515
110014,202003,374,325,49,339625.5,52250,391875.5
110015,202003,1383,1111,272,1160996.66,286330,1447326.66
110018,202003,1093,678,415,710600,435765,1146365
110020,202003,15503,8880,6623,9299463.16,6939847.35,16239310.51
110025,202003,611,451,160,473385.5,167200,640585.5
110026,202003,36,28,8,29260,8360,37620
110028,202003,1631,1181,450,1237280.85,470251.5,1707532.35
110029,202003,138,125,13,130625,13585,144210
110030,202003,2423,1614,809,1690643.22,845406.35,2536049.57
110032,202003,302,229,73,239305.17,77330,316635.17
110033,202003,652,484,168,506825,176605,683430
110034,202003,356,265,91,276925.67,96140,373065.67
110037,202003,97,84,13,87780,13585,101365
110040,202003,370,256,114,267520,121220,388740
110045,202003,911,628,283,657201.65,296780.1,953981.75
110050,202003,88,77,11,80465.5,11495,91960.5
110060,202003,69,39,30,40755,31350,72105
110070,202003,107,68,39,71060,40755,111815
110080,202003,438,244,194,254980,203775,458755
110090,202003,30,25,5,26125,5225,31350
110092,202003,95,50,45,52250,48070,100320
110094,202003,194,141,53,147345,55385,202730
110100,202003,34,27,7,28215,7315,35530
110110,202003,73,41,32,42845,33440,76285
110120,202003,70,58,12,60610,12540,73150
110130,202003,289,237,52,248710,54340,303050
110140,202003,239,163,76,170335,80465,250800
110143,202003,47,39,8,40755,9405,50160
110145,202003,25,20,5,20900,5225,26125
110146,202003,23,12,11,12540,11495,24035
110147,202003,34,25,9,26125,9405,35530
110148,202003,34,23,11,24035,11495,35530
110149,202003,304,212,92,221540,96140,317680
110150,202003,124,94,30,98230,31350,129580
110155,202003,10,8,2,8360,2090,10450
110160,202003,68,54,14,56430,14630,71060
110170,202003,215,171,44,178695,45980,224675
110175,202003,68,51,17,53295,17765,71060
110180,202003,92,78,14,81510,14630,96140
120001,202003,204,153,51,159885,53295,213180
120005,202003,195,111,84,115995,87780,203775
120010,202003,1082,676,406,707465.72,425315,1132780.72
120013,202003,145,100,45,104500,47025,151525
120017,202003,100,57,43,59565,44935,104500
120020,202003,3517,2836,681,2963621.18,716870.5,3680491.68
120025,202003,542,306,236,319770.77,246620,566390.77
120030,202003,1060,903,157,945726.36,166155,1111881.36
120032,202003,37,35,2,36575,2090,38665
120033,202003,215,188,27,196460,28215,224675
120034,202003,163,119,44,124355,45980,170335
120035,202003,37,30,7,31350,7315,38665
120038,202003,402,261,141,273790,147345,421135
120039,202003,28,27,1,28215,1045,29260
120040,202003,13979,9533,4446,9984281.02,4652340,14636621.02
120042,202003,45,40,5,41800,5225,47025
120043,202003,11,3,8,3135,8360,11495
120045,202003,548,355,193,372020,201685,573705
120050,202003,1271,970,301,1014695.69,315590,1330285.69
120060,202003,1453,1190,263,1244595,277970,1522565
120070,202003,442,313,129,330220.82,134805,465025.82
120080,202003,168,101,67,105545,70015,175560
130002,202003,148,106,42,110770,43890,154660
130006,202003,87,53,34,55385,35530,90915
130008,202003,132,71,61,74195,63745,137940
130010,202003,142,81,61,84645,63745,148390
130014,202003,263,190,73,198550,76285,274835
130020,202003,100,60,40,62700,41800,104500
130030,202003,948,564,384,590425,402325,992750
130040,202003,330,164,166,171380,174515.4,345895.4
130050,202003,563,291,272,304095,285285,589380
130060,202003,858,582,276,608190,288420,896610
130063,202003,589,336,253,351120,265430,616550
130068,202003,185,119,66,124355,68970,193325
130070,202003,1299,882,417,924825,436810,1361635
130080,202003,704,461,243,481745,253935,735680
130083,202003,68,38,30,39710,31350,71060
130090,202003,337,170,167,179740,174515,354255
130100,202003,1117,478,639,501600,668800,1170400
130110,202003,734,308,426,321860,445170,767030
130115,202003,160,66,94,68970,98230,167200
130120,202003,1625,1039,586,1085755,613415,1699170
130130,202003,606,414,192,432630,200640,633270
130140,202003,1488,1146,342,1200705,357390,1558095
130150,202003,418,364,54,380380,56430,436810
130160,202003,456,264,192,275880,200640,476520
130165,202003,26,20,6,20900,6270,27170
130170,202003,958,659,299,688588.12,312455,1001043.12
130180,202003,182,124,58,130625,61655,192280
130185,202003,2352,1094,1258,1144275,1316701,2460976
130190,202003,3455,2148,1307,2249885.2,1366860,3616745.2
130195,202003,276,220,56,229900,58520,288420
130200,202003,182,83,99,86735,103455,190190
130210,202003,78,39,39,40755,40755,81510
130220,202003,180,123,57,129580,59565,189145
130230,202003,381,245,136,256025,142120,398145
130240,202003,1342,838,504,879890,528770,1408660
130250,202003,4717,3010,1707,3151720,1790085,4941805
130255,202003,428,205,223,214225,233035,447260
130260,202003,57042,26859,30183,28127144.02,31648873.5,59776017.52
130270,202003,1516,1022,494,1070174.05,517275,1587449.05
130280,202003,125,70,55,73150,57475,130625
130290,202003,2094,1471,623,1538240,652080,2190320
130300,202003,431,304,127,318725,132715,451440
130310,202003,910,475,435,496375,454575,950950
130320,202003,508,272,236,284240,247665,531905
130330,202003,746,466,280,488015,292600,780615
130340,202003,3510,2010,1500,2102541,1568546,3671087
130350,202003,434,280,154,294690,160930,455620
130353,202003,930,391,539,408595,564300,972895
130356,202003,813,368,445,385605,465025,850630
130360,202003,86,64,22,66880,22990,89870
130370,202003,710,547,163,571615,170335,741950
130380,202003,685,525,160,548625,169290,717915
130390,202003,495,398,97,415910,101365,517275
130395,202003,162,34,128,35530,133760,169290
130400,202003,67,45,22,47025,22990,70015
130406,202003,2095,1262,833,1319835.5,874665,2194500.5
130410,202003,434,198,236,207955,248710,456665
130420,202003,2975,2407,568,2517405.75,593560,3110965.75
130423,202003,154,79,75,82555,78375,160930
130426,202003,149,81,68,84645,71060,155705
130430,202003,403,255,148,266475,154660,421135
130440,202003,196,66,130,68970,136895,205865
140002,202003,30,10,20,10450,20900,31350
140005,202003,198,119,79,124355,82555,206910
140010,202003,10347,6623,3724,6931490.45,3903077.15,10834567.60
140015,202003,129,54,75,56430,78375,134805
140017,202003,119,77,42,80465,43890,124355
140020,202003,475,309,166,322905,173470,496375
140023,202003,48,22,26,22990.35,27170,50160.35
140028,202003,20,11,9,11495,9405,20900
140030,202003,345,244,101,256025,105545,361570
140040,202003,61,41,20,42845,20900,63745
140045,202003,247,98,149,102410,155705,258115
140047,202003,617,403,214,421135.5,223630,644765.5
140050,202003,154,93,61,97185,64790,161975
140060,202003,44,32,12,33440,12540,45980
140070,202003,32,30,2,31350,2090,33440
150010,202003,4615,2820,1795,2951080.5,1878910,4829990.5
150013,202003,156,108,48,112860,50160,163020
150020,202003,1065,566,499,591470,521455,1112925
150030,202003,672,277,395,289465,412775,702240
150034,202003,194,124,70,129580,73150,202730
150040,202003,1455,836,619,874665,646855,1521520
150050,202003,652,372,280,388740,292600,681340
150060,202003,4811,3061,1750,3203882.75,1833362.63,5037245.38
150070,202003,328,143,185,149435,193325,342760
150080,202003,14956,7107,7849,7436222.7,8215793,15652015.7
150085,202003,415,260,155,271700,161975,433675
150090,202003,728,615,113,642675,118085,760760
150095,202003,354,221,133,230945,138985,369930
150100,202003,60,38,22,39710,22990,62700
150110,202003,176,86,90,89870,94050,183920
150120,202003,414,300,114,313500,119130,432630
150125,202003,50,19,31,19855,32395,52250
150130,202003,1990,1057,933,1107700,974985,2082685
150140,202003,54357,24696,29661,25846202.75,31070992.71,56917195.46
150145,202003,189,103,86,107635,89870,197505
150150,202003,2913,1284,1629,1342825,1704396,3047221
150157,202003,388,274,114,286330.5,119130,405460.5
150160,202003,130,100,30,104500,31350,135850
150170,202003,3567,2651,916,2772385,957220,3729605
150172,202003,332,226,106,236170,110770,346940
150175,202003,75,46,29,48070,30305,78375
150178,202003,774,514,260,537130,271700,808830
150180,202003,3153,1541,1612,1615570.25,1687675.5,3303245.75
150190,202003,339,215,124,224675,129580,354255
150195,202003,107,55,52,57475,54340,111815
150200,202003,190,90,100,94050,104500,198550
150210,202003,3075,2466,609,2579060,636405,3215465
150215,202003,559,362,197,379335,206910,586245
150220,202003,3609,2426,1183,2541441.32,1239370.6,3780811.92
150230,202003,1180,944,236,986480.37,246620,1233100.37
150240,202003,6261,3582,2679,3751550.85,2807915,6559465.85
150250,202003,41,18,23,18810,24035,42845
150260,202003,86,55,31,57475,33440,90915
150270,202003,2237,1445,792,1511070,827640.5,2338710.5
150275,202003,521,327,194,341715,203775,545490
150276,202003,110,44,66,45980,68970,114950
150277,202003,756,329,427,343805,446215,790020
150280,202003,328,212,116,221540,121220,342760
150285,202003,97,49,48,51205,50160,101365
150290,202003,999,604,395,632225,413820.5,1046045.5
150293,202003,646,306,340,319770,356345,676115
150295,202003,483,220,263,229900,274835.5,504735.5
150300,202003,80,39,41,40755,42845,83600
150304,202003,173,106,67,110770,70015,180785
150307,202003,394,326,68,341715,72105,413820
150309,202003,575,413,162,432630,170335.8,602965.8
150310,202003,237,156,81,163020,84645,247665
150320,202003,1895,1321,574,1382535,599830,1982365
150330,202003,1963,1132,831,1183985,868395,2052380
150340,202003,195,131,64,136895,66880,203775
150345,202003,624,343,281,358435,293645,652080
150350,202003,406,315,91,330220,96140,426360
150360,202003,4678,2904,1774,3037815.75,1860100,4897915.75
150370,202003,820,564,256,590425,267520,857945
150375,202003,186,89,97,93005,101365,194370
150380,202003,1471,976,495,1020965,517275,1538240
150390,202003,791,458,333,478610,350075,828685
150400,202003,106,88,18,91960,18810,110770
150405,202003,1231,788,443,824505,463980,1288485
150410,202003,122,79,43,82555,44935,127490
150420,202003,7338,3982,3356,4164496.5,3510155.5,7674652.0
150430,202003,593,384,209,401280,218405,619685
150440,202003,555,334,221,349030,230945,579975
150442,202003,2279,1208,1071,1264451,1119195,2383646
150445,202003,545,348,197,363660,205865,569525
150450,202003,233,124,109,129580,113905,243485
150460,202003,725,543,182,567435,191235,758670
150470,202003,1304,782,522,817190,546535,1363725
150475,202003,225,171,54,180785,56430,237215
150480,202003,1306,905,401,945725,419045,1364770
150490,202003,592,328,264,342760,275880,618640
150495,202003,332,244,88,254980,91960,346940
150497,202003,286,196,90,205865,94050,299915
150500,202003,219,137,82,143165,85690,228855
150503,202003,1020,505,515,528770.5,538175,1066945.5
150506,202003,909,605,304,633270,317680,950950
150510,202003,1245,690,555,723140.5,582065,1305205.5
150520,202003,265,177,88,184965,91960,276925
150530,202003,1697,935,762,978121.18,797335,1775456.18
150540,202003,227,165,62,172425,64790,237215
150543,202003,802,426,376,445170,392920,838090
150548,202003,459,327,132,342760,137940,480700
150549,202003,59,42,17,43890,17765,61655
150550,202003,2909,1475,1434,1541375.25,1501665.5,3043040.75
150553,202003,3361,1924,1437,2015806.5,1502710,3518516.5
150555,202003,139,74,65,77330,67925,145255
150560,202003,29,13,16,13585,16720,30305
150563,202003,92,46,46,48070,48070,96140
150565,202003,181,106,75,110770,78375,189145
150570,202003,403,264,139,275880,145255,421135
150580,202003,1618,756,862,790020,901835,1691855
150590,202003,804,525,279,549670,291555,841225
150600,202003,469,280,189,292600,197505,490105
150610,202003,139,118,21,123310,22990,146300
150611,202003,122,83,39,86735,40755,127490
150613,202003,3200,1916,1284,2005355,1343870.5,3349225.5
150616,202003,517,301,216,314545,225720,540265
150618,202003,1315,699,616,731500,645810,1377310
150619,202003,390,297,93,310365,97185,407550
150620,202003,1237,729,508,762850,532950,1295800
150630,202003,302,192,110,200640,114950,315590
150635,202003,462,189,273,198550,286330,484880
150640,202003,54,27,27,28215,28215,56430
150650,202003,2347,1357,990,1419110.5,1036640.5,2455751.0
150655,202003,239,180,59,188100,61655,249755
150658,202003,91,48,43,50160,44935,95095
150660,202003,523,344,179,359480,187055,546535
150670,202003,1056,373,683,389785,713735,1103520
150680,202003,9981,5262,4719,5511331.44,4945985.5,10457316.94
150690,202003,15,9,6,9405,6270,15675
150700,202003,479,315,164,329175,171380,500555
150710,202003,278,150,128,157795,134805,292600
150715,202003,810,501,309,523545,323950,847495
150720,202003,401,311,90,324995,94050,419045
150730,202003,998,507,491,529815,513095,1042910
150740,202003,230,155,75,161975,78375,240350
150745,202003,799,440,359,460845,375155,836000
150746,202003,62,36,26,37620,27170,64790
150747,202003,229,176,53,183920,56430,240350
150750,202003,140,76,64,79420,66880,146300
150760,202003,1807,1171,636,1223695.62,664620,1888315.62
150770,202003,385,210,175,219450,182875,402325
150775,202003,96,46,50,48070,52250,100320
150780,202003,188,108,80,112860,84645,197505
150790,202003,832,455,377,475475,395010,870485
150795,202003,1514,897,617,938410,644765,1583175
150796,202003,361,207,154,217360,160930,378290
150797,202003,315,158,157,165110,164065,329175
150800,202003,1447,839,608,878845,635360,1514205
150803,202003,541,438,103,457710,107635,565345
150805,202003,199,122,77,127490,80465,207955
150808,202003,982,530,452,553850,473385,1027235
150810,202003,3254,2235,1019,2339755.97,1067990.5,3407746.47
150812,202003,434,225,209,235125,218405,453530
150815,202003,1020,636,384,665665,402325,1067990
150820,202003,1525,903,622,943635,649990,1593625
150830,202003,731,537,194,561165,202730,763895
150835,202003,204,118,86,123310,89870,213180
150840,202003,1370,844,526,883025,550715,1433740
160005,202003,52,33,19,34485,19855,54340
160010,202003,195,124,71,129580,74195,203775
160015,202003,114,67,47,70015,49115,119130
160020,202003,129,74,55,77330,57475,134805
160021,202003,57,28,29,29260,30305,59565
160023,202003,66,43,23,44935,24035,68970
160025,202003,26,11,15,11495,15675,27170
160027,202003,1514,857,657,895565.25,688655,1584220.25
160030,202003,15826,8112,7714,8479133.1,8072625.71,16551758.81
160040,202003,288,167,121,175560,128535,304095
160050,202003,717,353,364,368885,380380,749265
160053,202003,285,167,118,174515.5,123310,297825.5
160055,202003,29,20,9,20900,9405,30305
160060,202003,6572,3449,3123,3609431.25,3268760.5,6878191.75
160070,202003,176,104,72,108680,75240,183920
160080,202003,107,49,58,51205,60610,111815
170025,202003,27,15,12,15675,12540,28215
170030,202003,213,175,38,182875.62,39710,222585.62
170035,202003,229,109,120,113905,126445,240350
170040,202003,181,137,44,143165.08,45980,189145.08
170070,202003,314,193,121,201685,126445,328130
170100,202003,357,259,98,271700,102410,374110
170105,202003,56,45,11,47025,11495,58520
170110,202003,112,71,41,74195,42845,117040
170130,202003,67,31,36,32395,37620.5,70015.5
170190,202003,93,57,36,59565,37620,97185
170200,202003,370,254,116,267520,121220,388740
170210,202003,6044,3192,2852,3344001.88,2985567.12,6329569.00
170215,202003,116,47,69,49115,72105,121220
170220,202003,1383,1015,368,1063810,386650,1450460
170230,202003,146,96,50,100320,52250,152570
170240,202003,529,354,175,370975,183920,554895
170255,202003,1084,877,207,916465,217360,1133825
170270,202003,45,31,14,32395,14630,47025
170290,202003,112,75,37,79420,38665,118085
170300,202003,92,61,31,63745,32395,96140
170305,202003,50,38,12,39710,12540,52250
170307,202003,63,49,14,51205,14630,65835
170310,202003,112,62,50,64790,52250,117040
170320,202003,26,17,9,17765,9405,27170
170330,202003,24,22,2,22990,2090,25080
170360,202003,29,18,11,18810,11495,30305
170370,202003,97,45,52,49115,54340,103455
170380,202003,76,58,18,62700,18810,81510
170382,202003,44,36,8,37620,8360,45980
170384,202003,145,110,35,114950,36575,151525
170386,202003,63,25,38,26125,40755,66880
170388,202003,48,18,30,18810,31350,50160
170389,202003,26,21,5,21945,5225,27170
170390,202003,66,38,28,39710,29260,68970
170410,202003,32,24,8,25080,8360,33440
170460,202003,17,12,5,12540,5225,17765
170510,202003,36,27,9,28215,9405,37620
170550,202003,1538,893,645,937365,676115,1613480
170555,202003,113,79,34,82555,35530,118085
170560,202003,99,69,30,72105,31350,103455
170600,202003,33,15,18,16720,18810,35530
170610,202003,194,104,90,108680,94050.5,202730.5
170625,202003,37,21,16,21945,16720,38665
170650,202003,79,57,22,59565,22990,82555
170700,202003,577,439,138,458755.25,144210,602965.25
170710,202003,157,98,59,102410,61655,164065
170720,202003,88,70,18,73150,18810,91960
170730,202003,84,48,36,50160,37620,87780
170740,202003,83,60,23,62700,24035,86735
170755,202003,65,34,31,36575,32395,68970
170765,202003,141,75,66,78375,68970,147345
170770,202003,206,128,78,133760,81510,215270
170820,202003,596,394,202,412775,211090.5,623865.5
170825,202003,32,16,16,16720,16720,33440
170830,202003,80,66,14,68970,14630,83600
170900,202003,180,140,40,146300,41800,188100
170930,202003,909,476,433,498465.8,452485.5,950951.3
170950,202003,3120,1426,1694,1493305,1773365.88,3266670.88
170980,202003,16,10,6,10450,7315,17765
171050,202003,140,111,29,115995,31350,147345
171070,202003,34,29,5,30305,5225,35530
171090,202003,42,30,12,31350,12540,43890
171110,202003,22,15,7,15675,7315,22990
171150,202003,40,19,21,19855,21945,41800
171180,202003,26,13,13,13585,13585,27170
171190,202003,149,85,64,88825,66880,155705
171195,202003,66,56,10,58520,10450,68970
171200,202003,49,25,24,26125,25080,51205
171215,202003,4,3,1,3135,1045,4180
171240,202003,57,42,15,43890,15675,59565
171245,202003,58,49,9,52250,9405,61655
171250,202003,74,40,34,41800,35530,77330
171270,202003,14,10,4,10450,4180,14630
171280,202003,43,37,6,38665,6270,44935
171320,202003,968,567,401,592515.54,419045,1011560.54
171330,202003,425,211,214,221540,223630,445170
171360,202003,86,61,25,63745,26125,89870
171370,202003,34,17,17,17765,17765,35530
171380,202003,131,111,20,115995,20900,136895
171395,202003,53,33,20,34485,20900,55385
171420,202003,280,181,99,190190,103455,293645
171430,202003,74,60,14,62700,14630,77330
171488,202003,175,97,78,101365,81510,182875
171500,202003,57,32,25,33440,26125,59565
171510,202003,71,44,27,45980,28215,74195
171515,202003,42,34,8,35530,8360.5,43890.5
171525,202003,30,28,2,29260,2090,31350
171550,202003,13,9,4,9405,4180,13585
171570,202003,51,27,24,28215,25080,53295
171575,202003,311,201,110,211090,114950,326040
171610,202003,1762,891,871,934230,911240,1845470
171620,202003,138,95,43,99275,44935,144210
171630,202003,60,31,29,32395,30305,62700
171650,202003,281,188,93,197505,97185,294690
171660,202003,268,149,119,156750,124355.5,281105.5
171665,202003,61,42,19,43890,19855,63745
171670,202003,422,246,176,257070.25,183920,440990.25
171700,202003,65,59,6,61655,6270,67925
171720,202003,27,10,17,10450,17765,28215
171750,202003,99,52,47,55385,49115,104500
171780,202003,71,57,14,59565,14630,74195
171790,202003,76,66,10,68970,10450,79420
171800,202003,34,26,8,27170,8360,35530
171820,202003,2097,1204,893,1262360.46,934230.5,2196590.96
171830,202003,35,28,7,29260,7315,36575
171840,202003,62,40,22,41800,22990,64790
171845,202003,30,19,11,19855,11495,31350
171850,202003,40,29,11,30305,11495,41800
171855,202003,77,60,17,62700,17765,80465
171865,202003,7,6,1,6270,1045,7315
171870,202003,30,22,8,22990,8360,31350
171875,202003,76,53,23,55385,24035,79420
171880,202003,33,21,12,21945,12540,34485
171884,202003,50,27,23,28215,24035,52250
171886,202003,135,55,80,57475,83600,141075
171888,202003,26,20,6,20900,6270,27170
171889,202003,20,14,6,14630,6270,20900
171890,202003,56,48,8,50160,8360,58520
171900,202003,37,25,12,26125,12540,38665
172000,202003,41,32,9,33440,9405,42845
172010,202003,50,39,11,40755,11495,52250
172015,202003,28,18,10,18810.45,10450,29260.45
172020,202003,139,87,52,90915,54340,145255
172025,202003,34,21,13,21945,13585,35530
172030,202003,44,25,19,26125,19855,45980
172049,202003,82,53,29,55385,30305,85690
172065,202003,140,89,51,93005,53295,146300
172080,202003,105,70,35,73150,36575,109725
172085,202003,29,15,14,15675,14630,30305
172090,202003,423,326,97,340670.03,101365,442035.03
172093,202003,17,15,2,15675,2090,17765
172097,202003,19,12,7,12540,7315.5,19855.5
172100,202003,5044,2863,2181,3000196.47,2287506.2,5287702.67
172110,202003,76,47,29,49115,30305,79420
172120,202003,1640,1382,258,1448373.11,269610,1717983.11
172125,202003,5,4,1,4180,1045,5225
172130,202003,20,13,7,13585,7315,20900
172208,202003,198,122,76,127490,79420,206910
172210,202003,390,185,205,193325,214225.5,407550.5
210005,202003,2940,1851,1089,1936385.15,1138010.5,3074395.65
210010,202003,164,92,72,96140,75240,171380
210015,202003,39,29,10,30305,10450,40755
210020,202003,344,195,149,203775,155705,359480
210030,202003,322,209,113,220495,118085,338580
210040,202003,139,111,28,115995,29260,145255
210043,202003,250,186,64,194370,66880,261250
210047,202003,518,304,214,317680,223630,541310
210050,202003,289,211,78,220495,82555,303050
210055,202003,47,35,12,36575,12540,49115
210060,202003,549,440,109,459800,113905,573705
210070,202003,399,307,92,321860,96140,418000
210080,202003,118,108,10,112860,10450,123310
210083,202003,304,150,154,156750.5,161975,318725.5
210087,202003,2,1,1,1045,1045,2090
210090,202003,446,320,126,334400,131670,466070
210095,202003,438,333,105,347985,109725,457710
210100,202003,687,537,150,562210,156750,718960
210110,202003,130,79,51,82555,53295,135850
210120,202003,5024,3909,1115,4086996.85,1168310.12,5255306.97
210125,202003,196,120,76,125400,79420,204820
210130,202003,478,271,207,283195,216315,499510
210135,202003,28,19,9,19855,9405,29260
210140,202003,4339,3390,949,3546730,992750,4539480
210150,202003,376,238,138,248710,144210,392920
210160,202003,3247,2751,496,2875841.36,519365,3395206.36
210170,202003,1123,908,215,949905,225720,1175625
210173,202003,124,109,15,113905,15675,129580
210177,202003,366,204,162,213180,171380,384560
210180,202003,32,17,15,17765,15675,33440
210190,202003,421,282,139,294690,145255,439945
210193,202003,1,1,0,1045,0,1045
210197,202003,77,55,22,57475,22990,80465
210200,202003,619,510,109,533995,113905,647900
210203,202003,228,152,76,158840,79420,238260
210207,202003,369,299,70,312455,73150,385605
210210,202003,748,693,55,724185,57475,781660
210215,202003,73,66,7,68970,7315,76285
210220,202003,390,331,59,345895,61655,407550
210230,202003,311,248,63,259160,65835,324995
210232,202003,1365,924,441,965580,461890,1427470
210235,202003,168,127,41,132715,42845,175560
210237,202003,35,22,13,22990,13585,36575
210240,202003,87,73,14,76285,14630,90915
210250,202003,180,154,26,160930,27170,188100
210255,202003,352,264,88,275880,91960,367840
210260,202003,391,270,121,282150,126445,408595
210270,202003,639,425,214,444125,223630,667755
210275,202003,72,55,17,57475,17765,75240
210280,202003,1046,691,355,722095.7,372020,1094115.7
210290,202003,530,359,171,375155,179740,554895
210300,202003,5275,3313,1962,3465220.93,2051335,5516555.93
210310,202003,111,76,35,79420,36575,115995
210312,202003,116,80,36,83600,37620,121220
210315,202003,104,82,22,85690,22990,108680
210317,202003,127,95,32,99275,33440,132715
210320,202003,2312,1961,351,2053425,366795,2420220
210325,202003,133,87,46,90915.5,48070.5,138986.0
210330,202003,4495,2570,1925,2691920.75,2013715,4705635.75
210340,202003,1253,933,320,974985,336490.5,1311475.5
210350,202003,612,516,96,539220,100320,639540
210355,202003,148,119,29,124355,30305,154660
210360,202003,2224,1532,692,1600940,725230.5,2326170.5
210370,202003,1219,592,627,619685,656260,1275945
210375,202003,184,95,89,99275,93005,192280
210380,202003,703,539,164,563255,171380,734635
210390,202003,188,161,27,169290,28215,197505
210400,202003,392,341,51,356345,53295,409640
210405,202003,979,684,295,716870,310365,1027235
210407,202003,51,41,10,42845,10450,53295
210408,202003,61,54,7,56430,7315,63745
210409,202003,321,278,43,290510,44935,335445
210410,202003,436,339,97,354255,101365,455620
210420,202003,196,161,35,168245,36575,204820
210430,202003,52,34,18,35530,18810,54340
210440,202003,327,220,107,229900,111815,341715
210450,202003,143,112,31,117040,32395,149435
210455,202003,228,121,107,126445.5,111815,238260.5
210460,202003,305,204,101,213180,106590,319770
210462,202003,63,52,11,54340,11495,65835
210465,202003,141,109,32,113905,33440,147345
210467,202003,531,390,141,407550,147345,554895
210470,202003,50,43,7,44935,7315,52250
210480,202003,1251,896,355,937365,370975.62,1308340.62
210490,202003,204,137,67,143165,71060,214225
210500,202003,504,307,197,320815,205865,526680
210510,202003,550,438,112,457710,117040,574750
210515,202003,369,231,138,241395,144210,385605
210520,202003,397,359,38,375155,39710,414865
210530,202003,9307,4934,4373,5172755.55,4579193.01,9751948.56
210535,202003,125,94,31,98230,32395,130625
210540,202003,1474,971,503,1014695,525635,1540330
210542,202003,1194,613,581,640585,607146,1247731
210545,202003,16,15,1,15675,1045,16720
210547,202003,129,112,17,117040,17765,134805
210550,202003,685,496,189,519365.6,197505,716870.6
210560,202003,159,141,18,147345,19855,167200
210565,202003,21,16,5,16720,5225,21945
210570,202003,1303,1048,255,1095160.11,266475,1361635.11
210580,202003,119,102,17,106590,17765,124355
210590,202003,720,590,130,617595,135850,753445
210592,202003,34,31,3,32395,3135,35530
210594,202003,105,90,15,94050,15675,109725
210596,202003,97,81,16,84645,16720,101365
210598,202003,131,97,34,101365,35530,136895
210600,202003,324,277,47,289465,49115,338580
210610,202003,253,238,15,248710,15675,264385
210620,202003,42,28,14,29260,14630,43890
210630,202003,74,71,3,74195,3135,77330
210632,202003,1010,706,304,737770,317680,1055450
210635,202003,22,19,3,19855,3135,22990
210637,202003,109,79,30,82555,31350,113905
210640,202003,582,513,69,536085,72105,608190
210650,202003,387,325,62,339625,65835,405460
210660,202003,381,294,87,307230,90915,398145
210663,202003,34,23,11,24035,11495,35530
210667,202003,96,37,59,38665,61655,100320
210670,202003,245,219,26,228855,27170,256025
210675,202003,531,297,234,311410,245575,556985
210680,202003,216,142,74,148390,77330,225720
210690,202003,614,507,107,530860,111815,642675
210700,202003,162,122,40,127490,41800,169290
210710,202003,250,158,92,165110,96140,261250
210720,202003,130,116,14,121220,14630,135850
210725,202003,67,59,8,61655,8360,70015
210730,202003,25,18,7,18810,7315,26125
210735,202003,282,197,85,205865,88825.5,294690.5
210740,202003,525,451,74,472340,77330,549670
210745,202003,152,114,38,119130,39710,158840
210750,202003,2353,1198,1155,1252955.25,1208021,2460976.25
210760,202003,253,192,61,200640,63745,264385
210770,202003,377,295,82,308275,85690,393965
210780,202003,444,326,118,340670,123310,463980
210790,202003,183,150,33,156750,34485,191235
210800,202003,171,130,41,135850,42845,178695
210805,202003,51,46,5,48070,5225,53295
210810,202003,456,365,91,381425,95095,476520
210820,202003,2114,1753,361,1835020.9,377245,2212265.9
210825,202003,153,89,64,93005,66880,159885
210830,202003,718,477,241,498465,251845,750310
210840,202003,194,136,58,142120,60610,202730
210845,202003,229,162,67,169290,70015,239305
210850,202003,757,517,240,541310,251845,793155
210860,202003,3676,2076,1600,2172555.25,1672000,3844555.25
210870,202003,429,337,92,353210,97185,450395
210880,202003,72,56,16,58520,16720,75240
210890,202003,314,271,43,283195,44935,328130
210900,202003,625,408,217,426360,226765,653125
210905,202003,62,32,30,33440,31350,64790
210910,202003,1939,1467,472,1533016.06,495330,2028346.06
210920,202003,168,65,103,67925,108680,176605
210923,202003,79,62,17,64790,17765,82555
210927,202003,398,185,213,193325,222585,415910
210930,202003,74,59,15,61655,15675,77330
210940,202003,83,65,18,67925,18810,86735
210945,202003,187,100,87,104500,90915,195415
210950,202003,526,384,142,401280,148390,549670
210955,202003,79,53,26,55385,28215,83600
210960,202003,2156,1083,1073,1133042,1121285,2254327
210970,202003,113,100,13,104500,13585,118085
210975,202003,80,74,6,77330,6270,83600
210980,202003,1058,515,543,538175,568480,1106655
210990,202003,4041,2664,1377,2785970,1438965.5,4224935.5
211000,202003,1316,1064,252,1113970.5,263340,1377310.5
211003,202003,1000,710,290,741950,304095,1046045
211010,202003,483,431,52,450395,54340,504735
211020,202003,1440,611,829,638495,867350,1505845
211023,202003,32,30,2,31350,2090,33440
211027,202003,67,49,18,51205,18810,70015
211030,202003,366,259,107,271700,112860,384560
211040,202003,299,249,50,260205.5,52250,312455.5
211050,202003,1139,754,385,788975,404415.5,1193390.5
211060,202003,634,549,85,573705.5,88825.96,662531.46
211065,202003,22,18,4,18810,4180,22990
211070,202003,897,742,155,775391.15,161975,937366.15
211080,202003,85,81,4,84645,4180,88825
211085,202003,54,27,27,28215,28215,56430
211090,202003,89,73,16,76285,16720,93005
211100,202003,489,405,84,423225,88825.5,512050.5
211102,202003,243,171,72,178695,75240,253935
211105,202003,219,154,65,161975,67925,229900
211107,202003,132,83,49,86735,51205,137940
211110,202003,815,530,285,553850,298870,852720
211120,202003,5262,2625,2637,2745216.05,2755665.4,5500881.45
211125,202003,34,25,9,26125,9405,35530
211130,202003,41671,19047,22624,19939650.6,23676568.25,43616218.85
211140,202003,395,344,51,359480,53295,412775
211150,202003,1203,801,402,838090,422180.5,1260270.5
211153,202003,175,106,69,110770,73150,183920
211157,202003,64,51,13,53295,13585,66880
211160,202003,700,596,104,622820,108680,731500
211163,202003,0,,,,,0.0
211167,202003,11,10,1,10450,1045,11495
211170,202003,416,312,104,326040,108680,434720
211172,202003,116,79,37,82555,38665,121220
211174,202003,251,155,96,161975,100320,262295
211176,202003,484,358,126,374110.5,131670,505780.5
211178,202003,89,58,31,60610,32395,93005
211180,202003,202,162,40,169290,41800,211090
211190,202003,72,67,5,70015,5225,75240
211195,202003,34,24,10,25080,10450,35530
211200,202003,149,128,21,133760,21945,155705
211210,202003,440,325,115,339625,120175,459800
211220,202003,4018,2340,1678,2447392.07,1759781.5,4207173.57
211223,202003,94,90,4,95095,4180,99275
211227,202003,72,56,16,58520,16720,75240
211230,202003,731,602,129,631180,134805,765985
211240,202003,399,312,87,326040,90915,416955
211245,202003,183,87,96,90915,100320,191235
211250,202003,1545,1331,214,1392985,223630,1616615
211260,202003,799,659,140,689700,146300,836000
211270,202003,1944,1599,345,1672000.5,360525.5,2032526.0
211280,202003,1713,1098,615,1147410,642675,1790085
211285,202003,191,118,73,123310,76285,199595
211290,202003,667,471,196,492195,205865,698060
211300,202003,758,601,157,628045,164065,792110
211400,202003,1526,948,578,992750,605055,1597805
220005,202003,15,14,1,14630,1045,15675
220010,202003,86,66,20,68970,20900,89870
220020,202003,688,547,141,571615,147345,718960
220025,202003,112,109,3,113905,3135,117040
220027,202003,43,35,8,36575,8360,44935
220030,202003,110,90,20,94050,20900,114950
220040,202003,1214,923,291,964535,304095,1268630
220045,202003,32,21,11,21945,11495,33440
220050,202003,673,567,106,592515.61,110770,703285.61
220060,202003,168,148,20,155705,20900,176605
220070,202003,112,102,10,106590,10450,117040
220080,202003,15,13,2,13585,2090,15675
220090,202003,33,27,6,28215,6270,34485
220095,202003,2,1,1,1045,1045,2090
220100,202003,19,16,3,16720,3135,19855
220105,202003,23,21,2,21945.5,2090,24035.5
220110,202003,219,201,18,210045,18810,228855
220115,202003,36,35,1,36575,1045,37620
220117,202003,20,19,1,19855,1045,20900
220120,202003,1469,1122,347,1173535,364705,1538240
220130,202003,31,30,1,31350,1045,32395
220140,202003,101,77,24,80465,25080,105545
220150,202003,490,359,131,375155,136895,512050
220155,202003,6,6,0,6270,0,6270
220157,202003,19,15,4,15675,4180,19855
220160,202003,88,76,12,79420,12540,91960
220170,202003,30,30,0,31350,0,31350
220173,202003,7,7,0,7315,0,7315
220177,202003,6,6,0,6270,0,6270
220180,202003,68,67,1,70015,1045,71060
220190,202003,1049,935,114,978120,119130,1097250
220191,202003,45,39,6,40755,6270,47025
220192,202003,79,76,3,79420,3135,82555
220194,202003,50,48,2,50160,2090,52250
220196,202003,99,83,16,86735,16720,103455
220198,202003,3,2,1,2090,1045,3135
220200,202003,413,345,68,361570.25,71060,432630.25
220202,202003,39,34,5,35530,5225,40755
220205,202003,48,43,5,44935,5225,50160
220207,202003,11,11,0,11495,0,11495
220208,202003,78,41,37,42845,39710,82555
220209,202003,31,28,3,29260,3135,32395
220210,202003,18,14,4,14630,4180,18810
220211,202003,28,26,2,27170,2090,29260
220213,202003,39,35,4,36575,4180.5,40755.5
220217,202003,39,31,8,32395,8360,40755
220220,202003,2164,1417,747,1483900,780615.5,2264515.5
220225,202003,10,4,6,4180,6270,10450
220230,202003,964,753,211,787930,220495,1008425
220240,202003,157,142,15,148390,15675,164065
220245,202003,33,30,3,31350.97,3135,34485.97
220250,202003,122,108,14,112860,14630,127490
220253,202003,42,35,7,36575,7315,43890
220255,202003,28,26,2,27170,2090,29260
220260,202003,692,515,177,539220,184965,724185
220265,202003,9,7,2,7315,2090,9405
220270,202003,752,675,77,705375,80465,785840
220271,202003,40,33,7,34485,7315,41800
220272,202003,24,24,0,25080,0,25080
220273,202003,17,15,2,15675,2090,17765
220275,202003,57,47,10,49115,10450,59565
220277,202003,15,13,2,13585,2090,15675
220280,202003,16,13,3,13585,3135,16720
220285,202003,44,41,3,42845,3135,45980
220290,202003,1462,1252,210,1309386,220495.25,1529881.25
220300,202003,34,33,1,34485,1045,35530
220310,202003,319,272,47,284240,49115,333355
220320,202003,446,413,33,431585.5,34485,466070.5
220323,202003,0,,,,,0.0
220325,202003,15,13,2,13585,2090,15675
220327,202003,13,11,2,11495,2090,13585
220330,202003,228,166,62,173470,64790,238260
220335,202003,136,119,17,124355,17765,142120
220340,202003,41,28,13,29260,14630,43890
220342,202003,57,50,7,52250,7315,59565
220345,202003,81,74,7,77330,7315,84645
220350,202003,440,382,58,400235,60610,460845
220360,202003,41,31,10,32395,10450,42845
220370,202003,1215,1003,212,1048135,221540,1269675
220375,202003,21,19,2,19855,2090,21945
220380,202003,19,16,3,16720,3135,19855
220385,202003,15,13,2,13585,2090,15675
220390,202003,2313,1314,999,1373130.6,1045000.75,2418131.35
220400,202003,32,28,4,29260,4180,33440
220410,202003,19,17,2,17765,2090,19855
220415,202003,12,11,1,11495,1045,12540
220420,202003,126,106,20,110770,20900,131670
220430,202003,127,115,12,120175,12540,132715
220435,202003,23,16,7,16720,7315,24035
220440,202003,290,246,44,257070,45980,303050
220450,202003,326,169,157,176605,164065,340670
220455,202003,53,52,1,54340,1045,55385
220460,202003,20,19,1,19855,1045,20900
220465,202003,94,64,30,66880,31350,98230
220470,202003,242,212,30,221540,31350,252890
220480,202003,71,63,8,65835,8360,74195
220490,202003,88,75,13,78375,13585,91960
220500,202003,104,90,14,94050,14630,108680
220510,202003,418,325,93,340670,97185,437855
220515,202003,22,20,2,20900,2090,22990
220520,202003,366,329,37,343805.85,38665,382470.85
220525,202003,10,7,3,7315,3135,10450
220527,202003,19,13,6,13585,6270,19855
220530,202003,31,13,18,13585,18810,32395
220535,202003,4,4,0,4180,0,4180
220540,202003,65,54,11,56430,11495,67925
220545,202003,41,27,14,28215,14630,42845
220550,202003,689,544,145,568480,151525,720005
220551,202003,12,9,3,9405,3135,12540
220552,202003,14,14,0,14630,0,14630
220553,202003,54,49,5,51205,5225,56430
220554,202003,10,8,2,8360,2090,10450
220555,202003,33,30,3,31350,3135,34485
220556,202003,46,44,2,45980,2090,48070
220557,202003,56,53,3,55385,3135,58520
220558,202003,8,3,5,3135,5225,8360
220559,202003,2,2,0,2090,0,2090
220560,202003,67,45,22,47025,22990,70015
220570,202003,749,459,290,479655.5,303050,782705.5
220580,202003,549,506,43,529815,44935,574750
220585,202003,7,6,1,6270,1045,7315
220590,202003,14,14,0,14630,0,14630
220595,202003,62,47,15,49115,15675,64790
220600,202003,18,11,7,11495,7315,18810
220605,202003,27,25,2,26125,2090,28215
220610,202003,74,65,9,67925,9405,77330
220620,202003,557,458,99,478610,103455,582065
220630,202003,5,4,1,4180,1045,5225
220635,202003,36,32,4,33440,4180,37620
220640,202003,105,86,19,89870,19855,109725
220650,202003,113,107,6,111815,6270,118085
220660,202003,51,40,11,41800,11495,53295
220665,202003,4,4,0,4180,0,4180
220667,202003,19,17,2,17765,2090,19855
220669,202003,27,24,3,25080,3135,28215
220670,202003,63,51,12,53295,12540,65835
220672,202003,67,45,22,47025,22990,70015
220675,202003,34,27,7,28215,7315,35530
220680,202003,36,31,5,32395,5225,37620
220690,202003,47,43,4,44935,4180,49115
220695,202003,33,17,16,17765,16720,34485
220700,202003,1688,1307,381,1366860,398145,1765005
220710,202003,4,3,1,3135,1045,4180
220720,202003,103,87,16,90915,17765,108680
220730,202003,15,15,0,15675,0,15675
220735,202003,5,1,4,1045,4180,5225
220740,202003,47,44,3,45980,3135,49115
220750,202003,111,94,17,98230,17765,115995
220755,202003,15,14,1,14630,1045,15675
220760,202003,66,61,5,63745,5225,68970
220770,202003,5509,2999,2510,3138136.51,2634445.5,5772582.01
220775,202003,19,11,8,11495,8360,19855
220777,202003,18,17,1,17765,1045,18810
220779,202003,0,0,0,0,0,0
220780,202003,889,759,130,794200,135850.5,930050.5
220785,202003,4,1,3,1045,3135,4180
220790,202003,1072,853,219,893475.05,228855,1122330.05
220793,202003,7,6,1,6270,1045,7315
220795,202003,14,13,1,13585,1045,14630
220800,202003,3980,3061,919,3202925.81,963490,4166415.81
220810,202003,65,57,8,59565.5,8360,67925.5
220820,202003,238,217,21,226765,21945,248710
220830,202003,1203,1037,166,1084710,175560,1260270
220840,202003,2391,1661,730,1737837.09,763895.95,2501733.04
220850,202003,53,43,10,44935,10450,55385
220855,202003,8,5,3,5225,3135,8360
220860,202003,14,12,2,12540,2090,14630
220865,202003,31,29,2,30305,2090,32395
220870,202003,73,65,8,67925,8360,76285
220880,202003,317,252,65,263340,67925,331265
220885,202003,33,30,3,31350,3135,34485
220887,202003,12,12,0,12540,0,12540
220890,202003,97,86,11,89870,11495,101365
220900,202003,21,14,7,14630,7315,21945
220910,202003,54,45,9,47025,9405,56430
220915,202003,10,9,1,9405,1045,10450
220920,202003,52,48,4,50160,4180,54340
220930,202003,41,40,1,41800,1045,42845
220935,202003,15,15,0,15675,0,15675
220937,202003,35,34,1,35530,1045,36575
220940,202003,57,53,4,55385,4180,59565
220945,202003,1,1,0,1045,0,1045
220950,202003,44,38,6,39710,6270,45980
220955,202003,24,23,1,24035,1045,25080
220960,202003,11,10,1,11495,1045,12540
220965,202003,37,33,4,34485,4180,38665
220970,202003,58,48,10,50160,10450,60610
220975,202003,14,12,2,12540,2090,14630
220980,202003,29,27,2,28215,2090,30305
220985,202003,64,57,7,59565,7315,66880
220987,202003,28,27,1,28215,1045,29260
220990,202003,19,18,1,18810,1045,19855
220995,202003,18,14,4,14630,4180,18810
220997,202003,63,52,11,54340,11495,65835
221000,202003,1175,1063,112,1110835,118085,1228920
221005,202003,55,48,7,50160,7315,57475
221010,202003,16,12,4,12540,4180,16720
221020,202003,39,37,2,38665,2090,40755
221030,202003,34,27,7,28215,7315,35530
221035,202003,23,23,0,24035,0,24035
221037,202003,12,8,4,8360,4180,12540
221038,202003,26,23,3,24035,3135,27170
221039,202003,23,23,0,24035,0,24035
221040,202003,246,212,34,221540,35530,257070
221050,202003,231,196,35,204820,36575,241395
221060,202003,1856,1622,234,1696035,244530,1940565
221062,202003,33,33,0,34485,0,34485
221063,202003,13,9,4,9405,4180,13585
221065,202003,56,46,10,48070,10450,58520
221070,202003,139,120,19,125400,19855,145255
221080,202003,373,323,50,337535,52250,389785
221090,202003,28,26,2,27170,2090,29260
221093,202003,48,33,15,34485,15675,50160
221095,202003,7,7,0,7315,0,7315
221097,202003,14,11,3,11495,3135,14630
221100,202003,25009,14815,10194,15495263.94,10667360,26162623.94
221110,202003,1067,805,262,843315,274835,1118150
221120,202003,529,390,139,407968.5,145255,553223.5
221130,202003,970,790,180,825550,188100,1013650
221135,202003,34,31,3,32395,3135,35530
221140,202003,45,39,6,40755,6270,47025
221150,202003,12,10,2,10450,2090,12540
221160,202003,13,13,0,13585,0,13585
221170,202003,15,15,0,15675,0,15675
230010,202003,165,150,15,156750,15675,172425
230015,202003,127,103,24,107635,25080,132715
230020,202003,1635,1388,247,1453595.5,258115,1711710.5
230030,202003,1682,1210,472,1265496,493240,1758736
230040,202003,222,190,32,198550.5,33440.5,231991.0
230050,202003,227,169,58,176605,60610,237215
230060,202003,161,130,31,135850,32395,168245
230070,202003,296,258,38,269610,39710,309320
230075,202003,836,722,114,754491.5,119130,873621.5
230080,202003,198,170,28,177650,29260,206910
230090,202003,123,86,37,89870,38665,128535
230100,202003,2123,1223,900,1279081,944680,2223761
230110,202003,2843,1844,999,1930115.5,1046045.5,2976161.0
230120,202003,980,770,210,805695,219450,1025145
230125,202003,153,128,25,134805,26125,160930
230130,202003,470,421,49,443080,51205,494285
230140,202003,222,186,36,194370,37620,231990
230150,202003,147,114,33,119130,35530,154660
230160,202003,935,794,141,830775.5,148390,979165.5
230170,202003,608,549,59,574750.5,61655,636405.5
230180,202003,74,69,5,72105,5225,77330
230185,202003,404,347,57,362615,59565,422180
230190,202003,2303,1837,466,1921755.15,488015,2409770.15
230195,202003,491,426,65,446215,67925,514140
230200,202003,395,337,58,352165,60610,412775
230205,202003,392,260,132,271700,138985,410685
230210,202003,1363,1060,303,1108745.38,316635,1425380.38
230220,202003,1559,1061,498,1108745.8,520410,1629155.8
230230,202003,902,774,128,810920,133760,944680
230240,202003,1723,1487,236,1558358.25,247665,1806023.25
230250,202003,1795,1481,314,1547645,329175,1876820
230260,202003,3216,2008,1208,2098360,1263405,3361765
230270,202003,1364,1105,259,1154726.38,271700.5,1426426.88
230280,202003,2728,2055,673,2149565,707465.5,2857030.5
230290,202003,408,365,43,381425.72,44935,426360.72
230300,202003,513,381,132,398145,138985,537130
230310,202003,419,315,104,329175,108680,437855
230320,202003,928,795,133,831821,140030,971851
230330,202003,313,254,59,265430,61655,327085
230340,202003,446,361,85,377245,88825,466070
230350,202003,3136,1990,1146,2079550,1200705,3280255
230360,202003,276,222,54,231990,56430,288420
230365,202003,133,112,21,117040,22990,140030
230370,202003,10066,4901,5165,5129908.42,5405786,10535694.42
230380,202003,472,406,66,425315.5,68970,494285.5
230390,202003,540,303,237,317680,248710,566390
230393,202003,243,201,42,210045,43890,253935
230395,202003,353,282,71,294690.7,74195,368885.7
230400,202003,614,487,127,509960,132715,642675
230410,202003,2705,1684,1021,1762915.97,1067990.5,2830906.47
230420,202003,6307,4191,2116,4383778.04,2217490.7,6601268.74
230423,202003,329,287,42,299915,43890,343805
230425,202003,417,341,76,356345.85,79420,435765.85
230426,202003,120,97,23,101365,24035,125400
230427,202003,76,74,2,77330,2090,79420
230428,202003,1497,753,744,786885,777480,1564365
230430,202003,455,372,83,388740,86735,475475
230435,202003,895,639,256,667755,267520.77,935275.77
230440,202003,88507,39270,49237,41097778.5,51565540.32,92663318.82
230445,202003,311,217,94,226765,98230,324995
230450,202003,550,434,116,453530,121220,574750
230460,202003,66,51,15,53295,15675,68970
230465,202003,311,253,58,265430,60610,326040
230470,202003,1996,1580,416,1651100,434720.25,2085820.25
230480,202003,160,151,9,157795,9405,167200
230490,202003,300,239,61,250800,63745,314545
230495,202003,448,332,116,346940,121220,468160
230500,202003,1013,748,265,781660,276925,1058585
230510,202003,58,45,13,47025,13585,60610
230520,202003,379,300,79,313500,82555,396055
230523,202003,2295,1442,853,1507935,893475.5,2401410.5
230526,202003,265,225,40,235125,41800,276925
230530,202003,691,514,177,538175,184965,723140
230533,202003,198,185,13,193325,13585,206910
230535,202003,371,275,96,287375,100320,387695
230540,202003,1801,1592,209,1663640,219450,1883090
230550,202003,3793,2437,1356,2548756.9,1418065,3966821.9
230560,202003,580,440,140,460845,146300,607145
230565,202003,227,165,62,172425,64790,237215
230570,202003,289,254,35,265430,36575,302005
230580,202003,1162,852,310,890340,323950,1214290
230590,202003,998,780,218,815100.25,227810,1042910.25
230600,202003,245,222,23,231990,24035,256025
230610,202003,376,291,85,304095,88825,392920
230620,202003,188,158,30,165110.5,31350,196460.5
230625,202003,753,528,225,553850.25,235125,788975.25
230630,202003,1333,1047,286,1095160,298870,1394030
230640,202003,3725,3176,549,3325191,573705.5,3898896.5
230650,202003,450,386,64,403370,66880,470250
230655,202003,677,579,98,606100,103455,709555
230660,202003,358,299,59,312455,61655,374110
230670,202003,435,378,57,395010,60610,455620
230680,202003,205,186,19,194370,19855,214225
230690,202003,903,767,136,805695,143165,948860
230700,202003,825,693,132,725230,137940.5,863170.5
230710,202003,693,658,35,687610,36575,724185
230720,202003,153,135,18,141075,18810,159885
230725,202003,259,210,49,219450,51205,270655
230730,202003,12165,6640,5525,6945073.05,5791392.62,12736465.67
230740,202003,672,543,129,569525.5,135850.5,705376.0
230750,202003,818,690,128,722095,133760,855855
230760,202003,1414,1217,197,1273855,205865,1479720
230763,202003,327,271,56,284240,58520,342760
230765,202003,7420,3417,4003,3574945.51,4186271.75,7761217.26
230770,202003,5118,2597,2521,2719091.75,2635490.5,5354582.25
230780,202003,721,631,90,659395.5,94050,753445.5
230790,202003,276,232,44,242440,45980,288420
230800,202003,1123,814,309,852720,322905,1175625
230810,202003,1341,1185,156,1239370,163020,1402390
230820,202003,360,251,109,262295.5,113905,376200.5
230830,202003,958,822,136,860035,142120,1002155
230835,202003,274,240,34,250800,35530,286330
230837,202003,160,136,24,142120,25080,167200
230840,202003,912,724,188,757625.5,196460.5,954086.0
230850,202003,1473,1278,195,1337600,204820,1542420
230860,202003,296,222,74,231990,77330,309320
230870,202003,1806,1539,267,1612435,279015,1891450
230880,202003,65,49,16,51205,16720,67925
230890,202003,539,497,42,520410,43890,564300
230900,202003,281,208,73,218405,76285.31,294690.31
230910,202003,214,169,45,176605,47025,223630
230920,202003,431,341,90,356345,95095,451440
230930,202003,970,682,288,713735.2,300960,1014695.2
230940,202003,854,667,187,697015,195415,892430
230945,202003,512,423,89,442035.5,93005,535040.5
230950,202003,408,353,55,368885,57475,426360
230960,202003,2652,1778,874,1860100.18,915420.5,2775520.68
230970,202003,1715,954,761,999020,796290,1795310
230980,202003,207,170,37,179740,38665,218405
230990,202003,138,113,25,118085,26125,144210
231000,202003,206,187,19,196460,19855,216315
231010,202003,148,113,35,118085,36575,154660
231020,202003,1340,933,407,976030,427405,1403435
231025,202003,1062,787,275,822415,287375.5,1109790.5
231030,202003,1096,913,183,954085.9,191235,1145320.9
231040,202003,136,95,41,99275,43890,143165
231050,202003,947,840,107,883025,112860,995885
231060,202003,155,129,26,134805,27170,161975
231070,202003,1496,1042,454,1089935.75,475475,1565410.75
231080,202003,256,238,18,249755,18810,268565
231085,202003,608,368,240,384560,250800,635360
231090,202003,243,198,45,207955,47025,254980
231095,202003,167,131,36,136895,37620,174515
231100,202003,146,123,23,128535,24035,152570
231110,202003,364,311,53,324995,55385,380380
231120,202003,269,228,41,238260,42845,281105
231123,202003,147,140,7,146300,7315,153615
231126,202003,329,257,72,269610.5,75240,344850.5
231130,202003,4599,3589,1010,3754685.5,1055450.5,4810136.0
231135,202003,210,182,28,190190,29260,219450
231140,202003,3051,2243,808,2350205,845405,3195610
231150,202003,362,344,18,359480,18810,378290
231160,202003,1200,951,249,993795,262295,1256090
231170,202003,521,361,160,377245,167200,544445
231180,202003,1665,1422,243,1487035,253935,1740970
231190,202003,206,173,33,180785,34485,215270
231195,202003,215,184,31,192280,32395,224675
231200,202003,801,655,146,684475,153615,838090
231210,202003,579,487,92,509960,96140,606100
231220,202003,1040,760,280,795245.75,292600,1087845.75
231230,202003,1467,1162,305,1216380,318725,1535105
231240,202003,1453,1035,418,1081575,436810,1518385
231250,202003,111,102,9,106590,9405,115995
231260,202003,276,178,98,186010,102410,288420
231270,202003,1010,826,184,863171.94,193325,1056496.94
231280,202003,74,57,17,59565,17765,77330
231290,202003,7564,4237,3327,4431845.66,3479850.94,7911696.60
231300,202003,612,568,44,595650,45980,641630
231310,202003,746,690,56,721050.56,58520,779570.56
231320,202003,584,443,141,463981.5,148390,612371.5
231325,202003,94,83,11,87780,11495,99275
231330,202003,2002,1547,455,1622104.9,476520.5,2098625.4
231335,202003,251,222,29,231990,30305,262295
231340,202003,1720,1265,455,1321925,476520,1798445
231350,202003,1282,1048,234,1096205,244531,1340736
231355,202003,432,370,62,388740,64790,453530
231360,202003,511,378,133,396055.86,138985,535040.86
231370,202003,89,77,12,80465,12540,93005
231375,202003,287,209,78,218405,81510,299915
231380,202003,490,395,95,412775,99275,512050
231390,202003,201,161,40,168245,41800,210045
231395,202003,735,458,277,478610,289465,768075
231400,202003,1114,926,188,968715.25,196460.5,1165175.75
231410,202003,1313,1075,238,1125465,249755,1375220
240010,202003,393,173,220,181830.67,229900,411730.67
240020,202003,2271,1827,444,1910261.68,466070,2376331.68
240030,202003,120,102,18,106590,18810,125400
240040,202003,31,31,0,32395,0,32395
240050,202003,529,453,76,473385,79420,552805
240060,202003,63,58,5,60610,5225,65835
240070,202003,215,168,47,176605,50160,226765
240080,202003,513,350,163,365750,170335.01,536085.01
240090,202003,105,94,11,99275,11495,110770
240100,202003,1497,1417,80,1484945.25,83600,1568545.25
240110,202003,1046,688,358,721050.5,375155,1096205.5
240120,202003,128,106,22,111815,22990,134805
240130,202003,276,255,21,266475,21945,288420
240140,202003,77,58,19,60610,19855,80465
240145,202003,735,656,79,686565,82555,769120
240150,202003,21,16,5,16720,5225,21945
240160,202003,41,35,6,36575,6270,42845
240165,202003,35,27,8,28215.25,8360,36575.25
240170,202003,106,78,28,82555,29260,111815
240180,202003,84,68,16,72105,16720,88825
240185,202003,42,39,3,40755,3135,43890
240190,202003,15,13,2,13585,2090,15675
240200,202003,3077,1720,1357,1802627.5,1420155.5,3222783.0
240210,202003,169,132,37,137940,38665,176605
240220,202003,1108,806,302,843315.75,315590,1158905.75
240230,202003,841,776,65,814055.75,70015,884070.75
240240,202003,70,51,19,53295,19855,73150
240250,202003,88,76,12,79420,12540,91960
240260,202003,1796,1331,465,1394030,486970,1881000
240270,202003,186,164,22,171380,22990,194370
240280,202003,42,34,8,36575,8360,44935
240290,202003,50,49,1,51205,1045,52250
240300,202003,170,96,74,100320,77330,177650
240310,202003,2303,1274,1029,1334465.98,1080530.85,2414996.83
240320,202003,186,176,10,183920,10450,194370
240325,202003,4477,2687,1790,2811052.53,1875775.7,4686828.23
240330,202003,72,68,4,71060,4180,75240
240340,202003,65,41,24,42845,25080,67925
240350,202003,99,87,12,90915,12540,103455
240360,202003,550,353,197,368885,206910,575795
240370,202003,50,46,4,48070,4180,52250
240375,202003,66,39,27,40755,28215,68970
240380,202003,225,187,38,196460,39710.5,236170.5
240390,202003,12,11,1,11495,1045,12540
240400,202003,82,76,6,79420,6270,85690
240410,202003,13,8,5,8360,5225,13585
240420,202003,990,734,256,769120,268565,1037685
240430,202003,261,244,17,254980,17765,272745
240440,202003,115,64,51,66880,53295,120175
240450,202003,217,148,69,154660.5,72105,226765.5
240460,202003,63,47,16,49115,16720,65835
240470,202003,232,205,27,214225,28215,242440
240480,202003,15,13,2,13585,2090,15675
240485,202003,79,66,13,68970,13585,82555
240490,202003,46,44,2,45980,2090,48070
240500,202003,82,62,20,64790,20900,85690
240510,202003,43,32,11,33440,11495,44935
240520,202003,115,111,4,115995,4180,120175
240530,202003,51,46,5,48070,5225,53295
240540,202003,78,65,13,67925,13585,81510
240550,202003,13,12,1,12540,1045,13585
240560,202003,374,273,101,285285.5,106590,391875.5
240570,202003,447,285,162,298870.5,169290.5,468161.0
240580,202003,1288,1021,267,1067990.25,280060,1348050.25
240590,202003,30,28,2,29260,2090,31350
240600,202003,108,104,4,108680,4180,112860
240610,202003,515,432,83,452485.5,86735,539220.5
240615,202003,19,18,1,18810,1045,19855
240620,202003,88,84,4,87780,4180,91960
240630,202003,38,33,5,34485,5225,39710
240640,202003,25,20,5,20900,5225,26125
240650,202003,239,199,40,207955,41800,249755
240660,202003,108,93,15,97185,15675,112860
240670,202003,302,176,126,183920.75,131670,315590.75
240680,202003,51,39,12,40755,12540,53295
240690,202003,48,45,3,47025,3135,50160
240700,202003,184,153,31,159885,32395,192280
240710,202003,2010,1254,756,1314610.75,791065,2105675.75
240720,202003,1061,784,277,821370,289465,1110835
240725,202003,64,59,5,61655,5225,66880
240730,202003,144,125,19,130625,19855,150480
240740,202003,232,199,33,207955,34485.85,242440.85
240750,202003,50,26,24,27170,25080,52250
240760,202003,45,41,4,42845,4180,47025
240770,202003,143,110,33,114950,34485,149435
240780,202003,672,552,120,587290,132715,720005
240790,202003,40,38,2,39710,2090,41800
240800,202003,9170,6240,2930,6533348.8,3068122.75,9601471.55
240810,202003,20321,11041,9280,11551440.7,9714323.65,21265764.35
240820,202003,236,138,98,144210.09,103455,247665.09
240830,202003,1628,1337,291,1398210.75,305140,1703350.75
240840,202003,78,68,10,71060,10450,81510
240850,202003,87,76,11,79420,11495,90915
240860,202003,106,102,4,106590,4180,110770
240870,202003,59,51,8,53295,8360,61655
240880,202003,32,28,4,29260,4180,33440
240890,202003,1114,644,470,674025.4,492195,1166220.4
240895,202003,59,38,21,39710,21945,61655
240910,202003,159,142,17,149435,17765,167200
240920,202003,13,10,3,10450,3135,13585
240930,202003,413,370,43,386650,44935,431585
240933,202003,41,29,12,30305,12540,42845
240940,202003,2389,2121,268,2219580.45,280060,2499640.45
240950,202003,45,42,3,43890,3135,47025
240960,202003,26,22,4,22990,4180,27170
240970,202003,113,84,29,87780,30305,118085
240980,202003,196,156,40,163020,41800,204820
240990,202003,127,85,42,88825,43890,132715
241000,202003,61,57,4,59565,4180,63745
241010,202003,69,55,14,57475,14630,72105
241020,202003,114,106,8,110770,8360,119130
241025,202003,10,4,6,4180,6270,10450
241030,202003,107,87,20,90915,20900,111815
241040,202003,42,30,12,31350,12540,43890
241050,202003,81,73,8,76285,8360,84645
241060,202003,29,24,5,25080,5225,30305
241070,202003,16,16,0,16720,0,16720
241080,202003,61,54,7,56430,7315,63745
241090,202003,59,49,10,51205,10450,61655
241100,202003,72,61,11,65835,11495,77330
241105,202003,6,1,5,1045,5225,6270
241110,202003,45,43,2,44935,2090,47025
241120,202003,1467,1118,349,1170400.5,365750,1536150.5
241140,202003,220,184,36,192280.5,38665,230945.5
241142,202003,40,35,5,36575,5225,41800
241150,202003,1176,1032,144,1078440,150480,1228920
241160,202003,19,17,2,17765,2090,19855
241170,202003,43,38,5,39710,5225,44935
241180,202003,42,36,6,38665,6270,44935
241190,202003,37,36,1,37620,1045,38665
241200,202003,3842,2012,1830,2104631.39,1914440,4019071.39
241210,202003,69,59,10,61655,10450,72105
241220,202003,1415,959,456,1002156.57,476520,1478676.57
241230,202003,239,202,37,211090,38665,249755
241240,202003,53,42,11,44935,11495,56430
241250,202003,1144,1050,94,1099340.5,99275,1198615.5
241255,202003,50,40,10,41800,10450,52250
241260,202003,674,526,148,550715,155705,706420
241270,202003,62,42,20,43890,20900,64790
241280,202003,94,82,12,85690,12540,98230
241290,202003,124,89,35,93005,36575,129580
241300,202003,75,55,20,57475,20900,78375
241310,202003,51,37,14,38665.75,14630,53295.75
241320,202003,29,17,12,17765,12540,30305
241330,202003,59,55,4,57475,4180,61655
241335,202003,72,64,8,66880,8360,75240
241340,202003,179,133,46,138985,48070,187055
241350,202003,61,52,9,54340,9405,63745
241355,202003,48,42,6,43890,6270,50160
241360,202003,52,50,2,52250,2090,54340
241370,202003,52,42,10,43890,10450,54340
241380,202003,37,33,4,34485,4180,38665
241390,202003,84,66,18,68970,18810,87780
241400,202003,218,176,42,183920,43890,227810
241410,202003,184,166,18,173470,18810,192280
241415,202003,101,81,20,84645,20900,105545
241420,202003,103,73,30,77330,31350.1,108680.1
241430,202003,28,25,3,26125,3135,29260
241440,202003,542,435,107,454575,111815,566390
241445,202003,34,32,2,33440,2090,35530
241450,202003,282,232,50,243485,52250,295735
241460,202003,137,123,14,128535.25,14630,143165.25
241470,202003,38,32,6,33440,6270,39710
241475,202003,56,53,3,55385,3135,58520
241480,202003,92,67,25,70015,26125,96140
241490,202003,11,10,1,10450,1045,11495
241500,202003,47,36,11,37620,11495,49115
250010,202003,101,86,15,89870,15675,105545
250020,202003,31,28,3,29260,3135,32395
250030,202003,849,639,210,669845,220495,890340
250040,202003,365,299,66,312455,70015,382470
250050,202003,251,206,45,215270,47025,262295
250053,202003,57,42,15,43890,15675,59565
250057,202003,1,1,0,1045,0,1045
250060,202003,562,407,155,425315,161975,587290
250070,202003,702,557,145,585200.1,151525,736725.1
250073,202003,8,8,0,8360,0,8360
250077,202003,181,138,43,145255,44935,190190
250080,202003,426,332,94,346940.3,99275,446215.3
250090,202003,215,140,75,146300,78375,224675
250100,202003,511,421,90,440990,94050,535040
250110,202003,605,461,144,481745,150480,632225
250115,202003,21,7,14,7315,14630,21945
250120,202003,121,86,35,89870,36575,126445
250130,202003,574,471,103,493240,107635,600875
250135,202003,18,11,7,11495,7315,18810
250140,202003,85,75,10,78375,10450,88825
250150,202003,594,429,165,448305,172425,620730
250153,202003,9,6,3,6270,3135,9405
250157,202003,30,23,7,24035,7315,31350
250160,202003,231,178,53,186010,55385,241395
250170,202003,62,40,22,41800,22990,64790
250180,202003,4190,2867,1323,2998105.3,1385670,4383775.3
250190,202003,837,549,288,574750,303050.25,877800.25
250200,202003,47,40,7,41800,7315,49115
250205,202003,23,20,3,20900,3135,24035
250210,202003,85,75,10,78375,10450,88825
250215,202003,65,54,11,56430,11495,67925
250220,202003,24,18,6,19855,6270,26125
250230,202003,79,73,6,76285,6270,82555
250240,202003,231,192,39,200640,40755,241395
250250,202003,391,337,54,353210,56430,409640
250260,202003,43,37,6,38665,6270,44935
250270,202003,68,50,18,52250,18810,71060
250280,202003,384,317,67,331265,70015,401280
250290,202003,91,84,7,87780,7315,95095
250300,202003,553,377,176,396055,183920,579975
250310,202003,48,43,5,44935,5225,50160
250320,202003,1944,1314,630,1375220.85,661485.76,2036706.61
250330,202003,96,81,15,84645,15675,100320
250340,202003,25,23,2,24035,2090,26125
250350,202003,163,107,56,111815,58520,170335
250355,202003,33,25,8,26125,8360,34485
250360,202003,198,163,35,170335,36575,206910
250370,202003,2348,1578,770,1651100,808830,2459930
250375,202003,9,5,4,5225,4180,9405
250380,202003,58,42,16,43890,16720,60610
250390,202003,43,33,10,34485,10450,44935
250400,202003,16271,8230,8041,8619145.56,8420611,17039756.56
250403,202003,329,268,61,280060,63745,343805
250407,202003,59,49,10,51205,10450,61655
250410,202003,30,26,4,27170,4180,31350
250415,202003,39,27,12,28215,12540,40755
250420,202003,44,38,6,39710,6270,45980
250430,202003,1450,1246,204,1306511.25,213180,1519691.25
250435,202003,17,13,4,13585,4180,17765
250440,202003,676,565,111,590425,115995,706420
250450,202003,82,68,14,71060,14630,85690
250460,202003,467,314,153,329175,159885,489060
250470,202003,91,64,27,66880,28215,95095
250480,202003,324,259,65,271700,67925,339625
250485,202003,2,2,0,2090,0,2090
250490,202003,226,182,44,190190,47025,237215
250500,202003,86,65,21,67925,21945,89870
250510,202003,759,603,156,630135,163020,793155
250520,202003,178,121,57,126445,59565,186010
250523,202003,115,93,22,97185,22990,120175
250527,202003,102,80,22,83600,22990,106590
250530,202003,9,5,4,5225,4180,9405
250535,202003,32,24,8,25080,8360,33440
250540,202003,131,103,28,107635,30305,137940
250550,202003,72,69,3,72105,3135,75240
250560,202003,48,35,13,36575,13585,50160
250570,202003,164,135,29,141075,30305,171380
250580,202003,109,85,24,88892,25080,113972
250590,202003,23,15,8,15675,8360,24035
250600,202003,1369,902,467,943636.46,489060,1432696.46
250610,202003,156,131,25,136895,26125,163020
250620,202003,23,18,5,18810,5225,24035
250625,202003,73,54,19,56430,19855,76285
250630,202003,3016,1926,1090,2015807.43,1139050,3154857.43
250640,202003,215,171,44,179740,45980,225720
250650,202003,29,20,9,20900,9405,30305
250660,202003,49,38,11,39710,11495,51205
250670,202003,63,42,21,43890,21945,65835
250680,202003,399,323,76,337535,79420,416955
250690,202003,2001,1384,617,1446280.96,646855,2093135.96
250700,202003,936,812,124,849585.25,129580,979165.25
250710,202003,433,338,95,353210,99275,452485
250720,202003,114,85,29,88825,30305,119130
250730,202003,380,318,62,332310,64790,397100
250740,202003,54,50,4,52250,4180,56430
250750,202003,21977,13268,8709,13881675.75,9115536.5,22997212.25
250760,202003,92,75,17,78375,18810,97185
250770,202003,359,234,125,244530.6,130625,375155.6
250780,202003,65,45,20,47025,20900,67925
250790,202003,461,302,159,315590.64,166155,481745.64
250800,202003,148,135,13,141075,13585,154660
250810,202003,80,61,19,63745,19855,83600
250820,202003,152,127,25,132715,26125,158840
250830,202003,431,295,136,308275.5,142120,450395.5
250840,202003,55,49,6,51205,6270,57475
250850,202003,57,48,9,50160,9405,59565
250855,202003,13,11,2,11495,2090,13585
250860,202003,209,144,65,150480,67925,218405
250870,202003,29,25,4,26125,4180,30305
250880,202003,79,60,19,62700,19855,82555
250890,202003,2799,2094,705,2190320,736725,2927045
250900,202003,52,42,10,43890,10450,54340
250905,202003,119,93,26,97185,28215,125400
250910,202003,1133,823,310,860035,324995,1185030
250915,202003,105,75,30,78375,31350,109725
250920,202003,139,102,37,106590,38665,145255
250930,202003,162,98,64,102410,66880,169290
250933,202003,4,2,2,2090,2090,4180
250937,202003,9,8,1,8360,1045,9405
250939,202003,35,26,9,27170,9405,36575
250940,202003,102,77,25,81510,26125,107635
250950,202003,71,49,22,51205,22990,74195
250960,202003,86,46,40,48070,41800,89870
250970,202003,1224,861,363,902880,380380,1283260
250980,202003,103,71,32,74195,33440,107635
250990,202003,165,127,38,132715,39710,172425
251000,202003,74,67,7,70015,7315,77330
251010,202003,113,84,29,87780,30305,118085
251020,202003,76,62,14,64790,14630,79420
251030,202003,45,34,11,35530,11495,47025
251040,202003,55,39,16,40755,16720,57475
251050,202003,24,21,3,21945,3135,25080
251060,202003,51,40,11,41800,11495,53295
251065,202003,4,4,0,4180,0,4180
251070,202003,20,16,4,16720,4180,20900
251080,202003,4964,2377,2587,2488145.75,2711776.34,5199922.09
251090,202003,187,160,27,169290,28215,197505
251100,202003,18,18,0,18810,0,18810
251110,202003,45,36,9,37620,9405,47025
251120,202003,1863,1144,719,1198617.89,752400.2,1951018.09
251130,202003,391,318,73,333355,76285,409640
251140,202003,557,363,194,379335,203775,583110
251150,202003,334,286,48,298870,50160,349030
251160,202003,91,74,17,77330,17765,95095
251170,202003,101,81,20,84645,20900,105545
251180,202003,288,175,113,183920,118085,302005
251190,202003,202,131,71,136895,74195,211090
251200,202003,268,217,51,226765,53295,280060
251203,202003,35,33,2,34485,2090,36575
251207,202003,90,74,16,77330,16720,94050
251210,202003,1473,1071,402,1120240,421135,1541375
251220,202003,49,36,13,37620,13585,51205
251230,202003,593,501,92,523545,96140,619685
251240,202003,98,67,31,70015,32395,102410
251250,202003,1398,992,406,1039775.75,425315.75,1465091.50
251260,202003,13,7,6,7315,6270,13585
251270,202003,323,246,77,257070,80465,337535
251272,202003,66,60,6,62700,6270,68970
251274,202003,30,23,7,24035,7315,31350
251275,202003,35,21,14,21945,14630,36575
251276,202003,12,9,3,9405,3135,12540
251278,202003,11,9,2,9405,2090,11495
251280,202003,100,96,4,100320,4180,104500
251290,202003,779,570,209,595650,218405,814055
251300,202003,14,12,2,12540,2090,14630
251310,202003,373,270,103,282150,108680,390830
251315,202003,31,28,3,29260,3135,32395
251320,202003,61,48,13,50160,13585,63745
251330,202003,76,67,9,70015,9405,79420
251335,202003,14,9,5,9405,5225,14630
251340,202003,725,429,296,448305,309320,757625
251350,202003,34,33,1,34485,1045,35530
251360,202003,81,70,11,73150,11495,84645
251365,202003,15,15,0,15675,0,15675
251370,202003,5516,3725,1791,3900985.65,1872640,5773625.65
251380,202003,45,37,8,38665,8360,47025
251385,202003,3,3,0,3135,0,3135
251390,202003,784,594,190,621775,198550.5,820325.5
251392,202003,15,8,7,8360,7315,15675
251394,202003,11,11,0,11495,0,11495
251396,202003,11,7,4,7315,4180,11495
251398,202003,16,14,2,14630,2090,16720
251400,202003,37,32,5,33440,5225,38665
251410,202003,37,31,6,32395,7315,39710
251420,202003,101,73,28,76285,29260,105545
251430,202003,41,37,4,38665,4180,42845
251440,202003,38,23,15,24035,15675,39710
251445,202003,49,43,6,44935.25,6270,51205.25
251450,202003,395,343,52,358435,54340,412775
251455,202003,4,2,2,2090,2090,4180
251460,202003,15,13,2,13585,2090,15675
251465,202003,4,2,2,2090,2090,4180
251470,202003,48,39,9,40755,9405,50160
251480,202003,26,21,5,21945,5225,27170
251490,202003,123,82,41,85690,42845.5,128535.5
251500,202003,126,103,23,107635,24035,131670
251510,202003,47,31,16,32395,16720,49115
251520,202003,28,28,0,29260,0,29260
251530,202003,4494,3155,1339,3301155.5,1401345,4702500.5
251540,202003,74,62,12,65835,12540,78375
251550,202003,410,314,96,329175,100320.75,429495.75
251560,202003,23,15,8,15675,8360,24035
251570,202003,19,18,1,18810,1045,19855
251580,202003,131,103,28,107635,29260,136895
251590,202003,115,84,31,87977.5,33440,121417.5
251593,202003,26,16,10,16720,10450,27170
251597,202003,78,61,17,63745,17765,81510
251600,202003,1099,779,320,815100.5,334400,1149500.5
251610,202003,233,178,55,187055,57475,244530
251615,202003,6,6,0,6270,0,6270
251620,202003,4214,2763,1451,2889426.6,1519431.5,4408858.1
251630,202003,457,337,120,352165,125400,477565
251640,202003,145,104,41,108680,42845,151525
251650,202003,275,200,75,209000.75,78375,287375.75
251660,202003,190,171,19,178695,19855,198550
251670,202003,366,284,82,296780,85690,382470
251675,202003,7,6,1,6270,1045,7315
251680,202003,94,87,7,90915,7315,98230
251690,202003,330,270,60,283195,62700,345895
251700,202003,283,243,40,253935.9,41800,295735.9
251710,202003,23,15,8,15675,8360,24035
251720,202003,22,15,7,15675,8360.5,24035.5
251740,202003,11,8,3,8360,3135,11495
260005,202003,3217,1770,1447,1852789.21,1514205,3366994.21
260010,202003,1586,1166,420,1218470.55,438900.1,1657370.65
260020,202003,419,367,52,383515,54340,437855
260030,202003,613,430,183,450395,191235,641630
260040,202003,806,503,303,525635,317680,843315
260050,202003,1173,838,335,878845,352166,1231011
260060,202003,380,347,33,362615,34485,397100
260070,202003,1373,849,524,888250.5,549670.3,1437920.8
260080,202003,735,568,167,593560,176605,770165
260090,202003,504,326,178,340670,186010,526680
260100,202003,215,150,65,156750,67925,224675
260105,202003,234,130,104,135850,108680,244530
260110,202003,2879,2116,763,2212266,799425.5,3011691.5
260120,202003,2816,1440,1376,1510026.8,1438965.75,2948992.55
260130,202003,164,112,52,117040,54340,171380
260140,202003,2122,1368,754,1433741.8,788975,2222716.8
260150,202003,212,137,75,143165,79420,222585
260160,202003,326,274,52,286330,54340,340670
260170,202003,3375,2047,1328,2141206.2,1394030.5,3535236.7
260180,202003,152,122,30,127490,31350,158840
260190,202003,2314,1585,729,1657370,761805,2419175
260200,202003,972,781,191,816145.29,199595.5,1015740.79
260210,202003,1436,1027,409,1074260,428450,1502710
260220,202003,696,626,70,655215.5,74195,729410.5
260230,202003,1200,904,296,945725,309320,1255045
260240,202003,221,164,57,171380,59565,230945
260250,202003,92,69,23,72105,24035,96140
260260,202003,1049,745,304,778525,318725,1097250
260270,202003,417,330,87,344850,91960,436810
260280,202003,1292,908,384,950950,403370.5,1354320.5
260290,202003,6523,3523,3000,3689897,3153812.46,6843709.46
260300,202003,940,818,122,855855.5,129580,985435.5
260310,202003,516,407,109,426360,113905,540265
260320,202003,871,637,234,667755,244530,912285
260330,202003,60,43,17,44935,18810,63745
260340,202003,76,56,20,58520,20900,79420
260345,202003,5531,3018,2513,3160081.43,2633400,5793481.43
260350,202003,485,351,134,366795.5,140030,506825.5
260360,202003,264,144,120,150480,125400,275880
260370,202003,713,469,244,492195.25,256025.75,748221.00
260380,202003,586,430,156,449350,163020.47,612370.47
260390,202003,294,249,45,261250,48070,309320
260392,202003,104,91,13,95095,13585,108680
260400,202003,4127,2362,1765,2473516.97,1848605,4322121.97
260410,202003,14779,7760,7019,8124877.22,7359936.25,15484813.47
260415,202003,138,120,18,125400,18810,144210
260420,202003,1734,1057,677,1106656.77,708510,1815166.77
260430,202003,188,172,16,180785.35,16720,197505.35
260440,202003,201,144,57,150480,59565,210045
260450,202003,434,320,114,334400.96,120175,454575.96
260460,202003,826,434,392,454575.5,412775,867350.5
260470,202003,350,214,136,224675,143165.5,367840.5
260480,202003,233,152,81,158840,84645,243485
260490,202003,214,176,38,184965,39710,224675
260500,202003,1126,755,371,790020,388740,1178760
260510,202003,778,622,156,651035,163020,814055
260515,202003,246,221,25,230945,26125,257070
260520,202003,3272,2003,1269,2100450,1328195.95,3428645.95
260530,202003,797,660,137,690745,144210,834955
260540,202003,558,436,122,455620,127490,583110
260545,202003,12,9,3,9405,3135,12540
260550,202003,328,204,124,213180,129580,342760
260560,202003,523,393,130,412775.5,135850,548625.5
260570,202003,977,795,182,831820,190190,1022010
260580,202003,242,213,29,224675,31350,256025
260590,202003,636,365,271,381425,285285.5,666710.5
260600,202003,7974,4326,3648,4524852.84,3820520.5,8345373.34
260610,202003,486,323,163,337535,170335,507870
260620,202003,3687,1934,1753,2026256.65,1839201.08,3865457.73
260630,202003,86,81,5,84645,5225,89870
260640,202003,3543,1971,1572,2062830.8,1643785,3706615.8
260650,202003,325,238,87,248710,90915,339625
260660,202003,551,370,181,386650,190190,576840
260670,202003,106,78,28,81510,29260,110770
260680,202003,3704,2070,1634,2171510.22,1711710.5,3883220.72
260690,202003,129,93,36,97185,37620,134805
260700,202003,308,204,104,213180,108680,321860
260710,202003,40,35,5,36575,5225,41800
260720,202003,2397,1422,975,1489126,1024100,2513226
260730,202003,688,516,172,539220,179740,718960
260740,202003,63,58,5,60610,5225,65835
260750,202003,593,428,165,447260,173470,620730
260760,202003,650,343,307,359480.23,321860,681340.23
260765,202003,977,496,481,519365,503690,1023055
260770,202003,222,163,59,171362,61655.5,233017.5
260775,202003,787,444,343,467116.25,359480,826596.25
260780,202003,255,164,91,172425,95095,267520
260790,202003,12949,6775,6174,7094509.72,6475867.28,13570377.00
260795,202003,163,109,54,113905,56430,170335
260800,202003,284,238,46,248710.5,48070,296780.5
260805,202003,169,111,58,115995,60610,176605
260810,202003,744,643,101,672980,105545,778525
260820,202003,286,183,103,191235.85,107635,298870.85
260825,202003,208,148,60,154660,62700,217360
260830,202003,277,174,103,181830,107635,289465
260840,202003,237,177,60,184965,63745,248710
260845,202003,175,121,54,126445,56430,182875
260850,202003,445,329,116,343805,121220,465025
260860,202003,253,190,63,198550,65835,264385
260870,202003,366,277,89,290510,94050,384560
260875,202003,730,520,210,543400,219450,762850
260880,202003,1585,1010,575,1060675,600875,1661550
260890,202003,2376,1678,698,1756646,731500,2488146
260900,202003,976,689,287,722095,299915,1022010
260910,202003,260,204,56,213180,58520,271700
260915,202003,291,213,78,222585,81510,304095
260920,202003,175,95,80,99275,84645,183920
260930,202003,403,344,59,359480,61655,421135
260940,202003,2721,1473,1248,1540331.4,1306251,2846582.4
260950,202003,2015,1153,862,1206975.75,901835,2108810.75
260960,202003,13790,7007,6783,7341133.43,7124812.45,14465945.88
260970,202003,417,349,68,365750,71060,436810
260980,202003,192,172,20,179740,20900,200640
260990,202003,2606,2110,496,2204951.35,519365,2724316.35
261000,202003,4286,2572,1714,2690875.75,1798445,4489320.75
261010,202003,166,125,41,130625,42845,173470
261020,202003,600,451,149,471295.99,156750,628045.99
261030,202003,238,178,60,186010,63745,249755
261040,202003,368,322,46,336490,48070,384560
261050,202003,507,439,68,458755,71060,529815
261060,202003,1385,896,489,937365.25,511005,1448370.25
261070,202003,8735,4359,4376,4567698.15,4582328.12,9150026.27
261080,202003,377,290,87,303050,90915,393965
261090,202003,2209,1692,517,1774414.7,541310.83,2315725.53
261100,202003,1142,801,341,837045.75,356345,1193390.75
261110,202003,8572,5259,3313,5501925.8,3473581.5,8975507.3
261120,202003,258,221,37,230945,38665,269610
261130,202003,582,346,236,361570,249755.55,611325.55
261140,202003,193,122,71,127490,74195,201685
261150,202003,680,419,261,438900.03,272745,711645.03
261153,202003,65,61,4,63745,4180,67925
261160,202003,76013,37838,38175,39620159.32,40018282.11,79638441.43
261170,202003,473,362,111,378290,115995,494285
261180,202003,1796,1121,675,1171445,707465,1878910
261190,202003,622,432,190,453530.9,198550,652080.9
261200,202003,218,186,32,194370,33440,227810
261210,202003,34,28,6,31350,6270,37620
261220,202003,2688,1893,795,1984456.12,831820,2816276.12
261230,202003,343,256,87,267520,90915,358435
261240,202003,462,405,57,423225,59565,482790
261245,202003,230,192,38,200640,39710,240350
261247,202003,171,135,36,141075,37620,178695
261250,202003,3062,1515,1547,1586310.75,1618705,3205015.75
261255,202003,245,223,22,233035,22990,256025
261260,202003,856,744,112,780615.06,118085,898700.06
261270,202003,200,143,57,149435,59565,209000
261280,202003,177,144,33,150480,34485,184965
261290,202003,117,85,32,88825,33440,122265
261300,202003,1287,935,352,978120,369930,1348050
261310,202003,814,549,265,574750,279015,853765
261320,202003,556,377,179,396055,188100,584155
261330,202003,985,752,233,786885,244530.29,1031415.29
261340,202003,291,163,128,170335,133760,304095
261350,202003,847,603,244,632225.5,256025,888250.5
261360,202003,1282,837,445,875710,468160,1343870
261370,202003,4832,2912,1920,3046176.5,2010581,5056757.5
261380,202003,550,418,132,436810.69,137940.5,574751.19
261390,202003,3599,2420,1179,2532035.5,1235190.75,3767226.25
261400,202003,291,264,27,275880,28215,304095
261410,202003,1101,731,370,768075,388740,1156815
261420,202003,869,537,332,561166.05,350075,911241.05
261430,202003,328,297,31,311410,33440,344850
261440,202003,119,110,9,114950,9405,124355
261450,202003,2517,2050,467,2148522.19,490105.5,2638627.69
261460,202003,716,575,141,600875.85,147345,748220.85
261470,202003,247,195,52,203775,54340,258115
261480,202003,443,345,98,360525,102363,462888
261485,202003,345,206,139,216315,145255,361570
261500,202003,598,411,187,430540.86,196460,627000.86
261510,202003,51,34,17,35530,17765,53295
261520,202003,112,100,12,104500,12540,117040
261530,202003,4139,2614,1525,2742081.23,1594670.75,4336751.98
261540,202003,1326,787,539,825550,566390,1391940
261550,202003,269,136,133,142120.5,138985,281105.5
261560,202003,848,560,288,585201.75,300961,886162.75
261570,202003,398,311,87,326040,90915,416955
261580,202003,373,291,82,305140,85690,390830
261590,202003,190,155,35,161975,36575,198550
261600,202003,295,235,60,245575,62700.5,308275.5
261610,202003,92,78,14,81510,14630,96140
261618,202003,76,60,16,62700,16720,79420
261620,202003,207,128,79,133760,82555,216315
261630,202003,560,438,122,457710,127490,585200
261640,202003,6371,3383,2988,3544642.59,3132910.75,6677553.34
261650,202003,482,304,178,317680,186010,503690
270010,202003,521,463,58,483835,60610,544445
270020,202003,286,231,55,241395,57475,298870
270030,202003,8565,5519,3046,5785123.28,3192475.5,8977598.78
270040,202003,1992,1244,748,1304160,782705,2086865
270050,202003,149,112,37,117040,39710,156750
270060,202003,111,61,50,63745,52250,115995
270070,202003,868,635,233,663575,243485,907060
270080,202003,37,30,7,32395,7315,39710
270090,202003,20,15,5,15675,5225,20900
270100,202003,1223,815,408,852720,426360,1279080
270110,202003,123,95,28,99275,29260,128535
270120,202003,225,185,40,193325,41800,235125
270130,202003,250,173,77,181830,80465,262295
270135,202003,115,72,43,76285,44935,121220
270140,202003,1364,860,504,899989.33,527725,1427714.33
270150,202003,254,200,54,209000,57475,266475
270160,202003,507,396,111,413820,117040,530860
270170,202003,797,521,276,545490,290510,836000
270180,202003,69,54,15,57475,15675,73150
270190,202003,91,79,12,82555,12540,95095
270200,202003,102,89,13,93005,13585,106590
270210,202003,498,280,218,292600,227810,520410
270220,202003,176,139,37,145255,38665,183920
270230,202003,2084,1278,806,1336556.6,842270,2178826.6
270235,202003,690,537,153,561165,160930,722095
270240,202003,3040,2407,633,2518451.42,663575.85,3182027.27
270250,202003,157,114,43,119130,44935,164065
270255,202003,209,178,31,187055,32395,219450
270260,202003,360,293,67,307230,71060,378290
270270,202003,95,43,52,44935,54340,99275
270280,202003,236,130,106,135850,111815,247665
270290,202003,1163,888,275,930050,288420,1218470
270300,202003,307,211,96,220495,100320,320815
270310,202003,844,693,151,726275,157795,884070
270320,202003,829,705,124,737770.79,129580,867350.79
270330,202003,283,241,42,251845,43890,295735
270340,202003,60,47,13,49115,13585,62700
270350,202003,90,48,42,50160,43890,94050
270360,202003,62,34,28,35530,29260,64790
270370,202003,52,44,8,45980,8360,54340
270375,202003,73,46,27,48070,28215,76285
270380,202003,999,624,375,657305,397100,1054405
270390,202003,186,111,75,117040,78375,195415
270400,202003,696,514,182,538175.79,190190,728365.79
270410,202003,652,481,171,502645,179740,682385
270420,202003,402,278,124,290510,130625,421135
270430,202003,32614,23425,9189,24519158.53,9624452.9,34143611.43
270440,202003,482,382,100,399190,104500,503690
270450,202003,790,442,348,461890,363660,825550
270460,202003,193,155,38,161975,39710,201685
270470,202003,1424,987,437,1032460,458755,1491215
270480,202003,535,440,95,459800.5,99275,559075.5
270490,202003,24,19,5,19855,5225,25080
270500,202003,485,404,81,423225,84645,507870
270510,202003,793,490,303,512050,317680,829730
270520,202003,291,189,102,197505,108680,306185
270530,202003,66,57,9,59565,9405,68970
270540,202003,108,84,24,88825,25080,113905
270550,202003,1750,1343,407,1407615,425315,1832930
270560,202003,267,140,127,146300,133760,280060
270570,202003,507,358,149,374110,155705,529815
270580,202003,94,70,24,73150,25080,98230
270590,202003,69,54,15,56430,15675,72105
270600,202003,177,146,31,153615,32395,186010
270610,202003,216,175,41,182875,42845,225720
270620,202003,28,27,1,28215,1045,29260
270630,202003,3723,2836,887,2966756,929005.9,3895761.9
270640,202003,874,647,227,677160,237215,914375
270642,202003,218,186,32,194370,35530,229900
270644,202003,246,160,86,167200,89870,257070
270650,202003,317,187,130,196460,135850,332310
270660,202003,248,205,43,214225,44935,259160
270670,202003,3022,2311,711,2419178.55,744040,3163218.55
270680,202003,444,261,183,272745,191235,463980
270690,202003,1153,746,407,779570.95,426360,1205930.95
270700,202003,28,23,5,24035,5225,29260
270710,202003,867,673,194,704330,203775,908105
270720,202003,244,193,51,201685,53295,254980
270730,202003,1847,1112,735,1163085.5,771210.25,1934295.75
270740,202003,40,27,13,28215,13585,41800
270750,202003,624,468,156,489060,164065,653125
270760,202003,291,214,77,224675,80465,305140
270770,202003,2733,1794,939,1876264.21,983345,2859609.21
270780,202003,76,49,27,51205,28215,79420
270790,202003,262,174,88,181830,91960,273790
270800,202003,1966,1579,387,1653190,407550,2060740
270810,202003,279,220,59,229900,61655,291555
270820,202003,144,96,48,101365,50160.5,151525.5
270830,202003,784,583,201,611325,210045,821370
270840,202003,1376,1045,331,1093070,345895.85,1438965.85
270850,202003,1508,934,574,978120.5,601920,1580040.5
270860,202003,2495,1649,846,1726340.46,884070,2610410.46
270870,202003,125,67,58,70015,60610,130625
270880,202003,889,689,200,720005,209000,929005
270890,202003,289,213,76,222585,79420,302005
270895,202003,62,53,9,55385,9405,64790
270900,202003,92,71,21,74195,21945,96140
270910,202003,305,249,56,260205,58520,318725
270915,202003,1909,1196,713,1252816.4,746130.6,1998947.0
270920,202003,467,392,75,409640,78375,488015
270930,202003,5907,4410,1497,4613953.66,1565410.03,6179363.69
270940,202003,2311,1797,514,1883090,539220,2422310
280010,202003,39,33,6,34485,6270,40755
280020,202003,468,406,62,424270.8,64790,489060.8
280030,202003,20229,13087,7142,13697883.87,7475937.48,21173821.35
280040,202003,332,217,115,226765,120175,346940
280050,202003,397,304,93,318725,97185,415910
280060,202003,355,225,130,235125.7,135850,370975.7
280067,202003,1048,754,294,788975.63,307230.62,1096206.25
280070,202003,120,98,22,102410,22990,125400
280100,202003,626,492,134,514140.88,140030,654170.88
280110,202003,75,69,6,72105,6270,78375
280120,202003,634,522,112,545490,117040,662530
280130,202003,1695,1103,592,1152635,619685.5,1772320.5
280140,202003,478,393,85,410685,89870,500555
280150,202003,383,278,105,290510,110770,401280
280160,202003,96,82,14,85690,14630,100320
280170,202003,401,274,127,286330,132715,419045
280190,202003,31,29,2,30305,2090,32395
280200,202003,28,24,4,25080,4180,29260
280210,202003,2915,2100,815,2201692.36,853765.5,3055457.86
280220,202003,38,30,8,31350,8360,39710
280230,202003,327,268,59,280060,61655,341715
280240,202003,115,110,5,114950,5225,120175
280250,202003,16,10,6,10450,6270,16720
280260,202003,83,74,9,77330,9405,86735
280270,202003,145,114,31,119130,32395,151525
280280,202003,191,120,71,125400.37,74195,199595.37
280290,202003,3325,2416,909,2526744.16,953040.1,3479784.26
280300,202003,1592,1240,352,1296845.5,367840,1664685.5
280310,202003,99,95,4,99275.5,4180,103455.5
280320,202003,664,464,200,484880,209000,693880
280330,202003,333,239,94,250800,98230,349030
280340,202003,398,324,74,339625,77330,416955
280350,202003,3639,2831,808,2960487.26,845405.75,3805893.01
280360,202003,457,302,155,316635,161975,478610
280370,202003,97,86,11,89870.63,11495,101365.63
280380,202003,54,42,12,43890,12540,56430
280390,202003,169,146,23,154660,24035,178695
280400,202003,356,243,113,254981.4,118085,373066.4
280410,202003,286,234,52,245575,54340,299915
280420,202003,171,143,28,149435,29260,178695
280430,202003,35,26,9,27170,9405,36575
280440,202003,691,541,150,565345.65,157795,723140.65
280445,202003,116,107,9,111815,9405,121220
280450,202003,1188,1025,163,1071125,170335,1241460
280460,202003,617,451,166,472341.63,173470,645811.63
280470,202003,187,173,14,180785,14630.75,195415.75
280480,202003,2575,1807,768,1890408.21,802560.32,2692968.53
280490,202003,268,253,15,264385.66,15675,280060.66
280500,202003,41,37,4,38665,4180,42845
280510,202003,141,114,27,119130,28215.5,147345.5
280520,202003,54,40,14,41800,14630,56430
280530,202003,71,46,25,48070,26125,74195
280540,202003,528,441,87,461890,91960,553850
280550,202003,721,667,54,698061.71,56430,754491.71
280560,202003,494,435,59,457710,61655,519365
280570,202003,2207,1727,480,1807851.45,501600,2309451.45
280580,202003,598,464,134,485925,141075.5,627000.5
280590,202003,197,121,76,126445,79420,205865
280600,202003,386,324,62,340670,64790,405460
280610,202003,117,89,28,93005,29260,122265
280620,202003,548,452,96,472340,101365,573705
280630,202003,146,121,25,126445,26125,152570
280640,202003,190,152,38,158840,39710,198550
280650,202003,89,61,28,63745,29260,93005
280660,202003,141,107,34,112860,35530,148390
280670,202003,1803,1138,665,1191303.83,695970.3,1887274.13
280680,202003,174,151,23,157795.22,24035,181830.22
280690,202003,79,70,9,74195,9405,83600
280700,202003,22,22,0,22990,0,22990
280710,202003,1463,1127,336,1178760,351120,1529880
280720,202003,112,71,41,74195,42845,117040
280730,202003,25,20,5,20900,5225,26125
280740,202003,2519,1881,638,1967735.5,666710,2634445.5
280750,202003,228,201,27,211090,29260,240350
280760,202003,766,526,240,549670,250800,800470
290010,202003,201,141,60,147345,62700,210045
290020,202003,181,163,18,170335,18810,189145
290030,202003,621,401,220,419045,231990,651035
290035,202003,129,104,25,108680,26125,134805
290040,202003,303,204,99,213180,104500,317680
290050,202003,86,66,20,68970,20900,89870
290060,202003,261,120,141,125400,147345,272745
290070,202003,5710,2773,2937,2899876.1,3074390.75,5974266.85
290080,202003,463,209,254,218405,265430,483835
290090,202003,387,174,213,182875,222585,405460
290100,202003,1631,1063,568,1111880,593561,1705441
290110,202003,822,481,341,502645.75,357390,860035.75
290115,202003,197,182,15,191235,15675,206910
290120,202003,759,500,259,522500.29,270655,793155.29
290130,202003,427,262,165,273790,172425,446215
290135,202003,297,225,72,235125,75240,310365
290140,202003,317,261,56,272745,58520,331265
290150,202003,136,99,37,103455,38665,142120
290160,202003,240,184,56,193325,58520,251845
290170,202003,92,66,26,68970,27170,96140
290180,202003,177,131,46,136895,48070,184965
290190,202003,435,355,80,370975,83600,454575
290195,202003,318,204,114,213180,119130,332310
290200,202003,269,218,51,227810,54340,282150
290205,202003,149,91,58,95095,60610,155705
290210,202003,1156,854,302,893475.5,316635,1210110.5
290220,202003,220,123,97,129580,101365,230945
290225,202003,290,112,178,117040,186010,303050
290230,202003,73,48,25,50160,26125,76285
290240,202003,346,132,214,140030,223630,363660
290250,202003,256,236,20,246620,20900,267520
290260,202003,314,259,55,271700.5,57475,329175.5
290265,202003,188,162,26,169290,27170,196460
290270,202003,1420,1179,241,1235190.25,251845.5,1487035.75
290280,202003,476,338,138,353210,144210,497420
290290,202003,1292,766,526,801516.03,549670.5,1351186.53
290300,202003,439,374,65,390830.5,67925,458755.5
290310,202003,298,136,162,142120,169290,311410
290320,202003,4038,2505,1533,2621905.3,1606165.1,4228070.4
290323,202003,190,165,25,172425,26125,198550
290327,202003,162,129,33,134805,34485,169290
290330,202003,98,54,44,57475,45980,103455
290340,202003,841,346,495,362615,519365,881980
290350,202003,612,372,240,389785,250800,640585
290360,202003,354,276,78,288421.64,82555,370976.64
290370,202003,915,391,524,408595.75,549670,958265.75
290380,202003,314,196,118,205865,125400,331265
290390,202003,2441,1529,912,1601986.75,955130,2557116.75
290395,202003,249,144,105,151525.25,109725,261250.25
290400,202003,274,203,71,212135.5,75240,287375.5
290405,202003,247,213,34,222585,35530,258115
290410,202003,628,526,102,550715.53,107635,658350.53
290420,202003,253,204,49,214225,51205,265430
290430,202003,476,306,170,319770,177650,497420
290440,202003,75,67,8,71060,8360,79420
290450,202003,207,160,47,168245,49115,217360
290460,202003,1934,1168,766,1221605,800470,2022075
290470,202003,1414,605,809,633270,846450,1479720
290475,202003,562,525,37,548625.2,38665,587290.2
290480,202003,287,160,127,167200,132715,299915
290485,202003,241,222,19,233035,19855,252890
290490,202003,1210,871,339,911240,354255,1265495
290500,202003,726,376,350,392920,365750,758670
290510,202003,225,174,51,181830,53295,235125
290515,202003,147,91,56,96140,58520,154660
290520,202003,1418,943,475,989615.5,497421.44,1487036.94
290530,202003,300,277,23,289465,24035,313500
290540,202003,106,57,49,59565,51205,110770
290550,202003,158,133,25,138985,26125,165110
290560,202003,3206,1355,1851,1415975.5,1935340,3351315.5
290570,202003,6139,3002,3137,3143361.4,3283391.5,6426752.9
290580,202003,1284,768,516,802560,540265,1342825
290590,202003,565,468,97,490105,102410,592515
290600,202003,1753,1207,546,1263405.63,570570,1833975.63
290610,202003,208,187,21,195415,21945,217360
290620,202003,354,314,40,328130,41800,369930
290630,202003,2018,860,1158,898700,1213245.5,2111945.5
290640,202003,149,120,29,127490,30305,157795
290650,202003,1740,806,934,843315.84,978120,1821435.84
290660,202003,276,223,53,233035,55385,288420
290670,202003,926,482,444,503691.21,467115,970806.21
290680,202003,1235,988,247,1034550,258115,1292665
290682,202003,306,230,76,240350.8,79420,319770.8
290685,202003,236,154,82,160930,85690,246620
290687,202003,1032,664,368,695095.1,384560,1079655.1
290689,202003,139,75,64,79420,66880,146300
290690,202003,609,256,353,269610,369930,639540
290700,202003,248,122,126,127490,131670,259160
290710,202003,734,501,233,523545,243485,767030
290720,202003,1022,829,193,868395,201685,1070080
290730,202003,1159,667,492,698060.75,515185,1213245.75
290740,202003,16,14,2,14630,2090,16720
290750,202003,1420,627,793,656260,829731.54,1485991.54
290755,202003,72,65,7,67925,7315,75240
290760,202003,300,261,39,272745,40755,313500
290770,202003,186,175,11,182875,11495.5,194370.5
290780,202003,1102,840,262,879891,273790,1153681
290790,202003,363,255,108,266475,113905.5,380380.5
290800,202003,2522,1017,1505,1065900.5,1578995,2644895.5
290810,202003,467,323,144,338580,150480,489060
290820,202003,398,232,166,242440,173470,415910
290830,202003,414,296,118,310365,123310,433675
290840,202003,1739,1087,652,1136961.7,682385.5,1819347.2
290850,202003,828,445,383,465025,402325,867350
290860,202003,638,291,347,304095,363660.5,667755.5
290870,202003,640,455,185,476520.6,194370.6,670891.2
290880,202003,122,66,56,68970,58520,127490
290890,202003,387,263,124,274835,129580,404415
290900,202003,163,126,37,132715,38665,171380
290910,202003,379,292,87,305140,90915,396055
290920,202003,213,183,30,192280,31350,223630
290930,202003,821,622,199,654170.5,207955,862125.5
290940,202003,248,205,43,214225,44935,259160
290950,202003,153,93,60,97185,62700,159885
290960,202003,471,329,142,343805,148390,492195
290970,202003,253,222,31,231990,32395,264385
290980,202003,1615,1141,474,1192345.7,495331,1687676.7
290990,202003,393,331,62,345895,64790,410685
291000,202003,864,250,614,261250,641630,902880
291005,202003,2299,1022,1277,1067990.5,1338645,2406635.5
291010,202003,154,141,13,147345,13585,160930
291020,202003,101,80,21,83600,21945,105545
291030,202003,95,70,25,73150,26125,99275
291040,202003,602,333,269,347985,281105,629090
291050,202003,1418,781,637,818235,666710,1484945
291060,202003,1525,843,682,880935,714780,1595715
291070,202003,1967,1460,507,1525701,531905.12,2057606.12
291072,202003,7242,2700,4542,2829861.1,4754752,7584613.1
291075,202003,235,192,43,201685,45980,247665
291077,202003,55,37,18,38665,18810,57475
291080,202003,20214,8872,11342,9285873.06,11880607.27,21166480.33
291085,202003,296,242,54,252890,56430,309320
291090,202003,301,123,178,128535.5,186010,314545.5
291100,202003,656,197,459,205865,480700,686565
291110,202003,419,320,99,336490,103455,439945
291120,202003,2423,1199,1224,1252955.75,1282215,2535170.75
291125,202003,65,31,34,32395,35530,67925
291130,202003,203,180,23,189145,24035,213180
291140,202003,139,112,27,117040,28215.5,145255.5
291150,202003,383,147,236,154660,246620,401280
291160,202003,387,317,70,331265.25,73150,404415.25
291165,202003,38,30,8,31350,8360,39710
291170,202003,3107,1557,1550,1627067.42,1621840.5,3248907.92
291180,202003,1268,505,763,528770.31,798380,1327150.31
291185,202003,89,84,5,87780,5225,93005
291190,202003,1362,603,759,631180.25,794200,1425380.25
291200,202003,166,124,42,129580,43890,173470
291210,202003,2276,909,1367,950950.2,1431650.5,2382600.7
291220,202003,273,207,66,217360,68970,286330
291230,202003,990,347,643,363660.5,672980,1036640.5
291240,202003,426,399,27,418000.5,28215,446215.5
291250,202003,445,361,84,377245,87780,465025
291260,202003,55,45,10,47025,11495,58520
291270,202003,1160,485,675,507870,705375,1213245
291280,202003,363,173,190,180785,199595,380380
291290,202003,1734,892,842,934230.5,884070.5,1818301.0
291300,202003,232,184,48,192280,50160,242440
291310,202003,220,200,20,209000,20900,229900
291320,202003,1366,963,403,1006335,421135,1427470
291330,202003,129,110,19,114950,19855,134805
291340,202003,203,115,88,122265,91960,214225
291345,202003,135,94,41,98230,42845,141075
291350,202003,1638,576,1062,601920,1110835.75,1712755.75
291360,202003,8471,4105,4366,4297041.25,4578146.25,8875187.50
291370,202003,1125,638,487,667755.5,508915,1176670.5
291380,202003,262,208,54,217360,56430,273790
291390,202003,3899,1719,2180,1797401.6,2280191,4077592.6
291400,202003,2086,1483,603,1553915,630135.84,2184050.84
291410,202003,186,164,22,171380,22990,194370
291420,202003,119,87,32,90915,33440,124355
291430,202003,163,89,74,93005,77330.02,170335.02
291440,202003,517,424,93,443081,98230,541311
291450,202003,910,581,329,608190.25,343805,951995.25
291460,202003,1828,1494,334,1561231.5,351120.5,1912352.0
291465,202003,2176,1030,1146,1077395.5,1199660,2277055.5
291470,202003,2845,1436,1409,1501666.93,1475540.5,2977207.43
291480,202003,11872,5269,6603,5515515.17,6916860.21,12432375.38
291490,202003,600,243,357,253935,373065,627000
291500,202003,374,216,158,226765,165110,391875
291510,202003,1230,479,751,501600,785840,1287440
291520,202003,938,427,511,446215,533995,980210
291530,202003,944,255,689,266475,722095,988570
291535,202003,125,103,22,107635,22990,130625
291540,202003,343,102,241,106590.5,251845,358435.5
291550,202003,1231,577,654,604010,684475.5,1288485.5
291560,202003,5271,2661,2610,2787015,2731631,5518646
291570,202003,197,103,94,107635,98230,205865
291580,202003,1208,746,462,779570.05,483835,1263405.05
291590,202003,86,35,51,36575,53295.5,89870.5
291600,202003,1144,567,577,592515,602965,1195480
291610,202003,1452,711,741,742995,774345,1517340
291620,202003,577,268,309,281105,322905,604010
291630,202003,485,149,336,156750,351120,507870
291640,202003,3939,2008,1931,2100452.2,2018941.5,4119393.7
291650,202003,420,290,130,303051.12,135850,438901.12
291660,202003,398,158,240,166155.29,250800,416955.29
291670,202003,223,134,89,140030,93005,233035
291680,202003,662,393,269,410685,281105.5,691790.5
291685,202003,590,329,261,343805,272745,616550
291690,202003,541,322,219,336490,229900.27,566390.27
291700,202003,972,757,215,793155,225720.5,1018875.5
291710,202003,1654,792,862,828685.25,900790,1729475.25
291720,202003,421,279,142,292600,148390,440990
291730,202003,942,554,388,578930,405460,984390
291733,202003,283,192,91,200640,95095,295735
291735,202003,75,56,19,58520,19855,78375
291740,202003,355,275,80,288420,83600,372020
291750,202003,2126,1384,742,1448370.38,776435,2224805.38
291760,202003,2992,1646,1346,1724250,1407615,3131865
291770,202003,787,533,254,558031.05,266475,824506.05
291780,202003,58,36,22,37620,24035,61655
291790,202003,161,80,81,84645,84645,169290
291800,202003,10050,4146,5904,4338842.59,6182221.75,10521064.34
291810,202003,1099,820,279,857945.5,291555,1149500.5
291820,202003,277,199,78,207955,81510,289465
291830,202003,1077,431,646,452486.46,676115,1128601.46
291835,202003,577,535,42,560120,43890,604010
291840,202003,4838,2452,2386,2564431.21,2498596,5063027.21
291845,202003,268,88,180,91960,188100,280060
291850,202003,325,288,37,300960,39710,340670
291855,202003,263,102,161,106590,168245,274835
291860,202003,170,108,62,112860,64790,177650
291870,202003,85,35,50,36575,52250,88825
291875,202003,180,167,13,174515,13585,188100
291880,202003,458,364,94,380380,98230,478610
291890,202003,241,77,164,80465,171380.5,251845.5
291900,202003,58,32,26,33440,27170,60610
291905,202003,128,94,34,98230.5,35530,133760.5
291910,202003,165,134,31,140030,32395,172425
291915,202003,426,378,48,395010.25,51205,446215.25
291920,202003,5045,2558,2487,2675200,2602050.5,5277250.5
291930,202003,171,103,68,107635.55,71060,178695.55
291940,202003,356,203,153,212135.5,159885,372020.5
291950,202003,1143,922,221,963491,230945.5,1194436.5
291955,202003,1242,739,503,773300,526680,1299980
291960,202003,191,138,53,144210,55385,199595
291970,202003,758,580,178,606100,186010,792110
291980,202003,1500,1329,171,1392986.23,178695.5,1571681.73
291990,202003,133,124,9,129580,9405,138985
291992,202003,170,88,82,93005,85690,178695
291995,202003,168,111,57,115995,59565,175560
292000,202003,395,305,90,318725,94050,412775
292010,202003,307,216,91,226765,95095,321860
292020,202003,298,221,77,230945,82555,313500
292030,202003,145,113,32,118085,33440,151525
292040,202003,635,320,315,334400,329175,663575
292045,202003,104,96,8,100320,8360,108680
292050,202003,937,685,252,718960,264385.5,983345.5
292060,202003,906,749,157,784795.65,164065,948860.65
292070,202003,56,21,35,21945,36575,58520
292080,202003,141,97,44,101365,45980,147345
292090,202003,528,185,343,193325,359480,552805
292100,202003,1479,634,845,663575,884070,1547645
292105,202003,192,169,23,176605,24035,200640
292110,202003,2259,831,1428,868395,1493305,2361700
292120,202003,695,548,147,572660,153615,726275
292130,202003,436,248,188,260205,197505,457710
292140,202003,208,168,40,175560,41800,217360
292145,202003,160,87,73,90915.5,76285,167200.5
292150,202003,1479,1204,275,1259225,287375,1546600
292160,202003,172,140,32,146300,33440,179740
292170,202003,1208,1049,159,1098295,168245,1266540
292180,202003,217,157,60,164065,62700,226765
292190,202003,160,103,57,107635,61655,169290
292200,202003,1332,490,842,512050,880935.5,1392985.5
292205,202003,127,113,14,118085,14630,132715
292210,202003,362,254,108,266475,112860.25,379335.25
292220,202003,27,21,6,21945,6270,28215
292225,202003,39,34,5,35530,5225,40755
292230,202003,966,771,195,806740.75,204820,1011560.75
292240,202003,616,441,175,461890.75,182875,644765.75
292250,202003,1740,1147,593,1198615,621775.38,1820390.38
292260,202003,410,246,164,257070,171380,428450
292265,202003,252,179,73,187055,76285,263340
292270,202003,732,336,396,351120,413820,764940
292273,202003,196,110,86,114950,89870,204820
292275,202003,172,84,88,87780,91960,179740
292280,202003,140,97,43,101365,44935,146300
292285,202003,74,62,12,64790,12540,77330
292290,202003,570,386,184,403370,193325.5,596695.5
292300,202003,1670,629,1041,657305,1087845.3,1745150.3
292303,202003,109,71,38,74195,39710,113905
292305,202003,112,83,29,86735,30305,117040
292310,202003,922,607,315,634316.6,329175.9,963492.5
292320,202003,602,458,144,478610,151525,630135
292330,202003,173,100,73,104500,76285,180785
292335,202003,278,216,62,226765,64790,291555
292340,202003,571,400,171,419045.5,179740,598785.5
292350,202003,269,144,125,150480,130625,281105
292360,202003,709,541,168,565345.9,176605,741950.9
292370,202003,738,568,170,594605,179740,774345
292380,202003,642,516,126,540265.35,132715,672980.35
292390,202003,482,188,294,196460,308275,504735
292400,202003,3595,2214,1381,2314678.11,1444190.5,3758868.61
292405,202003,261,172,89,179740,93005,272745
292410,202003,143,87,56,90915,58520,149435
292420,202003,294,254,40,265430,41800,307230
292430,202003,534,408,126,428450,131670,560120
292440,202003,588,510,78,532950.16,81510,614460.16
292450,202003,252,196,56,204820,58520,263340
292460,202003,555,412,143,430540.95,149435,579975.95
292465,202003,212,177,35,186010,36575,222585
292467,202003,118,72,46,75240,48070,123310
292470,202003,287,196,91,204820,95095,299915
292480,202003,367,251,116,262295,121220.5,383515.5
292490,202003,234,164,70,172425,73150,245575
292500,202003,871,388,483,405460.15,504735,910195.15
292510,202003,3432,1594,1838,1666775.6,1923845,3590620.6
292520,202003,1078,510,568,533995,595650,1129645
292525,202003,397,277,120,289465,125400,414865
292530,202003,4315,1745,2570,1827705.96,2692967,4520672.96
292540,202003,468,263,205,274835,214225,489060
292550,202003,1078,576,502,601920,525635,1127555
292560,202003,329,309,20,322905,20900,343805
292570,202003,304,239,65,249755,70015,319770
292575,202003,493,323,170,340670.5,177650.5,518321.0
292580,202003,985,650,335,681340,350075.5,1031415.5
292590,202003,565,489,76,514140,79420,593560
292593,202003,143,114,29,119130,30305,149435
292595,202003,198,155,43,161975,44935,206910
292600,202003,1259,916,343,957220.29,358435,1315655.29
292610,202003,136,105,31,109725,32395,142120
292620,202003,523,442,81,463980.5,84645,548625.5
292630,202003,1414,799,615,834955.42,643720.25,1478675.67
292640,202003,806,553,253,578930,264385,843315
292650,202003,187,154,33,160930.5,34485,195415.5
292660,202003,2019,1452,567,1518385,592515.42,2110900.42
292665,202003,141,99,42,104500,43890,148390
292670,202003,387,314,73,328130,76285,404415
292680,202003,250,190,60,198550,62700.5,261250.5
292690,202003,192,142,50,148390,52250,200640
292700,202003,961,635,326,663575,341715,1005290
292710,202003,112,98,14,102410,14630,117040
292720,202003,917,525,392,550715,409640,960355
292730,202003,195,90,105,94050,109725,203775
292740,202003,68041,33385,34656,34970944.58,36325254.83,71296199.41
292750,202003,386,276,110,288420.95,115995,404415.95
292760,202003,329,275,54,287376.45,56430,343806.45
292770,202003,798,344,454,359480.5,475475,834955.5
292780,202003,405,159,246,166155,258115,424270
292790,202003,767,392,375,409640,391875,801515
292800,202003,1246,751,495,784795,518320,1303115
292805,202003,397,117,280,122265,293645,415910
292810,202003,1492,846,646,885116.5,676115,1561231.5
292820,202003,717,593,124,619686.62,130625,750311.62
292830,202003,110,91,19,95095,19855,114950
292840,202003,687,564,123,589380,128535,717915
292850,202003,140,93,47,97185,49115,146300
292860,202003,2177,1270,907,1329240.5,951995,2281235.5
292870,202003,3458,2312,1146,2419175.45,1197570.5,3616745.95
292880,202003,1494,982,512,1028280.05,535040,1563320.05
292890,202003,519,443,76,465025,80465,545490
292895,202003,141,93,48,97185,50160,147345
292900,202003,391,279,112,292600.4,117040,409640.4
292905,202003,470,241,229,251845,240350,492195
292910,202003,452,340,112,355300.75,117040,472340.75
292920,202003,521,228,293,238260,306185,544445
292925,202003,483,445,38,466070,39710,505780
292930,202003,603,367,236,383515,248710,632225
292935,202003,283,122,161,127490,169290,296780
292937,202003,225,160,65,167200,68970,236170
292940,202003,192,148,44,154660,45980,200640
292950,202003,1160,584,576,612370.75,604010.6,1216381.35
292960,202003,582,414,168,433675,176605,610280
292970,202003,248,175,73,182875,76285,259160
292975,202003,121,68,53,71060,55385,126445
292980,202003,282,189,93,197505.52,97185,294690.52
292990,202003,1333,990,343,1035597.3,359480,1395077.3
293000,202003,110,76,34,79420,35530,114950
293010,202003,2797,1673,1124,1751420.75,1174580.72,2926001.47
293015,202003,641,521,120,544445,125400,669845
293020,202003,327,266,61,277970,63745,341715
293030,202003,593,518,75,541310,78375,619685
293040,202003,351,279,72,293645,75240,368885
293050,202003,2847,1693,1154,1772320.5,1208020.5,2980341.0
293060,202003,258,208,50,217360.6,52250,269610.6
293070,202003,3445,1750,1695,1833977.22,1776501.75,3610478.97
293075,202003,91,61,30,63745,31350,95095
293076,202003,74,53,21,55385,21945,77330
293077,202003,503,297,206,310365.5,215270,525635.5
293080,202003,434,389,45,408595.85,47025,455620.85
293090,202003,131,116,15,121220,15675,136895
293100,202003,520,366,154,384560,163020,547580
293105,202003,342,246,96,257070,100320,357390
293110,202003,167,119,48,125400,50160,175560
293120,202003,315,214,101,223630,105545,329175
293130,202003,241,168,73,175560,76285,251845
293135,202003,8007,3154,4853,3302201.75,5074524.5,8376726.25
293140,202003,208,134,74,141075,77330,218405
293150,202003,328,284,44,296780,47025,343805
293160,202003,419,244,175,256025,182875,438900
293170,202003,174,122,52,127490,54340,181830
293180,202003,494,354,140,369930.5,146300,516230.5
293190,202003,1335,929,406,970805.61,424270,1395075.61
293200,202003,546,485,61,507870,63745,571615
293210,202003,391,300,91,313500,95095,408595
293220,202003,2504,1055,1449,1102475,1517340,2619815
293230,202003,1718,635,1083,663575.94,1131735,1795310.94
293240,202003,231,213,18,222585,18810,241395
293245,202003,126,107,19,111815,19855,131670
293250,202003,716,258,458,270655.9,480700,751355.9
293260,202003,300,250,50,261250,52250,313500
293270,202003,1160,540,620,565345.65,648945,1214290.65
293280,202003,264,144,120,150480,125400,275880
293290,202003,3027,1978,1049,2069100,1099340,3168440
293300,202003,729,520,209,543400.75,218405,761805.75
293305,202003,188,151,37,157795,38665,196460
293310,202003,149,112,37,117040,38665,155705
293315,202003,164,128,36,133760,37620,171380
293317,202003,91,65,26,67925,27170,95095
293320,202003,1037,580,457,606100.75,477565,1083665.75
293325,202003,183,68,115,71060,120175,191235
293330,202003,13478,6318,7160,6614853.76,7493698.75,14108552.51
293340,202003,263,187,76,195415,79420,274835
293345,202003,245,200,45,209000,47025,256025
293350,202003,614,353,261,368885.25,272745,641630.25
293360,202003,1526,1096,430,1149500,450395,1599895
310010,202003,136,75,61,78375,63745.5,142120.5
310020,202003,1015,566,449,591470,471295,1062765
310030,202003,334,267,67,279015,70015,349030
310040,202003,41,29,12,30305,12540,42845
310050,202003,184,116,68,121220.32,71060,192280.32
310060,202003,240,165,75,173470.5,78375,251845.5
310070,202003,15,9,6,9405,6270,15675
310080,202003,42,25,17,26125,17765,43890
310090,202003,1009,530,479,553852,502646,1056498
310100,202003,296,221,75,230945,79420,310365
310110,202003,705,386,319,404415,335445,739860
310120,202003,367,213,154,222585,161975,384560
310130,202003,30,19,11,19855,11495,31350
310140,202003,26,13,13,13585,13585,27170
310150,202003,1214,828,386,867350.5,404416,1271766.5
310160,202003,2056,1016,1040,1061721.25,1090980.5,2152701.75
310163,202003,88,51,37,53295,38665,91960
310170,202003,2546,1129,1417,1180851.35,1485992.5,2666843.85
310180,202003,143,54,89,56430.5,93005,149435.5
310190,202003,477,332,145,347985,151525,499510
310200,202003,487,311,176,324995,184965,509960
310205,202003,53,37,16,38665,16720,55385
310210,202003,283,228,55,238260,57475,295735
310220,202003,62,35,27,36575,28215,64790
310230,202003,274,189,85,197505,88825,286330
310240,202003,105,94,11,98230,11495,109725
310250,202003,93,78,15,81510,16720,98230
310260,202003,770,409,361,429496.17,378290,807786.17
310270,202003,268,174,94,182875.6,98230,281105.6
310280,202003,375,277,98,290510,102410,392920
310285,202003,210,153,57,159885,59565,219450
310290,202003,245,133,112,140030,117040,257070
310300,202003,158,130,28,136895,29260,166155
310310,202003,10,8,2,8360,2090,10450
310320,202003,30,13,17,13585,17765,31350
310330,202003,38,25,13,26125,13585,39710
310340,202003,1745,1152,593,1206977,620730.5,1827707.5
310350,202003,2797,1501,1296,1572725,1357455,2930180
310360,202003,40,34,6,35530,6270,41800
310370,202003,115,95,20,100320,20900.5,121220.5
310375,202003,104,38,66,39710,68970,108680
310380,202003,47,26,21,27170,21945,49115
310390,202003,91,62,29,64790,30305,95095
310400,202003,2367,1531,836,1603031,876755,2479786
310410,202003,129,72,57,75240,59565,134805
310420,202003,677,357,320,373065,335445,708510
310430,202003,308,197,111,207955,115995,323950
310440,202003,77,45,32,47025,33440,80465
310445,202003,80,67,13,70015,13585,83600
310450,202003,634,389,245,406505,257070,663575
310460,202003,260,183,77,192280,80465,272745
310470,202003,500,316,184,331265,193325,524590
310480,202003,74,52,22,54340,22990,77330
310490,202003,542,257,285,268565,297825,566390
310500,202003,131,53,78,55385,81510,136895
310510,202003,602,414,188,434720,196460,631180
310520,202003,132,91,41,95095,42845,137940
310530,202003,103,44,59,45980,61655,107635
310540,202003,457,269,188,281105,196460,477565
310550,202003,80,51,29,53295,30305,83600
310560,202003,2974,2051,923,2150611,970805,3121416
310570,202003,102,68,34,71060,35530,106590
310590,202003,368,235,133,245575.25,138985,384560.25
310600,202003,149,82,67,85690.5,70015,155705.5
310610,202003,60,23,37,24035,38665,62700
310620,202003,46944,22421,24523,23477952.08,25707008.02,49184960.10
310630,202003,635,396,239,416955,249755.5,666710.5
310640,202003,127,98,29,102410,30305,132715
310650,202003,162,145,17,151525,17765,169290
310660,202003,99,63,36,65835,37620,103455
310665,202003,59,44,15,45980,15675,61655
310670,202003,6638,2888,3750,3024232.9,3934426,6958658.9
310680,202003,56,35,21,36575,21945,58520
310690,202003,607,426,181,445170.25,189145,634315.25
310700,202003,58,39,19,40755,19855,60610
310710,202003,1309,896,413,937365.5,433675.5,1371041.0
310720,202003,123,35,88,36575,91960,128535
310730,202003,1428,992,436,1038731.25,456665.5,1495396.75
310740,202003,982,546,436,572661,455620.25,1028281.25
310750,202003,242,145,97,151525.65,102410,253935.65
310760,202003,61,43,18,44935,18810.5,63745.5
310770,202003,103,48,55,50160,57475,107635
310780,202003,365,296,69,311410,72105,383515
310790,202003,100,81,19,84645,19855,104500
310800,202003,448,213,235,222585.25,245575,468160.25
310810,202003,172,123,49,128535.72,51205,179740.72
310820,202003,343,271,72,283195,75240,358435
310825,202003,193,165,28,172425,29260,201685
310830,202003,472,226,246,237215.5,258115,495330.5
310840,202003,363,212,151,223630,158840,382470
310850,202003,104,83,21,86735,21945,108680
310855,202003,396,312,84,327085,87780,414865
310860,202003,1596,1179,417,1232058,435766.25,1667824.25
310870,202003,53,43,10,44935,10450,55385
310880,202003,80,63,17,65835,17765,83600
310890,202003,303,178,125,186010,131670,317680
310900,202003,652,303,349,316644.86,364717.96,681362.82
310910,202003,237,161,76,168245.5,80465,248710.5
310920,202003,456,272,184,284241.45,192280.5,476521.95
310925,202003,37,31,6,32395,6270,38665
310930,202003,1310,822,488,861080,514140,1375220
310940,202003,692,347,345,362615,361570,724185
310945,202003,122,76,46,79420,48070,127490
310950,202003,238,192,46,201685,48070,249755
310960,202003,77,25,52,26125,54340,80465
310970,202003,160,100,60,104500,62700.5,167200.5
310980,202003,49,31,18,32395,18810,51205
310990,202003,160,81,79,84645,82555,167200
311000,202003,800,398,402,415911.49,422180.5,838091.99
311010,202003,43,38,5,39710,5225,44935
311020,202003,45,27,18,28215,18810,47025
311030,202003,383,225,158,236170.5,165110,401280.5
311040,202003,44,33,11,34485,11495,45980
311050,202003,491,194,297,202730,310365,513095
311060,202003,788,436,352,456665,368885.5,825550.5
311070,202003,342,156,186,163020,194370,357390
311080,202003,108,60,48,62700,50160,112860
311090,202003,338,159,179,167200,188100,355300
311100,202003,595,359,236,375155,247665,622820
311110,202003,692,482,210,505780,220495,726275
311115,202003,77,55,22,57475,22990,80465
311120,202003,1081,575,506,601920.5,529815,1131735.5
311130,202003,357,216,141,227810,148390,376200
311140,202003,167,91,76,95095,80465,175560
311150,202003,352,229,123,240350,128535,368885
311160,202003,693,493,200,515185.5,209000,724185.5
311170,202003,85,68,17,71060,17765,88825
311180,202003,322,219,103,229900,107635.5,337535.5
311190,202003,41,20,21,20900,21945,42845
311200,202003,328,229,99,239305,103455,342760
311205,202003,34,23,11,24035,11495,35530
311210,202003,46,41,5,42845.5,5225,48070.5
311220,202003,22,19,3,19855,3135,22990
311230,202003,1633,1072,561,1121285.5,587290,1708575.5
311240,202003,181,117,64,122265,66880,189145
311250,202003,94,27,67,29260,70015,99275
311260,202003,553,348,205,363660,216315,579975
311265,202003,121,82,39,85690,41800,127490
311270,202003,282,193,89,201685,94050,295735
311280,202003,215,99,116,103455,122265,225720
311290,202003,103,85,18,88825,18810,107635
311300,202003,582,368,214,384560,224675,609235
311310,202003,22,17,5,17765,5225,22990
311320,202003,658,487,171,509960,182875,692835
311330,202003,1092,807,285,845405,298870.5,1144275.5
311340,202003,2629,1858,771,1945791,807785,2753576
311350,202003,277,215,62,224675,64790,289465
311360,202003,171,106,65,110770,67925,178695
311370,202003,1210,497,713,519365.25,746130,1265495.25
311380,202003,7,6,1,6270,1045,7315
311390,202003,259,141,118,147345,124355,271700
311400,202003,137,88,49,91960,51205,143165
311410,202003,107,58,49,60610,51205,111815
311420,202003,304,166,138,174515,146300,320815
311430,202003,846,567,279,593560,297825.5,891385.5
311440,202003,460,326,134,343805,142120,485925
311450,202003,316,193,123,202730,128535,331265
311455,202003,277,190,87,200640,93005,293645
311460,202003,141,61,80,63745,84645,148390
311470,202003,22,12,10,12540,10450,22990
311480,202003,48,22,26,22990,27170,50160
311490,202003,13,9,4,9405,4180,13585
311500,202003,24,11,13,11495,13585,25080
311510,202003,636,437,199,457710,207955,665665
311520,202003,41,33,8,34485,8360,42845
311530,202003,1796,1328,468,1389851.7,490105,1879956.7
311535,202003,67,48,19,50160,19855,70015
311540,202003,34,30,4,31350,4180,35530
311545,202003,178,134,44,140030,45980,186010
311547,202003,39,32,7,33440,7315,40755
311550,202003,692,324,368,338580,384560,723140
311560,202003,43,29,14,30305,14630,44935
311570,202003,283,192,91,201685,95095,296780
311580,202003,332,199,133,207955,138985,346940
311590,202003,33,30,3,31350,3135,34485
311600,202003,104,80,24,83600,25080,108680
311610,202003,252,217,35,226765.25,36575,263340.25
311615,202003,73,59,14,61655,14630,76285
311620,202003,26,14,12,14630,12540,27170
311630,202003,83,69,14,72105,14630,86735
311640,202003,133,65,68,67925,71060,138985
311650,202003,124,87,37,90915,39710,130625
311660,202003,405,199,206,207955,218405,426360
311670,202003,150,101,49,105545.66,52250,157795.66
311680,202003,207,153,54,159885,56430,216315
311690,202003,15,11,4,11495,4180,15675
311700,202003,197,138,59,144210,61655,205865
311710,202003,201,132,69,137940,72105,210045
311720,202003,40,29,11,30305.5,11495,41800.5
311730,202003,579,388,191,406505,199595,606100
311740,202003,35,25,10,26125,10450,36575
311750,202003,721,486,235,507870.76,248710,756580.76
311760,202003,63,29,34,31350,35530,66880
311770,202003,397,199,198,207956.35,206910,414866.35
311780,202003,177,93,84,97185.5,88825,186010.5
311783,202003,85,76,9,80465,9405,89870
311787,202003,37,14,23,14630,24035,38665
311790,202003,262,115,147,121220,153615,274835
311800,202003,678,448,230,470250.95,240350,710600.95
311810,202003,49,40,9,41800,9405,51205
311820,202003,123,101,22,105545,22990,128535
311830,202003,1902,1178,724,1238325.75,759715,1998040.75
311840,202003,1006,558,448,584155.5,473385.25,1057540.75
311850,202003,11,7,4,7315,4180,11495
311860,202003,9548,4195,5353,4399452.25,5607471.63,10006923.88
311870,202003,128,66,62,68970,65835,134805
311880,202003,929,676,253,706420,265430.5,971850.5
311890,202003,208,100,108,106504,112860,219364
311900,202003,75,30,45,31350,47025,78375
311910,202003,1399,882,517,922735.75,541310.5,1464046.25
311920,202003,233,151,82,157795,85690,243485
311930,202003,905,518,387,542355.5,404415,946770.5
311940,202003,2506,1321,1185,1384625,1245640.15,2630265.15
311950,202003,57,43,14,44935,14630,59565
311960,202003,59,43,16,44935,16720,61655
311970,202003,23,14,9,14630,9405,24035
311980,202003,45,35,10,36575,10450,47025
311990,202003,39,30,9,31350,9405,40755
311995,202003,55,37,18,38665,18810,57475
312000,202003,29,22,7,22990,7315,30305
312010,202003,76,60,16,63745,16720,80465
312015,202003,78,61,17,63745,17765,81510
312020,202003,129,83,46,86735,48070,134805
312030,202003,57,42,15,43890,15675,59565
312040,202003,87,52,35,54340.99,36575,90915.99
312050,202003,211,115,96,120175,100320,220495
312060,202003,23,12,11,13585,11495,25080
312070,202003,77,50,27,52250,28215,80465
312080,202003,537,243,294,253935,307230,561165
312083,202003,59,39,20,40755,20900,61655
312087,202003,107,84,23,87780,24035,111815
312090,202003,3161,1898,1263,1986547.1,1322972,3309519.1
312100,202003,152,107,45,111575.15,47025,158600.15
312110,202003,115,70,45,73150,47025,120175
312120,202003,145,106,39,110771.14,40755,151526.14
312125,202003,90,48,42,50160,43890,94050
312130,202003,124,82,42,86735,43890,130625
312140,202003,135,106,29,110770.76,30305,141075.76
312150,202003,43,33,10,34485,10450,44935
312160,202003,1558,1025,533,1074357,558030.5,1632387.5
312170,202003,12,10,2,10450,2090,12540
312180,202003,112,66,46,68970,48070.5,117040.5
312190,202003,35,31,4,32395,4180,36575
312200,202003,760,646,114,676115.5,119130,795245.5
312210,202003,112,59,53,61655,57475,119130
312220,202003,137,101,36,105545.25,37620,143165.25
312230,202003,3614,1698,1916,1777545.4,2005356,3782901.4
312235,202003,168,114,54,119130,56430,175560
312240,202003,99,69,30,72105,31350,103455
312245,202003,185,128,57,133760,59565,193325
312247,202003,69,48,21,50160,21945,72105
312250,202003,175,85,90,88825,94050,182875
312260,202003,111,73,38,76285,39710,115995
312270,202003,129,76,53,79420,55385,134805
312280,202003,26,12,14,12540,14630,27170
312290,202003,147,105,42,110770,43890,154660
312300,202003,210,132,78,137940,81510,219450
312310,202003,63,57,6,59565,6270,65835
312320,202003,424,267,157,281105,164065.75,445170.75
312330,202003,90,79,11,82555,11495,94050
312340,202003,37,17,20,17765,20900,38665
312350,202003,18,11,7,11495,7315,18810
312352,202003,93,69,24,72105,25080,97185
312360,202003,578,253,325,265430,340670,606100
312370,202003,299,168,131,175560,137940,313500
312380,202003,146,95,51,99275,53295,152570
312385,202003,165,132,33,137940,34485,172425
312390,202003,303,187,116,196460,121220.5,317680.5
312400,202003,379,286,93,298870,97185.5,396055.5
312410,202003,981,314,667,329175,700150,1029325
312420,202003,627,481,146,502645.5,152570,655215.5
312430,202003,865,636,229,666711.11,239305,906016.11
312440,202003,42,31,11,33440,11495,44935
312450,202003,209,131,78,136895,81510,218405
312460,202003,33,16,17,16720,17765,34485
312470,202003,49,32,17,33440,17765,51205
312480,202003,191,118,73,123310,76285,199595
312490,202003,269,187,82,196460,85690,282150
312500,202003,36,21,15,21945,15675,37620
312510,202003,527,208,319,217360,334400,551760
312520,202003,32,9,23,9405,24035,33440
312530,202003,48,33,15,34485,15675,50160
312540,202003,97,86,11,89870,11495,101365
312550,202003,35,29,6,30305,8360,38665
312560,202003,216,167,49,175560.5,51205,226765.5
312570,202003,435,265,170,276925,177650,454575
312580,202003,90,48,42,50160,43890,94050
312590,202003,246,197,49,206910,52250,259160
312595,202003,134,120,14,126445,14630,141075
312600,202003,67,38,29,39710.25,30305,70015.25
312610,202003,1582,817,765,853767,800470.5,1654237.5
312620,202003,205,144,61,150480,63745,214225
312630,202003,62,52,10,54340,10450,64790
312640,202003,45,13,32,13585,33440,47025
312650,202003,146,121,25,126445.5,26125,152570.5
312660,202003,85,62,23,64790.75,24035,88825.75
312670,202003,919,596,323,624910,338580,963490
312675,202003,32,25,7,26125,7315,33440
312680,202003,77,49,28,51205,29260,80465
312690,202003,248,129,119,135850,124355,260205
312695,202003,37,31,6,32395,6270,38665
312700,202003,227,131,96,136895,103455,240350
312705,202003,83,67,16,70015,16720,86735
312707,202003,127,90,37,95095,38665,133760
312710,202003,1887,1007,880,1054406.41,921690,1976096.41
312720,202003,61,32,29,33440,30305,63745
312730,202003,279,162,117,169290,122265,291555
312733,202003,54,45,9,47025,9405,56430
312735,202003,22,14,8,14630,8360,22990
312737,202003,70,38,32,39710,33440,73150
312738,202003,57,40,17,41800,17765,59565
312740,202003,80,53,27,55385,28215,83600
312750,202003,78,56,22,58520,22990,81510
312760,202003,285,205,80,216315,85690,302005
312770,202003,7828,3610,4218,3782904.25,4428710,8211614.25
312780,202003,423,322,101,338580,105545,444125
312790,202003,22,16,6,16720,6270,22990
312800,202003,1587,1106,481,1156815.75,503690,1660505.75
312810,202003,371,235,136,246620,142120,388740
312820,202003,186,142,44,148390,45980,194370
312825,202003,25,16,9,16720,9405,26125
312830,202003,233,133,100,141075.15,105545,246620.15
312840,202003,157,108,49,113905,51205,165110
312850,202003,43,39,4,40755,4180,44935
312860,202003,153,95,58,99275,60610,159885
312870,202003,1047,545,502,569525.75,526680,1096205.75
312880,202003,128,89,39,93005,40755,133760
312890,202003,157,113,44,118085,45980,164065
312900,202003,194,146,48,152570,50160,202730
312910,202003,179,94,85,98230,88825,187055
312920,202003,155,87,68,90915,71060,161975
312930,202003,329,230,99,240350,103455,343805
312940,202003,111,79,32,82555,33440,115995
312950,202003,700,476,224,497420,235125,732545
312960,202003,172,129,43,134805.4,44935,179740.4
312965,202003,74,64,10,66880,10450,77330
312970,202003,271,219,52,228855.25,54340,283195.25
312980,202003,2454,1232,1222,1292666,1284305,2576971
312990,202003,42,23,19,24035,19855,43890
313000,202003,49,28,21,29260,21945,51205
313005,202003,174,135,39,141075,40755.5,181830.5
313010,202003,907,360,547,377245.5,571615,948860.5
313020,202003,189,100,89,104500,93005,197505
313030,202003,193,130,63,135850.35,65835,201685.35
313040,202003,75,24,51,25080,53295,78375
313050,202003,184,133,51,140030,54340,194370
313055,202003,38,29,9,31350,9405,40755
313060,202003,130,89,41,93005,42845,135850
313065,202003,61,44,17,45980,17765,63745
313070,202003,132,68,64,71060,66880,137940
313080,202003,40,17,23,17765,24035,41800
313090,202003,646,429,217,449350,227810,677160
313100,202003,174,64,110,66880,115995,182875
313110,202003,136,73,63,76285,65835,142120
313115,202003,203,115,88,120175,93005,213180
313120,202003,798,451,347,472340.5,363660.5,836001.0
313130,202003,5648,3093,2555,3237412.7,2681471.75,5918884.45
313140,202003,141,75,66,78375,70015,148390
313150,202003,305,245,60,256025,62700,318725
313160,202003,186,138,48,144210.5,51205,195415.5
313170,202003,1380,943,437,986480.5,457710,1444190.5
313180,202003,298,175,123,183920.5,128535,312455.5
313190,202003,751,451,300,471295.5,314545,785840.5
313200,202003,29,25,4,26125,4180,30305
313210,202003,995,841,154,879892.55,160930,1040822.55
313220,202003,261,170,91,177650,95095.5,272745.5
313230,202003,262,201,61,210045.87,63745,273790.87
313240,202003,2115,1095,1020,1148458.25,1069035,2217493.25
313250,202003,1255,955,300,997976,315590.8,1313566.8
313260,202003,91,49,42,51205,44935,96140
313270,202003,974,563,411,588335.75,429496,1017831.75
313280,202003,52,44,8,45980,8360,54340
313290,202003,217,174,43,181830,44935,226765
313300,202003,348,182,166,190190,173470,363660
313310,202003,252,123,129,128535,135850,264385
313320,202003,374,280,94,294690,98230,392920
313330,202003,1395,862,533,901835,558030,1459865
313340,202003,324,229,95,240350,99275,339625
313350,202003,503,335,168,351120,175560,526680
313360,202003,129,69,60,72105,62700.5,134805.5
313370,202003,205,68,137,71060,143165,214225
313375,202003,277,166,111,173470,115995,289465
313380,202003,1350,711,639,744040.5,672980,1417020.5
313390,202003,53,47,6,49115,6270,55385
313400,202003,403,275,128,287375,133761,421136
313410,202003,23,13,10,13585,10450,24035
313420,202003,4594,2453,2141,2572791,2241525.5,4814316.5
313430,202003,138,67,71,70015,74195,144210
313440,202003,1441,989,452,1034551.81,473387,1507938.81
313450,202003,67,27,40,28215,41800,70015
313460,202003,389,172,217,179740.5,226765,406505.5
313470,202003,526,248,278,259160.5,290511,549671.5
313480,202003,146,108,38,113905.5,39710,153615.5
313490,202003,514,239,275,249755.5,288420.25,538175.75
313500,202003,24,14,10,14630,10450,25080
313505,202003,1016,803,213,839135,223630,1062765
313507,202003,98,54,44,57475,45980,103455
313510,202003,2801,1772,1029,1853831.04,1077395.5,2931226.54
313520,202003,3443,2676,767,2804782.66,803605.5,3608388.16
313530,202003,34,23,11,24035,11495,35530
313535,202003,60,48,12,50160,12540,62700
313540,202003,68,51,17,53295,17765.5,71060.5
313545,202003,113,94,19,98230,19855,118085
313550,202003,230,196,34,204820,35530.5,240350.5
313560,202003,333,168,165,175560,173470,349030
313570,202003,66,28,38,29260,39710,68970
313580,202003,1302,732,570,767031.25,599831.5,1366862.75
313590,202003,67,37,30,38665,31350,70015
313600,202003,681,413,268,431585,282150.5,713735.5
313610,202003,58,47,11,49115,11495,60610
313620,202003,1380,702,678,734636,710600,1445236
313630,202003,1613,1240,373,1297891,392920,1690811
313640,202003,119,73,46,77330,48070,125400
313650,202003,235,110,125,115995,130625.5,246620.5
313652,202003,17,17,0,17765,0,17765
313655,202003,63,41,22,42845,24035,66880
313657,202003,49,45,4,48070,4180,52250
313660,202003,134,94,40,98230,42863.81,141093.81
313665,202003,644,304,340,318725.75,356345,675070.75
313670,202003,10312,7057,3255,7396514.37,3416107.37,10812621.74
313680,202003,44,33,11,34485,11495.95,45980.95
313690,202003,144,110,34,114950,36575,151525
313695,202003,76,58,18,60610,18810,79420
313700,202003,304,246,58,258115.5,60610,318725.5
313710,202003,144,99,45,103455,47025,150480
313720,202003,1113,528,585,554895.5,613416.5,1168312.0
313730,202003,73,44,29,45980,30305,76285
313740,202003,149,120,29,125400,31350,156750
313750,202003,433,313,120,327085,125400,452485
313753,202003,238,177,61,184965,63745,248710
313760,202003,1284,467,817,489060,856901.25,1345961.25
313770,202003,377,274,103,286330.25,107635,393965.25
313780,202003,759,402,357,420090,373065,793155
313790,202003,27,26,1,27170,1045,28215
313800,202003,136,83,53,86735,55385,142120
313810,202003,76,43,33,44935,34485,79420
313820,202003,1307,631,676,661486,707465.5,1368951.5
313830,202003,59,42,17,43890,17765,61655
313835,202003,61,51,10,53295,10450,63745
313840,202003,1669,1009,660,1056496.5,690746,1747242.5
313850,202003,205,74,131,77330,136895,214225
313860,202003,480,363,117,380380.5,122265,502645.5
313862,202003,165,110,55,114950,58520,173470
313865,202003,117,86,31,89870,32395,122265
313867,202003,46,36,10,37620,10450,48070
313868,202003,32,20,12,20900,12540,33440
313870,202003,120,63,57,65835,59565,125400
313880,202003,369,228,141,239305,147345,386650
313890,202003,334,178,156,186010,163020,349030
313900,202003,889,482,407,504735.25,425315.25,930050.50
313910,202003,138,101,37,105545,38665,144210
313920,202003,635,451,184,472340,195415.44,667755.44
313925,202003,31,28,3,29260,3135,32395
313930,202003,867,676,191,707465,201685,909150
313940,202003,1837,1157,680,1209065,712690,1921755
313950,202003,880,550,330,578930,345895,924825
313960,202003,1398,799,599,834955.9,628047,1463002.9
313970,202003,145,97,48,101365,50160,151525
313980,202003,206,128,78,133760.25,81510,215270.25
313990,202003,239,160,79,167200,82555,249755
314000,202003,911,605,306,633270.85,319770,953040.85
314010,202003,84,54,30,56430,31350,87780
314015,202003,65,18,47,18810,49115,67925
314020,202003,56,37,19,38665,19855,58520
314030,202003,73,36,37,37620,38665,76285
314040,202003,43,24,19,25080,19855,44935
314050,202003,281,166,115,173470,121220,294690
314053,202003,97,63,34,65835,36575,102410
314055,202003,299,186,113,194370,118085,312455
314060,202003,136,118,18,123310.04,18810,142120.04
314070,202003,1062,551,511,576840,535040,1111880
314080,202003,207,134,73,140030,76285.4,216315.4
314085,202003,140,95,45,99275,48070,147345
314090,202003,376,270,106,282150.25,110770.5,392920.75
314100,202003,487,391,96,408595.75,100320,508915.75
314110,202003,740,386,354,405460.5,370975,776435.5
314120,202003,92,54,38,56430,39710,96140
314130,202003,22,12,10,12540,10450,22990
314140,202003,1094,676,418,709555.5,436810,1146365.5
314150,202003,172,109,63,113905,66880,180785
314160,202003,333,254,79,266475,83600,350075
314170,202003,81,64,17,66880,17765,84645
314180,202003,727,645,82,674025.5,85690.25,759715.75
314190,202003,98,59,39,62700,40755,103455
314200,202003,488,332,156,346940.5,163020,509960.5
314210,202003,251,192,59,200640,61655.5,262295.5
314220,202003,303,223,80,234080.5,83600,317680.5
314225,202003,66,48,18,50160,18810,68970
314230,202003,117,53,64,55385,66880,122265
314240,202003,142,110,32,114950,34485,149435
314250,202003,53,30,23,31350,24035,55385
314260,202003,213,106,107,110770,112860,223630
314270,202003,357,277,80,289465,83600,373065
314280,202003,704,389,315,406505,331265,737770
314290,202003,542,440,102,460845,108680,569525
314300,202003,362,261,101,272745.75,105545.25,378291.00
314310,202003,1374,927,447,970022.57,468160,1438182.57
314315,202003,31,25,6,26125,6270,32395
314320,202003,587,386,201,405460.5,210045,615505.5
314330,202003,11029,5399,5630,5658259,5897981.07,11556240.07
314340,202003,599,275,324,289465,341716,631181
314345,202003,46,30,16,31350,16720,48070
314350,202003,182,115,67,120175,70015,190190
314360,202003,63,39,24,40755,25080,65835
314370,202003,67,48,19,50160,19855,70015
314380,202003,91,59,32,62700,33440,96140
314390,202003,3317,2139,1178,2243616.85,1236235,3479851.85
314400,202003,693,496,197,518321.3,205865,724186.3
314410,202003,473,307,166,322905,173470,496375
314420,202003,14,7,7,7315,7315,14630
314430,202003,2433,894,1539,935275.86,1613480.5,2548756.36
314435,202003,210,130,80,135850,83600,219450
314437,202003,28,22,6,22990,6270,29260
314440,202003,96,69,27,73150,28215,101365
314450,202003,153,107,46,112860,48070,160930
314460,202003,643,303,340,316635,356345,672980
314465,202003,92,60,32,62700,33440,96140
314467,202003,68,56,12,58520,12540,71060
314470,202003,413,208,205,217361.45,214225,431586.45
314480,202003,1060,506,554,530860,582065,1112925
314490,202003,48,34,14,35530,14630,50160
314500,202003,284,194,90,202730,97185,299915
314505,202003,120,79,41,82555,42845,125400
314510,202003,237,195,42,203775,43890,247665
314520,202003,1285,685,600,716877,630136.5,1347013.5
314530,202003,744,598,146,624911.01,152570,777481.01
314535,202003,191,116,75,123310,78375,201685
314537,202003,61,36,25,37620,26125,63745
314540,202003,16,10,6,10450,6270,16720
314545,202003,54,35,19,36575,19855,56430
314550,202003,80,42,38,43890,39710,83600
314560,202003,867,474,393,498465.5,412775,911240.5
314570,202003,21,16,5,16720,5225,21945
314580,202003,13,5,8,5225,8360,13585
314585,202003,26,19,7,19855,7315,27170
314587,202003,84,72,12,75240,12540,87780
314590,202003,568,408,160,426360.75,168245,594605.75
314600,202003,932,604,328,633271,344850.79,978121.79
314610,202003,951,492,459,517276.25,480700,997976.25
314620,202003,142,107,35,111815,36575.5,148390.5
314625,202003,94,69,25,72105.5,26125,98230.5
314630,202003,1169,622,547,651035,572660,1223695
314640,202003,81,54,27,56430,28215.5,84645.5
314650,202003,182,104,78,108680,81510,190190
314655,202003,64,46,18,49115,18810,67925
314660,202003,17,14,3,14630,3135,17765
314670,202003,200,153,47,160930.5,49115,210045.5
314675,202003,210,124,86,129580,89870,219450
314690,202003,583,311,272,324995,284240,609235
314700,202003,2290,1238,1052,1296847,1102475,2399322
314710,202003,1678,983,695,1030371.75,728365.5,1758737.25
314720,202003,386,231,155,242440,163020,405460
314730,202003,508,267,241,279016,251845,530861
314740,202003,702,340,362,355300,380380,735680
314750,202003,22,19,3,19855,3135,22990
314760,202003,337,159,178,166155,186010,352165
314770,202003,106,74,32,77330,33440,110770
314780,202003,18,7,11,7315,11495,18810
314790,202003,2355,1479,876,1546601,918555,2465156
314795,202003,52,42,10,43890,10450,54340
314800,202003,2920,1706,1214,1785907.22,1271765,3057672.22
314810,202003,1531,867,664,907060,693880,1600940
314820,202003,109,61,48,63745,50160,113905
314830,202003,213,172,41,179740,42845,222585
314840,202003,84,50,34,53295,35530,88825
314850,202003,371,185,186,193325.5,195415,388740.5
314860,202003,676,515,161,539220.75,168245,707465.75
314870,202003,1518,795,723,831820.5,756580,1588400.5
314875,202003,57,48,9,50160,9405,59565
314880,202003,42,29,13,30305,13585,43890
314890,202003,57,33,24,34485,25080,59565
314900,202003,30,23,7,24035,7315,31350
314910,202003,241,160,81,167200,85690,252890
314915,202003,141,126,15,131670,16720,148390
314920,202003,102,63,39,65835,40755,106590
314930,202003,1057,520,537,544445.5,561165,1105610.5
314940,202003,47,37,10,38665,10450,49115
314950,202003,32,22,10,22990,10450,33440
314960,202003,38,30,8,31350,8360,39710
314970,202003,148,71,77,74195.5,80465,154660.5
314980,202003,300,194,106,203775,110770,314545
314990,202003,442,243,199,253935,209000,462935
314995,202003,206,68,138,71060,144210,215270
315000,202003,92,71,21,74195,21945,96140
315010,202003,44,28,16,29260,16720,45980
315015,202003,170,137,33,143165,34485,177650
315020,202003,72,58,14,60610,14630,75240
315030,202003,114,88,26,91960.5,27170,119130.5
315040,202003,69,50,19,52250,20900,73150
315050,202003,182,108,74,112860,77330,190190
315053,202003,44,37,7,38665,7315,45980
315057,202003,103,81,22,84645,22990,107635
315060,202003,75,64,11,66880.8,11495,78375.8
315070,202003,104,58,46,60610,48070,108680
315080,202003,380,305,75,319770,78375,398145
315090,202003,98,58,40,60610,41800,102410
315100,202003,82,41,41,42845,42845,85690
315110,202003,271,144,127,151525,132715,284240
315120,202003,1716,844,872,884070,913330.2,1797400.2
315130,202003,348,252,96,263340,100320,363660
315140,202003,518,302,216,315590.5,225720.5,541311.0
315150,202003,962,457,505,478610,531905.5,1010515.5
315160,202003,215,106,109,111815,113905,225720
315170,202003,313,208,105,217360.5,109725,327085.5
315180,202003,3285,1364,1921,1428551.83,2014761.25,3443313.08
315190,202003,326,190,136,198550,142120,340670
315200,202003,1233,730,503,762850,526680,1289530
315210,202003,1657,947,710,989615,744040,1733655
315213,202003,41,23,18,24035,18810,42845
315217,202003,216,170,46,177650,48070,225720
315220,202003,1565,1182,383,1236235.95,403370,1639605.95
315230,202003,172,122,50,127490.5,52250,179740.5
315240,202003,420,268,152,280060,159885.5,439945.5
315250,202003,2550,1262,1288,1322970,1347005.5,2669975.5
315260,202003,142,82,60,85690,62700,148390
315270,202003,128,88,40,93005,41800,134805
315280,202003,656,425,231,445170,241395,686565
315290,202003,194,120,74,125400,77330,202730
315300,202003,75,56,19,58520,19855,78375
315310,202003,73,66,7,68970,7315,76285
315320,202003,168,100,68,104500,72105,176605
315330,202003,56,47,9,49115,9405,58520
315340,202003,391,282,109,294690,113905,408595
315350,202003,152,91,61,95095,64790,159885
315360,202003,90,46,44,48070,45980,94050
315370,202003,54,35,19,36575,19855,56430
315380,202003,12,8,4,8360,4180,12540
315390,202003,65,16,49,16720,51205.5,67925.5
315400,202003,843,629,214,657305.5,223630,880935.5
315410,202003,327,190,137,198550.5,143166.5,341717.0
315415,202003,60,45,15,47025,15675,62700
315420,202003,195,143,52,152570.5,54340,206910.5
315430,202003,661,375,286,395010.5,299915,694925.5
315440,202003,93,65,28,70015,29260,99275
315445,202003,233,191,42,201685,43890,245575
315450,202003,182,138,44,144210,45980,190190
315460,202003,3981,1942,2039,2034615.5,2134935,4169550.5
315470,202003,42,16,26,16720,27170,43890
315480,202003,65,22,43,24035,45980,70015
315490,202003,652,407,245,425315,257070,682385
315500,202003,18,12,6,12540,6270,18810
315510,202003,149,100,49,104500,51205,155705
315520,202003,69,61,8,63745,8360,72105
315530,202003,48,26,22,27170,22990,50160
315540,202003,243,165,78,172425,81510,253935
315550,202003,176,142,34,148390,35530,183920
315560,202003,742,595,147,621775.5,153615,775390.5
315570,202003,313,163,150,170336.69,156750,327086.69
315580,202003,708,474,234,496375,244530,740905
315590,202003,197,104,93,108680,97185,205865
315600,202003,303,227,76,238260,79420,317680
315610,202003,99,52,47,54340,49115,103455
315620,202003,35,28,7,29260,7315,36575
315630,202003,128,85,43,89870,44935,134805
315640,202003,71,44,27,45980,28215,74195
315645,202003,46,32,14,33440,14630,48070
315650,202003,172,124,48,129581,50160,179741
315660,202003,461,204,257,213180.5,268565,481745.5
315670,202003,2385,1148,1237,1204887,1295800,2500687
315680,202003,844,591,253,618640,267520,886160
315690,202003,680,466,214,489062.08,224675,713737.08
315700,202003,1893,992,901,1038731.21,943635,1982366.21
315710,202003,341,101,240,105545,250800,356345
315720,202003,444,275,169,288420.5,177650,466070.5
315725,202003,190,153,37,159885.5,39710,199595.5
315727,202003,51,22,29,22990,30305,53295
315730,202003,47,45,2,48070,2090,50160
315733,202003,89,60,29,62700,30305,93005
315737,202003,50,37,13,38665,13585,52250
315740,202003,32,25,7,26125,7315,33440
315750,202003,160,119,41,125400,42845,168245
315760,202003,41,31,10,32395,10450,42845
315765,202003,124,74,50,77330,52250,129580
315770,202003,218,138,80,144210,85690.5,229900.5
315780,202003,3455,1737,1718,1820390.75,1804716.49,3625107.24
315790,202003,226,176,50,183920,52250,236170
315800,202003,292,206,86,215270,89870,305140
315810,202003,95,57,38,59565,39710.5,99275.5
315820,202003,744,539,205,563255.5,214225,777480.5
315830,202003,128,78,50,81510,52250,133760
315840,202003,86,57,29,60610,30305,90915
315850,202003,254,181,73,190190,76285,266475
315860,202003,15,6,9,6270,9405,15675
315870,202003,38,28,10,29260,10450,39710
315880,202003,106,67,39,70015,40755,110770
315890,202003,91,68,23,71060,24035,95095
315895,202003,447,299,148,312455,154661,467116
315900,202003,71,33,38,34485,40755,75240
315910,202003,39,24,15,25080,15675,40755
315920,202003,165,108,57,112860,59565.75,172425.75
315930,202003,49,18,31,18810,32395,51205
315935,202003,131,101,30,105545.5,31350,136895.5
315940,202003,100,73,27,76285,28215,104500
315950,202003,40,29,11,30305,11495,41800
315960,202003,536,257,279,268565,291555.5,560120.5
315970,202003,33,27,6,28215,6270,34485
315980,202003,688,339,349,356345,367840,724185
315990,202003,249,144,105,150480,109725.5,260205.5
316000,202003,50,32,18,33440,18810,52250
316010,202003,77,67,10,70015,10450,80465
316020,202003,117,100,17,104500,17765,122265
316030,202003,391,218,173,228855.5,180785.75,409641.25
316040,202003,526,220,306,229900.5,320815.5,550716.0
316045,202003,61,55,6,57475,6270,63745
316050,202003,13,11,2,11495,2090,13585
316060,202003,96,63,33,65835,34485,100320
316070,202003,1091,703,388,735680.75,406505,1142185.75
316080,202003,102,68,34,71060,35530,106590
316090,202003,41,21,20,21945,20900,42845
316095,202003,102,83,19,86735,19855,106590
316100,202003,310,179,131,188100.25,136895,324995.25
316105,202003,38,25,13,26125,13585,39710
316110,202003,1874,1495,379,1565410.62,396055,1961465.62
316120,202003,82,59,23,61655,24035,85690
316130,202003,124,93,31,97185.5,32395,129580.5
316140,202003,33,22,11,22990,11495,34485
316150,202003,205,142,63,148390,65835,214225
316160,202003,81,47,34,49115,35530,84645
316165,202003,65,49,16,51205,16720,67925
316170,202003,188,124,64,129580,66880,196460
316180,202003,201,86,115,89870,121220.5,211090.5
316190,202003,139,100,39,104500,40755,145255
316200,202003,657,364,293,381425,306185,687610
316210,202003,767,511,256,536336.74,268565,804901.74
316220,202003,115,75,40,78375,41800,120175
316225,202003,25,15,10,16720,10450,27170
316230,202003,32,18,14,18810,14630,33440
316240,202003,652,523,129,547580,134805,682385
316245,202003,127,111,16,115995,16720,132715
316250,202003,1532,1042,490,1090981,513095,1604076
316255,202003,125,99,26,103455,27170,130625
316257,202003,181,95,86,99275,90915,190190
316260,202003,197,140,57,146300.25,60610.5,206910.75
316265,202003,27,18,9,18810,9405,28215
316270,202003,688,482,206,504735.5,216315.6,721051.1
316280,202003,546,341,205,359480.29,214226,573706.29
316290,202003,745,496,249,518320.65,261250,779570.65
316292,202003,505,200,305,210045,321860,531905
316294,202003,99,60,39,62700,40755,103455
316295,202003,307,134,173,140030.5,182875,322905.5
316300,202003,104,71,33,75240,34485,109725
316310,202003,31,16,15,16720,15675,32395
316320,202003,46,26,20,27170,20900,48070
316330,202003,161,110,51,114950.25,53295,168245.25
316340,202003,135,94,41,99275,42845,142120
316350,202003,189,136,53,142120.74,56430,198550.74
316360,202003,19,13,6,13585,6270,19855
316370,202003,1104,573,531,602966.25,556985,1159951.25
316380,202003,118,89,29,93005,30305,123310
316390,202003,118,86,32,89870,33440,123310
316400,202003,131,99,32,103455,33440,136895
316410,202003,285,206,79,215270,82555,297825
316420,202003,204,139,65,146300,67925,214225
316430,202003,152,80,72,84645,75240,159885
316440,202003,87,41,46,43890,48070,91960
316443,202003,41,39,2,40755,2090,42845
316447,202003,58,42,16,43890,16720,60610
316450,202003,225,171,54,179740,56430,236170
316460,202003,75,26,49,28215,51205,79420
316470,202003,1666,1222,444,1284297.76,463980,1748277.76
316480,202003,11,8,3,8360,3135,11495
316490,202003,18,7,11,7315,11495,18810
316500,202003,150,101,49,105545,51205,156750
316510,202003,155,119,36,124355,37620,161975
316520,202003,190,116,74,121220,77330,198550
316530,202003,161,108,53,112860,55385,168245
316540,202003,141,76,65,79420,67925,147345
316550,202003,128,86,42,89870,43890,133760
316553,202003,293,135,158,143165,167200.72,310365.72
316555,202003,39,33,6,34485,6270,40755
316556,202003,12,9,3,9405,3135,12540
316557,202003,19,17,2,17765,2090,19855
316560,202003,66,47,19,49115,19855,68970
316570,202003,219,199,20,207955,20900,228855
316580,202003,19,14,5,14630,5225,19855
316590,202003,105,89,16,93005,16720,109725
316600,202003,178,146,32,152570.5,33440,186010.5
316610,202003,65,49,16,51205,16720,67925
316620,202003,138,105,33,109725,34485,144210
316630,202003,43,34,9,35530,9405,44935
316640,202003,22,14,8,14630,8360,22990
316650,202003,74,61,13,63745,13585,77330
316660,202003,8,3,5,3135,5225,8360
316670,202003,436,153,283,159885,295735,455620
316680,202003,160,111,49,115995,51205,167200
316690,202003,188,117,71,123310,75240,198550
316695,202003,63,54,9,56430,9405,65835
316700,202003,16,10,6,10450,6270,16720
316710,202003,777,586,191,612370.25,201685,814055.25
316720,202003,4983,2440,2543,2558163.24,2664751,5222914.24
316730,202003,16,16,0,16720,0,16720
316740,202003,138,89,49,93005,52250,145255
316750,202003,17,10,7,10450,7315,17765
316760,202003,328,260,68,272745,71060,343805
316770,202003,154,81,73,84645,77330,161975
316780,202003,69,42,27,43890,29260,73150
316790,202003,52,39,13,40755,13585,54340
316800,202003,1750,1086,664,1135915,695970.5,1831885.5
316805,202003,23,14,9,14630,9405,24035
316810,202003,67,44,23,45980,24035,70015
316820,202003,42,21,21,21945,21945,43890
316830,202003,93,44,49,45980,51205,97185
316840,202003,531,306,225,320815.5,235125,555940.5
316850,202003,330,220,110,230945,115995,346940
316860,202003,5951,2632,3319,2755669.15,3474627.75,6230296.90
316870,202003,1535,995,540,1041867.25,566390.5,1608257.75
316880,202003,123,61,62,63745,65835,129580
316890,202003,240,165,75,172425,78375,250800
316900,202003,421,298,123,311410.65,128535,439945.65
316905,202003,21,10,11,10450,11495,21945
316910,202003,65,27,38,28215,39710,67925
316920,202003,132,105,27,109725,28215,137940
316930,202003,1897,977,920,1026191.5,967670.75,1993862.25
316935,202003,910,557,353,583110.1,370975.5,954085.6
316940,202003,1088,619,469,647900.5,491150.5,1139051.0
316950,202003,179,88,91,91960,95095,187055
316960,202003,1117,626,491,654171.5,513095,1167266.5
316970,202003,653,517,136,540265.5,142120,682385.5
316980,202003,77,45,32,47025,33440,80465
316990,202003,2179,1457,722,1525700.85,756581.33,2282282.18
317000,202003,334,256,78,267520,81510,349030
317005,202003,239,167,72,174515,75240,249755
317010,202003,6368,3526,2842,3691990.23,2975115.5,6667105.73
317020,202003,16044,7017,9027,7357854.6,9459344.1,16817198.7
317030,202003,80,31,49,32395,51205,83600
317040,202003,3057,1905,1152,1995951.81,1205930,3201881.81
317043,202003,74,54,20,57475,20900,78375
317047,202003,29,16,13,16720,13585,30305
317050,202003,158,118,40,123310,41800,165110
317052,202003,133,100,33,104500,34485,138985
317057,202003,172,132,40,137940,41800,179740
317060,202003,66,41,25,42845,26125,68970
317065,202003,55,45,10,47025,10450,57475
317070,202003,1959,906,1053,951996.44,1100386.03,2052382.47
317075,202003,105,57,48,59565,51205,110770
317080,202003,909,468,441,489060.75,460845,949905.75
317090,202003,644,518,126,541310,131670,672980
317100,202003,426,321,105,335445,109725,445170
317103,202003,99,81,18,84645,18810,103455
317107,202003,45,39,6,40755,6270,47025
317110,202003,114,48,66,50160,68970,119130
317115,202003,39,34,5,35530,5225,40755
317120,202003,1907,928,979,971851.5,1026190.5,1998042.0
317130,202003,1973,1313,660,1377311.5,692835,2070146.5
317140,202003,9,7,2,7315,2090,9405
317150,202003,262,156,106,163020.5,110770,273790.5
317160,202003,318,237,81,247665.79,84645,332310.79
317170,202003,216,148,68,154660,71060,225720
317180,202003,439,305,134,318725,140030,458755
317190,202003,263,183,80,192280,83600,275880
317200,202003,815,569,246,595653.65,257070,852723.65
317210,202003,186,102,84,106590,87780,194370
317220,202003,24,13,11,13585,11495,25080
320010,202003,611,444,167,463980.25,175560,639540.25
320013,202003,126,89,37,93005,38665,131670
320016,202003,271,169,102,177650,107635,285285
320020,202003,717,417,300,436811.87,314545,751356.87
320030,202003,151,105,46,109725,48070.25,157795.25
320035,202003,137,102,35,109725,36575,146300
320040,202003,490,249,241,261250,251845,513095
320050,202003,102,74,28,77330,29260,106590
320060,202003,1644,783,861,819280.25,903927.25,1723207.50
320070,202003,101,63,38,67925,39710,107635
320080,202003,797,454,343,474430.75,358435,832865.75
320090,202003,1231,833,398,875710,416955,1292665
320100,202003,331,190,141,198550,147345,345895
320110,202003,123,80,43,83601.25,44935,128536.25
320115,202003,110,89,21,93005,21945,114950
320120,202003,3415,1847,1568,1940567.65,1645875.5,3586443.15
320130,202003,7454,3384,4070,3545687.52,4266736.5,7812424.02
320140,202003,438,291,147,304095,157796.16,461891.16
320150,202003,2052,1159,893,1215336.67,934230,2149566.67
320160,202003,645,290,355,304095,373065.5,677160.5
320170,202003,109,86,23,89870,24035,113905
320180,202003,52,30,22,31350,22990,54340
320190,202003,242,155,87,161975,90915.5,252890.5
320200,202003,57,44,13,45980,13585,59565
320210,202003,908,501,407,523546,426361,949907
320220,202003,303,108,195,112860,204820,317680
320225,202003,87,68,19,72105,19855,91960
320230,202003,599,382,217,399190,226765,625955
320240,202003,3251,1589,1662,1660507,1744105.5,3404612.5
320245,202003,475,322,153,336490.5,159885,496375.5
320250,202003,228,117,111,122265,115995,238260
320255,202003,145,113,32,118085,33440,151525
320260,202003,204,141,63,147345,65835,213180
320265,202003,167,132,35,137940,36575,174515
320270,202003,154,122,32,127490,33440,160930
320280,202003,1012,583,429,609236.07,449350,1058586.07
320290,202003,59,51,8,53295,8360,61655
320300,202003,575,395,180,412776.35,188101.6,600877.95
320305,202003,678,368,310,385605,323950.5,709555.5
320310,202003,202,117,85,122265.9,88825,211090.9
320313,202003,329,163,166,172425.25,173470.5,345895.75
320316,202003,112,87,25,90915,26125,117040
320320,202003,3435,1545,1890,1616615.65,1978251.88,3594867.53
320330,202003,257,193,64,201685,66880,268565
320332,202003,838,511,327,536086.5,341716,877802.5
320334,202003,241,148,93,154660.5,97185,251845.5
320335,202003,150,104,46,108680,48070,156750
320340,202003,551,383,168,402325.75,175560,577885.75
320350,202003,988,421,567,439945.97,592516,1032461.97
320360,202003,166,91,75,95095,78375,173470
320370,202003,240,181,59,189145.9,62700.5,251846.4
320380,202003,279,195,84,204820.5,87780,292600.5
320390,202003,1141,686,455,720005,476520.5,1196525.5
320400,202003,309,228,81,238260.5,84645,322905.5
320405,202003,952,400,552,418000.25,577885.5,995885.75
320410,202003,991,503,488,526680,509960.25,1036640.25
320420,202003,500,241,259,251845.75,270655,522500.75
320425,202003,184,99,85,103455,88825,192280
320430,202003,388,214,174,223630.88,181830,405460.88
320435,202003,156,104,52,108680,54340,163020
320440,202003,195,114,81,119130,84645,203775
320450,202003,126,66,60,68970,62700,131670
320455,202003,248,201,47,210045.5,49115,259160.5
320460,202003,268,163,105,171380,109725,281105
320465,202003,116,78,38,81510,39710,121220
320470,202003,691,427,264,447260.5,275880,723140.5
320480,202003,196,125,71,130625,74195,204820
320490,202003,3050,1501,1549,1571681.26,1621843.23,3193524.49
320495,202003,108,67,41,70015,42846,112861
320500,202003,9662,4731,4931,4955396.3,5167530.2,10122926.5
320501,202003,554,282,272,295735,286330,582065
320503,202003,288,200,88,209000,91960,300960
320506,202003,261,184,77,192280,80465,272745
320510,202003,1024,454,570,476520,596695,1073215
320515,202003,85,68,17,71060,17765,88825
320517,202003,208,150,58,156750,60610,217360
320520,202003,6931,2997,3934,3138136.8,4126708.5,7264845.3
320530,202003,6088,3010,3078,3149632.22,3226960,6376592.22
330010,202003,3116,1592,1524,1664687.5,1596760,3261447.5
330015,202003,161,69,92,72105.9,96140,168245.9
330020,202003,3630,1564,2066,1637516.1,2169420.5,3806936.6
330022,202003,245,124,121,129580,127490.5,257070.5
330023,202003,593,191,402,199595,421135,620730
330025,202003,561,107,454,111815,476520,588335
330030,202003,1923,1224,699,1281170.12,730455.5,2011625.62
330040,202003,2435,1256,1179,1313565.75,1233100.5,2546666.25
330045,202003,8778,2685,6093,2813141,6383906,9197047
330050,202003,893,574,319,600875,334400,935275
330060,202003,991,587,404,615506.25,422180,1037686.25
330070,202003,3594,1298,2296,1360590.4,2405590.5,3766180.9
330080,202003,1593,711,882,746131.29,922735,1668866.29
330090,202003,376,220,156,231990,163020,395010
330093,202003,262,118,144,123310,152570,275880
330095,202003,82,46,36,48070,38665,86735
330100,202003,9777,4915,4862,5142447.67,5094376.25,10236823.92
330110,202003,469,201,268,210045.75,280060,490105.75
330115,202003,532,279,253,291555,265430,556985
330120,202003,371,194,177,202730,184966,387696
330130,202003,1531,383,1148,400235,1200705.63,1600940.63
330140,202003,602,317,285,331265,298870,630135
330150,202003,513,296,217,309320,226765,536085
330160,202003,211,126,85,131670,88825,220495
330170,202003,26817,9079,17738,9508457.6,18573834.8,28082292.4
330180,202003,245,146,99,152570,104500,257070
330185,202003,948,330,618,345895,645810,991705
330187,202003,354,107,247,112860,258115,370975
330190,202003,5726,2179,3547,2284372.15,3719155.5,6003527.65
330200,202003,4688,1394,3294,1459866.81,3446410.5,4906277.31
330205,202003,433,254,179,265430,188100.5,453530.5
330210,202003,984,607,377,637450.35,395011,1032461.35
330220,202003,2630,1574,1056,1650055.2,1107700.5,2757755.7
330225,202003,563,292,271,306185,283195,589380
330227,202003,2402,720,1682,752400,1760825.25,2513225.25
330230,202003,239,138,101,145255,105545,250800
330240,202003,3814,1896,1918,1985500.75,2009537,3995037.75
330245,202003,149,68,81,71060.1,84645,155705.1
330250,202003,6647,3375,3272,3532101.87,3427602.02,6959703.89
330260,202003,573,153,420,159885,440990,600875
330270,202003,3530,1205,2325,1260270,2437986,3698256
330280,202003,458,289,169,302005.5,177650.45,479655.95
330285,202003,7018,2196,4822,2299000.75,5049442.25,7348443.00
330290,202003,641,236,405,246620.25,425315,671935.25
330300,202003,758,491,267,514140.75,283195,797335.75
330310,202003,445,246,199,259160.75,209000,468160.75
330320,202003,7880,2921,4959,3057671.49,5190517.5,8248188.99
330330,202003,8886,3381,5505,3542551.75,5773626.5,9316178.25
330340,202003,2687,1581,1106,1654235,1159950,2814185
330350,202003,18286,7039,11247,7373526.24,11781336.62,19154862.86
330360,202003,2265,1089,1176,1140096.5,1232055,2372151.5
330370,202003,1035,510,525,532952,549670,1082622
330380,202003,880,377,503,393965,528770.01,922735.01
330385,202003,636,325,311,340670.25,324995,665665.25
330390,202003,5512,2950,2562,3091111,2687741,5778852
330395,202003,311,192,119,200640,125400.75,326040.75
330400,202003,715,374,341,392920,357390,750310
330410,202003,511,371,140,387695.25,146300.5,533995.75
330411,202003,251,134,117,140030.55,123310,263340.55
330412,202003,240,98,142,102410.5,148390,250800.5
330414,202003,5396,2169,3227,2273922.7,3381621.39,5655544.09
330415,202003,591,261,330,273791.5,345895,619686.5
330420,202003,2202,1129,1073,1185031.55,1124420.5,2309452.05
330430,202003,1784,813,971,849586,1016787.5,1866373.5
330440,202003,285,136,149,143165,155705,298870
330450,202003,122,52,70,54340,73150,127490
330452,202003,1986,877,1109,920645,1163085.5,2083730.5
330455,202003,110777,39020,71757,40876322.96,75214944.77,116091267.73
330460,202003,262,111,151,115995,157795,273790
330470,202003,1216,661,555,692837.35,582066.75,1274904.10
330475,202003,1502,393,1109,411730,1158905,1570635
330480,202003,813,433,380,452485,398145,850630
330490,202003,14273,4643,9630,4867611.25,10092611.5,14960222.75
330500,202003,1419,607,812,635360,850630.14,1485990.14
330510,202003,10702,3681,7021,3857097.15,7360983.57,11218080.72
330513,202003,104,52,52,54340,54340,108680
330515,202003,822,337,485,352166.25,507870.5,860036.75
330520,202003,2481,883,1598,922735.35,1673045,2595780.35
330530,202003,205,114,91,119130.25,95095,214225.25
330540,202003,379,185,194,193325.5,203775.5,397101.0
330550,202003,2880,1009,1871,1057540.7,1959376,3016916.7
330555,202003,807,311,496,324995,519365,844360
330560,202003,676,221,455,230945,476520,707465
330570,202003,266,192,74,200640,77330,277970
330575,202003,788,296,492,309320,515186.75,824506.75
330580,202003,3360,1876,1484,1961467.12,1552871,3514338.12
330590,202003,291,150,141,156750.09,147345,304095.09
330600,202003,1170,736,434,771211,454575,1225786
330610,202003,1591,852,739,890377.58,774346.5,1664724.08
330615,202003,207,162,45,169290,47025,216315
330620,202003,1061,423,638,443080,667755,1110835
330630,202003,4080,2563,1517,2684605.94,1591536.25,4276142.19
350010,202003,595,400,195,418000.97,205865,623865.97
350020,202003,52,23,29,24035,30305,54340
350030,202003,517,323,194,337535.5,203775.5,541311.0
350040,202003,124,50,74,52250,77330,129580
350050,202003,300,161,139,170335,147345,317680
350055,202003,94,50,44,52250,45980,98230
350060,202003,90,32,58,34485,60610,95095
350070,202003,800,470,330,492195.49,345895.5,838090.99
350075,202003,72,48,24,50160,25080,75240
350080,202003,58,30,28,31350,29260,60610
350090,202003,85,51,34,53295,35530,88825
350100,202003,286,176,110,183920,115995,299915
350110,202003,63,43,20,44935,20900,65835
350115,202003,146,88,58,93005,60610,153615
350120,202003,107,68,39,71060,40755,111815
350130,202003,367,166,201,173470.03,210045,383515.03
350140,202003,41,27,14,28215,14630,42845
350150,202003,72,54,18,56430,18810,75240
350160,202003,2443,950,1493,993796,1563320.5,2557116.5
350170,202003,386,228,158,238261.85,166155.5,404417.35
350180,202003,170,98,72,103455,75240.5,178695.5
350190,202003,1007,525,482,550715.29,504736,1055451.29
350200,202003,69,25,44,26125,45980,72105
350210,202003,1300,730,570,763897,599830.29,1363727.29
350220,202003,668,553,115,581020.29,120175,701195.29
350230,202003,72,50,22,53295,22990,76285
350240,202003,61,43,18,44935,18810,63745
350250,202003,1133,539,594,564301,622821.25,1187122.25
350260,202003,93,68,25,72105.5,26125,98230.5
350270,202003,862,574,288,600876,300960.5,901836.5
350275,202003,299,124,175,129580,183920,313500
350280,202003,4597,2339,2258,2453664.67,2365880.5,4819545.17
350290,202003,443,203,240,212135,250800.5,462935.5
350300,202003,55,28,27,29260,28215,57475
350310,202003,86,53,33,55385,34485,89870
350315,202003,48,26,22,27170,22990,50160
350320,202003,3296,1611,1685,1687675,1770230,3457905
350330,202003,1690,907,783,948862.62,821371.5,1770234.12
350335,202003,17,12,5,12540,5225,17765
350340,202003,126,57,69,59565,72105.75,131670.75
350350,202003,84,43,41,44935,43890,88825
350360,202003,119,78,41,81510,42845,124355
350370,202003,89,51,38,54340.29,39710,94050.29
350380,202003,782,331,451,346940,473386,820326
350390,202003,1541,596,945,623865.37,992750.5,1616615.87
350395,202003,25,20,5,20900,5225,26125
350400,202003,1697,870,827,912287.12,868395.29,1780682.41
350410,202003,2631,1141,1490,1193390,1560185.79,2753575.79
350420,202003,249,149,100,155705.79,104500,260205.79
350430,202003,73,44,29,45980,30305,76285
350440,202003,151,109,42,113905.5,43890.5,157796.0
350450,202003,1621,969,652,1022011.06,682386,1704397.06
350460,202003,388,129,259,137940,271700,409640
350470,202003,20,11,9,11495,9405,20900
350480,202003,174,97,77,102410,80465,182875
350490,202003,229,112,117,117040,122265,239305
350500,202003,50,20,30,20900,31350,52250
350510,202003,168,111,57,115995,59565,175560
350520,202003,454,227,227,239305,239305,478610
350530,202003,443,207,236,218405,247665,466070
350535,202003,81,65,16,67925,17765,85690
350540,202003,381,190,191,199595,201685,401280
350550,202003,2745,1630,1115,1707530.83,1167266.08,2874796.91
350560,202003,618,426,192,448305,202730,651035
350570,202003,4188,1727,2461,1807850.79,2576971.85,4384822.64
350580,202003,373,180,193,188100,201685,389785
350590,202003,913,496,417,521455.5,436810,958265.5
350600,202003,6081,2952,3129,3095293.25,3279210.5,6374503.75
350610,202003,1514,782,732,823460.29,765985,1589445.29
350620,202003,31,20,11,20900,11495,32395
350630,202003,242,138,104,145255.29,110770.29,256025.58
350635,202003,962,383,579,402326.35,605055.5,1007381.85
350640,202003,126,95,31,99275,32395,131670
350650,202003,1883,1250,633,1310430.95,666710,1977140.95
350660,202003,750,315,435,332310,454575,786885
350670,202003,310,153,157,159885,165110,324995
350680,202003,179,95,84,99275,87781,187056
350690,202003,200,99,101,103455,105545,209000
350700,202003,773,368,405,385606,424270,809876
350710,202003,374,138,236,144210,247665,391875
350715,202003,55,44,11,45980,11495,57475
350720,202003,18,12,6,12540,6270,18810
350730,202003,43,27,16,28215,16720,44935
350740,202003,217,124,93,129580,97185,226765
350745,202003,23,10,13,10450,13585,24035
350750,202003,2204,1366,838,1428515.75,878845,2307360.75
350760,202003,3748,1622,2126,1699170.59,2230030,3929200.59
350770,202003,61,44,17,45980,17765,63745
350775,202003,43,32,11,33440,11495,44935
350780,202003,433,221,212,230945,221540.81,452485.81
350790,202003,370,154,216,161975,226765,388740
350800,202003,468,276,192,288420,200640,489060
350810,202003,520,417,103,437855.75,107635,545490.75
350820,202003,91,53,38,55385,39710,95095
350830,202003,77,39,38,40755,39710,80465
350840,202003,764,307,457,320815.5,478610.5,799426.0
350850,202003,1733,967,766,1014695.5,802560.5,1817256.0
350860,202003,593,332,261,346940.75,272745,619685.75
350870,202003,425,284,141,296780,147345,444125
350880,202003,287,160,127,168245.25,132715,300960.25
350890,202003,41,27,14,28215,14630,42845
350900,202003,1457,459,998,481745.75,1048135.29,1529881.04
350910,202003,29,16,13,16720,13585,30305
350920,202003,684,361,323,378290,338580,716870
350925,202003,1202,636,566,665665.95,593562.39,1259228.34
350930,202003,103,63,40,65835,41800,107635
350940,202003,712,393,319,410685,333355,744040
350945,202003,109,78,31,81510,32395,113905
350950,202003,16243,7635,8608,8002615.59,9026712.75,17029328.34
350960,202003,1359,628,731,656260,763895,1420155
350970,202003,1107,578,529,605989.19,554896.3,1160885.49
350980,202003,97,65,32,67925,33440,101365
350990,202003,375,133,242,138985,252890,391875
350995,202003,36,16,20,16720,20900,37620
351000,202003,636,435,201,456665.58,211090,667755.58
351010,202003,51,31,20,32395,20900,53295
351015,202003,50,35,15,36575,15675,52250
351020,202003,1580,950,630,994840.5,659395,1654235.5
351030,202003,342,227,115,238260,120175,358435
351040,202003,894,463,431,483835.79,451440.89,935276.68
351050,202003,3317,1506,1811,1577953.3,1898765,3476718.3
351060,202003,5265,2049,3216,2149566.7,3372215,5521781.7
351070,202003,406,256,150,268566.64,157795,426361.64
351080,202003,750,548,202,573705.5,213180,786885.5
351090,202003,55,24,31,25080,32395,57475
351100,202003,435,250,185,261250.7,195415,456665.7
351110,202003,2028,969,1059,1013651.31,1110835.5,2124486.81
351120,202003,66,33,33,34485,34485,68970
351130,202003,187,60,127,62700,132715,195415
351140,202003,326,221,105,230945,109725,340670
351150,202003,442,230,212,240350.75,221540.5,461891.25
351160,202003,270,183,87,192280.5,90915,283195.5
351170,202003,188,98,90,102410,95095,197505
351190,202003,88,61,27,63745,28215,91960
351200,202003,364,245,119,257070.5,124355,381425.5
351210,202003,118,60,58,62700,60610,123310
351220,202003,534,320,214,334401.91,223630,558031.91
351230,202003,273,187,86,197505,90915,288420
351240,202003,235,114,121,120175,126445,246620
351250,202003,80,58,22,60610.57,22990,83600.57
351260,202003,149,112,37,117040,38665,155705
351270,202003,44,18,26,18810,27170,45980
351280,202003,992,449,543,473385.29,569525.79,1042911.08
351290,202003,248,107,141,111815,147345.5,259160.5
351300,202003,3735,1658,2077,1739844.61,2178825.29,3918669.90
351310,202003,760,379,381,398145,399190,797335
351320,202003,116,67,49,70015.29,51205,121220.29
351330,202003,42,26,16,28215,16720,44935
351340,202003,1238,730,508,763895.5,531906.3,1295801.8
351350,202003,2409,1391,1018,1453596.25,1066945.5,2520541.75
351360,202003,773,373,400,391875,419045,810920
351370,202003,392,196,196,205865.5,205865,411730.5
351380,202003,9023,4078,4945,4273010.85,5187382.29,9460393.14
351385,202003,27,17,10,17765,10450,28215
351390,202003,275,206,69,215270.35,72105,287375.35
351400,202003,66,43,23,45980,24035,70015
351410,202003,439,280,159,293645.77,167200,460845.77
351420,202003,65,50,15,52250,15675,67925
351430,202003,68,37,31,38665,32395,71060
351440,202003,799,558,241,584157.83,251845,836002.83
351450,202003,259,129,130,134805,136895,271700
351460,202003,126,57,69,59565,72105,131670
351470,202003,144,79,65,82555,67925,150480
351480,202003,502,285,217,298870.79,227810,526680.79
351490,202003,288,104,184,108680,194370,303050
351492,202003,28,21,7,21945,7315,29260
351495,202003,24,18,6,18810,6270,25080
351500,202003,3545,1484,2061,1554961.35,2163151.9,3718113.25
351510,202003,1895,738,1157,772256,1212200.5,1984456.5
351512,202003,20,15,5,15675,5225,20900
351515,202003,192,108,84,113905,87780,201685
351518,202003,759,477,282,498465,296780,795245
351519,202003,75,45,30,48070,31350,79420
351520,202003,151,92,59,96140,61655,157795
351530,202003,22,13,9,13585,9405,22990
351535,202003,133,78,55,81510,57475,138985
351540,202003,453,325,128,340670.05,133760,474430.05
351550,202003,1403,834,569,874667.08,598785,1473452.08
351560,202003,73,42,31,43890,32395,76285
351565,202003,9,7,2,7315,2090,9405
351570,202003,2698,1322,1376,1384625.5,1443145,2827770.5
351580,202003,38,34,4,35530,4180,39710
351590,202003,65,42,23,43890,24035,67925
351600,202003,183,132,51,138985,53295,192280
351610,202003,47,21,26,21945,27170,49115
351620,202003,5844,3275,2569,3442233.25,2699235.75,6141469.00
351630,202003,2786,1383,1403,1446280.25,1469270,2915550.25
351640,202003,2010,941,1069,984390.02,1117106.29,2101496.31
351650,202003,27,23,4,24035,4180,28215
351660,202003,140,92,48,97185,50160,147345
351670,202003,714,448,266,470251,277970.5,748221.5
351680,202003,73,61,12,63745,12540,76285
351685,202003,28,16,12,16720,12540,29260
351690,202003,297,203,94,214225.37,98230,312455.37
351700,202003,161,111,50,115995.5,52250,168245.5
351710,202003,69,45,24,47025,25080,72105
351720,202003,131,74,57,77330,59565,136895
351730,202003,107,70,37,73150,39710.29,112860.29
351740,202003,732,475,257,498466.18,268565,767031.18
351750,202003,352,145,207,151525,217360,368885
351760,202003,766,579,187,606100,196460,802560
351770,202003,308,261,47,274835.29,49115,323950.29
351780,202003,157,93,64,97185,66880,164065
351790,202003,256,136,120,142120,125400.75,267520.75
351800,202003,41,27,14,28215,14630,42845
351810,202003,122,82,40,85690,41800,127490
351820,202003,820,590,230,620730.5,240350.59,861081.09
351830,202003,544,194,350,204820,367840,572660
351840,202003,1909,945,964,990661.6,1011560,2002221.6
351850,202003,238,170,68,177650,71060,248710
351860,202003,672,463,209,484880.45,220495,705375.45
351870,202003,5551,2592,2959,2720137.6,3108875.62,5829013.22
351880,202003,19292,7924,11368,8308798,11929721.5,20238519.5
351885,202003,82,53,29,56430,30305,86735
351890,202003,75,61,14,63745,14630,78375
351900,202003,221,129,92,137940,97185,235125
351905,202003,78,33,45,34485,47025,81510
351907,202003,3424,1414,2010,1483900.85,2105676,3589576.85
351910,202003,180,74,106,77330,110770,188100
351920,202003,121,69,52,72105,54340,126445
351925,202003,90,58,32,60610,33440,94050
351930,202003,393,253,140,265430,146300,411730
351940,202003,239,104,135,108680,141075,249755
351950,202003,133,72,61,76285,63745,140030
351960,202003,911,449,462,470577.37,483835.5,954412.87
351970,202003,1871,981,890,1025145.5,936320.5,1961466.0
351980,202003,155,76,79,79420,82555,161975
351990,202003,258,169,89,176606,93005,269611
352000,202003,348,216,132,227810.5,137940,365750.5
352010,202003,394,248,146,261250,153615.5,414865.5
352020,202003,189,69,120,72105,125400,197505
352030,202003,1074,545,529,571615,552805,1124420
352040,202003,568,239,329,250800,346940,597740
352042,202003,283,86,197,89870,205866,295736
352044,202003,356,219,137,228855,144210,373065
352050,202003,3224,1252,1972,1318792.14,2065965.5,3384757.64
352060,202003,104,65,39,67925,40755,108680
352070,202003,93,68,25,72105.58,26125,98230.58
352080,202003,66,43,23,44935,24035,68970
352090,202003,156,104,52,109725,54340,164065
352100,202003,290,144,146,150480.5,152570.5,303051.0
352110,202003,114,34,80,35530,83600,119130
352115,202003,59,20,39,20900,40755,61655
352120,202003,85,59,26,61655.29,27170,88825.29
352130,202003,214,179,35,189145,37620,226765
352140,202003,183,85,98,88825,104500,193325
352150,202003,117,62,55,64790,57475,122265
352160,202003,139,88,51,91960,53295,145255
352170,202003,387,266,121,279015,127490,406505
352180,202003,619,399,220,418000.29,230945,648945.29
352190,202003,246,98,148,102410,155705,258115
352200,202003,31,16,15,16720,15675,32395
352210,202003,4060,1655,2405,1735747,2522630.79,4258377.79
352215,202003,58,33,25,34485,26125,60610
352220,202003,6736,2538,4198,2663706.55,4402588.19,7066294.74
352230,202003,3322,2148,1174,2257201.7,1234146.62,3491348.32
352240,202003,2404,1367,1037,1432695.5,1085755.5,2518451.0
352250,202003,2761,1317,1444,1378356.58,1511071.5,2889428.08
352260,202003,970,496,474,519365.5,497420.5,1016786.0
352265,202003,56,27,29,28215,30305,58520
352270,202003,402,235,167,246620,174515.25,421135.25
352280,202003,440,278,162,291555.58,170335,461890.58
352290,202003,172,102,70,107635,73150,180785
352300,202003,94,66,28,68970,29260,98230
352310,202003,6316,2822,3494,2956307.44,3665860.3,6622167.74
352320,202003,1023,533,490,556985,515185.5,1072170.5
352330,202003,535,258,277,269610,289465.5,559075.5
352340,202003,1342,615,727,645812,764941.5,1410753.5
352350,202003,344,207,137,216315,144210.5,360525.5
352360,202003,220,101,119,106590,125400,231990
352370,202003,104,69,35,72105,36575,108680
352380,202003,116,74,42,77330,43890,121220
352390,202003,2429,1038,1391,1090980.5,1455686.54,2546667.04
352400,202003,489,216,273,225720,287375.5,513095.5
352410,202003,839,591,248,618640.29,261250,879890.29
352420,202003,99,67,32,71060,33440,104500
352430,202003,1711,785,926,822416.87,969760.58,1792177.45
352440,202003,3195,1592,1603,1669911.6,1682450.5,3352362.1
352450,202003,201,167,34,174515,35530,210045
352460,202003,611,313,298,328130,312455,640585
352470,202003,651,221,430,230945,450395,681340
352480,202003,1402,776,626,815100,656261,1471361
352490,202003,62,22,40,22990,42845,65835
352500,202003,1207,514,693,538175.85,728365.5,1266541.35
352510,202003,726,391,335,410685.58,351120,761805.58
352520,202003,658,315,343,331265,359480,690745
352530,202003,1746,914,832,959310,878845.5,1838155.5
352540,202003,76,48,28,50160,29260,79420
352550,202003,187,113,74,118085,77330,195415
352560,202003,49,39,10,40755,10450,51205
352570,202003,675,345,330,360525.29,345895,706420.29
352580,202003,54,41,13,42845,13585,56430
352585,202003,20,6,14,6270,14630,20900
352590,202003,4401,2198,2203,2305270.29,2310496,4615766.29
352600,202003,350,251,99,262295,103455,365750
352610,202003,949,433,516,453530.67,541310,994840.67
352620,202003,1022,405,617,423225,646855,1070080
352630,202003,174,63,111,65835,117040,182875
352640,202003,521,351,170,367840,177650,545490
352650,202003,83,60,23,62700,24035,86735
352660,202003,68,40,28,41800,29260,71060
352670,202003,1655,889,766,929006.32,804650,1733656.32
352680,202003,936,583,353,612370,370975,983345
352690,202003,4545,2051,2494,2151657.38,2618770.29,4770427.67
352700,202003,103,62,41,65835.5,43890,109725.5
352710,202003,1375,731,644,765985,675070,1441055
352720,202003,1350,622,728,654170,761805.5,1415975.5
352725,202003,23,19,4,19855,4180,24035
352730,202003,394,202,192,212135,200640,412775
352740,202003,413,262,151,274836.4,157795.11,432631.51
352750,202003,19,12,7,12540,7315,19855
352760,202003,174,113,61,119130,63745,182875
352770,202003,85,64,21,66880,21945,88825
352780,202003,76,41,35,42845,36575,79420
352790,202003,25,20,5,20900,5225,26125
352800,202003,235,171,64,178695,66880,245575
352810,202003,155,96,59,101365.5,61655,163020.5
352820,202003,63,50,13,52250,13585,65835
352830,202003,80,54,26,56430,27170,83600
352840,202003,663,331,332,345895.25,346940,692835.25
352850,202003,1506,502,1004,524590,1051270,1575860
352860,202003,118,75,43,79420,44935,124355
352870,202003,42,28,14,29260,14630,43890
352880,202003,185,121,64,126445,66880,193325
352885,202003,32,22,10,22990,10450,33440
352890,202003,53,35,18,36575,18810.5,55385.5
352900,202003,4805,2339,2466,2457842.65,2593691.79,5051534.44
352910,202003,35,28,7,31350,7315,38665
352920,202003,657,395,262,415910,273790,689700
352930,202003,1211,580,631,609235.5,665665.75,1274901.25
352940,202003,6127,2536,3591,2664752.29,3776631,6441383.29
352950,202003,103,40,63,41800,65835,107635
352960,202003,58,40,18,41800,19855,61655
352965,202003,19,9,10,9405,10450,19855
352970,202003,513,390,123,407550.23,131670,539220.23
352980,202003,157,86,71,90915,74195,165110
352990,202003,982,444,538,463980,562210,1026190
353000,202003,67,30,37,31350,38665,70015
353010,202003,540,333,207,350075,217360,567435
353020,202003,297,213,84,222585,87780,310365
353030,202003,1253,573,680,601921.35,713735,1315656.35
353040,202003,85,55,30,57475,32395,89870
353050,202003,1335,870,465,909152.19,489060,1398212.19
353060,202003,8402,3653,4749,3826795,4978380,8805175
353070,202003,1748,1085,663,1140096.33,693693.99,1833790.32
353080,202003,1284,691,593,724185.47,621775,1345960.47
353090,202003,56,31,25,33440,26125,59565
353100,202003,50,42,8,43890,8360,52250
353110,202003,2079,629,1450,658350.5,1519430.54,2177781.04
353120,202003,96,50,46,52250,48070,100320
353130,202003,846,415,431,435765.41,453530,889295.41
353140,202003,550,224,326,234080.29,341715,575795.29
353150,202003,339,192,147,200640.29,154660,355300.29
353160,202003,93,76,17,79420,17765,97185
353170,202003,217,74,143,77330,151525,228855
353180,202003,1053,483,570,506825,597741.25,1104566.25
353190,202003,494,361,133,379335,138985.5,518320.5
353200,202003,214,108,106,112860,112860,225720
353205,202003,20,13,7,13585,7315,20900
353210,202003,72,41,31,42845,32395,75240
353215,202003,47,28,19,29260,19855,49115
353220,202003,79,45,34,48070,35530,83600
353230,202003,161,62,99,64790,103455,168245
353240,202003,316,162,154,169290,163020,332310
353250,202003,211,106,105,110770,110770,221540
353260,202003,458,319,139,336490.8,145255,481745.8
353270,202003,69,53,16,55385,16720,72105
353280,202003,102,51,51,55385,54340,109725
353282,202003,128,89,39,93005,40755,133760
353284,202003,24,17,7,17765,7315,25080
353286,202003,1,0,1,0,1045,1045
353290,202003,72,43,29,44935,30305,75240
353300,202003,447,241,206,252891.33,216315,469206.33
353310,202003,48,41,7,42845,7315,50160
353320,202003,56,32,24,33440,25080,58520
353325,202003,53,31,22,32395,22990.5,55385.5
353330,202003,61,42,19,43890.75,19855,63745.75
353340,202003,635,226,409,237215,429495.5,666710.5
353350,202003,900,437,463,456665,485925.5,942590.5
353360,202003,103,84,19,87780,19855,107635
353370,202003,112,62,50,64790,53295,118085
353380,202003,31,18,13,18810,14630,33440
353390,202003,1117,541,576,567435,605055,1172490
353400,202003,44,25,19,26125,19855,45980
353410,202003,108,67,41,70015,42845.25,112860.25
353420,202003,61,27,34,28215,36575,64790
353430,202003,586,394,192,414865.91,200640,615505.91
353440,202003,10825,4703,6122,4926132.44,6424661.5,11350793.94
353450,202003,57,31,26,32395,27170,59565
353460,202003,603,326,277,341715.75,290510,632225.75
353470,202003,2125,1121,1004,1173535.37,1052315,2225850.37
353475,202003,241,162,79,169290.5,82555,251845.5
353480,202003,189,156,33,163020,34485,197505
353490,202003,241,148,93,154660,97185.5,251845.5
353500,202003,199,117,82,122265.29,85690,207955.29
353510,202003,100,68,32,72105,33440,105545
353520,202003,204,144,60,150480,62700,213180
353530,202003,464,252,212,263340,222585,485925
353540,202003,374,248,126,260205,131670,391875
353550,202003,715,469,246,491151.47,257070,748221.47
353560,202003,593,239,354,249755,370975,620730
353570,202003,67,37,30,38665.5,31350,70015.5
353580,202003,354,264,90,276926.35,94050,370976.35
353590,202003,92,65,27,67925,28215,96140
353600,202003,280,161,119,169290.29,124355,293645.29
353610,202003,127,70,57,73150,59565,132715
353620,202003,604,318,286,332310.91,300960,633270.91
353625,202003,48,27,21,28215,21945,50160
353630,202003,232,170,62,177650.45,64790,242440.45
353640,202003,128,85,43,88825,44935,133760
353650,202003,923,349,574,367840,599830,967670
353657,202003,23,17,6,17765,6270,24035
353660,202003,274,147,127,153615,132715,286330
353670,202003,760,454,306,476520.79,320815.5,797336.29
353680,202003,105,75,30,78375.25,31350,109725.25
353690,202003,40,30,10,31350,10450,41800
353700,202003,272,196,76,205865,79420,285285
353710,202003,467,220,247,229900,259160.5,489060.5
353715,202003,46,33,13,34485,13585,48070
353720,202003,349,160,189,167200.5,197505,364705.5
353730,202003,1098,681,417,714780.5,438900.5,1153681.0
353740,202003,623,339,284,355300.5,298870,654170.5
353750,202003,80,48,32,51205,33440,84645
353760,202003,2937,1109,1828,1159950.65,1918621.65,3078572.30
353770,202003,89,72,17,75240,17765,93005
353780,202003,1208,574,634,600875.29,665665,1266540.29
353790,202003,505,307,198,321861.4,207955.5,529816.9
353800,202003,3380,1648,1732,1723226,1813147,3536373
353810,202003,233,134,99,141075,103455,244530
353820,202003,206,96,110,101365,115995,217360
353830,202003,49,43,6,44935,6270,51205
353850,202003,180,83,97,86735,101365,188100
353860,202003,498,223,275,234080,290510,524590
353870,202003,5355,2728,2627,2862259,2754621.75,5616880.75
353880,202003,683,475,208,500555.89,217360,717915.89
353890,202003,563,321,242,337535.5,253935.61,591471.11
353900,202003,132,71,61,75240,63745,138985
353910,202003,172,72,100,77330,104500,181830
353920,202003,432,241,191,251845.75,201685,453530.75
353930,202003,995,584,411,611325,432631.35,1043956.35
353940,202003,193,97,96,101365,100320,201685
353950,202003,508,310,198,323950,207955,531905
353960,202003,75,61,14,63745,14630,78375
353970,202003,58,33,25,34485,26125,60610
353980,202003,1672,778,894,817190,938410.5,1755600.5
353990,202003,68,41,27,42845,28215,71060
354000,202003,382,184,198,192280,207955,400235
354010,202003,90,49,41,51205,42845.5,94050.5
354020,202003,515,328,187,344850,197505,542355
354025,202003,50,42,8,43890,8360,52250
354030,202003,50,31,19,33440,19855,53295
354040,202003,101,77,24,80465,25080,105545
354050,202003,179,99,80,103455.79,83600,187055.79
354060,202003,765,370,395,389785,414865,804650
354070,202003,906,523,383,547581,401280,948861
354075,202003,222,107,115,111815,120175,231990
354080,202003,311,133,178,138985,186010,324995
354085,202003,20,13,7,13585,7315,20900
354090,202003,292,165,127,173382,132715,306097
354100,202003,5536,2271,3265,2389916.53,3422377.35,5812293.88
354105,202003,91,44,47,47025,49115,96140
354110,202003,47,22,25,22990,26125,49115
354120,202003,136,97,39,101365,40755,142120
354130,202003,723,456,267,477565,279015.5,756580.5
354140,202003,3163,1457,1706,1524656.02,1785905,3310561.02
354150,202003,624,376,248,393965.87,259160,653125.87
354160,202003,662,421,241,442035.72,253936.39,695972.11
354165,202003,16,14,2,15675,2090,17765
354170,202003,174,120,54,125400,57475,182875
354180,202003,62,37,25,38665.59,26125,64790.59
354190,202003,191,83,108,87780,112860,200640
354200,202003,117,61,56,63745,58520,122265
354210,202003,56,24,32,25080,33440,58520
354220,202003,643,403,240,422180.79,251845,674025.79
354230,202003,173,73,100,76285,104500,180785
354240,202003,333,214,119,223630.62,125400,349030.62
354250,202003,83,51,32,54340,33440,87780
354260,202003,2030,957,1073,1001112.72,1122331.6,2123444.32
354270,202003,93,68,25,71060,26125,97185
354280,202003,41,20,21,21945,21945,43890
354290,202003,142,98,44,102410,45980,148390
354300,202003,386,269,117,281105.29,122265,403370.29
354310,202003,91,66,25,68970.5,26125,95095.5
354320,202003,201,101,100,105545,105545,211090
354323,202003,10,9,1,9405,1045,10450
354325,202003,119,69,50,72105.83,52250,124355.83
354330,202003,2462,820,1642,856751.5,1722160.5,2578912.0
354340,202003,10353,4992,5361,5242767.3,5623147.71,10865915.01
354350,202003,125,83,42,86735,43890,130625
354360,202003,76,44,32,45980,33440,79420
354370,202003,243,129,114,134805,120175,254980
354380,202003,186,111,75,115995,78375,194370
354390,202003,2695,972,1723,1019920,1806805.95,2826725.95
354400,202003,313,172,141,180785,147345,328130
354410,202003,619,300,319,315590.85,335445.5,651036.35
354420,202003,275,174,101,181830,107635,289465
354425,202003,302,180,122,189194,127490,316684
354430,202003,177,103,74,107635,77330,184965
354440,202003,37,28,9,29260,9405,38665
354450,202003,53,37,16,39710,16720,56430
354460,202003,100,58,42,60610,44935,105545
354470,202003,37,21,16,21945,16720,38665
354480,202003,112,60,52,63745,54340,118085
354490,202003,146,91,55,95095,57475,152570
354500,202003,371,178,193,187055,201685,388740
354510,202003,97,67,30,70015,31350,101365
354515,202003,37,12,25,12540,26125,38665
354520,202003,1590,678,912,711496.75,960355.5,1671852.25
354530,202003,748,375,373,391875.5,389785,781660.5
354540,202003,271,147,124,153615,129580,283195
354550,202003,38,24,14,25080,16720,41800
354560,202003,147,76,71,81510,74195,155705
354570,202003,136,88,48,91960.25,50160,142120.25
354580,202003,1876,885,991,929006,1039775.5,1968781.5
354600,202003,250,139,111,146300,115995,262295
354610,202003,74,61,13,63745.15,13585,77330.15
354620,202003,65,19,46,20900,48070,68970
354625,202003,15,10,5,10450,5225,15675
354630,202003,315,203,112,213180,117040,330220
354640,202003,803,509,294,533996.15,308275,842271.15
354650,202003,72,42,30,43890,31350,75240
354660,202003,795,591,204,618640.54,215270,833910.54
354670,202003,242,90,152,94050,158840,252890
354680,202003,1256,465,791,486970,826595,1313565
354690,202003,83,58,25,60610.5,26125,86735.5
354700,202003,67,47,20,49115,20900,70015
354710,202003,48,35,13,36575,13585,50160
354720,202003,20,20,0,20900,0,20900
354730,202003,1742,726,1016,759715.55,1065900.5,1825616.05
354740,202003,73,53,20,55385,20900,76285
354750,202003,433,247,186,258115,196460,454575
354760,202003,467,284,183,296781.25,191235.5,488016.75
354765,202003,10,5,5,5225,5225,10450
354770,202003,349,227,122,237215.5,127490,364705.5
354780,202003,8168,3247,4921,3408793.38,5161256.7,8570050.08
354790,202003,99,55,44,57475,45980,103455
354800,202003,457,249,208,261250,218405.22,479655.22
354805,202003,100,45,55,47025.5,57475,104500.5
354810,202003,103,63,40,65835,41800,107635
354820,202003,207,84,123,87780.9,128535,216315.9
354830,202003,40,22,18,22990,18810,41800
354840,202003,59,41,18,42845,18810,61655
354850,202003,4503,1995,2508,2094181,2633401.25,4727582.25
354860,202003,327,158,169,165110,176605.04,341715.04
354870,202003,12186,5460,6726,5722426.78,7050620.43,12773047.21
354880,202003,2808,1048,1760,1098295.88,1849650.75,2947946.63
354890,202003,2897,1556,1341,1630201.75,1407615,3037816.75
354900,202003,63,42,21,43890,21945,65835
354910,202003,1253,657,596,690746,622820,1313566
354920,202003,45,37,8,38665,8360,47025
354925,202003,12,6,6,6270,6270,12540
354930,202003,33,30,3,31350.78,3135,34485.78
354940,202003,799,581,218,607408.04,227810,835218.04
354950,202003,201,132,69,138985.25,72105,211090.25
354960,202003,152,57,95,59565,100320,159885
354970,202003,952,629,323,658351.64,337535.5,995887.14
354980,202003,8728,3163,5565,3315788.95,5836326.02,9152114.97
354990,202003,9235,4269,4966,4467378.5,5208280.03,9675658.53
354995,202003,539,178,361,186010,377245,563255
355000,202003,465,158,307,165110,321860,486970
355010,202003,605,379,226,396055.5,238260.79,634316.29
355020,202003,768,486,282,509960,295735.5,805695.5
355030,202003,206226,79942,126284,83777834.6,132406804.69,216184639.29
355040,202003,757,359,398,375155.5,416955,792110.5
355050,202003,149,95,54,100320,56430,156750
355060,202003,1608,814,794,851676.5,831820,1683496.5
355070,202003,1442,684,758,714780.77,794200.29,1508981.06
355080,202003,201,121,80,126445,84645,211090
355090,202003,288,175,113,182875,119130.19,302005.19
355100,202003,4963,2355,2608,2469234.6,2739991,5209225.6
355110,202003,258,174,84,181830.5,88825,270655.5
355120,202003,78,56,22,58520,22990,81510
355130,202003,50,29,21,30305,21945,52250
355140,202003,181,112,69,117040,73150,190190
355150,202003,675,403,272,422181,284240.5,706421.5
355160,202003,468,228,240,239305.29,250800.5,490105.79
355170,202003,2047,1075,972,1128600,1018875,2147475
355180,202003,677,289,388,302005,405460,707465
355190,202003,203,141,62,148390,64790,213180
355200,202003,111,63,48,65835,50160,115995
355210,202003,695,393,302,410685,316635,727320
355220,202003,7104,3698,3406,3874863.5,3572858,7447721.5
355230,202003,97,56,41,58520,42845,101365
355240,202003,4466,1868,2598,1960422.66,2721180,4681602.66
355250,202003,5798,2625,3173,2754639.6,3323100.25,6077739.85
355255,202003,46,27,19,28215,19855,48070
355260,202003,182,111,71,115995.5,74195,190190.5
355270,202003,164,103,61,109725,63745,173470
355280,202003,6297,2534,3763,2653257,3945921,6599178
355290,202003,75,61,14,63745,14630,78375
355300,202003,194,122,72,128535,75240.5,203775.5
355310,202003,106,57,49,59565,51205,110770
355320,202003,86,44,42,47025,43890,90915
355330,202003,284,161,123,168245,129580,297825
355340,202003,1503,519,984,543400.77,1032460,1575860.77
355350,202003,131,68,63,72105,65835,137940
355360,202003,168,114,54,119130,56430,175560
355365,202003,23,19,4,19855,4180,24035
355370,202003,1043,608,435,636406.08,458755,1095161.08
355380,202003,817,523,294,548625,308275,856900
355385,202003,73,51,22,53295,22990,76285
355390,202003,109,64,45,67925,47025,114950
355395,202003,193,111,82,117040.92,86735,203775.92
355400,202003,1631,983,648,1030287.51,680296.54,1710584.05
355410,202003,4836,2293,2543,2406638,2664751.25,5071389.25
355420,202003,51,36,15,37620,15675,53295
355430,202003,370,227,143,237215.5,149435,386650.5
355440,202003,76,43,33,44935,34485,79420
355450,202003,461,227,234,238261.2,245575.75,483836.95
355460,202003,63,47,16,49115.35,16720,65835.35
355465,202003,45,28,17,29260,17765,47025
355470,202003,174,71,103,74195.75,107635,181830.75
355475,202003,11,7,4,7315,4180,11495
355480,202003,517,221,296,231990,309320,541310
355490,202003,119,84,35,87780,36575,124355
355495,202003,61,25,36,27170,37620,64790
355500,202003,1579,882,697,924827.05,731500.5,1656327.55
355510,202003,270,201,69,210045.29,72105,282150.29
355520,202003,35,25,10,26125.5,10450,36575.5
355530,202003,19,12,7,13585,7315,20900
355535,202003,76,35,41,36575,42845,79420
355540,202003,2441,965,1476,1010662.84,1547645.79,2558308.63
355550,202003,57,37,20,38665,20900,59565
355560,202003,250,115,135,120175,141075,261250
355570,202003,24,16,8,16720,8360,25080
355580,202003,241,170,71,177650,75240.5,252890.5
355590,202003,17,11,6,11495,6270,17765
355600,202003,273,141,132,147345,137940,285285
355610,202003,230,153,77,159885,81510,241395
355620,202003,1319,603,716,632225.5,752400,1384625.5
355630,202003,445,326,119,341715,126445.29,468160.29
355635,202003,117,54,63,56430,66880,123310
355640,202003,560,318,242,332310,254980,587290
355645,202003,840,336,504,355300,527726.36,883026.36
355650,202003,1989,844,1145,883026.85,1202795.5,2085822.35
355660,202003,251,132,119,137940,126445,264385
355670,202003,555,223,332,234080,346940,581020
355680,202003,208,121,87,126445,90915,217360
355690,202003,94,43,51,44935,53295.66,98230.66
355695,202003,16,10,6,10450,6270,16720
355700,202003,1154,605,549,637450.65,577886,1215336.65
355710,202003,2235,1220,1015,1276991.82,1064855.5,2341847.32
355715,202003,19,15,4,15675,4180,19855
355720,202003,221,132,89,137940.6,93005,230945.6
355730,202003,103,60,43,63745,45980,109725
410010,202003,131,108,23,112860,24035,136895
410020,202003,111,87,24,90915,25080,115995
410030,202003,160,99,61,105545.5,63745,169290.5
410040,202003,1142,572,570,599830,597740,1197570
410045,202003,38,30,8,32395,8360,40755
410050,202003,477,270,207,282150,216315,498465
410060,202003,278,209,69,219450,72105,291555
410070,202003,299,250,49,261250,52250,313500
410080,202003,167,104,63,108680,65835,174515
410090,202003,80,70,10,73150.9,10450,83600.9
410100,202003,286,202,84,213180,87780,300960
410105,202003,48,30,18,31350,18810,50160
410110,202003,323,194,129,204820,134805,339625
410115,202003,32,24,8,25080,8360,33440
410120,202003,410,207,203,216315,213180,429495
410130,202003,48,29,19,30305,19855,50160
410140,202003,3109,1508,1601,1581087.67,1676184,3257271.67
410150,202003,2676,1052,1624,1102476.35,1707531,2810007.35
410160,202003,508,313,195,328130,204820,532950
410165,202003,68,42,26,43890,27170,71060
410170,202003,172,115,57,120175.5,60610,180785.5
410180,202003,2250,1254,996,1313565.5,1042910,2356475.5
410185,202003,37,32,5,33440,5225,38665
410190,202003,486,318,168,332310.89,177650,509960.89
410200,202003,937,688,249,721050,263340,984390
410210,202003,598,310,288,323950,302005.5,625955.5
410220,202003,44,22,22,22990,22990,45980
410230,202003,150,71,79,74195,82555,156750
410240,202003,756,495,261,518321.75,274835,793156.75
410250,202003,377,273,104,285285,108680,393965
410260,202003,298,166,132,173470,137940.5,311410.5
410270,202003,28,20,8,20900,8360,29260
410275,202003,57,44,13,45980,13585,59565
410280,202003,322,188,134,196460,140030,336490
410290,202003,245,152,93,159885,97185,257070
410300,202003,74,52,22,54340,22990,77330
410302,202003,18,11,7,11495,7315,18810
410304,202003,43,29,14,30305,14630,44935
410305,202003,213,114,99,120175,103455,223630
410310,202003,219,130,89,135850,93005,228855
410315,202003,50,34,16,35530,16720,52250
410320,202003,133,93,40,98230,41800,140030
410322,202003,34,22,12,22990,12540,35530
410330,202003,175,121,54,127490,56430,183920
410335,202003,100,56,44,58520,45980,104500
410337,202003,40,32,8,33440,8360,41800
410340,202003,34,29,5,30305,5225,35530
410345,202003,217,126,91,132715,95095,227810
410347,202003,51,39,12,40755,12540,53295
410350,202003,236,145,91,151525,95095,246620
410360,202003,470,296,174,310365.5,181831,492196.5
410370,202003,2352,995,1357,1048135.7,1425381.35,2473517.05
410380,202003,207,129,78,134805,81510,216315
410390,202003,383,266,117,277970,122265,400235
410395,202003,37,24,13,25080,13585,38665
410400,202003,828,389,439,406505.27,458165.25,864670.52
410405,202003,92,69,23,72105,24035,96140
410410,202003,33,25,8,26125,8360,34485
410420,202003,1660,788,872,824412.49,913330.85,1737743.34
410425,202003,168,70,98,73150,102410,175560
410430,202003,2270,1281,989,1341780,1036641.47,2378421.47
410440,202003,373,274,99,286330,103455,389785
410442,202003,357,237,120,247665,125400,373065
410445,202003,418,294,124,307230.5,129580,436810.5
410450,202003,393,199,194,207955,202730,410685
410460,202003,499,259,240,270655,250800,521455
410465,202003,213,130,83,137940,86735,224675
410470,202003,232,144,88,150480,91960,242440
410480,202003,6184,2999,3185,3143366.14,3337731.75,6481097.89
410490,202003,1421,873,548,913330.51,572660.5,1485991.01
410500,202003,259,149,110,155705,114950,270655
410510,202003,167,123,44,128535,45980,174515
410520,202003,248,183,65,191235,67925,259160
410530,202003,265,98,167,102410,175560,277970
410540,202003,315,233,82,243485,85690,329175
410550,202003,1659,718,941,751355,987526,1738881
410560,202003,143,100,43,104500,45980,150480
410570,202003,432,289,143,302006.3,149435,451441.3
410580,202003,3432,1508,1924,1580041.79,2014760.5,3594802.29
410590,202003,403,276,127,292582,133760,426342
410600,202003,193,166,27,173470,28215,201685
410610,202003,53,44,9,45980,9405,55385
410620,202003,252,174,78,181830.03,81510,263340.03
410630,202003,438,251,187,263340,196460,459800
410640,202003,1024,640,384,668800.75,403370,1072170.75
410645,202003,107,77,30,81510,31350,112860
410650,202003,352,229,123,241395,130625,372020
410655,202003,87,63,24,65835,25080,90915
410657,202003,23,8,15,8360,15675,24035
410660,202003,598,417,181,440990.52,189145,630135.52
410670,202003,73,62,11,64790,11495,76285
410680,202003,215,173,42,181830,43890,225720
410685,202003,19,11,8,11495,8360,19855
410690,202003,28282,12057,16225,12638141.5,17012604.5,29650746.0
410700,202003,332,244,88,256025,93005,349030
410710,202003,125,103,22,107635,22990,130625
410712,202003,31,23,8,24035,8360,32395
410715,202003,89,67,22,70015,22990,93005
410720,202003,702,398,304,416955,318725,735680
410725,202003,179,129,50,135850,52250,188100
410730,202003,94,49,45,51205,47025,98230
410740,202003,107,76,31,79420,32395,111815
410750,202003,256,171,85,178695,88825,267520
410752,202003,25,15,10,15675,10450,26125
410753,202003,52,23,29,24035,30305,54340
410754,202003,47,25,22,26125.5,22990,49115.5
410755,202003,81,51,30,53295,31350,84645
410760,202003,765,420,345,438900.5,361570,800470.5
410765,202003,1734,812,922,849585.93,967671,1817256.93
410770,202003,106,83,23,86735,24035,110770
410773,202003,55,40,15,41800,15675,57475
410775,202003,182,134,48,142120,50160,192280
410780,202003,86,47,39,49115,40755,89870
410785,202003,58,45,13,47025,13585,60610
410790,202003,74,34,40,35530,41800,77330
410800,202003,285,175,110,182875,114950.5,297825.5
410810,202003,21,17,4,17765,4180.5,21945.5
410820,202003,174,127,47,132715,49115,181830
410830,202003,8587,3736,4851,3914571.78,5082880.94,8997452.72
410832,202003,102,71,31,74195,32395,106590
410840,202003,1444,793,651,832866.44,684475.25,1517341.69
410845,202003,70,44,26,45980,27170,73150
410850,202003,193,136,57,142120,60610,202730
410855,202003,57,46,11,48070,11495,59565
410860,202003,713,398,315,418000.5,331265,749265.5
410865,202003,102,76,26,79420,27170,106590
410870,202003,150,129,21,134805,21945,156750
410880,202003,1110,569,541,594605.5,565345,1159950.5
410890,202003,91,64,27,66880,28215,95095
410895,202003,72,56,16,58520,16720,75240
410900,202003,24,18,6,18810,6270,25080
410910,202003,16,13,3,13585,3135,16720
410920,202003,37,25,12,27170,12540,39710
410930,202003,519,323,196,339625,204820,544445
410940,202003,4351,2446,1905,2562341.57,1994905.5,4557247.07
410950,202003,104,77,27,80465,28215,108680
410960,202003,814,342,472,359480,494285,853765
410965,202003,62,48,14,50160,14630,64790
410970,202003,631,448,183,468160,191235,659395
410975,202003,119,72,47,75240.91,49115,124355.91
410980,202003,1621,729,892,762850,935275,1698125
410990,202003,266,185,81,194370,85690,280060
411000,202003,68,41,27,42845,28215.5,71060.5
411005,202003,25,21,4,21945,4180,26125
411007,202003,260,156,104,163020,110770,273790
411010,202003,603,407,196,425315,204820,630135
411020,202003,290,200,90,209000.85,94050,303050.85
411030,202003,18,10,8,10450,8360,18810
411040,202003,56,39,17,40755,17765,58520
411050,202003,207,161,46,168245,48070,216315
411060,202003,515,344,171,361570,178695,540265
411065,202003,56,48,8,50160,8360,58520
411070,202003,1240,766,474,803605,496375,1299980
411080,202003,239,169,70,176605,73150,249755
411090,202003,100,75,25,78375,26125,104500
411095,202003,284,110,174,114950,181830,296780
411100,202003,118,97,21,101365,22990,124355
411110,202003,127,83,44,86735,45980,132715
411120,202003,200,140,60,146300,62700,209000
411125,202003,239,103,136,107635,143165,250800
411130,202003,131,113,18,118085,18810,136895
411140,202003,210,139,71,145255,74195,219450
411150,202003,1222,803,419,845405,440990.29,1286395.29
411155,202003,118,81,37,84645,39710,124355
411160,202003,24,12,12,12540,12540,25080
411170,202003,52,47,5,49115.5,5225,54340.5
411180,202003,964,637,327,666710,341715,1008425
411190,202003,322,191,131,201685,137940,339625
411200,202003,674,417,257,436810.29,268565,705375.29
411210,202003,686,365,321,382470,336490,718960
411220,202003,153,111,42,115995,43890,159885
411230,202003,41,34,7,35530,7315,42845
411240,202003,121,76,45,80465,47025,127490
411250,202003,429,317,112,332310,117040,449350
411260,202003,18,12,6,12540,6270,18810
411270,202003,280,148,132,154660,138985,293645
411275,202003,188,166,22,174515,22990,197505
411280,202003,213,150,63,158840.29,65835,224675.29
411290,202003,60,47,13,49115,13585,62700
411295,202003,138,108,30,112860,31350,144210
411300,202003,78,36,42,37620,43890,81510
411310,202003,90,71,19,74195,19855,94050
411320,202003,773,525,248,549670,261250,810920
411325,202003,59,40,19,42845,19855,62700
411330,202003,898,571,327,598785.5,341715.99,940501.49
411340,202003,28,20,8,20900,8360,29260
411342,202003,65,50,15,52250,15675,67925
411345,202003,119,58,61,60610,63745,124355
411350,202003,481,372,109,389785.45,113905.5,503690.95
411360,202003,53,34,19,35530,19855,55385
411370,202003,14155,5780,8375,6058915.24,8780091.83,14839007.07
411373,202003,173,126,47,131670,49115,180785
411375,202003,72,58,14,60610,14630,75240
411380,202003,87,64,23,67925,24035,91960
411390,202003,123,78,45,81510,47025,128535
411400,202003,369,276,93,288420,97185,385605
411410,202003,436,219,217,229900,226765.5,456665.5
411420,202003,983,434,549,454575,574750,1029325
411430,202003,465,272,193,284240,201685,485925
411435,202003,32,21,11,21945,11495,33440
411440,202003,455,361,94,377245,98230,475475
411450,202003,414,353,61,368885,63745,432630
411460,202003,752,290,462,303050,483836.07,786886.07
411470,202003,84,62,22,65835,22990,88825
411480,202003,671,375,296,391875.5,309320,701195.5
411490,202003,291,189,102,197505,106590,304095
411500,202003,100,83,17,87780,17765,105545
411510,202003,221,176,45,183920,47025,230945
411520,202003,6015,2282,3733,2389916,3914572.26,6304488.26
411530,202003,122,83,39,87780,40755,128535
411535,202003,49,19,30,19855,31350,51205
411540,202003,348,240,108,251845,112860,364705
411545,202003,55,41,14,42845,14630,57475
411550,202003,76,58,18,60610,18810,79420
411560,202003,389,170,219,177650,229900,407550
411570,202003,815,301,514,314545.2,538175,852720.2
411573,202003,24,15,9,15675,9405,25080
411575,202003,292,185,107,193325,111815,305140
411580,202003,1284,474,810,495330,852720,1348050
411585,202003,75,36,39,37620,40755,78375
411590,202003,26,18,8,18810,8360,27170
411600,202003,25,11,14,11495,14630,26125
411605,202003,239,96,143,100320,149435,249755
411610,202003,203,134,69,140030,73150,213180
411620,202003,367,198,169,206910,176605,383515
411630,202003,55,38,17,40755,17765,58520
411640,202003,34,25,9,26125,9405,35530
411650,202003,12,7,5,7315,5225,12540
411660,202003,35,24,11,25080,11495,36575
411670,202003,237,174,63,181830,65835,247665
411680,202003,160,132,28,137940,31350,169290
411690,202003,586,314,272,329175,285285,614460
411695,202003,58,42,16,43890,16720,60610
411700,202003,139,116,23,121220,24035,145255
411705,202003,105,69,36,72105,37620,109725
411710,202003,300,205,95,214225,100320,314545
411720,202003,128,86,42,89870,43890,133760
411721,202003,67,56,11,58520,11495,70015
411722,202003,97,41,56,43890,58520,102410
411725,202003,157,117,40,123310.5,41800,165110.5
411727,202003,83,63,20,65835,20900,86735
411729,202003,37,29,8,30305,8360,38665
411730,202003,550,350,200,366795,210045,576840
411740,202003,40,24,16,25080,16720,41800
411745,202003,69,48,21,50160,21945,72105
411750,202003,856,389,467,408595.5,490105,898700.5
411760,202003,1177,877,300,923780.6,316635,1240415.6
411770,202003,457,303,154,318725,160930,479655
411780,202003,331,221,110,230945,115995,346940
411790,202003,525,296,229,310365.22,239305,549670.22
411800,202003,155,119,36,124355,37620,161975
411810,202003,179,135,44,141075,45980,187055
411820,202003,2177,966,1211,1012606.7,1268630,2281236.7
411830,202003,12,11,1,11495,1045,12540
411840,202003,2013,1238,775,1293710,810921,2104631
411845,202003,55,20,35,20900,36575,57475
411850,202003,1218,669,549,699105.5,575795.75,1274901.25
411860,202003,47,33,14,34485.5,14630,49115.5
411870,202003,71,48,23,50160,24035,74195
411880,202003,420,270,150,283195,156750,439945
411885,202003,107,69,38,72105,40755,112860
411890,202003,309,200,109,211091.49,114950,326041.49
411900,202003,77,58,19,60610.5,19855,80465.5
411910,202003,180,144,36,152570,37620,190190
411915,202003,2147,889,1258,931095,1319835.55,2250930.55
411920,202003,116,93,23,97185,24035,121220
411925,202003,12,8,4,8360,4180,12540
411930,202003,801,586,215,614461.65,224675,839136.65
411940,202003,583,399,184,416955.85,192280,609235.85
411950,202003,980,478,502,500555.76,526680,1027235.76
411960,202003,1033,700,333,733590.75,350075,1083665.75
411965,202003,20,14,6,14630,6270,20900
411970,202003,82,73,9,77330,9405,86735
411980,202003,164,106,58,110770,60610,171380
411990,202003,5142,2950,2192,3091117.74,2295867.25,5386984.99
411995,202003,480,173,307,180785,320815,501600
412000,202003,313,203,110,212135,114950,327085
412010,202003,48,31,17,32395,17765,50160
412015,202003,40,29,11,30305,11495,41800
412020,202003,31,25,6,26125,6270,32395
412030,202003,49,46,3,48070,3135,51205
412033,202003,46,30,16,31350,16720,48070
412035,202003,67,45,22,47025,22990,70015
412040,202003,41,23,18,24035.5,18810,42845.5
412050,202003,199,152,47,158840,49115,207955
412060,202003,778,585,193,615505,201685,817190
412065,202003,48,31,17,32395,17765,50160
412070,202003,162,110,52,115995,54340.5,170335.5
412080,202003,287,147,140,153615,147345,300960
412085,202003,35,16,19,16720,19855,36575
412090,202003,804,503,301,526680.25,315590,842270.25
412100,202003,243,206,37,215270,38665,253935
412110,202003,69,54,15,56430.4,15675,72105.4
412120,202003,325,195,130,203775,135850,339625
412125,202003,84,49,35,51205,36575,87780
412130,202003,37,24,13,25080.4,13585,38665.4
412135,202003,30,18,12,18810,12540,31350
412140,202003,336,226,110,236170,115995,352165
412150,202003,257,169,88,176605,91960,268565
412160,202003,89,50,39,52250,40755,93005
412170,202003,681,475,206,496375.5,215270,711645.5
412175,202003,39,29,10,30305,10450,40755
412180,202003,196,151,45,157795,47025,204820
412190,202003,338,267,71,280060,75240,355300
412200,202003,185,118,67,123310,70015,193325
412210,202003,72,57,15,59565,15675,75240
412215,202003,227,160,67,167200,70015,237215
412217,202003,67,53,14,55385,14630,70015
412220,202003,828,590,238,617595,249755,867350
412230,202003,330,199,131,207955,136895,344850
412240,202003,1347,672,675,706420,706420,1412840
412250,202003,403,253,150,265430,156750,422180
412260,202003,104,75,29,78375,30305,108680
412265,202003,173,138,35,144210,36575,180785
412270,202003,85,56,29,58520,31350,89870
412280,202003,90,73,17,76285,17765,94050
412290,202003,94,65,29,67925,30305,98230
412300,202003,205,136,69,143165,73150,216315
412310,202003,47,41,6,42845,6270,49115
412320,202003,98,81,17,84645,17765,102410
412330,202003,190,162,28,169290,29260,198550
412340,202003,152,106,46,110770,48070.5,158840.5
412350,202003,621,302,319,315590,334400,649990
412360,202003,26,22,4,22990,4180,27170
412370,202003,155,136,19,143165.3,19855,163020.3
412380,202003,262,196,66,204820,68970,273790
412382,202003,62,33,29,34485,30305,64790
412385,202003,146,108,38,112860,39710,152570
412390,202003,283,216,67,225720,70015,295735
412395,202003,71,58,13,60610,13585,74195
412400,202003,88,59,29,61655,30305,91960
412402,202003,233,116,117,121220.5,124355,245575.5
412405,202003,855,317,538,331265,564300,895565
412410,202003,967,594,373,621775.5,390830,1012605.5
412420,202003,11,10,1,10450,1045,11495
412430,202003,19,14,5,14630,5225,19855
412440,202003,612,333,279,350075,294690,644765
412450,202003,76,66,10,68970,10450,79420
412460,202003,91,69,22,72105,22990,95095
412470,202003,216,174,42,181830,43890,225720
412480,202003,146,108,38,112860.75,39710,152570.75
412490,202003,160,142,18,149435,18810,168245
412500,202003,435,355,80,372020.06,83600,455620.06
412510,202003,178,147,31,153615.5,32395,186010.5
412520,202003,89,60,29,62700,30305,93005
412530,202003,106,56,50,58520,52250,110770
412535,202003,91,68,23,71060,24035,95095
412540,202003,83,39,44,40755,45980,86735
412545,202003,94,65,29,68970,30305,99275
412550,202003,3769,1642,2127,1719025,2227940,3946965
412555,202003,13,9,4,9405,4180,13585
412560,202003,606,433,173,452486.5,180785.75,633272.25
412570,202003,759,396,363,413820,379335,793155
412575,202003,90,62,28,64790,29260,94050
412580,202003,177,115,62,120175,64790,184965
412590,202003,37,32,5,33440,5225,38665
412600,202003,165,123,42,128535.85,43890,172425.85
412610,202003,35,17,18,17765,18810,36575
412620,202003,148,126,22,132715,22990,155705
412625,202003,2133,1116,1017,1171446.04,1065902.35,2237348.39
412627,202003,68,51,17,53295,17765,71060
412630,202003,414,274,140,286330,147345,433675
412635,202003,64,18,46,18810,48070,66880
412640,202003,107,74,33,77330,34485,111815
412650,202003,343,220,123,229900,128535,358435
412660,202003,471,287,184,300960,193325,494285
412665,202003,46,41,5,42845,5225,48070
412667,202003,292,200,92,209000,96140,305140
412670,202003,65,53,12,57475,12540,70015
412680,202003,293,230,63,241395,65835.7,307230.7
412690,202003,101,66,35,68970,36575.5,105545.5
412700,202003,160,108,52,112860,54340,167200
412710,202003,1390,839,551,877801.25,576840,1454641.25
412720,202003,227,145,82,152570,85690,238260
412730,202003,187,157,30,164065,32395,196460
412740,202003,429,227,202,237215,212135,449350
412750,202003,442,251,191,262295,200640,462935
412760,202003,279,146,133,152570,138985,291555
412770,202003,2126,1176,950,1229965.29,1000066,2230031.29
412780,202003,140,108,32,113905,34485,148390
412785,202003,279,139,140,145255,146300,291555
412788,202003,35,21,14,21945,14630,36575
412790,202003,127,107,20,111815,20900,132715
412795,202003,150,109,41,114950,42845,157795
412796,202003,315,209,106,220495,112860,333355
412800,202003,609,372,237,391875.25,247665,639540.25
412810,202003,2924,1594,1330,1675137.25,1394030,3069167.25
412820,202003,934,591,343,619686.75,360525,980211.75
412830,202003,14,11,3,11495,3135,14630
412840,202003,223,162,61,169290.5,64790,234080.5
412850,202003,764,499,265,521455,277970,799425
412853,202003,171,87,84,91960,87780,179740
412855,202003,192,104,88,109725.09,91960,201685.09
412860,202003,96,64,32,66880,33440,100320
412862,202003,55,41,14,42845,14630,57475
412863,202003,6,5,1,5225,1045,6270
412865,202003,42,30,12,32395,12540,44935
412870,202003,108,67,41,70015,43890,113905
412880,202003,95,71,24,74195.5,25080,99275.5
420005,202003,44,39,5,40755,5225,45980
420010,202003,359,233,126,243485.75,132715,376200.75
420020,202003,83,70,13,74195,13585,87780
420030,202003,22,20,2,20900,2090,22990
420040,202003,105,82,23,85690,24035,109725
420050,202003,57,35,22,36575,22990,59565
420055,202003,18,18,0,18810,0,18810
420060,202003,27,21,6,21945,6270,28215
420070,202003,99,83,16,86735,17765,104500
420075,202003,13,13,0,13585,0,13585
420080,202003,43,38,5,39710,5225,44935
420090,202003,35,32,3,33440,3135,36575
420100,202003,147,125,22,130625.5,22990,153615.5
420110,202003,20,20,0,20900,0,20900
420120,202003,62,45,17,47025,17765,64790
420125,202003,79,61,18,64790,18810,83600
420127,202003,30,26,4,27170,4180,31350
420130,202003,416,255,161,267520,168245,435765
420140,202003,1287,715,572,748221,597740,1345961
420150,202003,44,37,7,39710,7315,47025
420160,202003,33,31,2,33440,2090,35530
420165,202003,18,12,6,12540,6270,18810
420170,202003,77,50,27,52250,28215,80465
420180,202003,22,19,3,19855,3135,22990
420190,202003,25,22,3,22990,3135,26125
420195,202003,131,64,67,66880,70015,136895
420200,202003,1264,558,706,585200.5,740905,1326105.5
420205,202003,77,44,33,45980,34485,80465
420207,202003,120,64,56,66880,58520,125400
420208,202003,19,15,4,15675,4180,19855
420209,202003,19,16,3,16720,3135,19855
420210,202003,501,235,266,248710,279015,527725
420213,202003,48,38,10,39710,10450,50160
420215,202003,26,23,3,24035,3135,27170
420220,202003,65,43,22,49115,22990,72105
420230,202003,826,468,358,490105,375155.5,865260.5
420240,202003,2236,1471,765,1557050.9,803605,2360655.9
420243,202003,42,33,9,34485,9405,43890
420245,202003,144,76,68,79420,71060,150480
420250,202003,62,41,21,42845,22990,65835
420253,202003,36,28,8,29260,8360,37620
420257,202003,14,11,3,11495,3135,14630
420260,202003,99,84,15,87780,15675,103455
420270,202003,30,25,5,27170,5225,32395
420280,202003,287,217,70,227810.75,73150.75,300961.50
420285,202003,21,11,10,11495,10450,21945
420287,202003,47,32,15,33440,15675,49115
420290,202003,976,679,297,712690.5,312455,1025145.5
420300,202003,1430,1137,293,1192347.35,307230.65,1499578.00
420310,202003,48,33,15,34485,15675,50160
420315,202003,35,28,7,29260,7315,36575
420320,202003,887,441,446,465025.1,466070,931095.1
420325,202003,0,,,,,0.0
420330,202003,119,78,41,82555,42845,125400
420340,202003,157,102,55,106590,57475,164065
420350,202003,249,179,70,189145,73150,262295
420360,202003,745,568,177,596695,186010.25,782705.25
420370,202003,119,71,48,74195,50160.5,124355.5
420380,202003,1169,816,353,854810.25,370975.5,1225785.75
420390,202003,251,175,76,184965,79420,264385
420395,202003,193,138,55,146300,57475,203775
420400,202003,243,184,59,192280.65,64790,257070.65
420410,202003,61,46,15,48070,15675,63745
420415,202003,34,29,5,30305,5225,35530
420417,202003,51,40,11,41800,11495,53295
420419,202003,11,11,0,11495,0,11495
420420,202003,2852,1770,1082,1853833.34,1132780.5,2986613.84
420425,202003,68,55,13,57475,13585,71060
420430,202003,1186,853,333,894520.45,349030,1243550.45
420435,202003,16,14,2,14630,2090,16720
420440,202003,101,71,30,74195.5,31350,105545.5
420445,202003,22,21,1,21945,1045,22990
420450,202003,77,39,38,40755,39710,80465
420455,202003,212,162,50,170335,52250,222585
420460,202003,2300,1493,807,1564367,845405.5,2409772.5
420470,202003,106,75,31,78375,32395,110770
420475,202003,7,7,0,7315,0,7315
420480,202003,863,654,209,684476,219450.5,903926.5
420490,202003,106,77,29,80465,30305,110770
420500,202003,455,239,216,249756.09,226765,476521.09
420510,202003,17,16,1,16720,1045,17765
420515,202003,24,18,6,18810,6270,25080
420517,202003,10,10,0,10450,0,10450
420519,202003,0,,,,,0.0
420520,202003,66,50,16,52250,16720,68970
420530,202003,164,109,55,113905.75,57475,171380.75
420535,202003,20,18,2,18810,2090,20900
420540,202003,5451,3249,2202,3414281.9,2307360.5,5721642.4
420543,202003,24,23,1,24035,1045,25080
420545,202003,205,146,59,152570,61655,214225
420550,202003,850,702,148,734635.5,155705,890340.5
420555,202003,37,27,10,28215,10450,38665
420560,202003,63,53,10,55385,10450,65835
420570,202003,157,91,66,95095,68970,164065
420580,202003,278,128,150,134805,156750.5,291555.5
420590,202003,516,350,166,369930,173470,543400
420600,202003,113,63,50,65835,53295,119130
420610,202003,39,35,4,36575,4180,40755
420620,202003,85,66,19,68970,19855,88825
420630,202003,149,105,44,109725,47025,156750
420640,202003,83,73,10,76285,10450,86735
420650,202003,242,125,117,131670,123310,254980
420660,202003,50,39,11,40755.5,11495,52250.5
420665,202003,38,29,9,30305,9405,39710
420670,202003,305,234,71,245575,74195,319770
420675,202003,12,11,1,11495,1045,12540
420680,202003,39,28,11,29260,11495,40755
420690,202003,173,134,39,141075,40755,181830
420700,202003,690,471,219,492195.46,230945,723140.46
420710,202003,150,86,64,89870,66880,156750
420720,202003,108,88,20,93005,21945,114950
420730,202003,599,377,222,393965.84,231990.5,625956.34
420740,202003,52,51,1,53295,1045,54340
420750,202003,502,340,162,357390,169290,526680
420757,202003,16,14,2,14630,2090,16720
420760,202003,38,30,8,31350,8360,39710
420765,202003,77,60,17,62700,17765,80465
420768,202003,49,45,4,47025,4180,51205
420770,202003,73,63,10,65835,10450,76285
420775,202003,41,38,3,39710,3135,42845
420780,202003,226,180,46,189145,48070,237215
420785,202003,12,10,2,10450,2090,12540
420790,202003,159,132,27,137940,28215,166155
420800,202003,66,49,17,51205,17765,68970
420810,202003,253,211,42,220495,43890,264385
420820,202003,2327,1338,989,1403435.5,1037686.22,2441121.72
420830,202003,601,322,279,337535.5,291555,629090.5
420840,202003,150,110,40,115995,41800,157795
420845,202003,413,177,236,184965,246620.5,431585.5
420850,202003,256,196,60,205865.25,62700,268565.25
420860,202003,62,52,10,54340,10450,64790
420870,202003,126,88,38,93005,39710,132715
420880,202003,178,115,63,121220,65835,187055
420890,202003,935,470,465,495330.25,490105,985435.25
420895,202003,9,9,0,9405,0,9405
420900,202003,409,326,83,342760,86735,429495
420910,202003,5860,3260,2600,3415064.33,2727450,6142514.33
420915,202003,68,63,5,65835,5225,71060
420917,202003,21,14,7,14630,7315,21945
420920,202003,23,16,7,16720,7315,24035
420930,202003,2783,1730,1053,1818234.5,1103522.28,2921756.78
420940,202003,593,435,158,456666,165110.9,621776.9
420945,202003,9,7,2,7315,2090,9405
420950,202003,57,50,7,52250,7315,59565
420960,202003,109,87,22,90915,22990,113905
420970,202003,295,237,58,247666,61655,309321
420980,202003,23,22,1,22990,1045,24035
420985,202003,57,50,7,52250,7315,59565
420990,202003,81,61,20,64790,20900,85690
421000,202003,38,24,14,25080,14630,39710
421003,202003,54,37,17,39710,18810,58520
421005,202003,6,3,3,3135,3135,6270
421010,202003,767,529,238,555940,250801.5,806741.5
421020,202003,25,20,5,20900,5225,26125
421030,202003,121,101,20,106590.75,20900,127490.75
421040,202003,72,55,17,57475,17765,75240
421050,202003,340,236,104,246621,108680,355301
421055,202003,21,17,4,17765,4180,21945
421060,202003,88,52,36,54340,37620,91960
421070,202003,51,45,6,47025.5,6270,53295.5
421080,202003,35,31,4,32395,4180,36575
421085,202003,20,15,5,16720,5225,21945
421090,202003,38,28,10,29260,10450,39710
421100,202003,122,89,33,93005,34485,127490
421105,202003,205,169,36,177650,37620,215270
421110,202003,113,89,24,93005,25080,118085
421120,202003,163,120,43,125400.42,44935,170335.42
421125,202003,17,12,5,12540,5225,17765
421130,202003,810,510,300,535040,314545.5,849585.5
421140,202003,30,20,10,20900,10450,31350
421145,202003,42,34,8,35530,8360,43890
421150,202003,102,73,29,76285,30305,106590
421160,202003,70,48,22,50160,22990,73150
421165,202003,16,15,1,15675,1045,16720
421170,202003,181,151,30,157921.5,31350,189271.5
421175,202003,165,113,52,118085,54340,172425
421180,202003,52,34,18,35530.1,18810,54340.1
421185,202003,17,14,3,14630,3135,17765
421187,202003,0,0,0,0,0,0
421189,202003,44,31,13,32395,13585,45980
421190,202003,1660,1044,616,1096205,646855.79,1743060.79
421200,202003,93,69,24,72105,25080,97185
421205,202003,27,17,10,17765,10450,28215
421210,202003,173,120,53,125400,55385,180785
421220,202003,282,217,65,228855,68970,297825
421223,202003,48,39,9,40755,9405,50160
421225,202003,69,43,26,44935,27170,72105
421227,202003,86,66,20,68970,20900,89870
421230,202003,53,37,16,38665,16720,55385
421240,202003,19,19,0,19855,0,19855
421250,202003,371,222,149,231990.5,156750,388740.5
421260,202003,24,20,4,20900,4180,25080
421265,202003,2,2,0,2090,0,2090
421270,202003,47,42,5,43890,5225,49115
421280,202003,340,188,152,196460,158840,355300
421290,202003,335,223,112,233035,117040,350075
421300,202003,24,19,5,19855,5225,25080
421310,202003,46,33,13,34485,13585,48070
421315,202003,31,20,11,20900,11495,32395
421320,202003,129,82,47,86735,49115,135850
421330,202003,107,78,29,81510,30305,111815
421335,202003,39,27,12,28215,12540,40755
421340,202003,243,155,88,161975.25,91960,253935.25
421350,202003,187,108,79,112860.82,82555,195415.82
421360,202003,643,478,165,501600.25,172425,674025.25
421370,202003,203,153,50,161975,52250,214225
421380,202003,125,98,27,102410,28215,130625
421390,202003,20,14,6,14630,6270,20900
421400,202003,125,107,18,112860,18810,131670
421410,202003,18,16,2,16720,2090,18810
421415,202003,21,20,1,20900,1045,21945
421420,202003,135,113,22,118085,22990,141075
421430,202003,17,12,5,12540,5225,17765
421440,202003,58,49,9,51205,9405,60610
421450,202003,91,76,15,79420,16720,96140
421460,202003,60,48,12,50160,12540,62700
421470,202003,68,43,25,44935,26125,71060
421480,202003,716,545,171,572660,179740,752400
421490,202003,24,23,1,24035,1045,25080
421500,202003,486,313,173,328130.5,180785.25,508915.75
421505,202003,25,18,7,18810,7315,26125
421507,202003,30,23,7,24035,7315,31350
421510,202003,70,45,25,47025,26125,73150
421520,202003,56,47,9,49115,9405,58520
421530,202003,50,43,7,44935,7315,52250
421535,202003,27,25,2,26125,2090,28215
421540,202003,54,48,6,50160,6270,56430
421545,202003,98,73,25,76285,26125,102410
421550,202003,287,208,79,217360,82555,299915
421555,202003,21,17,4,17765,4180.5,21945.5
421560,202003,9,7,2,7315,2090,9405
421565,202003,123,83,40,87780,41800,129580
421567,202003,29,24,5,25080,5225,30305
421568,202003,31,27,4,28215,4180,32395
421569,202003,10,10,0,10450,0,10450
421570,202003,197,132,65,140030,67925,207955
421575,202003,27,22,5,22990,5225,28215
421580,202003,715,428,287,448373,300960,749333
421590,202003,19,18,1,18810,1045,19855
421600,202003,147,97,50,102410,52250.5,154660.5
421605,202003,111,76,35,79420.75,36575,115995.75
421610,202003,190,145,45,151525,47025,198550
421620,202003,1032,602,430,629090,449350,1078440
421625,202003,21,18,3,18810,3135,21945
421630,202003,304,189,115,198550.25,120176.5,318726.75
421635,202003,18,9,9,9405,9405,18810
421640,202003,98,83,15,86735,15675,102410
421650,202003,301,179,122,187055,127490,314545
421660,202003,2193,1323,870,1385671.1,909151,2294822.1
421670,202003,186,133,53,140030,55385,195415
421680,202003,179,161,18,168245,18810,187055
421690,202003,343,242,101,253935.5,105545.6,359481.1
421700,202003,55,37,18,38665,20900,59565
421710,202003,24,23,1,24035,1045,25080
421715,202003,7,6,1,6270,1045,7315
421720,202003,621,436,185,456666.25,195415,652081.25
421725,202003,16,6,10,6270,10450,16720
421730,202003,35,25,10,26125,10450,36575
421740,202003,87,35,52,36575,54340,90915
421750,202003,212,158,54,165110,57475,222585
421755,202003,24,22,2,22990,2090,25080
421760,202003,99,67,32,70015,33440,103455
421770,202003,639,410,229,430541.75,239305,669846.75
421775,202003,30,19,11,19855,11495,31350
421780,202003,194,153,41,159885.5,43890,203775.5
421790,202003,154,130,24,136895,25080,161975
421795,202003,19,15,4,15675,4180,19855
421800,202003,514,330,184,344850,192280.25,537130.25
421810,202003,70,57,13,60610,13585,74195
421820,202003,320,209,111,222585.5,115995,338580.5
421825,202003,132,113,19,118085,19855,137940
421830,202003,136,95,41,100320,42845,143165
421835,202003,6,4,2,4180,2090,6270
421840,202003,52,44,8,45980,8360,54340
421850,202003,79,68,11,71060,11495,82555
421860,202003,37,31,6,32395,7315,39710
421870,202003,989,738,251,774367.56,263343.96,1037711.52
421875,202003,55,45,10,47025,10450,57475
421880,202003,165,115,50,120175,53295.5,173470.5
421885,202003,21,17,4,17765,4180,21945
421890,202003,135,95,40,99275,41800,141075
421895,202003,45,40,5,41800,5225,47025
421900,202003,153,119,34,125400,35530,160930
421910,202003,69,42,27,43890,28215,72105
421915,202003,30,25,5,26125,5225,31350
421917,202003,36,27,9,30305,9405,39710
421920,202003,42,38,4,39710,4180,43890
421930,202003,686,545,141,571615.87,148390,720005.87
421935,202003,48,42,6,43890,6270,50160
421940,202003,43,38,5,39710,5225,44935
421950,202003,857,575,282,600875.5,294690,895565.5
421960,202003,46,40,6,41800.5,6270,48070.5
421970,202003,359,232,127,242440.5,132715,375155.5
421985,202003,25,15,10,16720,10450,27170
422000,202003,0,,,,,0.0
430003,202003,182,56,126,58520,131670,190190
430005,202003,36,26,10,28215,10450,38665
430010,202003,264,191,73,199595,76285,275880
430020,202003,144,97,47,101365.5,49115,150480.5
430030,202003,119,97,22,101365,22990,124355
430040,202003,2915,1715,1200,1793222,1259225.5,3052447.5
430045,202003,69,58,11,60610,11495,72105
430047,202003,6,6,0,6270,1045,7315
430050,202003,79,67,12,70015,13585,83600
430055,202003,12,11,1,11495,1045,12540
430057,202003,5,4,1,4180,1045,5225
430060,202003,3657,2133,1524,2233166.75,1595715,3828881.75
430063,202003,51,47,4,49115,4180,53295
430064,202003,151,122,29,128535,30305,158840
430066,202003,5,2,3,2090,3135,5225
430070,202003,45,32,13,33440,13585,47025
430080,202003,70,47,23,50160,24035,74195
430085,202003,32,10,22,10450,22990,33440
430087,202003,29,21,8,21945.75,8360,30305.75
430090,202003,70,63,7,65835,7315,73150
430100,202003,123,84,39,87780,40755,128535
430105,202003,151,84,67,87780,70015,157795
430107,202003,18,12,6,12540,6270,18810
430110,202003,435,252,183,263340,193325,456665
430120,202003,152,141,11,147345,11495,158840
430130,202003,797,487,310,509960.5,323950,833910.5
430140,202003,125,117,8,122265,8360,130625
430150,202003,107,69,38,72105,39710,111815
430155,202003,34,30,4,32395,4180,36575
430160,202003,3623,2131,1492,2233167.75,1566455.5,3799623.25
430163,202003,361,165,196,172425,205865,378290
430165,202003,29,20,9,20900,10450,31350
430170,202003,92,78,14,81510,14630,96140
430175,202003,77,60,17,62700,18810,81510
430180,202003,105,86,19,89870,19855,109725
430185,202003,32,22,10,22990,10450,33440
430187,202003,80,38,42,39710,44935,84645
430190,202003,220,120,100,125400,104500,229900
430192,202003,13,11,2,11495,2090,13585
430195,202003,16,11,5,11495,5225,16720
430200,202003,165,142,23,148390,24035,172425
430205,202003,21,20,1,20900,1045,21945
430210,202003,688,531,157,556985.5,166155.5,723141.0
430215,202003,13,10,3,10450,3135,13585
430220,202003,70,48,22,50160,22990,73150
430222,202003,12,6,6,6270,6270,12540
430223,202003,14,7,7,7315,7315,14630
430225,202003,3,1,2,1045,2090,3135
430230,202003,320,187,133,195415,140030,335445
430235,202003,56,44,12,45980,12540,58520
430237,202003,24,19,5,19855,5225,25080
430240,202003,129,86,43,89870,44935,134805
430245,202003,69,55,14,57475,14630,72105
430250,202003,189,113,76,118085,79420,197505
430258,202003,9,8,1,8360,1045,9405
430260,202003,32,28,4,29260,4180,33440
430265,202003,36,31,5,32395,5225,37620
430270,202003,519,385,134,402326.25,140030,542356.25
430280,202003,1025,627,398,657305,415910,1073215
430290,202003,396,218,178,227810,186010,413820
430300,202003,2051,1133,918,1187120.5,961400.5,2148521.0
430310,202003,1971,999,972,1046045.5,1019921.21,2065966.71
430320,202003,56,45,11,47025,11495,58520
430330,202003,97,86,11,89870,11495,101365
430340,202003,72,58,14,60610,14630,75240
430350,202003,1654,1122,532,1175626,559075,1734701
430355,202003,20,18,2,18810,2090,20900
430360,202003,87,45,42,47025,43890,90915
430367,202003,35,27,8,28215,9405,37620
430370,202003,54,47,7,49115,7315,56430
430380,202003,137,103,34,107635,35530,143165
430390,202003,581,358,223,376200,234080,610280
430400,202003,135,100,35,104500.5,36575,141075.5
430410,202003,55,43,12,44935,12540,57475
430420,202003,504,334,170,351120.85,178695,529815.85
430430,202003,53,52,1,53644.03,1045,54689.03
430435,202003,150,112,38,118085,39710,157795
430440,202003,494,323,171,338580,179740,518320
430450,202003,1149,945,204,989615,215270,1204885
430460,202003,5182,2729,2453,2857031.4,2573835,5430866.4
430461,202003,16,15,1,15675,1045,16720
430462,202003,10,6,4,6270,4180,10450
430463,202003,1069,575,494,602965,517275,1120240
430465,202003,25,14,11,14630,11495,26125
430466,202003,674,481,193,503690.5,202730,706420.5
430467,202003,104,55,49,57475,51205,108680
430468,202003,114,69,45,72105,47025,119130
430469,202003,23,18,5,18810,5225,24035
430470,202003,1146,639,507,671202.12,530860,1202062.12
430471,202003,55,37,18,38665,18810,57475
430480,202003,100,63,37,65835,38665,104500
430485,202003,6,6,0,6270.5,0,6270.5
430490,202003,80,63,17,65835,17765,83600
430495,202003,33,26,7,27170,7315,34485
430500,202003,187,127,60,132715,62700,195415
430510,202003,3461,2250,1211,2361700.98,1270720,3632420.98
430511,202003,16,15,1,15675,1045,16720
430512,202003,150,104,46,108680,48070,156750
430513,202003,53,43,10,44935,10450,55385
430515,202003,27,25,2,26125,2090,28215
430517,202003,166,146,20,152570,20900,173470
430520,202003,348,243,105,254980,109725,364705
430530,202003,88,51,37,53295,38665,91960
430535,202003,459,309,150,323950,156750,480700
430537,202003,9,9,0,9405,0,9405
430540,202003,82,56,26,58520,27170,85690
430543,202003,342,109,233,114950,244530,359480
430544,202003,43,40,3,41800,3135,44935
430545,202003,368,190,178,198550,186010,384560
430550,202003,41,34,7,35530,7315,42845
430558,202003,3,2,1,2090,1045,3135
430560,202003,56,30,26,31350,27170,58520
430570,202003,105,40,65,41800,68970,110770
430580,202003,129,106,23,110770,24035,134805
430583,202003,13,13,0,13585,0,13585
430585,202003,12,5,7,5225,7315,12540
430587,202003,14,7,7,7315,7315,14630
430590,202003,140,115,25,120175,26125,146300
430593,202003,2,2,0,2090,0,2090
430595,202003,17,14,3,14630,3135,17765
430597,202003,47,25,22,26125,22990,49115
430600,202003,219,160,59,167200,61655,228855
430605,202003,159,100,59,104500,61655,166155
430607,202003,23,20,3,20900,3135,24035
430610,202003,1617,763,854,797335,896610.5,1693945.5
430613,202003,2,2,0,2090,0,2090
430620,202003,108,77,31,80465,33440,113905
430630,202003,48,42,6,43890,6270,50160
430632,202003,32,27,5,28215,5225,33440
430635,202003,34,31,3,32395,3135,35530
430637,202003,56,30,26,31350,27170,58520
430640,202003,179,101,78,106590,81510,188100
430642,202003,21,18,3,18810,3135,21945
430645,202003,36,29,7,31350,7315,38665
430650,202003,249,203,46,212135.5,48070,260205.5
430655,202003,2,2,0,2090,0,2090
430660,202003,972,483,489,506825,511005.5,1017830.5
430670,202003,75,51,24,53295,25080,78375
430673,202003,67,40,27,41800,28215,70015
430675,202003,11,9,2,9405,2090,11495
430676,202003,507,301,206,315590,217360,532950
430680,202003,241,167,74,174516,77330,251846
430690,202003,527,328,199,342760,210045.29,552805.29
430692,202003,9,6,3,6270,3135,9405
430693,202003,136,90,46,95095,48070,143165
430695,202003,69,57,12,59565,12540,72105
430697,202003,56,35,21,36575,21945,58520
430700,202003,1504,1049,455,1100385.9,479655,1580040.9
430705,202003,21,20,1,20900,1045,21945
430710,202003,257,164,93,171380,97185,268565
430720,202003,107,91,16,95095,16720,111815
430730,202003,137,118,19,123310,19855,143165
430740,202003,72,48,24,50160,25080,75240
430745,202003,30,23,7,24035,7315,31350
430750,202003,322,212,110,221540,114950,336490
430755,202003,86,48,38,50160,39710,89870
430760,202003,378,219,159,229900.6,166155,396055.6
430770,202003,1483,778,705,815100.5,737770.5,1552871.0
430780,202003,292,185,107,194370,112860,307230
430781,202003,26,22,4,22990,4180,27170
430783,202003,60,48,12,50160,12540,62700
430786,202003,5,3,2,3135,2090,5225
430790,202003,514,339,175,355300,183920.5,539220.5
430800,202003,152,126,26,131670.76,27170,158840.76
430805,202003,41,37,4,38665,4180,42845
430807,202003,42,23,19,24035,19855,43890
430810,202003,74,46,28,48070,29260,77330
430820,202003,144,86,58,90915,60610,151525
430825,202003,10,8,2,8360,2090,10450
430830,202003,236,217,19,227810.5,19855,247665.5
430840,202003,124,83,41,86735,42845,129580
430843,202003,6,4,2,4180,2090,6270
430845,202003,71,40,31,41800,32395,74195
430850,202003,580,406,174,426360,181830,608190
430860,202003,160,102,58,106590,60610,167200
430865,202003,72,41,31,42845,32395,75240
430870,202003,78,63,15,65835,15675,81510
430880,202003,152,114,38,119130,39710,158840
430885,202003,9,7,2,7315,2090,9405
430890,202003,348,208,140,218405,146300,364705
430900,202003,501,352,149,367840,156750,524590
430905,202003,114,49,65,51205,67925,119130
430910,202003,282,155,127,161975,133760,295735
430912,202003,5,5,0,5225,0,5225
430915,202003,33,28,5,29260,5225,34485
430920,202003,4248,2279,1969,2387825,2072235,4460060
430925,202003,4,3,1,3135,1045,4180
430930,202003,2085,1215,870,1272812.25,910195,2183007.25
430940,202003,258,167,91,175560,95095,270655
430950,202003,149,123,26,128535,27170,155705
430955,202003,23,12,11,12540,11495,24035
430957,202003,17,15,2,15675,2090,17765
430960,202003,244,166,78,174515,82555,257070
430965,202003,115,72,43,75240,44935,120175
430970,202003,83,70,13,73150,13585,86735
430975,202003,41,37,4,38665,4180,42845
430980,202003,45,28,17,29260,17765,47025
430990,202003,109,86,23,90915,24035,114950
430995,202003,113,107,6,111815,6270,118085
431000,202003,301,141,160,147346.1,167200,314546.1
431010,202003,351,200,151,209000,158840,367840
431020,202003,1858,1078,780,1129645.5,818235,1947880.5
431030,202003,41,34,7,35530,7315,42845
431033,202003,394,193,201,201685,211090,412775
431036,202003,12,7,5,7315,5225,12540
431040,202003,139,83,56,87780,58520,146300
431041,202003,40,27,13,28215.5,13585,41800.5
431043,202003,45,26,19,27170,19855,47025
431046,202003,11,7,4,7315,4180,11495
431050,202003,201,126,75,131670,79420,211090
431053,202003,69,41,28,42845,29260,72105
431055,202003,62,42,20,43890,20900,64790
431057,202003,18,18,0,18810,0,18810
431060,202003,1618,1052,566,1101431.34,594605.75,1696037.09
431065,202003,19,11,8,11495,8360,19855
431070,202003,63,57,6,60610,6270,66880
431075,202003,7,7,0,7315,0,7315
431080,202003,133,82,51,85690,53295,138985
431085,202003,32,29,3,30305,3135,33440
431087,202003,14,12,2,12540,2090,14630
431090,202003,55,43,12,44935,12540,57475
431100,202003,1209,732,477,767031.55,498465,1265496.55
431110,202003,229,139,90,145255,94050.5,239305.5
431112,202003,28,16,12,16720,12540,29260
431113,202003,33,24,9,25080,9405,34485
431115,202003,154,109,45,113905,47025,160930
431120,202003,603,360,243,376200,254980,631180
431123,202003,3,2,1,2090,1045,3135
431125,202003,96,87,9,90915,9405,100320
431127,202003,9,4,5,4180,5225,9405
431130,202003,693,455,238,476520,249755,726275
431140,202003,752,518,234,543400.5,244530,787930.5
431142,202003,27,23,4,24035.67,4180,28215.67
431150,202003,194,148,46,154660,48070,202730
431160,202003,51,46,5,49115,5225,54340
431162,202003,5,4,1,4180,1045,5225
431164,202003,5,5,0,5225,0,5225
431170,202003,105,83,22,86735,22990,109725
431171,202003,68,40,28,41800,29260.5,71060.5
431173,202003,1,1,0,1045,0,1045
431175,202003,195,100,95,104500.5,100320,204820.5
431177,202003,79,58,21,60610,21945,82555
431179,202003,13,11,2,11495,2090,13585
431180,202003,434,262,172,275880,179740,455620
431190,202003,78,60,18,63745,18810,82555
431198,202003,75,54,21,56430,21945,78375
431200,202003,21,17,4,17765,4180,21945
431205,202003,20,19,1,19855,1045,20900
431210,202003,94,58,36,60610,37620,98230
431213,202003,31,27,4,28215,4180,32395
431215,202003,21,18,3,18810,3135,21945
431217,202003,4,3,1,3135,1045,4180
431220,202003,66,57,9,59565.87,9405,68970.87
431225,202003,146,95,51,99275,53295,152570
431230,202003,100,86,14,89870,14630,104500
431235,202003,7,7,0,7315,0,7315
431237,202003,22,16,6,16720,6270,22990
431238,202003,9,6,3,6270,3135,9405
431240,202003,999,637,362,665665,380380,1046045
431242,202003,38,37,1,38665,1045,39710
431244,202003,13,9,4,9405,4180,13585
431245,202003,50,36,14,37620,14630,52250
431247,202003,10,7,3,7315,3135,10450
431250,202003,279,143,136,149435,142120,291555
431260,202003,58,45,13,48070,13585,61655
431261,202003,17,11,6,11495,6270,17765
431262,202003,17,16,1,16720,1045,17765
431265,202003,148,80,68,83600,71060,154660
431267,202003,16,14,2,14630,2090,16720
431270,202003,320,261,59,274835,61655,336490
431275,202003,37,34,3,35530,3135,38665
431280,202003,19,15,4,15675,4180,19855
431290,202003,23,20,3,20900,3135,24035
431295,202003,2,2,0,2090,0,2090
431300,202003,19,17,2,17765,3135,20900
431301,202003,6,6,0,6270,0,6270
431303,202003,57,38,19,39710,19855,59565
431306,202003,238,127,111,133573.99,115995,249568.99
431308,202003,7,5,2,5225,2090,7315
431310,202003,64,53,11,55385,11495,66880
431320,202003,143,85,58,88825,60610,149435
431330,202003,173,112,61,117040,63745,180785
431333,202003,24,20,4,20900,4180,25080
431335,202003,9,5,4,5225,4180,9405
431337,202003,346,157,189,165110,197505,362615
431339,202003,21,18,3,18810,3135,21945
431340,202003,2990,1653,1337,1731483.74,1404481.25,3135964.99
431342,202003,36,23,13,24035,13585,37620
431344,202003,18,18,0,18810,0,18810
431346,202003,5,5,0,5225,0,5225
431349,202003,34,30,4,31350,4180,35530
431350,202003,929,537,392,562210.75,411730.5,973941.25
431360,202003,46,40,6,41800,6270,48070
431365,202003,329,158,171,165110,178695,343805
431370,202003,1334,779,555,815100.5,579975,1395075.5
431380,202003,96,83,13,86735,13585,100320
431390,202003,497,266,231,279015,243485,522500
431395,202003,288,127,161,132715,168245,300960
431400,202003,42,29,13,30305,13585,43890
431402,202003,102,73,29,76285,30305,106590
431403,202003,25,14,11,14630,11495,26125
431405,202003,665,361,304,377245.25,317680,694925.25
431406,202003,29,25,4,26125,4180,30305
431407,202003,54,43,11,44935,11495,56430
431410,202003,3380,2062,1318,2170465.5,1383580.75,3554046.25
431413,202003,15,12,3,12540,3135,15675
431415,202003,71,51,20,53295,20900,74195
431417,202003,23,12,11,12540,11495,24035
431420,202003,317,215,102,224675,106590,331265
431430,202003,48,22,26,22990,27170,50160
431440,202003,8787,6123,2664,6412128.43,2791196.76,9203325.19
431442,202003,30,14,16,14630,16720,31350
431445,202003,23,21,2,21945,2090,24035
431446,202003,4,4,0,4180,0,4180
431447,202003,83,59,24,61655,25080,86735
431449,202003,53,46,7,48070,7315,55385
431450,202003,409,275,134,288420,141075,429495
431454,202003,0,,,,,0.0
431455,202003,53,41,12,42845,12540,55385
431460,202003,520,359,161,377245,169290,546535
431470,202003,118,90,28,94050,30305,124355
431475,202003,11,9,2,9405,2090,11495
431477,202003,37,25,12,26125,12540,38665
431478,202003,9,8,1,8360,1045,9405
431480,202003,498,302,196,316635,204820,521455
431490,202003,28148,15883,12265,16639545.59,12847233.79,29486779.38
431500,202003,75,61,14,63745,14630,78375
431505,202003,25,15,10,15675,10450,26125
431507,202003,10,8,2,8360,2090,10450
431510,202003,255,180,75,188100.25,78375,266475.25
431513,202003,24,21,3,21945,3135,25080
431514,202003,6,5,1,5225,1045,6270
431515,202003,82,68,14,72105,14630,86735
431517,202003,4,3,1,3135,1045,4180
431520,202003,39,34,5,35530,5225,40755
431530,202003,1463,663,800,694925,839135,1534060
431531,202003,24,23,1,24035,1045,25080
431532,202003,33,24,9,25080,9405,34485
431535,202003,27,16,11,16720,11495,28215
431540,202003,138,117,21,122265,22990,145255
431545,202003,14,12,2,12540,2090,14630
431550,202003,345,191,154,199595,163020,362615
431555,202003,13,13,0,13585,0,13585
431560,202003,4519,3096,1423,3242638.35,1493305,4735943.35
431570,202003,814,427,387,446216,405460,851676
431575,202003,39,22,17,22990,17765,40755
431580,202003,95,63,32,65835,33440,99275
431590,202003,144,123,21,128535,21945,150480
431595,202003,18,15,3,15675,3135,18810
431600,202003,241,139,102,145255,107635,252890
431610,202003,114,83,31,87780,32395,120175
431620,202003,44,37,7,38665,7315,45980
431630,202003,126,106,20,110770,20900,131670
431640,202003,1327,848,479,887205.5,502645.5,1389851.0
431642,202003,35,33,2,34485,2090,36575
431643,202003,44,21,23,21945,24035,45980
431645,202003,321,190,131,198550,136895,335445
431647,202003,8,8,0,8360,0,8360
431650,202003,33,23,10,24035,10450,34485
431660,202003,315,203,112,212135,119130,331265
431670,202003,224,103,121,107635,127490,235125
431673,202003,3,3,0,3135,0,3135
431675,202003,27,21,6,21945,6270,28215
431680,202003,1098,808,290,850630,306185,1156815
431690,202003,4645,2806,1839,2938543.1,1932206,4870749.1
431695,202003,22,16,6,16720,6270,22990
431697,202003,1,0,1,0,1045,1045
431700,202003,176,137,39,143165,40755,183920
431710,202003,3979,1752,2227,1832930.5,2330350,4163280.5
431720,202003,1310,809,501,846973,526680,1373653
431725,202003,0,0,0,0,0,0
431730,202003,1156,791,365,828687.9,381425,1210112.9
431740,202003,1333,659,674,689700,705375.5,1395075.5
431750,202003,1799,1178,621,1232055.55,652080,1884135.55
431755,202003,5,4,1,4180,1045,5225
431760,202003,1023,652,371,682387,387695,1070082
431770,202003,410,296,114,309320,119130,428450
431775,202003,30,22,8,22990,8360,31350
431780,202003,542,332,210,346940,219450,566390
431790,202003,163,127,36,133760,37620,171380
431795,202003,12,10,2,10450,2090,12540
431800,202003,3235,1701,1534,1780682.7,1604076,3384758.7
431805,202003,18,16,2,16720,2090,18810
431810,202003,596,395,201,413820,210045,623865
431820,202003,323,193,130,203775,135850,339625
431830,202003,2309,1385,924,1449415,969760,2419175
431840,202003,483,321,162,337535,171380,508915
431842,202003,36,29,7,30305,7315,37620
431843,202003,10,8,2,8360,2090,10450
431844,202003,16,13,3,13585,3135,16720
431845,202003,26,24,2,25080,2090,27170
431846,202003,26,22,4,22990,4180,27170
431848,202003,11,9,2,9405,2090,11495
431849,202003,8,6,2,6270,2090,8360
431850,202003,790,647,143,678205,149435,827640
431860,202003,109,73,36,77330,37620,114950
431861,202003,6,2,4,2090,4180,6270
431862,202003,57,38,19,39710,19855,59565
431870,202003,3454,2008,1446,2105675.5,1514205,3619880.5
431880,202003,919,674,245,706420,256025,962445
431890,202003,1274,772,502,809875.5,527725,1337600.5
431900,202003,181,128,53,133760,55385,189145
431910,202003,54,39,15,40755,15675,56430
431912,202003,42,25,17,26125,17765,43890
431915,202003,122,95,27,100320,28215,128535
431920,202003,151,109,42,114950,43890,158840
431930,202003,79,64,15,66880,15675,82555
431935,202003,3,3,0,3135,0,3135
431936,202003,12,11,1,11495,1045,12540
431937,202003,17,13,4,13585,4180,17765
431940,202003,461,309,152,322905,158840.25,481745.25
431950,202003,500,313,187,328130.5,198550,526680.5
431960,202003,723,399,324,416955.5,338580,755535.5
431970,202003,70,63,7,65835,7315,73150
431971,202003,3,3,0,3135,0,3135
431973,202003,21,17,4,17765,4180,21945
431975,202003,9,8,1,8360,1045,9405
431980,202003,211,133,78,138985,82555,221540
431990,202003,1140,610,530,639472.52,559075,1198547.52
432000,202003,1684,897,787,942591.75,825551,1768142.75
432010,202003,278,190,88,198550,91960,290510
432020,202003,169,141,28,147345,29260,176605
432023,202003,15,13,2,13585,2090,15675
432026,202003,67,62,5,65835,5225,71060
432030,202003,70,36,34,37620,35530,73150
432032,202003,20,16,4,16720,4180,20900
432035,202003,53,43,10,45980,10450,56430
432040,202003,97,67,30,70015,31350,101365
432045,202003,5,4,1,4180,1045,5225
432050,202003,81,48,33,50160,34485,84645
432055,202003,119,87,32,90915,33440,124355
432057,202003,5,4,1,4180.5,1045,5225.5
432060,202003,33,30,3,31350,3135,34485
432065,202003,33,29,4,30305,4180,34485
432067,202003,89,80,9,83600,9405,93005
432070,202003,390,300,90,313762.5,94050,407812.5
432080,202003,812,564,248,589380,262295,851675
432085,202003,11,8,3,8360,3135,11495
432090,202003,267,181,86,190190,89870,280060
432100,202003,175,115,60,120175,63745,183920
432110,202003,570,385,185,402325,193325,595650
432120,202003,935,552,383,576840,402325.5,979165.5
432130,202003,499,358,141,376200,147345,523545
432132,202003,22,19,3,19855,3135,22990
432135,202003,79,65,14,67925,14630,82555
432140,202003,260,203,57,212135,59565,271700
432143,202003,203,128,75,133760,78375,212135
432145,202003,277,192,85,202730,89870,292600
432146,202003,14,13,1,13585,1045,14630
432147,202003,96,55,41,57475,42845,100320
432149,202003,15,10,5,10450,5225,15675
432150,202003,868,527,341,551760.5,356345,908105.5
432160,202003,1460,753,707,787930.22,740905,1528835.22
432162,202003,4,3,1,3135,1045,4180
432163,202003,19,14,5,14630,6270,20900
432166,202003,114,83,31,86997.5,32395,119392.5
432170,202003,226,116,110,121220,115995,237215
432180,202003,539,338,201,354255,210045.5,564300.5
432183,202003,7,7,0,7315,0,7315
432185,202003,77,68,9,71060,9405,80465
432190,202003,474,281,193,294690,202730,497420
432195,202003,86,72,14,75240,14630,89870
432200,202003,397,253,144,265430,150480,415910
432210,202003,118,75,43,78375,44935,123310
432215,202003,44,40,4,41800,4180,45980
432218,202003,20,19,1,19855,1045,20900
432220,202003,672,348,324,366795,339625.29,706420.29
432225,202003,14,8,6,8360,6270,14630
432230,202003,133,93,40,97185,41800,138985
432232,202003,12,11,1,11495,1045,12540
432234,202003,4,3,1,3135,1045,4180
432235,202003,3,3,0,3135,0,3135
432237,202003,27,15,12,15675,12540,28215
432240,202003,4298,2419,1879,2528901,1970871.5,4499772.5
432250,202003,1098,715,383,748220,400235,1148455
432252,202003,43,40,3,41800,3135,44935
432253,202003,61,49,12,51205,12540,63745
432254,202003,27,13,14,13585,14630,28215
432255,202003,13,12,1,12540,1045,13585
432260,202003,812,638,174,671935.5,182875,854810.5
432270,202003,237,178,59,188100,61655,249755
432280,202003,142,107,35,111815,36575,148390
432285,202003,2,2,0,2090,0,2090
432290,202003,67,59,8,61655,8360,70015
432300,202003,4607,2540,2067,2657367.07,2167331.27,4824698.34
432310,202003,126,102,24,106590,25080,131670
432320,202003,22,17,5,17765,5225,22990
432330,202003,17,12,5,12540,5225,17765
432335,202003,8,6,2,6270,2090,8360
432340,202003,37,32,5,33440,5225,38665
432345,202003,100,69,31,72105,32395,104500
432350,202003,20,19,1,19855,1045,20900
432360,202003,6,5,1,5225,1045,6270
432370,202003,25,24,1,25080,1045,26125
432375,202003,30,27,3,28215,3135,31350
432377,202003,9,9,0,9405,0,9405
432380,202003,165,78,87,81510,91960,173470
500020,202003,239,132,107,137940,111815,249755
500025,202003,135,68,67,71060,70015,141075
500060,202003,1449,908,541,950950,566390.5,1517340.5
500070,202003,802,381,421,401280.29,442035,843315.29
500080,202003,133,103,30,108680,31350,140030
500085,202003,135,111,24,115995.5,25080,141075.5
500090,202003,344,154,190,160930,200640,361570
500100,202003,722,374,348,391875,365751,757626
500110,202003,2256,1044,1212,1092026,1270720.75,2362746.75
500124,202003,263,149,114,155705,119130,274835
500150,202003,340,134,206,140030,215270,355300
500190,202003,518,351,167,367840,175560.5,543400.5
500200,202003,186,161,25,168245.2,26125,194370.2
500210,202003,1540,541,999,566390,1045000.25,1611390.25
500215,202003,243,138,105,144210,110770,254980
500220,202003,747,481,266,504735.77,277970,782705.77
500230,202003,239,155,84,161975,87780,249755
500240,202003,682,468,214,492195.4,225720,717915.4
500260,202003,585,223,362,235125,380380,615505
500270,202003,29745,12711,17034,13314754.7,17875776.51,31190531.21
500280,202003,201,69,132,73150,138985,212135
500290,202003,1174,708,466,740905.5,489060,1229965.5
500295,202003,442,286,156,298870.5,165110,463980.5
500310,202003,74,24,50,25080,52250,77330
500315,202003,719,421,298,439945,311410,751355
500320,202003,3638,1792,1846,1877866.04,1931160,3809026.04
500325,202003,937,511,426,535041,447260.5,982301.5
500330,202003,1469,683,786,715825.5,823460,1539285.5
500345,202003,309,234,75,244530.5,78375,322905.5
500348,202003,245,146,99,152570,103455,256025
500350,202003,118,55,63,57475,66880,124355
500370,202003,5548,2496,3052,2610411,3205016.5,5815427.5
500375,202003,337,239,98,250800,104500,355300
500380,202003,589,337,252,353210,263340,616550
500390,202003,78,37,41,38665,42845,81510
500400,202003,213,142,71,149435,74195,223630
500410,202003,546,226,320,237215,335445,572660
500430,202003,517,366,151,384560,157795,542355
500440,202003,196,103,93,108680,97185,205865
500450,202003,393,171,222,179740,233035,412775
500460,202003,274,145,129,151525.5,134805,286330.5
500470,202003,428,338,90,353210.5,94050,447260.5
500480,202003,107,63,44,65835,45980,111815
500490,202003,109,46,63,48070,66880,114950
500500,202003,1439,521,918,546535,962445,1508980
500510,202003,43,35,8,36575,9405,45980
500515,202003,103,72,31,75240,33440,108680
500520,202003,324,173,151,180785,158840.5,339625.5
500525,202003,89,48,41,50160,42845,93005
500540,202003,893,375,518,391875,542355.5,934230.5
500560,202003,919,520,399,545490,416956,962446
500568,202003,982,557,425,585200,445170.5,1030370.5
500570,202003,1189,683,506,714780.5,529815,1244595.5
500580,202003,340,174,166,181830,173470,355300
500600,202003,326,161,165,168245,172425,340670
500620,202003,900,634,266,665665.4,279015,944680.4
500625,202003,77,60,17,62700,17765,80465
500627,202003,21,10,11,11495,11495,22990
500630,202003,1564,855,709,896612.54,745085.5,1641698.04
500635,202003,517,305,212,318725,221540,540265
500640,202003,385,203,182,213180,190190,403370
500660,202003,5460,2015,3445,2110900.5,3605251.5,5716152.0
500690,202003,589,207,382,217360,400235,617595
500710,202003,400,204,196,213180,204820,418000
500720,202003,962,548,414,572660.73,432630,1005290.73
500730,202003,194,117,77,122265,80465,202730
500740,202003,893,376,517,395010,540265,935275
500750,202003,138,44,94,45980,98230,144210
500755,202003,127,90,37,94050.5,38665,132715.5
500769,202003,744,411,333,429495.5,349030,778525.5
500770,202003,396,212,184,221540,192280,413820
500780,202003,154,102,52,106590,54340.5,160930.5
500790,202003,1072,542,530,570570,554895,1125465
500793,202003,274,149,125,155705,130625.5,286330.5
500795,202003,165,114,51,119130,53295,172425
500797,202003,52,37,15,38665,15675,54340
500800,202003,421,187,234,195415,244530,439945
500830,202003,2212,1232,980,1290575,1026190,2316765
500840,202003,137,102,35,106590,36575,143165
510010,202003,167,91,76,95095,79420,174515
510020,202003,501,220,281,230945,294690,525635
510025,202003,1685,958,727,1002155.2,759715.5,1761870.7
510030,202003,667,344,323,361570,338580.5,700150.5
510035,202003,125,61,64,63745,66880,130625
510040,202003,397,178,219,187055,228855.3,415910.3
510050,202003,407,216,191,225720,199595.73,425315.73
510060,202003,121,61,60,63745,62700,126445
510080,202003,229,87,142,90915,148390,239305
510100,202003,68,29,39,30305,40755,71060
510120,202003,37,23,14,24035,14630,38665
510125,202003,380,235,145,245575,151525,397100
510130,202003,556,318,238,332310,248710.5,581020.5
510140,202003,426,124,302,130625,315590,446215
510160,202003,112,37,75,38665,78375,117040
510170,202003,805,490,315,515185.03,333355,848540.03
510180,202003,2919,1378,1541,1445236,1616616.25,3061852.25
510185,202003,20,8,12,8360,12540,20900
510190,202003,234,85,149,89870,155705,245575
510250,202003,2556,1504,1052,1574815.5,1108746,2683561.5
510260,202003,173,127,46,132715,48070,180785
510263,202003,470,264,206,275880.5,216315,492195.5
510267,202003,675,378,297,395010.5,318725,713735.5
510268,202003,60,26,34,28215,35530,63745
510269,202003,73,34,39,35530,40755,76285
510270,202003,390,196,194,204820,204820,409640
510279,202003,212,158,54,165110,57475,222585
510285,202003,185,74,111,77330,115995,193325
510300,202003,514,273,241,285285,252890,538175
510305,202003,207,99,108,103455,112860,216315
510310,202003,102,53,49,55385,51205,106590
510320,202003,844,527,317,551760,332310,884070
510325,202003,403,173,230,180785,240350,421135
510330,202003,421,231,190,241395,198550,439945
510335,202003,634,360,274,377245,286330,663575
510336,202003,53,38,15,39710,15675,55385
510337,202003,109,47,62,49115,64790,113905
510340,202003,17284,7880,9404,8263861.79,9853306.75,18117168.54
510343,202003,65,47,18,49115,18810,67925
510345,202003,162,104,58,109725,60610.5,170335.5
510350,202003,640,357,283,374110,295735.5,669845.5
510360,202003,198,119,79,125400,82555,207955
510370,202003,148,72,76,75240,80465,155705
510380,202003,86,64,22,66880,22990,89870
510385,202003,61,25,36,26125,37620,63745
510390,202003,106,47,59,49115,61655,110770
510395,202003,46,33,13,34485,13585,48070
510410,202003,713,463,250,483835,261250,745085
510420,202003,571,276,295,288420,308275,596695
510450,202003,47,24,23,26125,24035,50160
510452,202003,49,23,26,24035,27170,51205
510454,202003,50,24,26,25080,27170,52250
510455,202003,131,77,54,80465,56430,136895
510460,202003,178,90,88,97185.75,91960,189145.75
510480,202003,720,422,298,443080.2,313500,756580.2
510490,202003,350,179,171,189145,179740,368885
510500,202003,233,173,60,180785,63745,244530
510510,202003,788,462,326,483835.5,341715,825550.5
510515,202003,1196,635,561,664620,587290,1251910
510517,202003,251,105,146,109725,152570.5,262295.5
510520,202003,227,149,78,155705,82555,238260
510523,202003,99,75,24,78375,25080,103455
510525,202003,812,479,333,502645,347985,850630
510530,202003,20,14,6,14630,6270,20900
510550,202003,253,112,141,117040,147345,264385
510558,202003,290,141,149,147345,156750,304095
510560,202003,409,242,167,253935.5,175560,429495.5
510562,202003,641,462,179,483835,188100,671935
510590,202003,752,392,360,410685,376200,786885
510600,202003,242,128,114,135850,119130,254980
510610,202003,201,84,117,87780,122265,210045
510615,202003,182,81,101,84645,105545,190190
510617,202003,18,11,7,11495,7315,18810
510618,202003,116,55,61,57475,63745,121220
510619,202003,97,69,28,72105,29260,101365
510620,202003,168,94,74,99275,77330,176605
510621,202003,180,118,62,123310,64790,188100
510622,202003,498,306,192,319770,200640.5,520410.5
510623,202003,327,223,104,234080,108680,342760
510624,202003,92,46,46,48070,49115,97185
510625,202003,530,325,205,339625,214225.29,553850.29
510626,202003,110,69,41,72105,42845,114950
510627,202003,70,48,22,50160,22990,73150
510628,202003,150,91,59,96140,61655,157795
510629,202003,260,162,98,169290,102410,271700
510630,202003,443,225,218,235125,229900.08,465025.08
510631,202003,13,3,10,3135,10450,13585
510637,202003,350,202,148,211090,154660,365750
510642,202003,978,530,448,553850,471295,1025145
510645,202003,1,0,1,0,1045,1045
510650,202003,1425,933,492,977075.5,514140,1491215.5
510665,202003,79,37,42,38665,43890,82555
510670,202003,60,34,26,35530,27170,62700
510675,202003,1131,711,420,744040.5,439945,1183985.5
510677,202003,347,178,169,186010,176605,362615
510680,202003,104,60,44,62700,47025,109725
510682,202003,201,101,100,105545,104500,210045
510685,202003,53,40,13,41800,13585,55385
510700,202003,588,332,256,346940,269610,616550
510704,202003,1144,605,539,634315,563255,1197570
510706,202003,132,67,65,70015,67925,137940
510710,202003,385,268,117,281105,122265,403370
510715,202003,59,43,16,44935,16720,61655
510718,202003,208,104,104,109725,108680,218405
510719,202003,39,17,22,17765,22990,40755
510720,202003,190,130,60,136895,62700,199595
510724,202003,89,35,54,36575,56430,93005
510726,202003,49,25,24,26125,25080,51205
510729,202003,68,30,38,31350,39710,71060
510730,202003,468,260,208,271700,217360,489060
510735,202003,116,48,68,50160,71060,121220
510740,202003,22,11,11,11495,11495,22990
510757,202003,17,14,3,14630,3135,17765
510760,202003,7144,3681,3463,3856051.5,3629286.75,7485338.25
510770,202003,687,321,366,336490,382470,718960
510774,202003,18,7,11,7315,11495,18810
510775,202003,104,79,25,82555,26125,108680
510776,202003,30,11,19,11495,19855,31350
510777,202003,193,82,111,86735,115995,202730
510779,202003,50,23,27,24035,28215,52250
510780,202003,286,158,128,165110,133760,298870
510785,202003,391,212,179,221540,188100,409640
510787,202003,191,93,98,99275,102410,201685
510788,202003,3,0,3,0,3135,3135
510790,202003,2467,1295,1172,1354370.44,1227875,2582245.44
510792,202003,1141,643,498,675070,523545.66,1198615.66
510794,202003,113,59,54,62700,57475,120175
510795,202003,2348,1362,986,1429560.5,1045001,2474561.5
510800,202003,173,104,69,109725,72105,181830
510805,202003,177,117,60,122265,62700,184965
510810,202003,98,43,55,44935,57475,102410
510820,202003,241,119,122,124355.45,128535.12,252890.57
510830,202003,71,43,28,44935,29260,74195
510835,202003,15,10,5,10450,5225,15675
510840,202003,9099,4347,4752,4555158,4977335.5,9532493.5
510850,202003,214,86,128,89870,133760,223630
510860,202003,382,172,210,180785,220495.5,401280.5
510880,202003,66,50,16,52250,16720,68970
510885,202003,74,41,33,42845,34485,77330
510890,202003,65,39,26,40755,27170,67925
510895,202003,181,106,75,110770,78375.5,189145.5
520005,202003,89,43,46,44935,48070,93005
520010,202003,276,125,151,130625,157795.5,288420.5
520013,202003,700,448,252,468160,263340,731500
520015,202003,55,41,14,42845,14630,57475
520017,202003,85,48,37,50160.5,39710,89870.5
520020,202003,19,10,9,10450,9405,19855
520025,202003,2200,1140,1060,1193391,1109790,2303181
520030,202003,784,414,370,433675,388740,822415
520050,202003,71,50,21,52250,21945,74195
520055,202003,48,29,19,30305,19855,50160
520060,202003,169,113,56,118085,58520,176605
520080,202003,575,409,166,427405,173470,600875
520082,202003,19,13,6,13585,6270,19855
520085,202003,95,70,25,73150,26125,99275
520090,202003,90,61,29,65835,30305,96140
520110,202003,9147,3921,5226,4106851.5,5473712.5,9580564.0
520120,202003,14,8,6,8360,6270,14630
520130,202003,784,549,235,574750,246620.5,821370.5
520140,202003,11876,6601,5275,6907452.5,5524916.3,12432368.8
520145,202003,53,32,21,33440,21945,55385
520150,202003,166,132,34,137940,35530,173470
520160,202003,35,25,10,26125,10450,36575
520170,202003,246,142,104,149435,108680,258115
520180,202003,155,74,81,77330,84645,161975
520215,202003,203,134,69,140030,72105,212135
520235,202003,76,57,19,59565,19855,79420
520250,202003,129,77,52,80465,54340,134805
520260,202003,116,73,43,76285,44935,121220
520280,202003,48,32,16,33440,16720,50160
520310,202003,39,26,13,27170,13585,40755
520320,202003,168,107,61,112860,63745,176605
520330,202003,784,413,371,432630,387695,820325
520340,202003,345,202,143,211090,149435,360525
520350,202003,514,236,278,246620,292600,539220
520355,202003,88,52,36,54340,37620,91960
520357,202003,25,19,6,19855,6270,26125
520360,202003,1,1,0,1045,0,1045
520380,202003,138,73,65,77330,68970,146300
520390,202003,262,109,153,113905.5,159885,273790.5
520393,202003,15,11,4,11495,4180,15675
520396,202003,79,48,31,50160,32395,82555
520400,202003,203,120,83,126445,86735,213180
520410,202003,191,93,98,97185,102410,199595
520420,202003,20,13,7,13585,7315,20900
520425,202003,287,141,146,148390,152570.5,300960.5
520430,202003,472,244,228,255076.14,239305.25,494381.39
520440,202003,660,469,191,490105,200640,690745
520450,202003,1938,852,1086,891385,1139050,2030435
520455,202003,52,33,19,34485,19855,54340
520460,202003,34,20,14,20900,14630,35530
520465,202003,30,26,4,27170,4180,31350
520470,202003,422,268,154,280060,161975,442035
520480,202003,79,48,31,50160,32395,82555
520485,202003,118,40,78,41800,81510.5,123310.5
520490,202003,409,302,107,316635,112860,429495
520495,202003,163,98,65,102410,67925,170335
520500,202003,183,140,43,147345,44935,192280
520505,202003,182,103,79,107635,82555,190190
520510,202003,1790,851,939,890340.5,984392.25,1874732.75
520520,202003,41,30,11,31350,11495,42845
520530,202003,226,171,55,179740,58520,238260
520540,202003,564,391,173,409640,181830,591470
520545,202003,134,82,52,85690,54340,140030
520547,202003,55,32,23,33440,24035,57475
520549,202003,1210,571,639,597740.3,669845,1267585.3
520551,202003,294,156,138,163020,144210.5,307230.5
520552,202003,39,26,13,27170,13585,40755
520570,202003,16,10,6,10450,6270,16720
520580,202003,282,174,108,181830,112860,294690
520590,202003,151,93,58,97185,60610,157795
520620,202003,1145,529,616,554895.5,644765.25,1199660.75
520630,202003,38,22,16,22990,16720,39710
520640,202003,386,224,162,234080,169290,403370
520650,202003,68,37,31,38665,32395,71060
520660,202003,43,22,21,22990,21945,44935
520670,202003,35,29,6,30305,6270,36575
520680,202003,51,34,17,35530,17765,53295
520690,202003,38,11,27,11495,28215,39710
520710,202003,33,30,3,31350,3135,34485
520725,202003,181,132,49,137940,51205,189145
520735,202003,55,37,18,38665,18810,57475
520740,202003,414,199,215,210045,224675,434720
520750,202003,33,25,8,26125,8360,34485
520753,202003,60,41,19,42845,19855,62700
520760,202003,100,67,33,71060,34485,105545
520780,202003,285,212,73,222585,76285,298870
520790,202003,155,86,69,89870,72105,161975
520800,202003,3404,1835,1569,1922800.5,1644830.2,3567630.7
520810,202003,159,120,39,126445,40755,167200
520815,202003,5,4,1,4180,1045,5225
520830,202003,147,101,46,105545,48070,153615
520840,202003,342,226,116,237215,123310,360525
520850,202003,101,61,40,64790,41800,106590
520860,202003,1721,1104,617,1154725.5,644765.5,1799491.0
520870,202003,31539,14943,16596,15640525.62,17373133,33013658.62
520880,202003,1155,619,536,647900.5,563255.5,1211156.0
520890,202003,785,472,313,494285,328130,822415
520910,202003,968,515,453,539220.93,474430,1013650.93
520915,202003,97,73,24,76285,25080,101365
520920,202003,410,198,212,206910,221540,428450
520929,202003,18,17,1,17765,1045,18810
520940,202003,72,49,23,51205,24035,75240
520945,202003,17,11,6,11495,6270,17765
520960,202003,44,29,15,30305,16720,47025
520970,202003,336,206,130,216315,135850,352165
520980,202003,95,68,27,71060,28215,99275
520990,202003,451,307,144,320815,151525,472340
520993,202003,129,61,68,63745,71060,134805
520995,202003,245,141,104,148390.65,108680.5,257071.15
521000,202003,1541,900,641,945725,672980.5,1618705.5
521010,202003,670,323,347,339625.63,362615,702240.63
521015,202003,14,9,5,9405,5225,14630
521020,202003,1415,995,420,1041865,442035.5,1483900.5
521030,202003,49,33,16,35530,16720,52250
521040,202003,943,593,350,621775.25,367840.5,989615.75
521056,202003,45,32,13,33440,13585,47025
521060,202003,128,84,44,87780,45980,133760
521080,202003,431,330,101,345895.5,105545,451440.5
521090,202003,526,332,194,349030,202730,551760
521100,202003,272,204,68,213180,71060,284240
521120,202003,1056,738,318,773300.5,335445,1108745.5
521130,202003,351,251,100,262295,104500.5,366795.5
521140,202003,179,97,82,101365,85690,187055
521150,202003,2652,1151,1501,1203840.5,1574815,2778655.5
521160,202003,28,15,13,15675,13585,29260
521170,202003,207,114,93,119130,97185,216315
521180,202003,1181,748,433,782705,454575.25,1237280.25
521190,202003,2531,1067,1464,1116060,1533015.5,2649075.5
521200,202003,54,40,14,41800,14630,56430
521205,202003,11,8,3,8360,3135,11495
521210,202003,123,73,50,76285,52250,128535
521220,202003,793,550,243,576840,254980.25,831820.25
521225,202003,34,22,12,22990,12540,35530
521230,202003,105,69,36,73150,37620,110770
521250,202003,6177,3491,2686,3655414.8,2817323.5,6472738.3
521260,202003,27,14,13,14630,13585,28215
521270,202003,142,110,32,114950,33440,148390
521280,202003,428,258,170,270655,177650,448305
521290,202003,27,12,15,12540,15675,28215
521295,202003,97,63,34,65835,35530,101365
521300,202003,214,115,99,120175,103455.5,223630.5
521305,202003,36,25,11,26125,11495,37620
521308,202003,1080,822,258,860035,271700,1131735
521310,202003,1330,758,572,792110,598785.5,1390895.5
521340,202003,19,15,4,16720,4180,20900
521350,202003,125,93,32,97185,33440,130625
521370,202003,170,119,51,124355,53295,177650
521375,202003,171,91,80,96140,83600,179740
521377,202003,45,34,11,35530,11495,47025
521380,202003,1045,661,384,693881.05,401280,1095161.05
521385,202003,13,8,5,8360,5225,13585
521390,202003,100,81,19,84645,19855,104500
521400,202003,335,222,113,231990,118085,350075
521405,202003,136,75,61,78375,64790,143165
521410,202003,65,44,21,45980,21945,67925
521440,202003,189,140,49,148390,52250,200640
521450,202003,724,404,320,422180,334400,756580
521460,202003,1147,733,414,768075,432630,1200705
521470,202003,12,8,4,8360,4180,12540
521480,202003,43,30,13,31350,13585.25,44935.25
521483,202003,310,180,130,188100.5,135850,323950.5
521486,202003,279,182,97,190190,102410,292600
521487,202003,23,11,12,11495,12540,24035
521490,202003,27,15,12,15675,12540,28215
521500,202003,115,74,41,77330,42845,120175
521520,202003,43,31,12,32395,12540,44935
521523,202003,699,414,285,434720,298870,733590
521525,202003,47,30,17,31350,17765,49115
521530,202003,245,131,114,136895,120175,257070
521540,202003,27,14,13,14630,13585,28215
521550,202003,86,37,49,39710,51205,90915
521560,202003,809,552,257,576840.5,269610.75,846451.25
521565,202003,56,36,20,37620,20900,58520
521570,202003,523,345,178,361570.5,186010.25,547580.75
521580,202003,59,34,25,35530,26125,61655
521590,202003,37,18,19,18810,19855,38665
521600,202003,22,12,10,12540,10450,22990
521630,202003,241,128,113,133760,118085.25,251845.25
521640,202003,301,162,139,169290,145255,314545
521645,202003,28,16,12,16720,12540,29260
521680,202003,229,141,88,147345,91960,239305
521690,202003,2,2,0,2090,0,2090
521710,202003,1148,545,603,569525,632225,1201750
521720,202003,533,367,166,385605,173470.85,559075.85
521730,202003,631,305,326,319771,342760,662531
521740,202003,907,386,521,403370,547580.5,950950.5
521760,202003,1872,983,889,1029325.95,932140.5,1961466.45
521770,202003,823,518,305,541310,320815,862125
521800,202003,1982,1262,720,1319836.5,753445,2073281.5
521805,202003,32,18,14,18810,14630,33440
521810,202003,86,54,32,56430,33440,89870
521830,202003,941,672,269,705375.09,281105,986480.09
521839,202003,85,53,32,55385,33440,88825
521850,202003,1091,573,518,599830.36,541310.5,1141140.86
521860,202003,340,212,128,221540,133760,355300
521870,202003,72,42,30,43890,31350,75240
521878,202003,33,16,17,17765,17765,35530
521880,202003,4702,2100,2602,2203906.5,2727453,4931359.5
521890,202003,597,426,171,445170,178695,623865
521900,202003,281,230,51,240350,53295,293645
521910,202003,162,114,48,119130,50160,169290
521920,202003,45,21,24,21945,25080,47025
521925,202003,50,27,23,28215,24035,52250
521930,202003,1150,635,515,666710.5,541310.5,1208021.0
521935,202003,35,25,10,26125,10450,36575
521940,202003,200,99,101,103455,105545,209000
521945,202003,16,14,2,14630,2090,16720
521950,202003,9,5,4,5225,4180,9405
521960,202003,69,52,17,54340,17765,72105
521970,202003,394,251,143,262295,149435,411730
521971,202003,93,47,46,49115,48070,97185
521973,202003,32,17,15,17765,15675,33440
521975,202003,1398,694,704,725230.41,737771.47,1463001.88
521980,202003,240,161,79,168245,82555,250800
521990,202003,74,52,22,54340,24035,78375
522000,202003,286,178,108,185645.29,112860,298505.29
522005,202003,20,11,9,11495,9405,20900
522010,202003,1132,633,499,661485,522500,1183985
522015,202003,62,38,24,39710,25080,64790
522020,202003,879,502,377,525635,395010.5,920645.5
522026,202003,22,13,9,13585,9405,22990
522028,202003,16,12,4,12540,4180,16720
522040,202003,784,318,466,332310.25,486970,819280.25
522045,202003,2314,1416,898,1488081.25,939456.25,2427537.50
522050,202003,160,79,81,84645,84645,169290
522060,202003,535,340,195,357390,203775,561165
522068,202003,117,81,36,84645,37620,122265
522070,202003,10,10,0,10450,0,10450
522100,202003,38,20,18,20900,18810,39710
522108,202003,42,31,11,32395,11495,43890
522119,202003,51,26,25,27170,26125,53295
522130,202003,79,33,46,34485,48070,82555
522140,202003,4024,2075,1949,2172556.1,2041930.5,4214486.6
522145,202003,49,34,15,35530,15675,51205
522150,202003,89,64,25,66880,27170,94050
522155,202003,52,34,18,35530,18810,54340
522157,202003,6,3,3,3135,3135,6270
522160,202003,1680,995,685,1043955,717915,1761870
522170,202003,393,264,129,276925,134805,411730
522180,202003,41,19,22,19855,22990,42845
522185,202003,2047,812,1235,849586,1292665,2142251
522190,202003,47,25,22,26125,22990,49115
522200,202003,292,174,118,181830,123310,305140
522205,202003,143,98,45,102410,47025,149435
522220,202003,154,110,44,114950,45980,160930
522230,202003,33,26,7,27170,7315,34485
530010,202003,54067,27357,26710,28654990.54,27993476.05,56648466.59
110001,202004,504,403,101,421135,105545,526680
110002,202004,2767,1693,1074,1773365.5,1123375.5,2896741.0
110003,202004,89,74,15,77330,15675,93005
110004,202004,1996,1301,695,1363726.5,728365,2092091.5
110005,202004,446,353,93,368885.5,97185,466070.5
110006,202004,439,340,99,355300.5,103455,458755.5
110007,202004,67,56,11,58520,11495,70015
110008,202004,236,135,101,141075,105545,246620
110009,202004,855,610,245,637450,257070,894520
110010,202004,1772,1075,697,1124525,728365,1852890
110011,202004,1760,1368,392,1431650,409640,1841290
110012,202004,4097,2376,1721,2487100,1805760.5,4292860.5
110013,202004,766,611,155,638495,164065,802560
110014,202004,374,324,50,339625.5,52250,391875.5
110015,202004,1381,1109,272,1163086.66,284240,1447326.66
110018,202004,1098,681,417,711645,435765,1147410
110020,202004,15566,8913,6653,9332519.99,6969107.35,16301627.34
110025,202004,614,452,162,473385.5,170335,643720.5
110026,202004,37,28,9,29260,9405,38665
110028,202004,1629,1177,452,1234145.85,474431.5,1708577.35
110029,202004,137,125,12,130625,13585,144210
110030,202004,2423,1615,808,1692733.22,846451.35,2539184.57
110032,202004,306,234,72,244530.17,76285,320815.17
110033,202004,658,486,172,509960,180785,690745
110034,202004,357,266,91,279015.67,95095,374110.67
110037,202004,98,85,13,88825,13585,102410
110040,202004,369,255,114,266475,119130,385605
110045,202004,923,634,289,663576,303050.1,966626.1
110050,202004,90,78,12,81510.5,12540,94050.5
110060,202004,69,39,30,40755,31350,72105
110070,202004,106,68,38,71060,39710,110770
110080,202004,444,248,196,259160,204820,463980
110090,202004,30,25,5,26125,5225,31350
110092,202004,96,50,46,52250,49115,101365
110094,202004,193,139,54,145255,56430,201685
110100,202004,34,27,7,28215,7315,35530
110110,202004,77,44,33,45980,34485,80465
110120,202004,70,58,12,61655,12540,74195
110130,202004,288,236,52,246620,54340,300960
110140,202004,240,164,76,171380,79420,250800
110143,202004,47,39,8,40755,8360,49115
110145,202004,25,20,5,20900,5225,26125
110146,202004,23,12,11,12540,11495,24035
110147,202004,35,26,9,27170,9405,36575
110148,202004,34,23,11,24035,11495,35530
110149,202004,303,211,92,220495,96140,316635
110150,202004,129,98,31,102410,32395,134805
110155,202004,10,8,2,8360,2090,10450
110160,202004,67,53,14,55385,14630,70015
110170,202004,214,169,45,176605,47025,223630
110175,202004,68,51,17,53295,17765,71060
110180,202004,92,78,14,81510,14630,96140
120001,202004,205,154,51,160930,53295,214225
120005,202004,195,111,84,115995,87780,203775
120010,202004,1086,678,408,711645.72,427405,1139050.72
120013,202004,144,99,45,104500,47025,151525
120017,202004,102,57,45,59565,47025,106590
120020,202004,3525,2842,683,2969891.18,714780.5,3684671.68
120025,202004,541,306,235,319770.77,246620,566390.77
120030,202004,1062,904,158,944681.36,167200,1111881.36
120032,202004,37,35,2,36575,2090,38665
120033,202004,214,188,26,196460,27170,223630
120034,202004,162,119,43,124355,45980,170335
120035,202004,37,30,7,31350,7315,38665
120038,202004,403,260,143,272745,150480,423225
120039,202004,29,28,1,29260,1045,30305
120040,202004,13974,9532,4442,9973831.02,4656520,14630351.02
120042,202004,45,40,5,42845,5225,48070
120043,202004,11,3,8,3135,8360,11495
120045,202004,547,355,192,370975,200640,571615
120050,202004,1276,975,301,1019920.69,315590,1335510.69
120060,202004,1458,1196,262,1249820,274835,1524655
120070,202004,438,312,126,326040.82,132715,458755.82
120080,202004,169,102,67,106590,70015,176605
130002,202004,148,106,42,110770,43890,154660
130006,202004,86,52,34,54340,35530,89870
130008,202004,132,71,61,74195,63745,137940
130010,202004,142,80,62,84645,64790,149435
130014,202004,268,193,75,201685,78375,280060
130020,202004,98,58,40,60610,41800,102410
130030,202004,953,568,385,594605,402325,996930
130040,202004,331,164,167,171380,174515.4,345895.4
130050,202004,570,294,276,307230,288420,595650
130060,202004,861,584,277,611325,289465,900790
130063,202004,594,340,254,355300,265430,620730
130068,202004,186,120,66,125400,68970,194370
130070,202004,1310,891,419,931095,439945,1371040
130080,202004,705,461,244,481745,254980,736725
130083,202004,70,39,31,40755,32395,73150
130090,202004,338,170,168,177650,175560,353210
130100,202004,1121,481,640,502645,668800,1171445
130110,202004,740,310,430,323950,450395,774345
130115,202004,160,67,93,70015,98230,168245
130120,202004,1629,1041,588,1087845,616550,1704395
130130,202004,615,418,197,436810,205865,642675
130140,202004,1493,1151,342,1203840,358435,1562275
130150,202004,417,364,53,380380,55385,435765
130160,202004,459,267,192,280060,201685,481745
130165,202004,50,41,9,42845,9405,52250
130170,202004,957,658,299,688588.12,313500,1002088.12
130180,202004,211,153,58,159885,61655,221540
130185,202004,2352,1094,1258,1149500,1318791,2468291
130190,202004,3447,2147,1300,2246750.2,1367905,3614655.2
130195,202004,276,220,56,229900,58520,288420
130200,202004,182,83,99,86735,103455,190190
130210,202004,78,39,39,40755,40755,81510
130220,202004,180,122,58,128535,60610,189145
130230,202004,385,247,138,258115,144210,402325
130240,202004,1340,835,505,874665,528770,1403435
130250,202004,4727,3021,1706,3163215,1785905,4949120
130255,202004,430,206,224,215270,234080,449350
130260,202004,57163,26999,30164,28292254.52,31812939.5,60105194.02
130270,202004,1523,1024,499,1072264.05,523545,1595809.05
130280,202004,124,70,54,73150,56430,129580
130290,202004,2110,1483,627,1552870,658350,2211220
130300,202004,429,302,127,316635,132715,449350
130310,202004,912,476,436,498465,457710,956175
130320,202004,509,272,237,284240,247665,531905
130330,202004,749,469,280,491150,292600,783750
130340,202004,3518,2015,1503,2107766,1572726,3680492
130350,202004,451,293,158,306185,165110,471295
130353,202004,928,391,537,408595,564300,972895
130356,202004,816,368,448,386650,468160,854810
130360,202004,86,64,22,66880,22990,89870
130370,202004,708,545,163,570570,170335,740905
130380,202004,686,526,160,549670,167200,716870
130390,202004,493,396,97,415910,101365,517275
130395,202004,164,35,129,36575,134805,171380
130400,202004,67,45,22,47025,22990,70015
130406,202004,2101,1264,837,1320880.5,875710,2196590.5
130410,202004,438,200,238,209000,250800,459800
130420,202004,2975,2405,570,2518450.75,596695,3115145.75
130423,202004,154,79,75,82555,78375,160930
130426,202004,148,81,67,84645,71060,155705
130430,202004,403,255,148,266475,154660,421135
130440,202004,197,66,131,68970,136895,205865
140002,202004,30,10,20,10450,20900,31350
140005,202004,199,120,79,126445,82555,209000
140010,202004,10445,6675,3770,6984785.4,3951147.15,10935932.55
140015,202004,130,55,75,57475,78375,135850
140017,202004,122,80,42,83600,43890,127490
140020,202004,474,309,165,323950,172425,496375
140023,202004,48,22,26,24035.35,27170,51205.35
140028,202004,20,11,9,11495,9405,20900
140030,202004,346,244,102,254980,107635,362615
140040,202004,61,41,20,42845,20900,63745
140045,202004,248,99,149,103455,156750,260205
140047,202004,623,406,217,424270.5,226765,651035.5
140050,202004,156,94,62,98230,64790,163020
140060,202004,46,32,14,33440,14630,48070
140070,202004,32,30,2,31350,2090,33440
150010,202004,4660,2844,1816,2974070.5,1897720,4871790.5
150013,202004,159,109,50,113905,52250,166155
150020,202004,1075,574,501,599830,524590,1124420
150030,202004,671,279,392,291555,409640,701195
150034,202004,193,124,69,129580,72105,201685
150040,202004,1462,841,621,878845,649990,1528835
150050,202004,655,375,280,391875,292600,684475
150060,202004,4843,3079,1764,3220602.75,1846947.63,5067550.38
150070,202004,329,144,185,150480,194370,344850
150080,202004,15084,7160,7924,7488472.7,8287898,15776370.7
150085,202004,423,265,158,276925,165110,442035
150090,202004,737,621,116,648945,121220,770165
150095,202004,357,221,136,230945,143165,374110
150100,202004,60,38,22,39710,22990,62700
150110,202004,177,86,91,89870,95095,184965
150120,202004,414,301,113,315590,118085,433675
150125,202004,50,19,31,19855,32395,52250
150130,202004,2001,1058,943,1107700,985435,2093135
150140,202004,54799,24884,29915,26024688.75,31301937.71,57326626.46
150145,202004,191,104,87,108680,90915,199595
150150,202004,2930,1288,1642,1347005,1717981,3064986
150157,202004,390,275,115,287375.5,120175,407550.5
150160,202004,131,100,31,104500,32395,136895
150170,202004,3616,2674,942,2795375,984390,3779765
150172,202004,332,228,104,238260,109725,347985
150175,202004,75,46,29,48070,30305,78375
150178,202004,778,514,264,539220,276925,816145
150180,202004,3161,1549,1612,1619750.25,1688720.5,3308470.75
150190,202004,341,215,126,225720,131670,357390
150195,202004,107,55,52,57475,54340,111815
150200,202004,191,90,101,94050,105545,199595
150210,202004,3115,2492,623,2604140,651035,3255175
150215,202004,557,359,198,377245,206910,584155
150220,202004,3621,2432,1189,2544576.32,1242505.6,3787081.92
150230,202004,1179,947,232,990660.37,243485,1234145.37
150240,202004,6292,3609,2683,3775585.85,2810005,6585590.85
150250,202004,41,18,23,18810,24035,42845
150260,202004,86,55,31,57475,32395,89870
150270,202004,2243,1453,790,1519430,827640.5,2347070.5
150275,202004,528,330,198,344850,206910,551760
150276,202004,112,45,67,47025,70015,117040
150277,202004,764,330,434,344850,454575,799425
150280,202004,327,210,117,219450,122265,341715
150285,202004,99,50,49,52250,51205,103455
150290,202004,1011,609,402,636405,420090.5,1056495.5
150293,202004,650,306,344,319770,360525,680295
150295,202004,484,221,263,230945,274835.5,505780.5
150300,202004,80,39,41,40755,42845,83600
150304,202004,174,106,68,110770,71060,181830
150307,202004,399,331,68,345895,71060,416955
150309,202004,576,411,165,429495,173470.8,602965.8
150310,202004,238,157,81,164065,84645,248710
150320,202004,1910,1335,575,1395075,600875,1995950
150330,202004,2007,1162,845,1214290,884070,2098360
150340,202004,196,131,65,137940,67925,205865
150345,202004,628,344,284,359480,296780,656260
150350,202004,406,317,89,332310,94050,426360
150360,202004,4679,2904,1775,3038860.75,1859055,4897915.75
150370,202004,819,563,256,590425,268565,858990
150375,202004,188,90,98,94050,102410,196460
150380,202004,1477,981,496,1025145,519365,1544510
150390,202004,794,459,335,479655,350075,829730
150400,202004,107,89,18,93005,18810,111815
150405,202004,1240,792,448,827640,468160,1295800
150410,202004,123,80,43,83600,44935,128535
150420,202004,7363,3988,3375,4167631.5,3533145.5,7700777.0
150430,202004,592,385,207,403370,217360,620730
150440,202004,555,334,221,349030,230945,579975
150442,202004,2294,1216,1078,1270721,1128600,2399321
150445,202004,546,349,197,364705,206910,571615
150450,202004,229,123,106,128535,111815,240350
150460,202004,727,545,182,569525,190190,759715
150470,202004,1307,784,523,819280,546535,1365815
150475,202004,228,173,55,180785,57475,238260
150480,202004,1309,905,404,946770,422180,1368950
150490,202004,599,334,265,349030,276925,625955
150495,202004,331,243,88,254980,91960,346940
150497,202004,283,193,90,202730,94050,296780
150500,202004,218,136,82,142120,85690,227810
150503,202004,1023,507,516,529815.5,540265,1070080.5
150506,202004,917,608,309,636405,322905,959310
150510,202004,1244,688,556,720005.5,582065,1302070.5
150520,202004,272,180,92,188100,96140,284240
150530,202004,1706,937,769,979165.75,804650,1783815.75
150540,202004,227,165,62,172425,65835,238260
150543,202004,809,428,381,447260,399190,846450
150548,202004,459,327,132,342760,137940,480700
150549,202004,61,42,19,43890,19855,63745
150550,202004,2913,1475,1438,1542420.25,1504800.5,3047220.75
150553,202004,3367,1923,1444,2010581.5,1510025,3520606.5
150555,202004,139,75,64,78375,67925,146300
150560,202004,30,14,16,14630,16720,31350
150563,202004,92,47,45,49115,47025,96140
150565,202004,182,108,74,112860,78375,191235
150570,202004,403,263,140,274835,146300,421135
150580,202004,1628,764,864,798380,903925,1702305
150590,202004,806,527,279,550715,291555,842270
150600,202004,471,281,190,293645,198550,492195
150610,202004,140,119,21,124355,21945,146300
150611,202004,122,83,39,86735,40755,127490
150613,202004,3206,1915,1291,2003265,1349095.5,3352360.5
150616,202004,517,301,216,315590,225720,541310
150618,202004,1319,699,620,732545,648945,1381490
150619,202004,390,296,94,309320,98230,407550
150620,202004,1247,732,515,764940,538175,1303115
150630,202004,306,194,112,202730,118085,320815
150635,202004,461,188,273,196460,285285,481745
150640,202004,54,27,27,28215,28215,56430
150650,202004,2354,1361,993,1422245.5,1039775.5,2462021.0
150655,202004,241,181,60,189145,62700,251845
150658,202004,90,48,42,50160,43890,94050
150660,202004,525,345,180,360525,188100,548625
150670,202004,1058,373,685,389785,715825,1105610
150680,202004,10027,5273,4754,5515511.19,4975245.5,10490756.69
150690,202004,16,9,7,9405,7315,16720
150700,202004,481,315,166,329175,173470,502645
150710,202004,278,151,127,157795,132715,290510
150715,202004,816,504,312,526680,326040,852720
150720,202004,407,316,91,330220,95095,425315
150730,202004,1003,509,494,532950,517275,1050225
150740,202004,231,154,77,160930,80465,241395
150745,202004,803,438,365,459800,381425,841225
150746,202004,63,36,27,37620,28215,65835
150747,202004,232,177,55,184965,57475,242440
150750,202004,140,76,64,79420,66880,146300
150760,202004,1809,1172,637,1224740.62,665665,1890405.62
150770,202004,389,212,177,221540,184965,406505
150775,202004,97,46,51,48070,53295,101365
150780,202004,190,109,81,113905,84645,198550
150790,202004,838,459,379,480700,396055,876755
150795,202004,1518,901,617,941545,644765,1586310
150796,202004,359,206,153,215270,159885,375155
150797,202004,319,159,160,166155,167200,333355
150800,202004,1455,846,609,884070,636405,1520475
150803,202004,546,442,104,461890,108680,570570
150805,202004,199,121,78,126445,81510,207955
150808,202004,985,533,452,556985,474430,1031415
150810,202004,3267,2238,1029,2339755.97,1076350.5,3416106.47
150812,202004,437,225,212,236170,221540,457710
150815,202004,1024,640,384,668800,403370,1072170
150820,202004,1542,916,626,957220,655215,1612435
150830,202004,738,546,192,571615,201685,773300
150835,202004,204,118,86,123310,89870,213180
150840,202004,1373,845,528,883025,552805,1435830
160005,202004,52,33,19,34485,19855,54340
160010,202004,198,125,73,130625,76285,206910
160015,202004,120,70,50,73150,52250,125400
160020,202004,130,74,56,77330,58520,135850
160021,202004,58,28,30,29260,31350,60610
160023,202004,69,45,24,47025,25080,72105
160025,202004,27,11,16,11495,16720,28215
160027,202004,1512,854,658,895565.25,688655,1584220.25
160030,202004,15937,8160,7777,8533473.1,8137415.71,16670888.81
160040,202004,294,171,123,178695,128535,307230
160050,202004,719,357,362,373065,378290,751355
160053,202004,285,166,119,174515.5,124355,298870.5
160055,202004,29,20,9,20900,9405,30305
160060,202004,6594,3461,3133,3616746.25,3279210.5,6895956.75
160070,202004,178,104,74,108680,77330,186010
160080,202004,108,50,58,52250,60610,112860
170025,202004,30,17,13,17765,13585,31350
170030,202004,214,175,39,182875.62,40755,223630.62
170035,202004,228,108,120,113905,125400,239305
170040,202004,183,139,44,145255.08,45980,191235.08
170070,202004,315,193,122,201685,127490,329175
170100,202004,356,258,98,270655,102410,373065
170105,202004,56,45,11,47025,11495,58520
170110,202004,113,72,41,75240,42845,118085
170130,202004,69,33,36,34485,37620.5,72105.5
170190,202004,96,59,37,61655,38665,100320
170200,202004,374,258,116,269610,122265,391875
170210,202004,6100,3223,2877,3374306.88,3014827.43,6389134.31
170215,202004,114,47,67,49115,70015,119130
170220,202004,1389,1021,368,1067990,385605,1453595
170230,202004,148,97,51,101365,53295,154660
170240,202004,529,353,176,370975,183920,554895
170255,202004,1085,878,207,917510,218405,1135915
170270,202004,44,31,13,32395,13585,45980
170290,202004,114,77,37,80465,38665,119130
170300,202004,92,61,31,63745,32395,96140
170305,202004,49,37,12,38665,12540,51205
170307,202004,64,49,15,51205,15675,66880
170310,202004,112,62,50,64790,52250,117040
170320,202004,26,17,9,17765,9405,27170
170330,202004,24,22,2,22990,2090,25080
170360,202004,29,18,11,18810,11495,30305
170370,202004,96,45,51,47025,53295,100320
170380,202004,73,56,17,58520,17765,76285
170382,202004,44,36,8,37620,8360,45980
170384,202004,145,110,35,114950,36575,151525
170386,202004,64,25,39,26125,40755,66880
170388,202004,49,18,31,18810,32395,51205
170389,202004,26,21,5,21945,5225,27170
170390,202004,67,39,28,40755,29260,70015
170410,202004,32,24,8,25080,8360,33440
170460,202004,17,12,5,12540,5225,17765
170510,202004,35,27,8,28215,9405,37620
170550,202004,1548,900,648,940500,677160,1617660
170555,202004,113,79,34,82555,35530,118085
170560,202004,99,69,30,72105,31350,103455
170600,202004,34,15,19,15675,19855,35530
170610,202004,196,105,91,109725,95095.5,204820.5
170625,202004,37,21,16,21945,16720,38665
170650,202004,80,58,22,60610,22990,83600
170700,202004,580,440,140,460845.25,146300,607145.25
170710,202004,157,98,59,102410,61655,164065
170720,202004,89,71,18,74195,18810,93005
170730,202004,84,48,36,50160,37620,87780
170740,202004,83,60,23,62700,24035,86735
170755,202004,65,34,31,35530,32395,67925
170765,202004,142,76,66,79420,68970,148390
170770,202004,207,129,78,134805,82555,217360
170820,202004,596,395,201,412775,210045.5,622820.5
170825,202004,33,17,16,17765,16720,34485
170830,202004,81,67,14,70015,14630,84645
170900,202004,183,143,40,149435,41800,191235
170930,202004,912,475,437,498465.8,457710.5,956176.3
170950,202004,3126,1427,1699,1493827.5,1779635.88,3273463.38
170980,202004,16,10,6,10450,6270,16720
171050,202004,144,115,29,120175,30305,150480
171070,202004,35,30,5,31350,5225,36575
171090,202004,43,31,12,32395,12540,44935
171110,202004,22,15,7,15675,7315,22990
171150,202004,39,19,20,19855,21945,41800
171180,202004,26,13,13,13585,13585,27170
171190,202004,149,85,64,88825,66880,155705
171195,202004,67,56,11,58520,11495,70015
171200,202004,50,25,25,26125,26125,52250
171215,202004,4,3,1,3135,1045,4180
171240,202004,57,42,15,43890,15675,59565
171245,202004,56,48,8,50160,8360,58520
171250,202004,73,40,33,41800,35530,77330
171270,202004,14,10,4,10450,4180,14630
171280,202004,43,37,6,38665,6270,44935
171320,202004,984,572,412,597740.54,430540,1028280.54
171330,202004,427,211,216,220495,225720,446215
171360,202004,87,62,25,64790,26125,90915
171370,202004,35,17,18,17765,18810,36575
171380,202004,132,112,20,117040,20900,137940
171395,202004,53,33,20,34485,20900,55385
171420,202004,282,181,101,189145,105545,294690
171430,202004,73,59,14,61655,14630,76285
171488,202004,175,97,78,101365,81510,182875
171500,202004,56,32,24,33440,25080,58520
171510,202004,71,44,27,45980,28215,74195
171515,202004,41,34,7,35530,7315,42845
171525,202004,30,28,2,29260,2090,31350
171550,202004,13,9,4,9405,4180,13585
171570,202004,52,28,24,29260,25080,54340
171575,202004,309,199,110,209000,114950,323950
171610,202004,1767,891,876,931095,917510,1848605
171620,202004,140,96,44,100320,45980,146300
171630,202004,60,31,29,32395,30305,62700
171650,202004,281,189,92,197505,97185,294690
171660,202004,270,151,119,157795,124355.5,282150.5
171665,202004,61,42,19,43890,19855,63745
171670,202004,424,248,176,260205.25,183920,444125.25
171700,202004,65,59,6,61655,6270,67925
171720,202004,28,10,18,10450,18810,29260
171750,202004,99,51,48,54340,50160,104500
171780,202004,73,58,15,60610,15675,76285
171790,202004,76,66,10,68970,10450,79420
171800,202004,35,27,8,28215,8360,36575
171820,202004,2104,1203,901,1259225.46,944680.5,2203905.96
171830,202004,35,28,7,29260,7315,36575
171840,202004,63,41,22,42845,22990,65835
171845,202004,30,19,11,19855,11495,31350
171850,202004,40,29,11,30305,11495,41800
171855,202004,77,60,17,62700,17765,80465
171865,202004,7,6,1,6270,1045,7315
171870,202004,31,22,9,22990,9405,32395
171875,202004,76,53,23,55385,24035,79420
171880,202004,34,22,12,22990,12540,35530
171884,202004,51,27,24,28215,25080,53295
171886,202004,137,55,82,57475,86735,144210
171888,202004,26,20,6,20900,6270,27170
171889,202004,20,14,6,14630,6270,20900
171890,202004,56,48,8,50160,8360,58520
171900,202004,34,24,10,26125,11495,37620
172000,202004,41,32,9,33440,9405,42845
172010,202004,53,42,11,43890,11495,55385
172015,202004,28,17,11,17765.45,11495,29260.45
172020,202004,140,88,52,91960,54340,146300
172025,202004,34,21,13,21945,13585,35530
172030,202004,43,24,19,25080,19855,44935
172049,202004,85,56,29,58520,30305,88825
172065,202004,140,90,50,94050,52250,146300
172080,202004,106,70,36,73150,37620,110770
172085,202004,29,15,14,15675,14630,30305
172090,202004,425,327,98,341715.03,102410,444125.03
172093,202004,17,15,2,15675,2090,17765
172097,202004,19,12,7,12540,7315.5,19855.5
172100,202004,5051,2867,2184,2998106.47,2288551.33,5286657.80
172110,202004,80,50,30,52250,31350,83600
172120,202004,1657,1394,263,1457778.11,274835,1732613.11
172125,202004,5,4,1,4180,1045,5225
172130,202004,20,13,7,13585,7315,20900
172208,202004,200,123,77,128535,80465,209000
172210,202004,390,186,204,194370,213180,407550
210005,202004,2962,1866,1096,1952060.15,1147415.5,3099475.65
210010,202004,164,91,73,95095,76285,171380
210015,202004,39,29,10,30305,10450,40755
210020,202004,347,197,150,205865,156750,362615
210030,202004,320,208,112,217360,117040,334400
210040,202004,139,111,28,115995,29260,145255
210043,202004,250,186,64,194370,66880,261250
210047,202004,520,307,213,320815,222585,543400
210050,202004,288,211,77,220495,80465,300960
210055,202004,48,37,11,38665,11495,50160
210060,202004,548,439,109,459800,113905,573705
210070,202004,405,311,94,324995,98230,423225
210080,202004,118,108,10,112860,10450,123310
210083,202004,303,149,154,155705.5,160930,316635.5
210087,202004,3,1,2,1045,2090,3135
210090,202004,448,322,126,336490,131670,468160
210095,202004,440,333,107,347985,111815,459800
210100,202004,693,541,152,565345,159885,725230
210110,202004,131,82,49,85690,51205,136895
210120,202004,5040,3917,1123,4098492.45,1174580.12,5273072.57
210125,202004,198,121,77,127490,80465,207955
210130,202004,478,271,207,283195,217360,500555
210135,202004,28,19,9,19855,9405,29260
210140,202004,4371,3417,954,3573900,997975,4571875
210150,202004,376,238,138,248710,144210,392920
210160,202004,3270,2772,498,2896741.36,522500,3419241.36
210170,202004,1138,917,221,959310,230945,1190255
210173,202004,126,111,15,115995,15675,131670
210177,202004,365,203,162,212135,169290,381425
210180,202004,32,17,15,17765,15675,33440
210190,202004,419,282,137,294690,143165,437855
210193,202004,1,1,0,1045,0,1045
210197,202004,74,54,20,56430,20900,77330
210200,202004,620,511,109,535040,113905,648945
210203,202004,229,153,76,160930,79420,240350
210207,202004,367,298,69,311410,73150,384560
210210,202004,752,697,55,728365,57475,785840
210215,202004,73,66,7,68970,7315,76285
210220,202004,393,332,61,346940,63745,410685
210230,202004,310,247,63,259160,65835,324995
210232,202004,1380,938,442,980210,461890,1442100
210235,202004,168,127,41,132715,42845,175560
210237,202004,35,22,13,22990,13585,36575
210240,202004,88,74,14,77330,14630,91960
210250,202004,182,156,26,163020,27170,190190
210255,202004,353,265,88,276925,91960,368885
210260,202004,391,269,122,281105,127490,408595
210270,202004,644,429,215,448305,225720,674025
210275,202004,72,55,17,58520,17765,76285
210280,202004,1053,697,356,728365.7,373065,1101430.7
210290,202004,532,359,173,376200,180785,556985
210300,202004,5341,3355,1986,3507020.93,2076415,5583435.93
210310,202004,111,76,35,79420,36575,115995
210312,202004,116,80,36,83600,37620,121220
210315,202004,106,84,22,87780,22990,110770
210317,202004,126,95,31,99275,32395,131670
210320,202004,2335,1980,355,2070145,372020,2442165
210325,202004,134,88,46,91960.5,48070.5,140031.0
210330,202004,4530,2590,1940,2708640.75,2028345,4736985.75
210340,202004,1256,937,319,979165,335445.5,1314610.5
210350,202004,621,522,99,545490,103455,648945
210355,202004,148,120,28,125400,29260,154660
210360,202004,2243,1546,697,1615570,729410.5,2344980.5
210370,202004,1220,594,626,620730,656260,1276990
210375,202004,184,95,89,99275,93005,192280
210380,202004,709,542,167,566390,174515,740905
210390,202004,188,160,28,167200,29260,196460
210400,202004,395,343,52,358435,54340,412775
210405,202004,988,689,299,720005,312455,1032460
210407,202004,51,41,10,43890,10450,54340
210408,202004,61,54,7,56430,7315,63745
210409,202004,324,281,43,293645,44935,338580
210410,202004,439,341,98,356345,102410,458755
210420,202004,200,165,35,172425,36575,209000
210430,202004,53,35,18,36575,18810,55385
210440,202004,333,224,109,234080,113905,347985
210450,202004,143,112,31,117040,32395,149435
210455,202004,229,122,107,127490.5,111815,239305.5
210460,202004,309,207,102,216315,106590,322905
210462,202004,65,53,12,55385,12540,67925
210465,202004,142,109,33,113905,34485,148390
210467,202004,543,397,146,414865,152570,567435
210470,202004,50,43,7,44935,7315,52250
210480,202004,1266,908,358,949905,375155,1325060
210490,202004,204,137,67,143165,71060,214225
210500,202004,510,308,202,321860,211090,532950
210510,202004,558,442,116,461890,121220,583110
210515,202004,371,230,141,241395,147345,388740
210520,202004,400,360,40,376200,41800,418000
210530,202004,9343,4947,4396,5182160.55,4599048.24,9781208.79
210535,202004,126,95,31,99275,32395,131670
210540,202004,1490,983,507,1027235,529815,1557050
210542,202004,1195,615,580,642675,607146,1249821
210545,202004,16,15,1,15675,1045,16720
210547,202004,130,113,17,118085,17765,135850
210550,202004,688,498,190,520410.6,199595,720005.6
210560,202004,159,141,18,147345,18810,166155
210565,202004,21,16,5,16720,5225,21945
210570,202004,1304,1052,252,1099340.11,263340,1362680.11
210580,202004,120,103,17,107635,17765,125400
210590,202004,727,595,132,621775,137940,759715
210592,202004,36,32,4,33440,4180,37620
210594,202004,106,91,15,95095,15675,110770
210596,202004,96,80,16,84645,16720,101365
210598,202004,133,99,34,103455,35530,138985
210600,202004,320,273,47,285285,49115,334400
210610,202004,253,238,15,248710,15675,264385
210620,202004,43,28,15,29260,15675,44935
210630,202004,72,71,1,74195,1045,75240
210632,202004,1016,709,307,741950,320815,1062765
210635,202004,22,19,3,19855,3135,22990
210637,202004,109,79,30,82555,31350,113905
210640,202004,588,518,70,541310,73150,614460
210650,202004,394,330,64,344850,66880,411730
210660,202004,378,294,84,307230,89870,397100
210663,202004,34,24,10,25080,10450,35530
210667,202004,98,37,61,38665,63745,102410
210670,202004,248,221,27,230945,28215,259160
210675,202004,530,297,233,310365,243485,553850
210680,202004,228,143,85,149435,89870,239305
210690,202004,620,513,107,536085,111815,647900
210700,202004,162,122,40,127490,41800,169290
210710,202004,247,156,91,163020,95095,258115
210720,202004,128,114,14,119130,14630,133760
210725,202004,67,59,8,61655,8360,70015
210730,202004,25,18,7,18810,7315,26125
210735,202004,285,199,86,207955,89870.5,297825.5
210740,202004,526,454,72,474430,76285,550715
210745,202004,152,114,38,119130,39710,158840
210750,202004,2380,1212,1168,1269675.25,1223696,2493371.25
210760,202004,256,195,61,203775,63745,267520
210770,202004,382,300,82,313500,85690,399190
210780,202004,449,332,117,346940,122265,469205
210790,202004,183,150,33,156750,34485,191235
210800,202004,172,131,41,136895,42845,179740
210805,202004,52,47,5,49115,5225,54340
210810,202004,463,372,91,388740,95095,483835
210820,202004,2126,1765,361,1844425.9,377245,2221670.9
210825,202004,152,87,65,90915,67925,158840
210830,202004,724,480,244,502645,254980,757625
210840,202004,195,136,59,142120,61655,203775
210845,202004,231,165,66,172425,68970,241395
210850,202004,761,520,241,543400,251845,795245
210860,202004,3704,2091,1613,2186140.25,1686630,3872770.25
210870,202004,430,338,92,354255,96140,450395
210880,202004,71,55,16,57475,16720,74195
210890,202004,317,274,43,287375,44935,332310
210900,202004,626,408,218,426360,227810,654170
210905,202004,63,32,31,33440,32395,65835
210910,202004,1964,1488,476,1554961.06,499510,2054471.06
210920,202004,168,65,103,67925,107635,175560
210923,202004,80,63,17,65835,17765,83600
210927,202004,398,184,214,193325,224675,418000
210930,202004,74,59,15,61655,15675,77330
210940,202004,84,66,18,68970,18810,87780
210945,202004,188,100,88,105545,91960,197505
210950,202004,529,386,143,403370,149435,552805
210955,202004,79,53,26,55385,27170,82555
210960,202004,2162,1086,1076,1135132,1124420,2259552
210970,202004,115,102,13,106590,13585,120175
210975,202004,80,74,6,77330,6270,83600
210980,202004,1072,517,555,540265,579975.5,1120240.5
210990,202004,4066,2679,1387,2801645,1452550.73,4254195.73
211000,202004,1315,1064,251,1113970.5,262295,1376265.5
211003,202004,1010,717,293,749265,306185,1055450
211010,202004,493,439,54,458755,56430,515185
211020,202004,1456,613,843,640585,881980,1522565
211023,202004,33,30,3,31350,3135,34485
211027,202004,70,52,18,54340,18810,73150
211030,202004,367,260,107,271700,111815,383515
211040,202004,299,249,50,260205.5,52250,312455.5
211050,202004,1154,763,391,797335,408595.5,1205930.5
211060,202004,634,548,86,572660.5,89870.79,662531.29
211065,202004,22,18,4,18810,4180,22990
211070,202004,902,748,154,781661.15,160930,942591.15
211080,202004,87,83,4,86735,4180,90915
211085,202004,54,27,27,28215,28215,56430
211090,202004,89,73,16,76285,16720,93005
211100,202004,490,406,84,424270,87780.5,512050.5
211102,202004,246,174,72,182875,75240,258115
211105,202004,220,155,65,161975,68970,230945
211107,202004,131,82,49,85690,51205,136895
211110,202004,818,530,288,553850,300960,854810
211120,202004,5308,2650,2658,2773431.05,2780745.4,5554176.45
211125,202004,34,25,9,26125,9405,35530
211130,202004,41960,19152,22808,20033700.22,23883478.25,43917178.47
211140,202004,396,345,51,361570,53295,414865
211150,202004,1213,812,401,848540,420090.5,1268630.5
211153,202004,174,105,69,109725,72105,181830
211157,202004,65,52,13,54340,13585,67925
211160,202004,704,599,105,625955,110770,736725
211163,202004,0,,,,,0.0
211167,202004,11,10,1,10450,1045,11495
211170,202004,422,316,106,330220,110770,440990
211172,202004,116,79,37,82555,38665,121220
211174,202004,250,154,96,161975,100320,262295
211176,202004,484,358,126,374110.5,131670,505780.5
211178,202004,89,59,30,61655,31350,93005
211180,202004,202,162,40,169290,41800,211090
211190,202004,72,67,5,70015,5225,75240
211195,202004,34,24,10,25080,10450,35530
211200,202004,149,129,20,134805,20900,155705
211210,202004,446,327,119,341715,124355,466070
211220,202004,4042,2350,1692,2459932.07,1772321.5,4232253.57
211223,202004,95,91,4,95095,4180,99275
211227,202004,70,55,15,57475,16720,74195
211230,202004,735,606,129,633270,135850,769120
211240,202004,404,315,89,329175,93005,422180
211245,202004,184,89,95,94050,99275,193325
211250,202004,1553,1337,216,1399255,225720,1624975
211260,202004,807,665,142,694925,148390,843315
211270,202004,1953,1602,351,1675135.5,366795.5,2041931.0
211280,202004,1734,1109,625,1158905,654170,1813075
211285,202004,194,119,75,124355,78375,202730
211290,202004,677,478,199,499510,207955,707465
211300,202004,762,605,157,634315,164065,798380
211400,202004,1529,948,581,991705,607145,1598850
220005,202004,15,14,1,14630,1045,15675
220010,202004,87,66,21,68970,21945,90915
220020,202004,694,552,142,577885,148390,726275
220025,202004,111,108,3,113905,3135,117040
220027,202004,43,35,8,36575,8360,44935
220030,202004,110,89,21,93005,21945,114950
220040,202004,1225,932,293,973940,306185,1280125
220045,202004,33,21,12,21945,12540,34485
220050,202004,675,569,106,594605.61,110770,705375.61
220060,202004,169,148,21,155705,21945,177650
220070,202004,111,101,10,105545,10450,115995
220080,202004,15,13,2,13585,2090,15675
220090,202004,33,27,6,28215,6270,34485
220095,202004,2,1,1,1045,1045,2090
220100,202004,19,16,3,16720,3135,19855
220105,202004,23,21,2,21945.5,2090,24035.5
220110,202004,220,202,18,211090,18810,229900
220115,202004,35,34,1,36575,1045,37620
220117,202004,20,19,1,19855,1045,20900
220120,202004,1476,1126,350,1178760,366795,1545555
220130,202004,32,31,1,32395,1045,33440
220140,202004,106,81,25,84645,26125,110770
220150,202004,493,362,131,378290,136895,515185
220155,202004,6,6,0,6270,0,6270
220157,202004,19,15,4,15675,4180,19855
220160,202004,86,75,11,78375,11495,89870
220170,202004,30,30,0,31350,0,31350
220173,202004,7,7,0,7315,0,7315
220177,202004,6,6,0,6270,0,6270
220180,202004,68,67,1,70015,1045,71060
220190,202004,1054,940,114,982300,119130,1101430
220191,202004,45,39,6,40755,6270,47025
220192,202004,79,76,3,79420,3135,82555
220194,202004,52,50,2,52250,2090,54340
220196,202004,97,81,16,84645,16720,101365
220198,202004,3,2,1,2090,1045,3135
220200,202004,413,345,68,360525.25,71060,431585.25
220202,202004,40,35,5,36575,5225,41800
220205,202004,49,44,5,45980,5225,51205
220207,202004,11,11,0,11495,0,11495
220208,202004,78,41,37,42845,38665,81510
220209,202004,32,29,3,30305,3135,33440
220210,202004,18,14,4,14630,4180,18810
220211,202004,28,26,2,27170,2090,29260
220213,202004,39,35,4,36575,4180.5,40755.5
220217,202004,39,31,8,32395,8360,40755
220220,202004,2162,1415,747,1480765,782705.5,2263470.5
220225,202004,10,4,6,4180,6270,10450
220230,202004,963,753,210,788975,219450,1008425
220240,202004,160,145,15,151525,15675,167200
220245,202004,33,30,3,31350.97,3135,34485.97
220250,202004,122,108,14,112860,14630,127490
220253,202004,43,36,7,37620,7315,44935
220255,202004,29,27,2,28215,2090,30305
220260,202004,697,517,180,540265,188100,728365
220265,202004,9,7,2,7315,2090,9405
220270,202004,756,679,77,709555,80465,790020
220271,202004,40,33,7,34485,7315,41800
220272,202004,24,24,0,25080,0,25080
220273,202004,17,15,2,15675,2090,17765
220275,202004,58,48,10,50160,10450,60610
220277,202004,16,14,2,14630,2090,16720
220280,202004,16,13,3,13585,3135,16720
220285,202004,44,41,3,42845,3135,45980
220290,202004,1466,1255,211,1313566,220495.25,1534061.25
220300,202004,35,34,1,35530,1045,36575
220310,202004,322,274,48,286330,50160,336490
220320,202004,445,412,33,432630.5,34485,467115.5
220323,202004,0,,,,,0.0
220325,202004,14,12,2,12540,2090,14630
220327,202004,12,11,1,11495,2090,13585
220330,202004,229,166,63,173470,65835,239305
220335,202004,136,119,17,124355,17765,142120
220340,202004,40,27,13,28215,13585,41800
220342,202004,58,50,8,52250,8360,60610
220345,202004,81,74,7,77330,7315,84645
220350,202004,439,380,59,398145,61655,459800
220360,202004,41,31,10,32395,10450,42845
220370,202004,1223,1009,214,1055450,223630,1279080
220375,202004,21,19,2,19855,2090,21945
220380,202004,20,17,3,17765,3135,20900
220385,202004,15,13,2,13585,2090,15675
220390,202004,2318,1320,998,1379400.6,1045000.75,2424401.35
220400,202004,32,28,4,29260,4180,33440
220410,202004,20,18,2,18810,2090,20900
220415,202004,13,11,2,11495,2090,13585
220420,202004,126,106,20,110770,20900,131670
220430,202004,127,115,12,120175,12540,132715
220435,202004,23,16,7,16720,7315,24035
220440,202004,290,246,44,258115,45980,304095
220450,202004,326,170,156,177650,164065,341715
220455,202004,53,52,1,54340,1045,55385
220460,202004,20,19,1,19855,1045,20900
220465,202004,95,64,31,66880,32395,99275
220470,202004,244,214,30,223630,31350,254980
220480,202004,72,64,8,67925,8360,76285
220490,202004,89,76,13,79420,13585,93005
220500,202004,104,90,14,94050,14630,108680
220510,202004,418,325,93,340670,97185,437855
220515,202004,22,20,2,20900,2090,22990
220520,202004,367,330,37,345895.85,38665,384560.85
220525,202004,10,7,3,7315,3135,10450
220527,202004,19,13,6,13585,6270,19855
220530,202004,31,13,18,13585,18810,32395
220535,202004,4,4,0,4180,0,4180
220540,202004,67,55,12,57475,12540,70015
220545,202004,40,27,13,28215,13585,41800
220550,202004,694,549,145,574750,152570,727320
220551,202004,12,9,3,9405,3135,12540
220552,202004,15,15,0,15675,0,15675
220553,202004,54,49,5,51205,5225,56430
220554,202004,10,8,2,8360,2090,10450
220555,202004,33,30,3,31350,3135,34485
220556,202004,46,44,2,45980,2090,48070
220557,202004,56,53,3,55385,3135,58520
220558,202004,8,3,5,3135,5225,8360
220559,202004,2,2,0,2090,0,2090
220560,202004,67,45,22,47025,22990,70015
220570,202004,750,461,289,481745.5,302005,783750.5
220580,202004,551,505,46,528770,48070,576840
220585,202004,7,6,1,6270,1045,7315
220590,202004,15,15,0,15675,0,15675
220595,202004,63,47,16,49115,16720,65835
220600,202004,19,11,8,11495,8360,19855
220605,202004,26,24,2,25080,2090,27170
220610,202004,73,64,9,66880,9405,76285
220620,202004,561,463,98,483835,103455,587290
220630,202004,5,4,1,4180,1045,5225
220635,202004,36,32,4,33440,4180,37620
220640,202004,106,87,19,90915,19855,110770
220650,202004,114,107,7,111815,7315,119130
220660,202004,52,41,11,42845,11495,54340
220665,202004,4,4,0,4180,0,4180
220667,202004,21,19,2,19855,2090,21945
220669,202004,27,24,3,25080,3135,28215
220670,202004,63,50,13,53295,13585,66880
220672,202004,68,46,22,48070,22990,71060
220675,202004,35,28,7,29260,7315,36575
220680,202004,38,33,5,34485,5225,39710
220690,202004,47,43,4,44935,4180,49115
220695,202004,35,17,18,17765,18810,36575
220700,202004,1696,1316,380,1375220,398145,1773365
220710,202004,4,3,1,3135,1045,4180
220720,202004,103,87,16,90915,16720,107635
220730,202004,15,15,0,15675,0,15675
220735,202004,5,1,4,1045,4180,5225
220740,202004,48,44,4,45980,4180,50160
220750,202004,111,94,17,98230,17765,115995
220755,202004,15,14,1,14630,1045,15675
220760,202004,66,61,5,63745,5225,68970
220770,202004,5541,3023,2518,3160081.94,2634445.5,5794527.44
220775,202004,18,11,7,11495,7315,18810
220777,202004,17,16,1,16720,1045,17765
220779,202004,1,0,1,0,1045,1045
220780,202004,897,766,131,800470,136895.5,937365.5
220785,202004,4,1,3,1045,3135,4180
220790,202004,1074,855,219,894520.05,228855,1123375.05
220793,202004,7,6,1,6270,1045,7315
220795,202004,14,13,1,13585,1045,14630
220800,202004,3994,3078,916,3217555.81,958265,4175820.81
220810,202004,65,57,8,59565.5,8360,67925.5
220820,202004,240,219,21,228855,21945,250800
220830,202004,1217,1049,168,1097250,175560,1272810
220840,202004,2417,1678,739,1753512.09,774345.95,2527858.04
220850,202004,53,43,10,44935,10450,55385
220855,202004,8,5,3,5225,3135,8360
220860,202004,14,12,2,12540,2090,14630
220865,202004,31,29,2,30305,2090,32395
220870,202004,73,65,8,67925,8360,76285
220880,202004,320,257,63,268565,66880,335445
220885,202004,33,30,3,31350,3135,34485
220887,202004,12,12,0,12540,0,12540
220890,202004,97,86,11,89870,11495,101365
220900,202004,22,15,7,15675,7315,22990
220910,202004,53,44,9,47025,9405,56430
220915,202004,10,9,1,9405,1045,10450
220920,202004,51,47,4,49115,4180,53295
220930,202004,41,40,1,41800,1045,42845
220935,202004,15,15,0,15675,0,15675
220937,202004,35,34,1,35530,1045,36575
220940,202004,55,51,4,54340,4180,58520
220945,202004,1,1,0,1045,0,1045
220950,202004,44,38,6,39710,6270,45980
220955,202004,24,23,1,24035,1045,25080
220960,202004,11,10,1,10450,1045,11495
220965,202004,37,33,4,34485,4180,38665
220970,202004,58,48,10,50160,10450,60610
220975,202004,16,14,2,14630,2090,16720
220980,202004,30,28,2,29260,2090,31350
220985,202004,64,57,7,59565,7315,66880
220987,202004,28,27,1,28215,1045,29260
220990,202004,19,18,1,18810,1045,19855
220995,202004,18,14,4,14630,4180,18810
220997,202004,64,53,11,55385,11495,66880
221000,202004,1172,1058,114,1110835,120175,1231010
221005,202004,55,48,7,50160,7315,57475
221010,202004,16,12,4,12540,4180,16720
221020,202004,39,37,2,38665,2090,40755
221030,202004,36,28,8,29260,8360,37620
221035,202004,23,23,0,24035,0,24035
221037,202004,12,8,4,8360,4180,12540
221038,202004,26,23,3,24035,3135,27170
221039,202004,23,23,0,24035,0,24035
221040,202004,247,213,34,222585,35530,258115
221050,202004,234,198,36,206910,37620,244530
221060,202004,1856,1624,232,1697080,242440,1939520
221062,202004,33,33,0,34485,0,34485
221063,202004,13,9,4,9405,4180,13585
221065,202004,57,46,11,48070,11495,59565
221070,202004,140,121,19,126445,19855,146300
221080,202004,372,323,49,337535,51205,388740
221090,202004,28,26,2,27170,2090,29260
221093,202004,48,33,15,34485,15675,50160
221095,202004,7,7,0,7315,0,7315
221097,202004,13,10,3,10450,3135,13585
221100,202004,25185,14930,10255,15614393.98,10734240.45,26348634.43
221110,202004,1072,810,262,847495,274835,1122330
221120,202004,535,395,140,412775.5,146300,559075.5
221130,202004,976,792,184,827640,192280,1019920
221135,202004,34,31,3,32395,3135,35530
221140,202004,45,39,6,40755,6270,47025
221150,202004,12,10,2,10450,2090,12540
221160,202004,13,13,0,13585,0,13585
221170,202004,15,15,0,15675,0,15675
230010,202004,167,152,15,158840,15675,174515
230015,202004,127,103,24,107635,25080,132715
230020,202004,1637,1391,246,1455685.5,258115,1713800.5
230030,202004,1685,1214,471,1268631,492195,1760826
230040,202004,223,192,31,200640,33440.5,234080.5
230050,202004,227,169,58,176605,60610,237215
230060,202004,162,130,32,135850,33440,169290
230070,202004,294,256,38,269610,39710,309320
230075,202004,844,731,113,764941.5,119130,884071.5
230080,202004,200,171,29,178695,30305,209000
230090,202004,124,88,36,91960,37620,129580
230100,202004,2129,1223,906,1280126,948860,2228986
230110,202004,2880,1870,1010,1955195.5,1056495.5,3011691.0
230120,202004,993,781,212,816145,220808.5,1036953.5
230125,202004,153,128,25,133760,26125,159885
230130,202004,475,425,50,444125,52250,496375
230140,202004,221,185,36,194370,37620,231990
230150,202004,147,114,33,119130,34485,153615
230160,202004,936,795,141,830775.5,147345,978120.5
230170,202004,610,550,60,574750.5,62700,637450.5
230180,202004,75,70,5,73150,5225,78375
230185,202004,406,349,57,364705,59565,424270
230190,202004,2317,1845,472,1933250.15,494285,2427535.15
230195,202004,494,428,66,447260,68970,516230
230200,202004,398,338,60,353210,62700,415910
230205,202004,392,260,132,271700,137940,409640
230210,202004,1368,1061,307,1108745.38,320815,1429560.38
230220,202004,1559,1063,496,1110835,520410,1631245
230230,202004,903,775,128,810920,133760,944680
230240,202004,1726,1491,235,1558358.25,245575,1803933.25
230250,202004,1801,1486,315,1554960,329175,1884135
230260,202004,3246,2027,1219,2118215,1275945,3394160
230270,202004,1364,1104,260,1154726.38,271700.5,1426426.88
230280,202004,2750,2067,683,2161060,714780.5,2875840.5
230290,202004,408,364,44,382470.72,45980,428450.72
230300,202004,520,385,135,402325,141075,543400
230310,202004,423,318,105,332310,109725,442035
230320,202004,932,798,134,833911,140030,973941
230330,202004,313,254,59,265430,61655,327085
230340,202004,446,361,85,377245,88825,466070
230350,202004,3147,1999,1148,2090000,1201750,3291750
230360,202004,277,223,54,233035,56430,289465
230365,202004,132,111,21,115995,21945,137940
230370,202004,10085,4912,5173,5145583.42,5423551,10569134.42
230380,202004,471,405,66,425315.5,68970,494285.5
230390,202004,539,303,236,316635,246620,563255
230393,202004,248,205,43,215270,44935,260205
230395,202004,353,283,70,297825.7,74195,372020.7
230400,202004,614,488,126,509960,131670,641630
230410,202004,2698,1679,1019,1758735.97,1065900.5,2824636.47
230420,202004,6304,4188,2116,4384823.04,2219580.2,6604403.24
230423,202004,329,287,42,299915,43890,343805
230425,202004,415,342,73,357390.85,77330,434720.85
230426,202004,119,96,23,100320,24035,124355
230427,202004,76,74,2,77330,2090,79420
230428,202004,1503,751,752,784795,788975,1573770
230430,202004,455,372,83,389785,86735,476520
230435,202004,898,644,254,672980,268565.77,941545.77
230440,202004,88740,39416,49324,41307823.7,51764090.32,93071914.02
230445,202004,312,218,94,227810,98230,326040
230450,202004,554,438,116,458755,121220,579975
230460,202004,66,51,15,53295,15675,68970
230465,202004,307,249,58,261250,60610,321860
230470,202004,2002,1587,415,1659460,433675.25,2093135.25
230480,202004,158,149,9,156750,9405,166155
230490,202004,303,242,61,252890,63745,316635
230495,202004,447,331,116,346940,122265,469205
230500,202004,1018,753,265,788975,276925,1065900
230510,202004,59,46,13,48070,13585,61655
230520,202004,380,300,80,314545,83600,398145
230523,202004,2300,1442,858,1508980,897655.5,2406635.5
230526,202004,267,227,40,237215,41800,279015
230530,202004,691,515,176,538175,183920,722095
230533,202004,201,188,13,196460,13585,210045
230535,202004,371,275,96,287375,100320,387695
230540,202004,1802,1591,211,1664685,220495,1885180
230550,202004,3805,2445,1360,2557117.4,1423290,3980407.4
230560,202004,579,440,139,460845,145255,606100
230565,202004,228,166,62,173470,64790,238260
230570,202004,290,255,35,266475,36575,303050
230580,202004,1168,855,313,894520,327085,1221605
230590,202004,1004,782,222,818235.25,231990,1050225.25
230600,202004,245,221,24,233035,25080,258115
230610,202004,379,294,85,307230,88825,396055
230620,202004,188,157,31,164065.5,32395,196460.5
230625,202004,759,530,229,553850.25,239305,793155.25
230630,202004,1335,1049,286,1099340,298870,1398210
230640,202004,3749,3193,556,3338776,582065.75,3920841.75
230650,202004,450,387,63,404415,66880,471295
230655,202004,681,581,100,607145,104500,711645
230660,202004,365,306,59,319770,61655,381425
230670,202004,434,377,57,395010,59565,454575
230680,202004,205,186,19,194370,19855,214225
230690,202004,904,769,135,803605,141075,944680
230700,202004,827,695,132,728365,137940.5,866305.5
230710,202004,698,662,36,692835,37620,730455
230720,202004,152,134,18,141075,18810,159885
230725,202004,264,212,52,221540,54340,275880
230730,202004,12202,6660,5542,6971132.05,5798707.62,12769839.67
230740,202004,674,543,131,568480.5,136895,705375.5
230750,202004,827,700,127,733590,133760,867350
230760,202004,1420,1225,195,1281170,205865,1487035
230763,202004,326,268,58,281105,60610,341715
230765,202004,7443,3439,4004,3598980.51,4195676.38,7794656.89
230770,202004,5125,2605,2520,2727451.86,2641760.5,5369212.36
230780,202004,727,637,90,665665.5,94050,759715.5
230790,202004,279,232,47,242440,49115,291555
230800,202004,1127,817,310,857945,328130,1186075
230810,202004,1346,1190,156,1243550,164065,1407615
230820,202004,359,251,108,262295.5,112860,375155.5
230830,202004,959,823,136,862125,142120,1004245
230835,202004,277,241,36,251845,37620,289465
230837,202004,163,138,25,144210,26125,170335
230840,202004,918,729,189,761805.5,197505.5,959311.0
230850,202004,1473,1277,196,1336555,204820,1541375
230860,202004,296,223,73,233035,76285,309320
230870,202004,1816,1548,268,1618705,281105,1899810
230880,202004,67,51,16,53295,16720,70015
230890,202004,540,497,43,521455,44935,566390
230900,202004,279,206,73,215270,76285.31,291555.31
230910,202004,214,169,45,176605,47025,223630
230920,202004,421,335,86,351120,90915,442035
230930,202004,974,684,290,714780.2,303050,1017830.2
230940,202004,860,672,188,702240,196460,898700
230945,202004,515,426,89,446215.5,93005,539220.5
230950,202004,410,355,55,370975,57475,428450
230960,202004,2670,1787,883,1869505.5,923780.5,2793286.0
230970,202004,1723,960,763,1004245,798380,1802625
230980,202004,207,170,37,177650,38665,216315
230990,202004,136,111,25,115995,26125,142120
231000,202004,205,187,18,196460,19855,216315
231010,202004,149,113,36,118085,37620,155705
231020,202004,1345,935,410,979165,428450,1407615
231025,202004,1062,786,276,822415,288420.5,1110835.5
231030,202004,1100,915,185,957220.19,193325,1150545.19
231040,202004,135,94,41,98230,42845,141075
231050,202004,951,842,109,880935,113905,994840
231060,202004,155,130,25,135850,27170,163020
231070,202004,1500,1044,456,1093070.75,478610,1571680.75
231080,202004,257,239,18,250800,18810,269610
231085,202004,608,366,242,382470,252890,635360
231090,202004,244,199,45,207955,47025,254980
231095,202004,169,133,36,138985,37620,176605
231100,202004,148,125,23,130625,24035,154660
231110,202004,365,312,53,327085,55385,382470
231120,202004,273,232,41,242440,42845,285285
231123,202004,149,142,7,148390,7315,155705
231126,202004,332,260,72,271700.5,75240,346940.5
231130,202004,4625,3607,1018,3774540.5,1066945.5,4841486.0
231135,202004,210,182,28,190190,29260,219450
231140,202004,3052,2242,810,2354385,847495,3201880
231150,202004,364,346,18,363660,18810,382470
231160,202004,1205,955,250,1001110,263340,1264450
231170,202004,522,361,161,378290,168245,546535
231180,202004,1677,1436,241,1502710,251845,1754555
231190,202004,207,173,34,180785,35530,216315
231195,202004,217,186,31,194370,32395,226765
231200,202004,805,658,147,687610,153615,841225
231210,202004,579,489,90,512050,95095,607145
231220,202004,1042,762,280,796290.75,293645,1089935.75
231230,202004,1470,1164,306,1216380,320815,1537195
231240,202004,1455,1035,420,1081575,440990.5,1522565.5
231250,202004,110,101,9,106590,9405,115995
231260,202004,276,179,97,187055,101365,288420
231270,202004,1008,825,183,866306.93,191235,1057541.93
231280,202004,75,58,17,60610,17765,78375
231290,202004,7654,4285,3369,4482005.66,3523740.94,8005746.60
231300,202004,612,568,44,593560,45980,639540
231310,202004,746,691,55,723140.56,58520,781660.56
231320,202004,584,443,141,462936.5,147345,610281.5
231325,202004,96,85,11,88825,11495,100320
231330,202004,1996,1544,452,1617924.9,472340.5,2090265.4
231335,202004,253,224,29,234080,30305,264385
231340,202004,1718,1265,453,1324015,475475,1799490
231350,202004,1287,1053,234,1100385,245576,1345961
231355,202004,432,370,62,388740,64790,453530
231360,202004,508,375,133,393965.86,138985,532950.86
231370,202004,88,76,12,79420,12540,91960
231375,202004,287,210,77,219450,82555,302005
231380,202004,494,398,96,415910,100320,516230
231390,202004,203,162,41,169290,42845,212135
231395,202004,740,462,278,482790,290510,773300
231400,202004,1115,927,188,971850.25,197505.5,1169355.75
231410,202004,1320,1082,238,1130690,249755,1380445
240010,202004,393,173,220,180785.67,229900,410685.67
240020,202004,2274,1830,444,1916531.68,465025,2381556.68
240030,202004,123,104,19,108680,19855,128535
240040,202004,31,31,0,32395,0,32395
240050,202004,529,453,76,475475,80465,555940
240060,202004,64,59,5,61655,5225,66880
240070,202004,216,169,47,176605,49115,225720
240080,202004,515,350,165,366795,172425.01,539220.01
240090,202004,105,94,11,98230,11495,109725
240100,202004,1496,1416,80,1481810.25,83600,1565410.25
240110,202004,1049,688,361,720005.5,377245.78,1097251.28
240120,202004,131,108,23,112860,24035,136895
240130,202004,283,262,21,273790,21945,295735
240140,202004,77,58,19,60610,19855,80465
240145,202004,736,656,80,685520,83600,769120
240150,202004,20,16,4,16720,4180,20900
240160,202004,41,35,6,36575,6270,42845
240165,202004,35,27,8,28215.25,8360,36575.25
240170,202004,106,78,28,81510,29260,110770
240180,202004,84,68,16,71060,16720,87780
240185,202004,42,39,3,40755,3135,43890
240190,202004,15,13,2,13585,2090,15675
240200,202004,3083,1728,1355,1807852.5,1420155.5,3228008.0
240210,202004,171,132,39,137940,40755,178695
240220,202004,1113,809,304,845405.75,317680,1163085.75
240230,202004,843,777,66,814055.75,68970,883025.75
240240,202004,69,50,19,52250,19855,72105
240250,202004,88,76,12,79420,12540,91960
240260,202004,1804,1334,470,1394030,491150,1885180
240270,202004,185,163,22,171380,22990,194370
240280,202004,42,34,8,35530,8360,43890
240290,202004,50,49,1,51205,1045,52250
240300,202004,172,97,75,101365,78375,179740
240310,202004,2306,1279,1027,1338645.98,1074260.85,2412906.83
240320,202004,191,180,11,188100,11495,199595
240325,202004,4499,2694,1805,2822547.29,1886225.7,4708772.99
240330,202004,72,68,4,71060,4180,75240
240340,202004,66,42,24,43890,25080,68970
240350,202004,98,87,11,90915,11495,102410
240360,202004,552,352,200,367840,211090,578930
240370,202004,51,47,4,49115,4180,53295
240375,202004,67,40,27,41800,28215,70015
240380,202004,226,188,38,196460,39710.5,236170.5
240390,202004,13,12,1,12540,1045,13585
240400,202004,82,76,6,79420,6270,85690
240410,202004,13,8,5,8360,5225,13585
240420,202004,993,735,258,768075,269610,1037685
240430,202004,261,244,17,256025,17765,273790
240440,202004,115,64,51,66880,53295,120175
240450,202004,218,148,70,155705.5,73150,228855.5
240460,202004,66,49,17,51205,17765,68970
240470,202004,233,206,27,215270,28215,243485
240480,202004,15,13,2,13585,2090,15675
240485,202004,79,66,13,68970,13585,82555
240490,202004,47,45,2,47025,2090,49115
240500,202004,82,62,20,64790,20900,85690
240510,202004,43,32,11,33440,11495,44935
240520,202004,115,111,4,115995,4180,120175
240530,202004,54,47,7,49115,7315,56430
240540,202004,78,66,12,68970,13585,82555
240550,202004,13,12,1,12540,1045,13585
240560,202004,375,274,101,286330.5,105545,391875.5
240570,202004,448,287,161,300960.67,168245.5,469206.17
240580,202004,1286,1021,265,1067990.25,277970,1345960.25
240590,202004,30,28,2,29260,2090,31350
240600,202004,108,104,4,108680,4180,112860
240610,202004,517,433,84,452485.5,87780,540265.5
240615,202004,19,18,1,18810,1045,19855
240620,202004,88,84,4,87780,4180,91960
240630,202004,38,33,5,34485,5225,39710
240640,202004,25,20,5,20900,5225,26125
240650,202004,240,200,40,209000,41800,250800
240660,202004,108,93,15,97185,15675,112860
240670,202004,302,177,125,186010.75,131670,317680.75
240680,202004,51,39,12,40755,12540,53295
240690,202004,47,44,3,45980,3135,49115
240700,202004,184,153,31,159885,32395,192280
240710,202004,2012,1253,759,1311475.75,793155,2104630.75
240720,202004,1065,787,278,824505,290510,1115015
240725,202004,64,59,5,61655,5225,66880
240730,202004,145,126,19,131670,19855,151525
240740,202004,234,201,33,211090,34485.85,245575.85
240750,202004,49,26,23,27170,24035,51205
240760,202004,46,41,5,42845,5225,48070
240770,202004,144,111,33,115995,34485,150480
240780,202004,675,556,119,581020,124355,705375
240790,202004,40,38,2,39710,2090,41800
240800,202004,9204,6267,2937,6564698.8,3079617.75,9644316.55
240810,202004,20415,11090,9325,11606825.7,9768663.9,21375489.6
240820,202004,233,138,95,144210.09,99275,243485.09
240830,202004,1635,1342,293,1403435.75,307230,1710665.75
240840,202004,78,68,10,71060,10450,81510
240850,202004,87,76,11,79420,11495,90915
240860,202004,107,103,4,107635,4180,111815
240870,202004,59,51,8,53295,8360,61655
240880,202004,32,28,4,29260,4180,33440
240890,202004,1114,645,469,675070.4,491150,1166220.4
240895,202004,62,40,22,41800,22990,64790
240910,202004,159,142,17,148390,17765,166155
240920,202004,13,10,3,10450,3135,13585
240930,202004,414,371,43,387695,44935,432630
240933,202004,43,30,13,31350,13585,44935
240940,202004,2391,2121,270,2217490.45,282150,2499640.45
240950,202004,47,43,4,44935,4180,49115
240960,202004,26,22,4,22990,4180,27170
240970,202004,114,85,29,88825,30305,119130
240980,202004,198,158,40,165110,41800,206910
240990,202004,129,86,43,89870,44935,134805
241000,202004,61,57,4,59565,4180,63745
241010,202004,68,53,15,55385,15675,71060
241020,202004,114,106,8,110770,8360,119130
241025,202004,10,4,6,4180,6270,10450
241030,202004,108,88,20,91960,20900,112860
241040,202004,44,32,12,33440,12540,45980
241050,202004,81,73,8,76285,8360,84645
241060,202004,29,24,5,25080,5225,30305
241070,202004,16,16,0,16720,0,16720
241080,202004,61,54,7,56430,7315,63745
241090,202004,60,49,11,51205,11495,62700
241100,202004,72,61,11,63745,11495,75240
241105,202004,7,1,6,1045,6270,7315
241110,202004,46,44,2,45980,2090,48070
241120,202004,1470,1120,350,1170400.5,365750,1536150.5
241140,202004,221,184,37,192280.5,38665,230945.5
241142,202004,40,35,5,36575,5225,41800
241150,202004,1179,1033,146,1079485,152570,1232055
241160,202004,19,17,2,17765,2090,19855
241170,202004,43,38,5,39710,5225,44935
241180,202004,42,36,6,37620,6270,43890
241190,202004,37,36,1,37620,1045,38665
241200,202004,3869,2028,1841,2122396.39,1928025,4050421.39
241210,202004,69,59,10,61655,10450,72105
241220,202004,1416,961,455,1004246.57,475475,1479721.57
241230,202004,240,202,38,212135,39710,251845
241240,202004,53,42,11,43890,11495,55385
241250,202004,1141,1047,94,1097250.5,98230,1195480.5
241255,202004,50,40,10,41800,10450,52250
241260,202004,678,528,150,551760,156750,708510
241270,202004,64,42,22,43890,22990,66880
241280,202004,93,81,12,85690,12540,98230
241290,202004,126,90,36,94050,37620,131670
241300,202004,76,56,20,58520,20900,79420
241310,202004,51,37,14,38665.75,14630,53295.75
241320,202004,29,17,12,17765,12540,30305
241330,202004,59,55,4,57475,4180,61655
241335,202004,72,64,8,66880,8360,75240
241340,202004,180,133,47,138985,49115,188100
241350,202004,60,52,8,54340,8360,62700
241355,202004,48,42,6,43890,6270,50160
241360,202004,52,50,2,52250,2090,54340
241370,202004,53,43,10,44935,10450,55385
241380,202004,37,33,4,34485,4180,38665
241390,202004,85,66,19,68970,19855,88825
241400,202004,222,179,43,187055,44935,231990
241410,202004,184,166,18,173470,18810,192280
241415,202004,100,80,20,84645,20900,105545
241420,202004,103,73,30,76285,31350.1,107635.1
241430,202004,28,25,3,26125,3135,29260
241440,202004,540,434,106,453530,110770,564300
241445,202004,34,32,2,33440,2090,35530
241450,202004,282,232,50,242440,52250,294690
241460,202004,139,125,14,130625.25,14630,145255.25
241470,202004,39,33,6,34485,6270,40755
241475,202004,56,53,3,55385,3135,58520
241480,202004,95,68,27,72105,28215,100320
241490,202004,11,10,1,10450,1045,11495
241500,202004,47,36,11,37620,11495,49115
250010,202004,102,87,15,90915,15675,106590
250020,202004,32,29,3,30305,3135,33440
250030,202004,856,648,208,679250,219450,898700
250040,202004,367,301,66,314545,68970,383515
250050,202004,253,209,44,218405,47025,265430
250053,202004,57,42,15,43890,15675,59565
250057,202004,1,1,0,1045,0,1045
250060,202004,566,408,158,426360,166155,592515
250070,202004,710,563,147,588335.1,153615,741950.1
250073,202004,8,8,0,8360,0,8360
250077,202004,180,137,43,143165,44935,188100
250080,202004,427,334,93,349030.3,98230,447260.3
250090,202004,217,142,75,148390,78375,226765
250100,202004,515,424,91,443080,95095,538175
250110,202004,608,464,144,485925,151525,637450
250115,202004,20,7,13,7315,13585,20900
250120,202004,122,87,35,91960,36575,128535
250130,202004,573,470,103,492195,107635,599830
250135,202004,18,11,7,11495,7315,18810
250140,202004,86,76,10,79420,10450,89870
250150,202004,592,427,165,447260,172425,619685
250153,202004,9,6,3,6270,3135,9405
250157,202004,30,23,7,24035,7315,31350
250160,202004,231,179,52,187055,55385,242440
250170,202004,62,40,22,41800,22990,64790
250180,202004,4219,2897,1322,3029455.3,1386715,4416170.3
250190,202004,835,550,285,576840,299915.25,876755.25
250200,202004,51,43,8,44935,8360,53295
250205,202004,24,20,4,20900,4180,25080
250210,202004,85,75,10,79420,10450,89870
250215,202004,64,53,11,55385,11495,66880
250220,202004,24,18,6,18810,6270,25080
250230,202004,78,72,6,75240,6270,81510
250240,202004,231,193,38,201685,39710,241395
250250,202004,389,336,53,352165,55385,407550
250260,202004,44,38,6,39710,6270,45980
250270,202004,67,49,18,51205,18810,70015
250280,202004,385,318,67,332310,70015,402325
250290,202004,94,87,7,90915,7315,98230
250300,202004,554,376,178,393965,186010,579975
250310,202004,49,44,5,45980,5225,51205
250320,202004,1953,1320,633,1382535.85,662530.9,2045066.75
250330,202004,98,83,15,86735,15675,102410
250340,202004,25,23,2,24035,2090,26125
250350,202004,163,109,54,113905,57475,171380
250355,202004,33,25,8,26125,8360,34485
250360,202004,198,163,35,170335,36575,206910
250370,202004,2378,1597,781,1670955,817190,2488145
250375,202004,10,6,4,6270,4180,10450
250380,202004,58,43,15,44935,16720,61655
250390,202004,44,33,11,34485,11495,45980
250400,202004,16338,8284,8054,8666170.56,8433151.4,17099321.96
250403,202004,328,267,61,279015,63745,342760
250407,202004,59,49,10,51205,10450,61655
250410,202004,30,26,4,27170,4180,31350
250415,202004,41,28,13,29260,13585,42845
250420,202004,44,38,6,39710,6270,45980
250430,202004,1455,1249,206,1306511.25,215270,1521781.25
250435,202004,18,14,4,14630,4180,18810
250440,202004,678,568,110,594605,114950,709555
250450,202004,83,68,15,71060,15675,86735
250460,202004,470,316,154,330220,160930,491150
250470,202004,91,64,27,66880,28215,95095
250480,202004,327,262,65,273790,67925,341715
250485,202004,2,2,0,2090,0,2090
250490,202004,225,182,43,190190,44935,235125
250500,202004,86,65,21,67925,21945,89870
250510,202004,758,602,156,630135,163020,793155
250520,202004,179,122,57,127490,59565,187055
250523,202004,115,93,22,97185,22990,120175
250527,202004,101,79,22,82555,22990,105545
250530,202004,10,6,4,6270,4180,10450
250535,202004,32,24,8,25080,8360,33440
250540,202004,132,104,28,108680,29260,137940
250550,202004,72,69,3,72105,3135,75240
250560,202004,49,35,14,36575,14630,51205
250570,202004,164,135,29,141075,30305,171380
250580,202004,109,84,25,88892,26125,115017
250590,202004,25,16,9,16720,9405,26125
250600,202004,1378,905,473,946771.46,494285,1441056.46
250610,202004,159,133,26,140030,27170,167200
250620,202004,23,18,5,18810,5225,24035
250625,202004,73,54,19,56430,19855,76285
250630,202004,3028,1929,1099,2022077.43,1150545,3172622.43
250640,202004,218,173,45,181830,47025,228855
250650,202004,29,20,9,20900,9405,30305
250660,202004,49,38,11,39710,11495,51205
250670,202004,63,42,21,43890,21945,65835
250680,202004,406,327,79,341715,82555,424270
250690,202004,2015,1397,618,1460910.96,648945,2109855.96
250700,202004,935,810,125,847495.25,130625,978120.25
250710,202004,433,338,95,353210,99275,452485
250720,202004,114,85,29,88825,30305,119130
250730,202004,381,318,63,332310,65835,398145
250740,202004,54,50,4,52250,4180,56430
250750,202004,22130,13335,8795,13956914.28,9203316.5,23160230.78
250760,202004,93,76,17,79420,17765,97185
250770,202004,360,235,125,245575.6,131670,377245.6
250780,202004,65,45,20,47025,20900,67925
250790,202004,464,304,160,317680.64,168245,485925.64
250800,202004,150,136,14,142120,14630,156750
250810,202004,80,61,19,63745,19855,83600
250820,202004,153,128,25,133760,26125,159885
250830,202004,430,293,137,307230.5,143165,450395.5
250840,202004,55,49,6,51205,6270,57475
250850,202004,57,48,9,50160,9405,59565
250855,202004,13,11,2,11495,2090,13585
250860,202004,212,147,65,153615,67925,221540
250870,202004,30,26,4,27170,4180,31350
250880,202004,80,61,19,63745,19855,83600
250890,202004,2808,2102,706,2199725.5,737770,2937495.5
250900,202004,52,42,10,43890,10450,54340
250905,202004,118,92,26,96140,28215,124355
250910,202004,1135,823,312,860035,326040,1186075
250915,202004,106,75,31,78375,32395,110770
250920,202004,140,103,37,107635,38665,146300
250930,202004,163,98,65,102410,67925,170335
250933,202004,5,3,2,3135,2090,5225
250937,202004,9,8,1,8360,1045,9405
250939,202004,34,25,9,26125,9405,35530
250940,202004,102,77,25,80465,26125,106590
250950,202004,71,49,22,51205,22990,74195
250960,202004,90,49,41,51205,42845,94050
250970,202004,1223,860,363,899745,379335,1279080
250980,202004,103,71,32,74195,33440,107635
250990,202004,163,125,38,130625,39710,170335
251000,202004,74,68,6,71060,6270,77330
251010,202004,114,85,29,88825,30305,119130
251020,202004,75,61,14,63745,14630,78375
251030,202004,45,34,11,35530,11495,47025
251040,202004,55,39,16,40755,16720,57475
251050,202004,24,21,3,21945,3135,25080
251060,202004,51,40,11,41800,11495,53295
251065,202004,4,4,0,4180,0,4180
251070,202004,20,16,4,16720,4180,20900
251080,202004,4974,2383,2591,2493370.75,2710731.51,5204102.26
251090,202004,188,161,27,168245,28215,196460
251100,202004,18,18,0,18810,0,18810
251110,202004,46,37,9,38665,9405,48070
251120,202004,1862,1143,719,1194437,751355.2,1945792.2
251130,202004,397,323,74,337535,77330,414865
251140,202004,556,363,193,380380,201685,582065
251150,202004,335,287,48,299915,50160,350075
251160,202004,90,73,17,77330,17765,95095
251170,202004,101,81,20,84645,20900,105545
251180,202004,287,174,113,182875,118085,300960
251190,202004,200,130,70,135850,75240,211090
251200,202004,267,217,50,226765,52250,279015
251203,202004,35,33,2,34485,2090,36575
251207,202004,90,74,16,77330,16720,94050
251210,202004,1479,1077,402,1125465,420090,1545555
251220,202004,49,36,13,37620,13585,51205
251230,202004,592,502,90,525635,94050,619685
251240,202004,97,67,30,70015,32395,102410
251250,202004,1392,986,406,1035595.75,426360.75,1461956.50
251260,202004,13,7,6,7315,6270,13585
251270,202004,323,246,77,259160,80465,339625
251272,202004,66,60,6,62700,6270,68970
251274,202004,30,23,7,24035,7315,31350
251275,202004,34,20,14,20900,14630,35530
251276,202004,12,9,3,9405,3135,12540
251278,202004,11,9,2,9405,2090,11495
251280,202004,100,96,4,100320,4180,104500
251290,202004,787,575,212,601920,222585,824505
251300,202004,14,12,2,12540,2090,14630
251310,202004,372,270,102,282150,107635,389785
251315,202004,31,28,3,29260,3135,32395
251320,202004,62,49,13,51205,13585,64790
251330,202004,80,71,9,74195,9405,83600
251335,202004,15,10,5,10450,5225,15675
251340,202004,730,432,298,451440,311410,762850
251350,202004,34,33,1,34485,1045,35530
251360,202004,80,70,10,73150,11495,84645
251365,202004,15,15,0,15675,0,15675
251370,202004,5540,3746,1794,3917705.65,1882045,5799750.65
251380,202004,45,37,8,38665,8360,47025
251385,202004,3,3,0,3135,0,3135
251390,202004,792,601,191,628045,199595.5,827640.5
251392,202004,15,8,7,8360,7315,15675
251394,202004,11,11,0,11495,0,11495
251396,202004,11,7,4,7315,4180,11495
251398,202004,18,16,2,16720,2090,18810
251400,202004,39,33,6,34485,6270,40755
251410,202004,37,31,6,32395,6270,38665
251420,202004,101,73,28,76285,29260,105545
251430,202004,41,37,4,38665,4180,42845
251440,202004,38,23,15,24035,15675,39710
251445,202004,50,45,5,47025.25,5225,52250.25
251450,202004,406,353,53,368885,55385,424270
251455,202004,4,2,2,2090,2090,4180
251460,202004,15,13,2,13585,2090,15675
251465,202004,4,2,2,2090,2090,4180
251470,202004,47,38,9,40755,9405,50160
251480,202004,26,21,5,21945,5225,27170
251490,202004,124,82,42,85690,43890.5,129580.5
251500,202004,126,103,23,107635,24035,131670
251510,202004,49,31,18,32395,18810,51205
251520,202004,29,29,0,30305,0,30305
251530,202004,4515,3177,1338,3319965.5,1401345,4721310.5
251540,202004,74,62,12,64790,12540,77330
251550,202004,413,315,98,329175,102410.75,431585.75
251560,202004,23,15,8,15675,8360,24035
251570,202004,20,19,1,19855,1045,20900
251580,202004,127,101,26,106590,29260,135850
251590,202004,115,84,31,87977.5,32395,120372.5
251593,202004,26,16,10,16720,10450,27170
251597,202004,95,74,21,77330,21945,99275
251600,202004,1104,784,320,820325.5,337535.36,1157860.86
251610,202004,235,180,55,188100,57475,245575
251615,202004,6,6,0,6270,0,6270
251620,202004,4224,2774,1450,2901966.6,1519431.5,4421398.1
251630,202004,455,336,119,352165,124355,476520
251640,202004,143,103,40,107635,41800,149435
251650,202004,277,202,75,211090.75,78375,289465.75
251660,202004,191,171,20,179740,20900,200640
251670,202004,372,290,82,303050,85690,388740
251675,202004,8,6,2,6270,2090,8360
251680,202004,96,89,7,93005,7315,100320
251690,202004,328,269,59,282150,62700,344850
251700,202004,284,244,40,254980.9,41800,296780.9
251710,202004,23,15,8,15675,8360,24035
251720,202004,22,15,7,15675,7315.5,22990.5
251740,202004,11,8,3,8360,3135,11495
260005,202004,3239,1783,1456,1865329.21,1524655,3389984.21
260010,202004,1597,1172,425,1225785.55,444125.1,1669910.65
260020,202004,420,367,53,384560,55385,439945
260030,202004,613,430,183,450395,192280,642675
260040,202004,814,504,310,528770,324995,853765
260050,202004,1167,835,332,873620,346941,1220561
260060,202004,380,346,34,361570,35530,397100
260070,202004,1386,859,527,899745.5,550715.3,1450460.8
260080,202004,740,571,169,596695,176605,773300
260090,202004,502,325,177,341715,186010,527725
260100,202004,216,151,65,158840,67925,226765
260105,202004,237,131,106,136895,111815,248710
260110,202004,2880,2114,766,2211221,801515.5,3012736.5
260120,202004,2833,1452,1381,1519431.8,1444190.75,2963622.55
260130,202004,165,113,52,118085,54340,172425
260140,202004,2137,1385,752,1449416.8,788975,2238391.8
260150,202004,211,137,74,143165,77330,220495
260160,202004,325,273,52,285285,54340,339625
260170,202004,3385,2050,1335,2149566.45,1397165.5,3546731.95
260180,202004,154,124,30,130625,31350,161975
260190,202004,2321,1590,731,1663640,764940,2428580
260200,202004,975,782,193,818235.29,201685.5,1019920.79
260210,202004,1433,1026,407,1074260,426360,1500620
260220,202004,698,628,70,656260.5,73150,729410.5
260230,202004,1207,908,299,948860,313500,1262360
260240,202004,220,165,55,172425,57475,229900
260250,202004,93,70,23,73150,24035,97185
260260,202004,1047,739,308,773300,322905,1096205
260270,202004,417,328,89,344850,93005,437855
260280,202004,1304,919,385,960355,402325.5,1362680.5
260290,202004,6543,3534,3009,3698257,3148587.46,6846844.46
260300,202004,940,818,122,856900.5,127490,984390.5
260310,202004,518,407,111,425315,115995,541310
260320,202004,873,640,233,670890,244530,915420
260330,202004,60,43,17,44935,17765,62700
260340,202004,76,56,20,58520,20900,79420
260345,202004,5543,3032,2511,3170531.43,2633400,5803931.43
260350,202004,487,353,134,368885.5,140030,508915.5
260360,202004,261,142,119,149435,125400,274835
260370,202004,716,470,246,491150.25,257070,748220.25
260380,202004,592,434,158,453530,165110.47,618640.47
260390,202004,293,247,46,261250,48070,309320
260392,202004,104,92,12,96140,13585,109725
260400,202004,4147,2373,1774,2481876.22,1853830,4335706.22
260410,202004,14811,7783,7028,8147867.22,7366205.75,15514072.97
260415,202004,139,121,18,126445,18810,145255
260420,202004,1736,1061,675,1110836.77,707465,1818301.77
260430,202004,189,173,16,180785.35,16720,197505.35
260440,202004,203,146,57,152570,59565,212135
260450,202004,431,318,113,333355.96,118085,451440.96
260460,202004,828,437,391,458755.5,409640,868395.5
260470,202004,350,215,135,224675,141075.5,365750.5
260480,202004,234,153,81,159885,86735,246620
260490,202004,216,177,39,184965,40755,225720
260500,202004,1125,754,371,790020,388740,1178760
260510,202004,779,623,156,651035,163020,814055
260515,202004,243,218,25,228855,26125,254980
260520,202004,3273,2002,1271,2097315,1332375.95,3429690.95
260530,202004,797,659,138,690745,144210,834955
260540,202004,558,438,120,458755,126445,585200
260545,202004,14,10,4,10450,4180,14630
260550,202004,328,203,125,213180,130625,343805
260560,202004,523,393,130,410685.5,135850,546535.5
260570,202004,976,795,181,830775,189145,1019920
260580,202004,242,211,31,220495,32395,252890
260590,202004,642,368,274,385605,286330.5,671935.5
260600,202004,8023,4359,3664,4561253.67,3838286,8399539.67
260610,202004,486,324,162,338580,169290,507870
260620,202004,3698,1939,1759,2030436.65,1844426.08,3874862.73
260630,202004,86,81,5,84645,5225,89870
260640,202004,3560,1981,1579,2072235.8,1653190,3725425.8
260650,202004,327,240,87,250800,90915,341715
260660,202004,552,371,181,387695,189145,576840
260670,202004,106,78,28,81510,29260,110770
260680,202004,3719,2079,1640,2176735.22,1716935.5,3893670.72
260690,202004,130,93,37,97185,38665,135850
260700,202004,312,205,107,214225,112860,327085
260710,202004,41,35,6,36575,6270,42845
260720,202004,2404,1430,974,1497486,1023055,2520541
260730,202004,697,524,173,547580,182875,730455
260740,202004,63,58,5,60610,5225,65835
260750,202004,591,424,167,444125,174515,618640
260760,202004,656,345,311,360525.23,324995,685520.23
260765,202004,982,500,482,523545,504735,1028280
260770,202004,223,164,59,171362,62700.5,234062.5
260775,202004,796,449,347,470251.25,362615,832866.25
260780,202004,258,168,90,175560,95095,270655
260790,202004,13016,6803,6213,7118544.47,6514532.28,13633076.75
260795,202004,166,110,56,114950,58520,173470
260800,202004,283,237,46,247665.5,48070,295735.5
260805,202004,171,112,59,117040,61655,178695
260810,202004,749,649,100,678205,104500,782705
260820,202004,292,187,105,195415.85,109725,305140.85
260825,202004,208,148,60,155705,62700,218405
260830,202004,278,176,102,183920,106590,290510
260840,202004,238,176,62,183954.83,64790,248744.83
260845,202004,172,118,54,125400,57475,182875
260850,202004,447,332,115,346940,122265,469205
260860,202004,250,188,62,197505,64790,262295
260870,202004,368,278,90,290510,94050,384560
260875,202004,732,524,208,547580,217360,764940
260880,202004,1597,1017,580,1062765,607145,1669910
260890,202004,2376,1678,698,1755601,730455,2486056
260900,202004,993,703,290,735680,304095,1039775
260910,202004,259,204,55,213180,57475,270655
260915,202004,290,212,78,221540,81510,303050
260920,202004,178,95,83,99275,86735,186010
260930,202004,403,344,59,360525,61655,422180
260940,202004,2720,1472,1248,1542421.4,1307296,2849717.4
260950,202004,2022,1164,858,1218470.75,900790,2119260.75
260960,202004,13774,7004,6770,7336186.26,7109137.45,14445323.71
260970,202004,420,352,68,368885,71060,439945
260980,202004,193,173,20,180785,20900,201685
260990,202004,2612,2116,496,2214356.35,518320,2732676.35
261000,202004,4302,2587,1715,2710730.75,1797400,4508130.75
261010,202004,165,125,40,130625,41800,172425
261020,202004,606,456,150,476520.99,156750,633270.99
261030,202004,241,180,61,188100,63745,251845
261040,202004,370,324,46,338580,48070,386650
261050,202004,507,440,67,459800,70015,529815
261060,202004,1385,898,487,938410.25,511005,1449415.25
261070,202004,8773,4371,4402,4578148.15,4616813.12,9194961.27
261080,202004,377,290,87,303050,91960,395010
261090,202004,2211,1692,519,1769189.7,542355.83,2311545.53
261100,202004,1145,805,340,841225.75,356345,1197570.75
261110,202004,8612,5279,3333,5523870.8,3486121.2,9009992.0
261120,202004,259,222,37,231990,38665,270655
261130,202004,583,346,237,361570,247665.55,609235.55
261140,202004,193,123,70,128535,74195,202730
261150,202004,681,420,261,438900.03,273790,712690.03
261153,202004,65,61,4,63745,4180,67925
261160,202004,76292,38016,38276,39814529.62,40154132.11,79968661.73
261170,202004,478,365,113,381425,118085,499510
261180,202004,1812,1133,679,1186075,710600,1896675
261190,202004,625,434,191,453530.9,199595,653125.9
261200,202004,220,187,33,195415,34485,229900
261210,202004,33,27,6,28215,6270,34485
261220,202004,2687,1894,793,1983411.12,833910,2817321.12
261230,202004,342,255,87,267520,90915,358435
261240,202004,461,404,57,422180,59565,481745
261245,202004,233,195,38,203775,39710,243485
261247,202004,171,136,35,142120,37620,179740
261250,202004,3081,1523,1558,1594670.75,1629155,3223825.75
261255,202004,246,224,22,235125,22990,258115
261260,202004,858,746,112,780615.06,117040,897655.06
261270,202004,203,145,58,151525,60610,212135
261280,202004,178,145,33,151525,34485,186010
261290,202004,117,85,32,88825,33440,122265
261300,202004,1297,944,353,986480,368885,1355365
261310,202004,812,546,266,571615,280060,851675
261320,202004,553,375,178,391875,186010,577885
261330,202004,981,749,232,784795,244530.29,1029325.29
261340,202004,295,165,130,172425,136895,309320
261350,202004,846,600,246,628045.5,258115,886160.5
261360,202004,1282,837,445,875710,466070,1341780
261370,202004,4848,2916,1932,3050356.5,2022076,5072432.5
261380,202004,557,422,135,440990.69,141075.5,582066.19
261390,202004,3607,2426,1181,2537260.5,1236235.75,3773496.25
261400,202004,295,268,27,280060,28215,308275
261410,202004,1104,731,373,764940,390830,1155770
261420,202004,879,542,337,567436.05,353210,920646.05
261430,202004,330,299,31,312455,32395,344850
261440,202004,119,110,9,114950,9405,124355
261450,202004,2524,2053,471,2147476.75,493240.5,2640717.25
261460,202004,721,579,142,605055.85,149435,754490.85
261470,202004,249,197,52,205865,54340,260205
261480,202004,440,342,98,359480,102363,461843
261485,202004,349,208,141,217360,147345,364705
261500,202004,599,410,189,428450,197505,625955
261510,202004,48,32,16,34485,16720,51205
261520,202004,113,101,12,105545,12540,118085
261530,202004,4147,2626,1521,2749396.23,1595715.75,4345111.98
261540,202004,1336,795,541,830775,565345,1396120
261550,202004,272,139,133,145255.5,140030,285285.5
261560,202004,852,562,290,587291.75,303051,890342.75
261570,202004,399,311,88,326040,91960,418000
261580,202004,373,292,81,305140,84645,389785
261590,202004,192,156,36,163020,37620,200640
261600,202004,293,234,59,245575,62700.5,308275.5
261610,202004,91,78,13,81510,13585,95095
261618,202004,75,60,15,62700,15675,78375
261620,202004,209,129,80,134805,83600,218405
261630,202004,561,440,121,459800,127490,587290
261640,202004,6406,3395,3011,3549868.11,3154856.25,6704724.36
261650,202004,487,310,177,323950,184965,508915
270010,202004,524,464,60,484880,62700,547580
270020,202004,289,232,57,242440,59565,302005
270030,202004,8876,5739,3137,6003597.94,3286525.5,9290123.44
270040,202004,2000,1247,753,1306250,786885,2093135
270050,202004,151,113,38,118085,39710,157795
270060,202004,111,61,50,63745,53295,117040
270070,202004,873,640,233,669845,243485,913330
270080,202004,37,30,7,31350,7315,38665
270090,202004,20,15,5,15675,5225,20900
270100,202004,1223,814,409,850630,427405,1278035
270110,202004,125,97,28,101365,29260,130625
270120,202004,229,188,41,196460,42845,239305
270130,202004,252,175,77,182875,81510,264385
270135,202004,116,72,44,75240,45980,121220
270140,202004,1368,863,505,903925.5,528770,1432695.5
270150,202004,256,202,54,212135,56430,268565
270160,202004,506,398,108,415910,114950,530860
270170,202004,795,520,275,544445,287375,831820
270180,202004,70,54,16,56430,16720,73150
270190,202004,90,78,12,81510,12540,94050
270200,202004,103,90,13,94050,13585,107635
270210,202004,498,280,218,292600,227810,520410
270220,202004,177,141,36,147345,37620,184965
270230,202004,2093,1284,809,1343871.6,845405,2189276.6
270235,202004,708,554,154,578930,160930,739860
270240,202004,3057,2423,634,2534126.42,664620.85,3198747.27
270250,202004,158,115,43,120175,44935,165110
270255,202004,210,179,31,187055,32395,219450
270260,202004,365,297,68,310365,71060,381425
270270,202004,95,43,52,44935,54340,99275
270280,202004,237,131,106,136895,110770,247665
270290,202004,1167,892,275,933185,288420,1221605
270300,202004,310,214,96,223630,100320,323950
270310,202004,851,698,153,729410,159885,889295
270320,202004,835,711,124,742995.79,130625,873620.79
270330,202004,286,243,43,253935,45980,299915
270340,202004,60,47,13,49115,13585,62700
270350,202004,90,48,42,50160,43890,94050
270360,202004,64,35,29,36575,30305,66880
270370,202004,53,45,8,47025,8360,55385
270375,202004,71,44,27,45980,28215,74195
270380,202004,1000,625,375,653125,392920,1046045
270390,202004,187,112,75,117040,78375,195415
270400,202004,696,516,180,540265.79,189145,729410.79
270410,202004,657,484,173,506825,180785,687610
270420,202004,406,281,125,293645,130625,424270
270430,202004,32767,23526,9241,24642399.46,9688197.9,34330597.36
270440,202004,486,385,101,403370,105545,508915
270450,202004,790,446,344,467115,362615,829730
270460,202004,193,154,39,160930,40755,201685
270470,202004,1425,989,436,1035595,456665,1492260
270480,202004,541,446,95,466070.5,99275,565345.5
270490,202004,24,19,5,19855,5225,25080
270500,202004,490,409,81,427405,84645,512050
270510,202004,798,492,306,515185,319770,834955
270520,202004,294,191,103,199595,107635,307230
270530,202004,66,57,9,59565,9405,68970
270540,202004,108,84,24,87780,26125,113905
270550,202004,1758,1346,412,1408660,431585,1840245
270560,202004,269,142,127,148390,132715,281105
270570,202004,516,365,151,381425,158840,540265
270580,202004,94,70,24,73150,25080,98230
270590,202004,69,54,15,56430,15675,72105
270600,202004,177,147,30,153615,31350,184965
270610,202004,222,177,45,184965,47025,231990
270620,202004,28,27,1,28215,1045,29260
270630,202004,3749,2855,894,2983859.16,936320.9,3920180.06
270640,202004,870,645,225,675070,235125,910195
270642,202004,222,190,32,198550,33440,231990
270644,202004,248,161,87,168245,90915,259160
270650,202004,319,190,129,198550,134805,333355
270660,202004,249,205,44,214225,45980,260205
270670,202004,3037,2323,714,2427538.55,747175,3174713.55
270680,202004,442,261,181,272745,189145,461890
270690,202004,1158,752,406,786885.95,424270,1211155.95
270700,202004,28,23,5,24035,5225,29260
270710,202004,876,681,195,711645,203775,915420
270720,202004,246,194,52,202730,54340,257070
270730,202004,1858,1115,743,1166603.66,776435.25,1943038.91
270740,202004,41,28,13,29260,13585,42845
270750,202004,630,474,156,495330,163020,658350
270760,202004,291,214,77,223630,80465,304095
270770,202004,2736,1801,935,1883091.55,978120,2861211.55
270780,202004,77,49,28,51205,29260,80465
270790,202004,263,176,87,184965,91960,276925
270800,202004,1969,1584,385,1661550,403370,2064920
270810,202004,280,220,60,229900,62700,292600
270820,202004,145,97,48,101365,50160.5,151525.5
270830,202004,790,589,201,616550,211090,827640
270840,202004,1379,1046,333,1096205,347985.85,1444190.85
270850,202004,1524,945,579,987525.5,606100,1593625.5
270860,202004,2511,1663,848,1739751.29,888250,2628001.29
270870,202004,125,68,57,71060,60610,131670
270880,202004,896,696,200,727320,210045,937365
270890,202004,289,214,75,223630,78375,302005
270895,202004,63,54,9,56430,9405,65835
270900,202004,92,71,21,74195,21945,96140
270910,202004,307,250,57,261250,59565,320815
270915,202004,1909,1202,707,1257135.75,744040.6,2001176.35
270920,202004,470,396,74,414865,77330,492195
270930,202004,5928,4429,1499,4633530,1567500.03,6201030.03
270940,202004,2318,1801,517,1885180,540265,2425445
280010,202004,39,33,6,34485,6270,40755
280020,202004,471,408,63,427405.8,65835,493240.8
280030,202004,20390,13201,7189,13807610.85,7524006.99,21331617.84
280040,202004,329,215,114,225720,120175,345895
280050,202004,397,305,92,318725,96140,414865
280060,202004,354,225,129,235125.7,135850,370975.7
280067,202004,1052,756,296,791065.63,309320.62,1100386.25
280070,202004,122,99,23,103455,24035,127490
280100,202004,626,490,136,513095.5,142120,655215.5
280110,202004,75,70,5,73150,5225,78375
280120,202004,642,528,114,551760,119130,670890
280130,202004,1704,1110,594,1162040,621775.5,1783815.5
280140,202004,476,391,85,410685,88825,499510
280150,202004,388,281,107,293645,111815,405460
280160,202004,103,86,17,89870,17765,107635
280170,202004,401,274,127,286330.75,132715,419045.75
280190,202004,31,29,2,31350,2090,33440
280200,202004,28,24,4,25080,4180,29260
280210,202004,2926,2104,822,2200647.36,858990.5,3059637.86
280220,202004,39,31,8,32395,8360,40755
280230,202004,328,269,59,282150,61655,343805
280240,202004,117,111,6,115995,6270,122265
280250,202004,16,10,6,10450,6270,16720
280260,202004,82,74,8,77330,9405,86735
280270,202004,147,115,32,120175,33440,153615
280280,202004,192,121,71,126445.37,74195,200640.37
280290,202004,3334,2420,914,2529879.16,956175.1,3486054.26
280300,202004,1599,1243,356,1299980.5,372020,1672000.5
280310,202004,100,96,4,100320.5,4180,104500.5
280320,202004,663,466,197,486970,209000,695970
280330,202004,332,239,93,249755,98230,347985
280340,202004,400,326,74,340670.5,77330,418000.5
280350,202004,3652,2839,813,2970937.26,850630.75,3821568.01
280360,202004,462,303,159,319770,166155,485925
280370,202004,98,86,12,89870.65,12540,102410.65
280380,202004,54,42,12,43890,12540,56430
280390,202004,169,146,23,152570,24035,176605
280400,202004,359,245,114,257071.4,119130,376201.4
280410,202004,285,234,51,244530,54340,298870
280420,202004,170,142,28,148390,29260,177650
280430,202004,35,26,9,27170,9405,36575
280440,202004,692,542,150,567435.65,156750,724185.65
280445,202004,116,107,9,111815,9405,121220
280450,202004,1187,1024,163,1071125,171380,1242505
280460,202004,615,449,166,469206.63,173470,642676.63
280470,202004,187,174,13,181830,13585.75,195415.75
280480,202004,2610,1835,775,1918623.21,811965.32,2730588.53
280490,202004,267,252,15,263340.66,15675,279015.66
280500,202004,42,38,4,39710,4180,43890
280510,202004,141,115,26,120175,27170.5,147345.5
280520,202004,54,40,14,41800,14630,56430
280530,202004,73,48,25,50160,26125,76285
280540,202004,530,442,88,461890,91960,553850
280550,202004,726,672,54,702241.71,56430,758671.71
280560,202004,494,435,59,455620,61655,517275
280570,202004,2208,1730,478,1807851.51,499510,2307361.51
280580,202004,597,463,134,483835,141075.5,624910.5
280590,202004,199,123,76,128535,79420,207955
280600,202004,387,324,63,338580,65835,404415
280610,202004,116,88,28,91960,29260,121220
280620,202004,551,455,96,476520,100320,576840
280630,202004,147,122,25,127490,26125,153615
280640,202004,189,150,39,157795,40755,198550
280650,202004,89,60,29,63745,30305,94050
280660,202004,142,107,35,111815,36575,148390
280670,202004,1815,1145,670,1197573.83,700150.59,1897724.42
280680,202004,177,154,23,160930.22,24035,184965.22
280690,202004,80,71,9,74195,9405,83600
280700,202004,22,22,0,22990,0,22990
280710,202004,1470,1132,338,1183985,353210,1537195
280720,202004,112,72,40,75240,41800,117040
280730,202004,25,20,5,20900,5225,26125
280740,202004,2524,1883,641,1969825.5,670890,2640715.5
280750,202004,229,202,27,211090,28215,239305
280760,202004,772,529,243,552805,253935,806740
290010,202004,201,141,60,147345,62700,210045
290020,202004,180,163,17,170335,17765,188100
290030,202004,624,400,224,418000,234080,652080
290035,202004,129,104,25,108680,26125,134805
290040,202004,300,201,99,210045,103455,313500
290050,202004,87,66,21,68970,21945,90915
290060,202004,267,120,147,125400,153615,279015
290070,202004,5741,2786,2955,2913461.1,3092155.75,6005616.85
290080,202004,465,211,254,220495,265430,485925
290090,202004,388,175,213,182875,222585,405460
290100,202004,1642,1069,573,1119195,598786,1717981
290110,202004,833,487,346,508915.75,361570,870485.75
290115,202004,195,180,15,189145,15675,204820
290120,202004,762,500,262,522500,273790,796290
290130,202004,428,263,165,274835,172425,447260
290135,202004,296,225,71,235125,75240,310365
290140,202004,319,263,56,274835,58520,333355
290150,202004,137,100,37,104500,38665,143165
290160,202004,242,186,56,194370,58520,252890
290170,202004,92,67,25,70015,26125,96140
290180,202004,176,131,45,136895,47025,183920
290190,202004,440,360,80,376200,83600,459800
290195,202004,316,203,113,212135,118085,330220
290200,202004,269,218,51,227810,53295,281105
290205,202004,150,92,58,96140,60610,156750
290210,202004,1164,858,306,896610.5,319770,1216380.5
290220,202004,220,123,97,128535,102410,230945
290225,202004,292,113,179,118085,187055,305140
290230,202004,74,48,26,50160,27170,77330
290240,202004,352,133,219,138985,229900,368885
290250,202004,256,236,20,246620,20900,267520
290260,202004,317,261,56,272745.5,58520,331265.5
290265,202004,187,162,25,169290,27170,196460
290270,202004,1425,1181,244,1234145,254980.5,1489125.5
290280,202004,476,338,138,354255,144210,498465
290290,202004,1297,770,527,804651.03,551760.5,1356411.53
290300,202004,440,375,65,391875.5,67925,459800.5
290310,202004,296,136,160,142120,168245,310365
290320,202004,4040,2506,1534,2621905.3,1608255.1,4230160.4
290323,202004,190,165,25,172425,26125,198550
290327,202004,165,132,33,138985,34485,173470
290330,202004,100,56,44,58520,45980,104500
290340,202004,841,346,495,362615,517275,879890
290350,202004,620,376,244,392920,254980,647900
290360,202004,355,276,79,289466.64,82555,372021.64
290370,202004,918,392,526,409640.75,550715,960355.75
290380,202004,317,197,120,205865,125400,331265
290390,202004,2437,1527,910,1595716.75,953040,2548756.75
290395,202004,247,143,104,149435.25,108680,258115.25
290400,202004,275,204,71,213180.5,75240,288420.5
290405,202004,248,214,34,223630,35530,259160
290410,202004,630,529,101,552805.53,106590,659395.53
290420,202004,251,202,49,212135,51205,263340
290430,202004,479,309,170,322905,177650,500555
290440,202004,75,67,8,70015,8360,78375
290450,202004,206,159,47,166155,49115,215270
290460,202004,1946,1176,770,1228920,804650,2033570
290470,202004,1406,605,801,633270,838090,1471360
290475,202004,560,523,37,546535.2,38665,585200.2
290480,202004,289,161,128,168245,133760,302005
290485,202004,241,222,19,231990,19855,251845
290490,202004,1213,871,342,910195,358435,1268630
290500,202004,727,377,350,395010,366795,761805
290510,202004,225,174,51,181830,53295,235125
290515,202004,147,91,56,95095,58520,153615
290520,202004,1424,944,480,987525,501601.44,1489126.44
290530,202004,301,277,24,289465,25080,314545
290540,202004,106,56,50,58520,52250,110770
290550,202004,159,133,26,138985,27170,166155
290560,202004,3222,1359,1863,1421200.5,1947880,3369080.5
290570,202004,6161,3010,3151,3148586.4,3292796.5,6441382.9
290580,202004,1291,770,521,804650,544445,1349095
290590,202004,567,469,98,490105,102410,592515
290600,202004,1761,1217,544,1271765.63,568480,1840245.63
290610,202004,209,188,21,196460,21945,218405
290620,202004,356,317,39,331265,40755,372020
290630,202004,2020,860,1160,898700,1212200.5,2110900.5
290640,202004,152,123,29,128535,30305,158840
290650,202004,1776,821,955,857945.84,999020,1856965.84
290660,202004,276,223,53,233035,55385,288420
290670,202004,933,484,449,506826.21,469205,976031.21
290680,202004,1235,989,246,1034550,258115,1292665
290682,202004,309,232,77,242440.8,80465,322905.8
290685,202004,236,154,82,160930,85690,246620
290687,202004,1037,669,368,700320.1,384560,1084880.1
290689,202004,140,76,64,79420,66880,146300
290690,202004,608,256,352,267520,367840,635360
290700,202004,248,122,126,127490,131670,259160
290710,202004,740,505,235,527725,245575,773300
290720,202004,1026,833,193,871530,202730,1074260
290730,202004,1159,668,491,698060.75,513095,1211155.75
290740,202004,16,14,2,14630,2090,16720
290750,202004,1425,629,796,658350,831821.54,1490171.54
290755,202004,71,64,7,66880,7315,74195
290760,202004,301,262,39,273790,40755,314545
290770,202004,188,177,11,184965,11495.5,196460.5
290780,202004,1109,846,263,884071,274835,1158906
290790,202004,365,258,107,269610,111815.5,381425.5
290800,202004,2523,1016,1507,1063810.5,1575860,2639670.5
290810,202004,467,322,145,337535,151525,489060
290820,202004,399,233,166,243485,173470,416955
290830,202004,416,296,120,309320,125400,434720
290840,202004,1752,1093,659,1144276.7,688655.5,1832932.2
290850,202004,833,447,386,468160,404415,872575
290860,202004,645,292,353,305140,368885.5,674025.5
290870,202004,638,452,186,472340.6,194370.6,666711.2
290880,202004,122,66,56,68970,58520,127490
290890,202004,388,262,126,273790,131670,405460
290900,202004,164,125,39,130625,40755,171380
290910,202004,383,294,89,307230,93005,400235
290920,202004,215,185,30,193325,31350,224675
290930,202004,823,623,200,652080.5,209000,861080.5
290940,202004,248,206,42,215270,43890,259160
290950,202004,156,95,61,99275,63745,163020
290960,202004,474,331,143,345895,149435,495330
290970,202004,253,223,30,233035,31350,264385
290980,202004,1627,1148,479,1201750.7,500556,1702306.7
290990,202004,395,333,62,347985,64790,412775
291000,202004,866,252,614,263340,641630,904970
291005,202004,2307,1027,1280,1073215,1337600,2410815
291010,202004,156,142,14,148390,14630,163020
291020,202004,102,81,21,84645,21945,106590
291030,202004,95,70,25,73150,26125,99275
291040,202004,605,334,271,349030,284240,633270
291050,202004,1423,784,639,819280,669845,1489125
291060,202004,1535,849,686,887205,717915,1605120
291070,202004,1974,1465,509,1530926,531905.12,2062831.12
291072,202004,7248,2703,4545,2831951.1,4755797,7587748.1
291075,202004,234,192,42,201685,44935,246620
291077,202004,55,37,18,38665,18810,57475
291080,202004,20326,8932,11394,9343348.06,11916136.77,21259484.83
291085,202004,297,243,54,253935,56430,310365
291090,202004,303,125,178,130625.5,186010,316635.5
291100,202004,658,196,462,204820,482790,687610
291110,202004,418,320,98,334400,102410,436810
291120,202004,2442,1212,1230,1267585.75,1285350,2552935.75
291125,202004,64,31,33,32395,35530,67925
291130,202004,203,180,23,188100,24035,212135
291140,202004,139,112,27,117040,28215.5,145255.5
291150,202004,387,149,238,156750,248710,405460
291160,202004,387,318,69,332310.25,72105,404415.25
291165,202004,38,30,8,31350,8360,39710
291170,202004,3116,1563,1553,1633337.42,1623930.5,3257267.92
291180,202004,1272,507,765,529815.31,803605,1333420.31
291185,202004,89,84,5,87780,5225,93005
291190,202004,1364,607,757,634315.25,792110,1426425.25
291200,202004,168,126,42,131670,43890,175560
291210,202004,2282,917,1365,958265.2,1430605.5,2388870.7
291220,202004,273,207,66,216315,68970,285285
291230,202004,991,346,645,362615.5,675070,1037685.5
291240,202004,430,403,27,421135.5,28215,449350.5
291250,202004,444,360,84,376200,87780,463980
291260,202004,55,45,10,47025,10450,57475
291270,202004,1164,488,676,511005,706420,1217425
291280,202004,362,172,190,179740,198550,378290
291290,202004,1738,895,843,936320.5,880935.5,1817256.0
291300,202004,232,184,48,192280,50160,242440
291310,202004,219,200,19,210045,20900,230945
291320,202004,1367,964,403,1007380,422180,1429560
291330,202004,129,110,19,115995,19855,135850
291340,202004,204,116,88,121220,91960,213180
291345,202004,134,93,41,97185,42845,140030
291350,202004,1640,577,1063,604010,1110835.75,1714845.75
291360,202004,8487,4114,4373,4305401.25,4581281.25,8886682.50
291370,202004,1122,642,480,670890.5,502645,1173535.5
291380,202004,266,210,56,219450,58520,277970
291390,202004,3910,1729,2181,1808896.6,2281236,4090132.6
291400,202004,2092,1487,605,1554960,632225.84,2187185.84
291410,202004,187,165,22,172425,22990,195415
291420,202004,120,87,33,90915,34485,125400
291430,202004,165,90,75,94050,78375.02,172425.02
291440,202004,518,425,93,445171,97185,542356
291450,202004,913,581,332,607145.25,346940,954085.25
291460,202004,1834,1498,336,1565411,352165.5,1917576.5
291465,202004,2177,1031,1146,1077395.5,1200705,2278100.5
291470,202004,2863,1448,1415,1515251.93,1478675.5,2993927.43
291480,202004,11885,5273,6612,5521785.17,6923130.52,12444915.69
291490,202004,605,245,360,256025,376200,632225
291500,202004,376,217,159,226765,166155,392920
291510,202004,1230,480,750,501600,784795,1286395
291520,202004,943,431,512,450395,535040,985435
291530,202004,944,254,690,266475,722095,988570
291535,202004,127,105,22,109725,22990,132715
291540,202004,344,102,242,106590.5,252890,359480.5
291550,202004,1229,577,652,602965,683430.5,1286395.5
291560,202004,5288,2671,2617,2795375,2737901,5533276
291570,202004,198,104,94,108680,98230,206910
291580,202004,1210,745,465,778525.05,486970,1265495.05
291590,202004,86,35,51,36575,53295.5,89870.5
291600,202004,1149,568,581,593561.36,607145,1200706.36
291610,202004,1469,714,755,747175,790020,1537195
291620,202004,576,265,311,276925,324995,601920
291630,202004,484,149,335,156750,350075,506825
291640,202004,3973,2027,1946,2118217.2,2033571.5,4151788.7
291650,202004,419,289,130,302006.12,135850,437856.12
291660,202004,399,160,239,167200.29,249755,416955.29
291670,202004,223,134,89,140030,93005,233035
291680,202004,663,392,271,409640,283195.5,692835.5
291685,202004,591,331,260,345895,272745,618640
291690,202004,538,323,215,337535,225720.27,563255.27
291700,202004,973,757,216,792110,225720,1017830
291710,202004,1660,793,867,830775.25,907060,1737835.25
291720,202004,420,279,141,291555,149435,440990
291730,202004,947,558,389,583110,406505,989615
291733,202004,283,192,91,201685,95095,296780
291735,202004,75,56,19,58520,19855,78375
291740,202004,353,273,80,286330,83600,369930
291750,202004,2138,1389,749,1451505.38,783750,2235255.38
291760,202004,2997,1651,1346,1725295,1409705,3135000
291770,202004,789,533,256,556986.05,268565,825551.05
291780,202004,58,36,22,37620,22990,60610
291790,202004,160,80,80,83600,83600,167200
291800,202004,10083,4171,5912,4366012.59,6189536.75,10555549.34
291810,202004,1102,824,278,861080.5,291555,1152635.5
291820,202004,279,200,79,209000,82555,291555
291830,202004,1074,429,645,450396.46,674025,1124421.46
291835,202004,579,538,41,562210,43890,606100
291840,202004,4873,2475,2398,2587421.21,2511135.5,5098556.71
291845,202004,269,89,180,93005,188100,281105
291850,202004,325,288,37,300960,38665,339625
291855,202004,266,105,161,109725,169290,279015
291860,202004,171,108,63,112860,65835,178695
291870,202004,85,35,50,36575,52250,88825
291875,202004,180,166,14,173470,14630,188100
291880,202004,457,362,95,379335,99275,478610
291890,202004,241,77,164,80465,171380.5,251845.5
291900,202004,58,32,26,33440,27170,60610
291905,202004,129,95,34,99275.5,35530,134805.5
291910,202004,165,134,31,140030,32395,172425
291915,202004,429,381,48,398145.25,50160,448305.25
291920,202004,5086,2580,2506,2696100,2619815.5,5315915.5
291930,202004,170,102,68,107635.55,71060,178695.55
291940,202004,359,206,153,215270.5,159885,375155.5
291950,202004,1149,929,220,970806,230945.5,1201751.5
291955,202004,1249,744,505,778525,528770,1307295
291960,202004,188,137,51,143165,54340,197505
291970,202004,762,582,180,608190,188100,796290
291980,202004,1502,1331,171,1392986.23,178695.5,1571681.73
291990,202004,133,124,9,129580,9405,138985
291992,202004,171,88,83,91960,86735,178695
291995,202004,168,112,56,117040,58520,175560
292000,202004,397,306,91,319770,95095,414865
292010,202004,314,219,95,228855,99275,328130
292020,202004,300,223,77,233035,81510,314545
292030,202004,147,114,33,119130,34485,153615
292040,202004,633,320,313,335445,328130,663575
292045,202004,104,96,8,100320,8360,108680
292050,202004,943,690,253,721050,264385.5,985435.5
292060,202004,909,754,155,787930.65,161975,949905.65
292070,202004,56,22,34,22990,35530,58520
292080,202004,143,99,44,103455,45980,149435
292090,202004,528,186,342,194370,357390,551760
292100,202004,1489,640,849,668800,887205,1556005
292105,202004,194,170,24,177650,25080,202730
292110,202004,2260,831,1429,871530,1495395,2366925
292120,202004,698,549,149,575795,155705,731500
292130,202004,440,250,190,261250,198550,459800
292140,202004,209,168,41,175560,42845,218405
292145,202004,161,87,74,90915.5,77330,168245.5
292150,202004,1482,1209,273,1263405,287375,1550780
292160,202004,171,140,31,146300,32395,178695
292170,202004,1212,1053,159,1102475,166155,1268630
292180,202004,219,158,61,165110,63745,228855
292190,202004,162,104,58,108680,60610,169290
292200,202004,1335,493,842,515185,884070.5,1399255.5
292205,202004,125,111,14,115995,14630,130625
292210,202004,363,254,109,266475,114950.25,381425.25
292220,202004,27,21,6,21945,6270,28215
292225,202004,39,34,5,35530,5225,40755
292230,202004,966,770,196,804650.75,204820,1009470.75
292240,202004,619,442,177,462935.75,184965,647900.75
292250,202004,1748,1151,597,1202795,623865,1826660
292260,202004,411,248,163,259160,170335,429495
292265,202004,252,179,73,187055,76285,263340
292270,202004,737,339,398,354255,415910,770165
292273,202004,198,110,88,114950,91960,206910
292275,202004,171,84,87,87780,90915,178695
292280,202004,141,97,44,101365,45980,147345
292285,202004,74,62,12,64790,12540,77330
292290,202004,569,385,184,402325,192280.5,594605.5
292300,202004,1676,632,1044,661485,1090980.3,1752465.3
292303,202004,111,72,39,75240,40755,115995
292305,202004,114,84,30,87780,31350,119130
292310,202004,922,609,313,636406.6,327085.9,963492.5
292320,202004,603,459,144,479655,150480,630135
292330,202004,176,102,74,106590,77330,183920
292335,202004,278,216,62,226765,64790,291555
292340,202004,572,401,171,419045.5,178695,597740.5
292350,202004,271,145,126,151525,131670,283195
292360,202004,709,542,167,567435.9,174515,741950.9
292370,202004,738,567,171,592515,178695,771210
292380,202004,645,517,128,541310.35,133760,675070.35
292390,202004,482,189,293,197505,306185,503690
292400,202004,3609,2221,1388,2320947.61,1452550.79,3773498.40
292405,202004,262,172,90,179740,95095,274835
292410,202004,142,86,56,89870,58520,148390
292420,202004,293,253,40,266475,41800,308275
292430,202004,535,409,126,427405,131670,559075
292440,202004,595,515,80,538175.16,84645,622820.16
292450,202004,251,194,57,202730,59565,262295
292460,202004,555,413,142,432630.95,148390,581020.95
292465,202004,214,178,36,186010,37620,223630
292467,202004,123,73,50,76285,52250,128535
292470,202004,287,196,91,204820,95095,299915
292480,202004,367,252,115,263340,121220.5,384560.5
292490,202004,234,164,70,171380,73150,244530
292500,202004,868,387,481,404415.15,504735,909150.15
292510,202004,3436,1595,1841,1667820.6,1924890,3592710.6
292520,202004,1088,515,573,539220,598785,1138005
292525,202004,398,278,120,290510,125400,415910
292530,202004,4341,1755,2586,1837110.96,2706551.5,4543662.46
292540,202004,471,264,207,275880,216315,492195
292550,202004,1082,577,505,602965,528770,1131735
292560,202004,330,310,20,323950,20900,344850
292570,202004,303,238,65,248710,67925,316635
292575,202004,496,326,170,340670.5,177650.5,518321.0
292580,202004,990,652,338,682385,354255.5,1036640.5
292590,202004,568,490,78,512050,81510,593560
292593,202004,142,113,29,119130,30305,149435
292595,202004,200,156,44,163020,45980,209000
292600,202004,1263,919,344,960355.29,360525,1320880.29
292610,202004,135,105,30,109725,31350,141075
292620,202004,528,443,85,465025.5,88825,553850.5
292630,202004,1426,808,618,845405.42,645810.25,1491215.67
292640,202004,809,557,252,582065,263340,845405
292650,202004,191,157,34,164065.5,35530,199595.5
292660,202004,2029,1458,571,1524655,596695.42,2121350.42
292665,202004,142,100,42,104500,43890,148390
292670,202004,390,315,75,329175,78375,407550
292680,202004,251,191,60,199595,62700.5,262295.5
292690,202004,194,144,50,150480,52250,202730
292700,202004,967,640,327,669845,342760,1012605
292710,202004,113,98,15,102410,15675,118085
292720,202004,922,527,395,550715,413820,964535
292730,202004,197,90,107,94050,111815,205865
292740,202004,68930,33737,35193,35288625.6,36821629.83,72110255.43
292750,202004,389,278,111,290510.95,115995,406505.95
292760,202004,332,277,55,290511.45,57475,347986.45
292770,202004,807,347,460,362615.65,480700,843315.65
292780,202004,403,159,244,166155,254980,421135
292790,202004,767,390,377,407550,395010,802560
292800,202004,1247,751,496,784795,518320,1303115
292805,202004,397,116,281,122265,293645,415910
292810,202004,1496,850,646,888251.5,677160,1565411.5
292820,202004,716,593,123,619686.25,128535,748221.25
292830,202004,110,91,19,95095,19855,114950
292840,202004,686,563,123,589380,128535,717915
292850,202004,140,93,47,97185,49115,146300
292860,202004,2183,1275,908,1333420.5,948860,2282280.5
292870,202004,3482,2328,1154,2433805.45,1205930,3639735.45
292880,202004,1498,986,512,1032460.05,536085,1568545.05
292890,202004,518,443,75,463980,78375,542355
292895,202004,141,93,48,97185,50160,147345
292900,202004,393,280,113,292600.4,118085,410685.4
292905,202004,472,241,231,252890,241395,494285
292910,202004,453,341,112,357390.75,117040,474430.75
292920,202004,520,227,293,238260,307230,545490
292925,202004,487,448,39,468160,40755,508915
292930,202004,607,370,237,386650,247665,634315
292935,202004,282,121,161,126445,168245,294690
292937,202004,225,160,65,167200,67925,235125
292940,202004,193,149,44,155705,45980,201685
292950,202004,1163,585,578,611325.75,604010.6,1215336.35
292960,202004,585,414,171,432630,178695,611325
292970,202004,248,175,73,183920,76285,260205
292975,202004,120,68,52,71060,54340,125400
292980,202004,281,190,91,198550.52,95095,293645.52
292990,202004,1338,992,346,1037687.3,361570,1399257.3
293000,202004,110,76,34,79420,35530,114950
293010,202004,2804,1676,1128,1753510.75,1179805.72,2933316.47
293015,202004,639,520,119,543400,125400,668800
293020,202004,330,269,61,281105,63745,344850
293030,202004,596,520,76,544445,79420,623865
293040,202004,354,280,74,292600,77330,369930
293050,202004,2859,1699,1160,1776500.5,1213245.5,2989746.0
293060,202004,259,209,50,218405.6,52250,270655.6
293070,202004,3474,1766,1708,1845472.22,1784861.75,3630333.97
293075,202004,91,61,30,63745,31350,95095
293076,202004,73,52,21,55385,21945,77330
293077,202004,504,297,207,310365.5,216315,526680.5
293080,202004,436,391,45,408595.85,47025,455620.85
293090,202004,131,116,15,121220,15675,136895
293100,202004,520,366,154,382470,161975,544445
293105,202004,343,247,96,258115,101365,359480
293110,202004,167,119,48,124355,50160,174515
293120,202004,317,215,102,224675,106590,331265
293130,202004,242,168,74,175560,77330,252890
293135,202004,8029,3165,4864,3313696.75,5087064.5,8400761.25
293140,202004,207,133,74,138985,77330,216315
293150,202004,331,286,45,298870,47025,345895
293160,202004,421,245,176,256025,183920,439945
293170,202004,174,122,52,127490,54340,181830
293180,202004,493,354,139,369930.5,146300,516230.5
293190,202004,1343,935,408,977075.61,426360,1403435.61
293200,202004,546,484,62,505780,64790,570570
293210,202004,395,302,93,315590,97185,412775
293220,202004,2506,1053,1453,1101430,1519430,2620860
293230,202004,1726,639,1087,667755.94,1135915,1803670.94
293240,202004,233,215,18,224675,18810,243485
293245,202004,126,107,19,111815,19855,131670
293250,202004,715,258,457,269610.9,480700,750310.9
293260,202004,301,250,51,261250,53295,314545
293270,202004,1166,544,622,568480.65,649990,1218470.65
293280,202004,267,146,121,152570,126445,279015
293290,202004,3050,1986,1064,2077460,1113970,3191430
293300,202004,732,523,209,547580.75,218405,765985.75
293305,202004,191,154,37,160930,38665,199595
293310,202004,149,112,37,117040,38665,155705
293315,202004,167,130,37,135850,38665,174515
293317,202004,91,65,26,68970,27170,96140
293320,202004,1049,587,462,613415.92,483835,1097250.92
293325,202004,183,68,115,71060,120175,191235
293330,202004,13530,6339,7191,6627392.91,7516688.75,14144081.66
293340,202004,264,188,76,196460,79420,275880
293345,202004,245,200,45,209000,47025,256025
293350,202004,616,356,260,372020,271700,643720
293360,202004,1532,1103,429,1153680,449350,1603030
310010,202004,136,75,61,78375,63745.5,142120.5
310020,202004,1031,576,455,601920,475475,1077395
310030,202004,334,267,67,279015,70015,349030
310040,202004,42,29,13,30305,13585,43890
310050,202004,185,115,70,120175.5,73150,193325.5
310060,202004,242,168,74,175560.5,78375,253935.5
310070,202004,14,9,5,9405,6270,15675
310080,202004,42,25,17,26125,17765,43890
310090,202004,1018,533,485,556987,507871,1064858
310100,202004,301,223,78,233035,81510,314545
310110,202004,705,388,317,405460,332310,737770
310120,202004,369,213,156,222585,163020,385605
310130,202004,30,19,11,19855,11495,31350
310140,202004,26,13,13,13585,13585,27170
310150,202004,1217,831,386,870485.5,403371,1273856.5
310160,202004,2058,1012,1046,1060676.25,1095160.5,2155836.75
310163,202004,87,50,37,53295,38665,91960
310170,202004,2555,1135,1420,1188166.35,1488082,2676248.35
310180,202004,147,55,92,57475.5,97185,154660.5
310190,202004,477,331,146,346940,152570,499510
310200,202004,486,309,177,322905,184965,507870
310205,202004,56,38,18,39710,18810,58520
310210,202004,283,229,54,239305,56430,295735
310220,202004,62,34,28,35530,29260,64790
310230,202004,274,188,86,196460,89870,286330
310240,202004,106,94,12,98230,12540,110770
310250,202004,94,79,15,82555,15675,98230
310260,202004,767,408,359,427406.17,379335,806741.17
310270,202004,269,174,95,181830.6,99275,281105.6
310280,202004,376,277,99,289465,104500,393965
310285,202004,210,153,57,159885,59565,219450
310290,202004,247,133,114,138985,119130,258115
310300,202004,158,131,27,136895,28215,165110
310310,202004,10,8,2,8360,2090,10450
310320,202004,31,13,18,13585,18810,32395
310330,202004,39,25,14,26125,14630,40755
310340,202004,1754,1155,599,1208022,627000.5,1835022.5
310350,202004,2808,1507,1301,1578995,1364770,2943765
310360,202004,40,34,6,35530,6270,41800
310370,202004,115,95,20,99275,20900.5,120175.5
310375,202004,103,37,66,39710,68970,108680
310380,202004,47,27,20,28215,20900,49115
310390,202004,91,62,29,64790,30305,95095
310400,202004,2365,1531,834,1603031,874665,2477696
310410,202004,131,73,58,76285,60610,136895
310420,202004,671,356,315,373065,329175,702240
310430,202004,309,196,113,205865,118085,323950
310440,202004,78,45,33,47025,34485,81510
310445,202004,80,67,13,70015,13585,83600
310450,202004,636,392,244,409640,257070,666710
310460,202004,262,184,78,192280,82555,274835
310470,202004,503,318,185,333355.5,193325,526680.5
310480,202004,74,52,22,54340,24035,78375
310490,202004,538,255,283,267520,297825,565345
310500,202004,132,53,79,55385,82555,137940
310510,202004,598,413,185,432630,195415,628045
310520,202004,133,92,41,96140,42845,138985
310530,202004,104,45,59,47025,61655,108680
310540,202004,462,272,190,284240,198550,482790
310550,202004,79,49,30,52250,31350,83600
310560,202004,2980,2052,928,2148521,971850,3120371
310570,202004,102,68,34,71060,35530,106590
310590,202004,371,236,135,246620.25,141075,387695.25
310600,202004,150,83,67,86735.5,70015,156750.5
310610,202004,61,24,37,25080,38665,63745
310620,202004,47156,22491,24665,23553192.08,25855397.27,49408589.35
310630,202004,635,395,240,412775,250800.5,663575.5
310640,202004,130,101,29,106590,30305,136895
310650,202004,161,144,17,150480,17765,168245
310660,202004,99,63,36,65835,37620,103455
310665,202004,59,45,14,47025,14630,61655
310670,202004,6653,2886,3767,3024232.5,3946966,6971198.5
310680,202004,58,36,22,37620,22990,60610
310690,202004,617,433,184,452485.25,192280,644765.25
310700,202004,56,38,18,39710,18810,58520
310710,202004,1316,901,415,942590.5,434720.5,1377311.0
310720,202004,125,37,88,38665,91960,130625
310730,202004,1444,999,445,1045001.25,466070.5,1511071.75
310740,202004,985,549,436,575796,456665.25,1032461.25
310750,202004,242,145,97,151525.65,101365,252890.65
310760,202004,62,44,18,45980,18810.5,64790.5
310770,202004,106,49,57,51205,59565,110770
310780,202004,367,296,71,309320,74195,383515
310790,202004,102,83,19,86735,19855,106590
310800,202004,446,211,235,221540.25,245575,467115.25
310810,202004,172,124,48,129581.22,50160,179741.22
310820,202004,341,269,72,281105,75240,356345
310825,202004,193,165,28,172425,29260,201685
310830,202004,473,227,246,238260.5,258115,496375.5
310840,202004,363,211,152,220495,158840,379335
310850,202004,102,83,19,86735,19855,106590
310855,202004,396,312,84,326040,87780,413820
310860,202004,1599,1180,419,1235193,437856.25,1673049.25
310870,202004,53,43,10,44935,10450,55385
310880,202004,80,63,17,65835,17765,83600
310890,202004,302,177,125,184965,130625,315590
310900,202004,649,300,349,313509.86,365762.96,679272.82
310910,202004,237,161,76,168245.5,80465,248710.5
310920,202004,456,272,184,284241.45,192280.5,476521.95
310925,202004,37,31,6,32395,6270,38665
310930,202004,1307,823,484,862125,507870,1369995
310940,202004,700,349,351,364705,366795,731500
310945,202004,119,74,45,79420,47025,126445
310950,202004,236,190,46,199595,48070,247665
310960,202004,77,25,52,26125,54340,80465
310970,202004,159,100,59,104500,62700.5,167200.5
310980,202004,51,32,19,33440,19855,53295
310990,202004,160,82,78,85690,81510,167200
311000,202004,810,402,408,421136.49,426360.5,847496.99
311010,202004,44,39,5,40755,5225,45980
311020,202004,45,27,18,28215,18810,47025
311030,202004,384,226,158,236170.5,166155,402325.5
311040,202004,44,33,11,34485,11495,45980
311050,202004,491,191,300,200640,314545,515185
311060,202004,788,436,352,457710,367840.5,825550.5
311070,202004,339,155,184,161975,192280,354255
311080,202004,108,60,48,62700,50160,112860
311090,202004,335,159,176,166155,187055,353210
311100,202004,594,357,237,373065,247665,620730
311110,202004,693,483,210,506825,220495,727320
311115,202004,77,55,22,57475,22990,80465
311120,202004,1085,575,510,601920.5,532950,1134870.5
311130,202004,355,216,139,225720,146300,372020
311140,202004,171,91,80,95095,83600,178695
311150,202004,354,231,123,241395,128535,369930
311160,202004,694,493,201,515185.5,212135,727320.5
311170,202004,85,68,17,71060,17765,88825
311180,202004,327,222,105,233035,109725.5,342760.5
311190,202004,41,20,21,20900,21945,42845
311200,202004,326,228,98,238260,103455,341715
311205,202004,35,24,11,25080,11495,36575
311210,202004,47,41,6,42845.5,6270,49115.5
311220,202004,23,20,3,20900,3135,24035
311230,202004,1636,1076,560,1124420.5,587290,1711710.5
311240,202004,182,118,64,123310,67925,191235
311250,202004,94,27,67,28215,71060,99275
311260,202004,554,347,207,362615,216315,578930
311265,202004,121,82,39,85690,40755,126445
311270,202004,283,194,89,202730,93005,295735
311280,202004,215,99,116,103455,121220,224675
311290,202004,104,86,18,89870,18810,108680
311300,202004,586,369,217,385605,226765,612370
311310,202004,21,16,5,16720,5225,21945
311320,202004,661,489,172,511005,179740,690745
311330,202004,1093,804,289,844360,302005.5,1146365.5
311340,202004,2637,1862,775,1947881,814055,2761936
311350,202004,277,215,62,225720,65835,291555
311360,202004,171,106,65,110770,67925,178695
311370,202004,1211,499,712,521455.25,745085,1266540.25
311380,202004,7,6,1,6270,1045,7315
311390,202004,257,141,116,147345,121220,268565
311400,202004,139,88,51,91960,53295,145255
311410,202004,108,58,50,60610,52250,112860
311420,202004,304,166,138,175560,144210,319770
311430,202004,848,567,281,593560,293645.5,887205.5
311440,202004,459,325,134,339625,141075,480700
311450,202004,314,192,122,200640,127490,328130
311455,202004,279,193,86,201685,89870,291555
311460,202004,142,61,81,63745,84645,148390
311470,202004,22,12,10,12540,10450,22990
311480,202004,47,22,25,22990,26125,49115
311490,202004,13,9,4,9405,4180,13585
311500,202004,24,11,13,11495,13585,25080
311510,202004,639,440,199,460845,207955,668800
311520,202004,41,33,8,34485,8360,42845
311530,202004,1809,1336,473,1397166.7,496375,1893541.7
311535,202004,67,48,19,50160,19855,70015
311540,202004,34,30,4,31350,4180,35530
311545,202004,180,134,46,140030,48070,188100
311547,202004,38,31,7,32395,7315,39710
311550,202004,696,325,371,340670,388740,729410
311560,202004,43,29,14,30305,14630,44935
311570,202004,283,191,92,199595,96140,295735
311580,202004,331,197,134,206910,140030,346940
311590,202004,32,29,3,30305,3135,33440
311600,202004,107,82,25,85690,26125,111815
311610,202004,256,221,35,230945.25,36575,267520.25
311615,202004,75,60,15,62700,15675,78375
311620,202004,26,14,12,14630,12540,27170
311630,202004,83,70,13,73150,14630,87780
311640,202004,132,64,68,66880,71060,137940
311650,202004,125,87,38,90915,39710,130625
311660,202004,401,198,203,206910,213180,420090
311670,202004,148,100,48,105545.66,50160,155705.66
311680,202004,211,156,55,163020,57475,220495
311690,202004,14,10,4,10450,4180,14630
311700,202004,198,138,60,144210,62700,206910
311710,202004,199,132,67,138985,71060,210045
311720,202004,40,29,11,30305.5,11495,41800.5
311730,202004,578,389,189,406505,197505,604010
311740,202004,35,25,10,26125,10450,36575
311750,202004,724,489,235,513095.76,246620,759715.76
311760,202004,64,29,35,30305,36575,66880
311770,202004,397,197,200,205866.35,209000,414866.35
311780,202004,178,93,85,97185.5,88825,186010.5
311783,202004,86,77,9,80465,9405,89870
311787,202004,37,13,24,13585,25080,38665
311790,202004,261,115,146,120175,152570,272745
311800,202004,680,448,232,469205.95,242440,711645.95
311810,202004,49,40,9,41800,9405,51205
311820,202004,122,100,22,104500,22990,127490
311830,202004,1908,1179,729,1234146.25,764940,1999086.25
311840,202004,1008,560,448,587290.5,469205.25,1056495.75
311850,202004,12,8,4,8360,4180,12540
311860,202004,9593,4199,5394,4395272.25,5646136,10041408.25
311870,202004,126,65,61,67925,64790,132715
311880,202004,931,678,253,708510,264385.13,972895.13
311890,202004,207,99,108,103369,113905,217274
311900,202004,73,29,44,30305,47025,77330
311910,202004,1409,888,521,930050.75,547580.5,1477631.25
311920,202004,234,152,82,158840,85690,244530
311930,202004,905,516,389,541310.5,407550,948860.5
311940,202004,2510,1325,1185,1386715,1239370.15,2626085.15
311950,202004,57,43,14,44935,14630,59565
311960,202004,58,43,15,44935,16720,61655
311970,202004,23,14,9,14630,9405,24035
311980,202004,45,35,10,36575,10450,47025
311990,202004,39,30,9,31350,9405,40755
311995,202004,55,37,18,38665,18810,57475
312000,202004,29,22,7,22990,7315,30305
312010,202004,76,60,16,62700,16720,79420
312015,202004,75,58,17,60610,17765,78375
312020,202004,127,82,45,85690,48070,133760
312030,202004,58,43,15,44935,15675,60610
312040,202004,87,52,35,54340.5,36575,90915.5
312050,202004,211,116,95,121220,99275,220495
312060,202004,23,12,11,12540,11495,24035
312070,202004,76,50,26,52250,28215,80465
312080,202004,534,241,293,251845,308275,560120
312083,202004,60,39,21,40755,21945,62700
312087,202004,106,84,22,87780,22990,110770
312090,202004,3175,1903,1272,1989682.1,1329240.5,3318922.6
312100,202004,151,106,45,110530.15,47025,157555.15
312110,202004,117,71,46,74195,48070,122265
312120,202004,144,106,38,110771.14,39710,150481.14
312125,202004,91,49,42,51205,43890,95095
312130,202004,126,84,42,87780,43890,131670
312140,202004,136,106,30,110770.5,31350,142120.5
312150,202004,43,33,10,34485,10450,44935
312160,202004,1557,1026,531,1072266.5,556985.5,1629252.0
312170,202004,12,10,2,10450,2090,12540
312180,202004,115,68,47,71060,49115.5,120175.5
312190,202004,35,31,4,32395,4180,36575
312200,202004,755,643,112,674025.5,118085,792110.5
312210,202004,110,59,51,61655,53295,114950
312220,202004,138,103,35,107635.25,37620,145255.25
312230,202004,3638,1698,1940,1778590.4,2032526,3811116.4
312235,202004,166,112,54,118085,56430,174515
312240,202004,98,69,29,73150,31350,104500
312245,202004,186,128,58,133760,60610,194370
312247,202004,69,49,20,51205,20900,72105
312250,202004,175,85,90,88825,94050,182875
312260,202004,110,73,37,76285,38665,114950
312270,202004,130,77,53,80465,55385,135850
312280,202004,26,12,14,12540,14630,27170
312290,202004,147,105,42,109725,43890,153615
312300,202004,211,133,78,138985,81510,220495
312310,202004,63,56,7,58520,7315,65835
312320,202004,425,270,155,283195,164065.75,447260.75
312330,202004,89,78,11,81510,11495,93005
312340,202004,36,17,19,17765,19855,37620
312350,202004,18,11,7,11495,7315,18810
312352,202004,93,69,24,72105,25080,97185
312360,202004,578,252,326,264385,341715,606100
312370,202004,304,168,136,175560,142120,317680
312380,202004,146,95,51,99275,53295,152570
312385,202004,165,131,34,137940,35530,173470
312390,202004,301,186,115,195415,121220.5,316635.5
312400,202004,378,285,93,299915,97185.5,397100.5
312410,202004,990,314,676,329175,706420,1035595
312420,202004,629,482,147,503690.5,153615,657305.5
312430,202004,863,633,230,664621.11,241395,906016.11
312440,202004,42,31,11,32395,11495,43890
312450,202004,209,131,78,136895,81510,218405
312460,202004,33,16,17,16720,17765,34485
312470,202004,49,32,17,33440,17765,51205
312480,202004,191,118,73,123310,76285,199595
312490,202004,268,186,82,196460,85690,282150
312500,202004,36,21,15,21945,15675,37620
312510,202004,528,205,323,217360,337535,554895
312520,202004,32,9,23,9405,24035,33440
312530,202004,48,33,15,34485,15675,50160
312540,202004,96,85,11,89870,11495,101365
312550,202004,34,28,6,29260,6270,35530
312560,202004,214,164,50,171380.5,52250,223630.5
312570,202004,438,263,175,276925,183920,460845
312580,202004,89,49,40,51205,41800,93005
312590,202004,247,198,49,206910,51205,258115
312595,202004,135,121,14,126445,14630,141075
312600,202004,67,38,29,39710.25,30305,70015.25
312610,202004,1591,820,771,856902,807785.5,1664687.5
312620,202004,207,145,62,151525,64790,216315
312630,202004,62,52,10,54340,10450,64790
312640,202004,46,14,32,14630,33440,48070
312650,202004,145,121,24,126445.5,25080,151525.5
312660,202004,88,64,24,66880.76,25080,91960.76
312670,202004,920,597,323,624910,337535,962445
312675,202004,30,24,6,26125,7315,33440
312680,202004,77,49,28,51205,29260,80465
312690,202004,248,128,120,133760,126445,260205
312695,202004,35,29,6,30305,6270,36575
312700,202004,227,132,95,137940,99275,237215
312705,202004,85,67,18,70015,18810,88825
312707,202004,127,89,38,93005,39710,132715
312710,202004,1896,1012,884,1057541.41,924825,1982366.41
312720,202004,62,32,30,33440,31350,64790
312730,202004,281,164,117,171380,122265,293645
312733,202004,54,45,9,47025,9405,56430
312735,202004,22,14,8,14630,8360,22990
312737,202004,70,38,32,39710,33440,73150
312738,202004,58,40,18,42845,18810,61655
312740,202004,80,53,27,55385,28215,83600
312750,202004,78,58,20,60610,20900,81510
312760,202004,288,206,82,215270,85690,300960
312770,202004,7884,3620,4264,3797534.25,4467375,8264909.25
312780,202004,422,321,101,335445,105545,440990
312790,202004,22,16,6,16720,6270,22990
312800,202004,1596,1111,485,1165175.75,509960,1675135.75
312810,202004,370,234,136,244530,142120,386650
312820,202004,186,143,43,149435,44935,194370
312825,202004,25,16,9,16720,9405,26125
312830,202004,233,133,100,138985,104500,243485
312840,202004,159,109,50,113905,52250,166155
312850,202004,43,39,4,40755,4180,44935
312860,202004,152,95,57,99275,59565,158840
312870,202004,1049,547,502,572660.9,525635,1098295.9
312880,202004,128,89,39,93005,40755,133760
312890,202004,158,114,44,119130,45980,165110
312900,202004,192,144,48,151525,50160,201685
312910,202004,179,94,85,98230,88825,187055
312920,202004,155,86,69,90915,72105,163020
312930,202004,327,228,99,238260,103455,341715
312940,202004,114,81,33,84645,34485,119130
312950,202004,705,480,225,501600,236170,737770
312960,202004,171,129,42,134805.4,44935,179740.4
312965,202004,74,63,11,65835,11495,77330
312970,202004,271,220,51,230945.25,53295,284240.25
312980,202004,2459,1236,1223,1292666,1284305,2576971
312990,202004,43,22,21,22990,21945,44935
313000,202004,49,28,21,29260,21945,51205
313005,202004,174,135,39,142120,40755.5,182875.5
313010,202004,911,361,550,378290.5,576840,955130.5
313020,202004,191,101,90,105545,94050,199595
313030,202004,194,130,64,135850.35,66880,202730.35
313040,202004,75,23,52,24035,54340,78375
313050,202004,185,133,52,138985,54340,193325
313055,202004,38,29,9,30305,9405,39710
313060,202004,129,89,40,93005,41800,134805
313065,202004,62,44,18,45980,18810,64790
313070,202004,132,68,64,71060,66880,137940
313080,202004,40,17,23,17765,24035,41800
313090,202004,648,429,219,449350,230945,680295
313100,202004,180,66,114,68970,119130,188100
313110,202004,137,74,63,77330,65835,143165
313115,202004,204,114,90,119130,95095,214225
313120,202004,810,458,352,479655.5,368885.5,848541.0
313130,202004,5678,3097,2581,3240547.44,2698191.75,5938739.19
313140,202004,141,75,66,78375,68970,147345
313150,202004,308,246,62,257070,64790,321860
313160,202004,186,138,48,144210.5,50160,194370.5
313170,202004,1385,943,442,988570.5,463980,1452550.5
313180,202004,300,177,123,184965.5,128535,313500.5
313190,202004,755,453,302,473385.5,318725,792110.5
313200,202004,29,24,5,25080,5225,30305
313210,202004,1001,848,153,886162.55,161975,1048137.55
313220,202004,265,170,95,177650,99275.5,276925.5
313230,202004,266,202,64,211090.87,66880,277970.87
313240,202004,2119,1098,1021,1148458.25,1071125,2219583.25
313250,202004,1256,957,299,1001111,313500.8,1314611.8
313260,202004,91,49,42,51205,43890,95095
313270,202004,972,564,408,589380.75,428451,1017831.75
313280,202004,51,43,8,44935,8360,53295
313290,202004,218,174,44,181830,45980,227810
313300,202004,350,182,168,190190,175560,365750
313310,202004,256,124,132,129580,137940,267520
313320,202004,376,280,96,293645,101365,395010
313330,202004,1394,860,534,899745,559075,1458820
313340,202004,326,231,95,241395,99275,340670
313350,202004,502,334,168,349030,175560,524590
313360,202004,129,69,60,72105,62700,134805
313370,202004,206,69,137,72105,143165,215270
313375,202004,283,168,115,175560,121220,296780
313380,202004,1351,710,641,742995.5,672980,1415975.5
313390,202004,54,47,7,49115,7315,56430
313400,202004,403,274,129,287375,134806,422181
313410,202004,22,13,9,13585,9405,22990
313420,202004,4608,2457,2151,2573836,2257200.5,4831036.5
313430,202004,138,67,71,70015,74195,144210
313440,202004,1447,989,458,1035596.81,478612,1514208.81
313450,202004,66,27,39,28215,40755,68970
313460,202004,391,172,219,179740.5,229900,409640.5
313470,202004,527,247,280,258115.5,293646.22,551761.72
313480,202004,147,108,39,112860.5,40755,153615.5
313490,202004,513,239,274,249755.5,286330.25,536085.75
313500,202004,24,14,10,14630,10450,25080
313505,202004,1021,805,216,841225,225720,1066945
313507,202004,99,54,45,56430,47025,103455
313510,202004,2809,1776,1033,1856966.04,1080530,2937496.04
313520,202004,3485,2709,776,2834042.66,811965,3646007.66
313530,202004,34,23,11,24035,11495,35530
313535,202004,65,50,15,52250,15675,67925
313540,202004,68,51,17,53295,17765.5,71060.5
313545,202004,112,93,19,97185,19855,117040
313550,202004,231,195,36,204820,37620.5,242440.5
313560,202004,337,167,170,174515,177650,352165
313570,202004,66,28,38,29260,39710,68970
313580,202004,1309,737,572,771211.25,598786.5,1369997.75
313590,202004,67,37,30,38665,31350,70015
313600,202004,679,412,267,431585,279015.5,710600.5
313610,202004,56,45,11,48070,11495,59565
313620,202004,1389,703,686,738816,720005,1458821
313630,202004,1608,1235,373,1293711,390830,1684541
313640,202004,119,73,46,76285,48070,124355
313650,202004,237,109,128,113905,133760.5,247665.5
313652,202004,17,17,0,17765,0,17765
313655,202004,64,42,22,43890,22990,66880
313657,202004,49,45,4,47025,4180,51205
313660,202004,135,95,40,99275,41818.81,141093.81
313665,202004,650,305,345,318725.75,363660,682385.75
313670,202004,10385,7102,3283,7438314.37,3437006.8,10875321.17
313680,202004,44,33,11,34485,11495.95,45980.95
313690,202004,144,110,34,114950,35530,150480
313695,202004,78,60,18,62700,18810,81510
313700,202004,307,249,58,260205.5,61655,321860.5
313710,202004,145,100,45,104500,47025,151525
313720,202004,1116,526,590,550715.5,617596.5,1168312.0
313730,202004,75,45,30,47025,31350,78375
313740,202004,151,122,29,127490,30305,157795
313750,202004,431,312,119,326040,125400,451440
313753,202004,234,174,60,183920,63745,247665
313760,202004,1291,470,821,491150,861081.25,1352231.25
313770,202004,378,275,103,287375.25,107635,395010.25
313780,202004,766,406,360,424270,378290,802560
313790,202004,27,26,1,27170,1045,28215
313800,202004,137,84,53,87780,55385,143165
313810,202004,76,44,32,45980,33440,79420
313820,202004,1312,632,680,663576,711645.5,1375221.5
313830,202004,59,42,17,43890,17765,61655
313835,202004,61,51,10,53295,10450,63745
313840,202004,1671,1009,662,1057541.5,694926,1752467.5
313850,202004,206,74,132,77330,137940,215270
313860,202004,479,363,116,380380.5,121220,501600.5
313862,202004,165,110,55,114950,57475,172425
313865,202004,117,87,30,90915,31350,122265
313867,202004,47,37,10,38665,10450,49115
313868,202004,33,20,13,20900,13585,34485
313870,202004,120,63,57,65835,59565,125400
313880,202004,372,230,142,240350,148390,388740
313890,202004,336,179,157,187055,164065.5,351120.5
313900,202004,887,479,408,501600.25,427405.25,929005.50
313910,202004,139,101,38,105545,39710,145255
313920,202004,640,452,188,472340,196460.94,668800.94
313925,202004,31,28,3,29260,3135,32395
313930,202004,869,677,192,708510,201685,910195
313940,202004,1849,1162,687,1216380,718960,1935340
313950,202004,877,550,327,575795,342760,918555
313960,202004,1402,803,599,839135.9,627002,1466137.9
313970,202004,146,96,50,101365,52250,153615
313980,202004,206,128,78,133760.25,81510,215270.25
313990,202004,242,162,80,169290,83600,252890
314000,202004,909,605,304,634315.85,317680,951995.85
314010,202004,85,54,31,56430,32395,88825
314015,202004,63,17,46,19855,48070,67925
314020,202004,55,36,19,38665,19855,58520
314030,202004,74,36,38,37620,39710,77330
314040,202004,43,24,19,25080,19855,44935
314050,202004,284,166,118,173470,123310,296780
314053,202004,98,64,34,66880,35530,102410
314055,202004,302,187,115,195415,120175,315590
314060,202004,137,118,19,123310.04,19855,143165.04
314070,202004,1066,551,515,576840,539220,1116060
314080,202004,207,133,74,140030,77330.4,217360.4
314085,202004,140,96,44,100320,45980,146300
314090,202004,377,270,107,282150.25,111815,393965.25
314100,202004,493,396,97,413820.75,101365,515185.75
314110,202004,748,389,359,406505.5,375155,781660.5
314120,202004,93,55,38,57475,39710,97185
314130,202004,22,12,10,12540,10450,22990
314140,202004,1102,678,424,709555,443080,1152635
314150,202004,173,109,64,113905,66880,180785
314160,202004,331,253,78,264385,81510,345895
314170,202004,83,66,17,68970,17765,86735
314180,202004,730,647,83,677160.5,86735.25,763895.75
314190,202004,98,59,39,61655,40755,102410
314200,202004,488,332,156,347985,163020,511005
314210,202004,250,192,58,200640,61655.5,262295.5
314220,202004,305,224,81,234080.5,84645,318725.5
314225,202004,64,47,17,49115,17765,66880
314230,202004,117,52,65,55385,67925,123310
314240,202004,142,110,32,114950,33440,148390
314250,202004,53,30,23,31350,24035,55385
314260,202004,210,104,106,108680,110770,219450
314270,202004,358,278,80,292600,83600,376200
314280,202004,703,388,315,408595,329175,737770
314290,202004,545,440,105,459800,109725,569525
314300,202004,362,261,101,272745.75,105545.25,378291.00
314310,202004,1377,933,444,976292.57,466070,1442362.57
314315,202004,33,26,7,27170,7315,34485
314320,202004,594,389,205,406505.5,214225,620730.5
314330,202004,11062,5410,5652,5663902,5924106,11588008
314340,202004,602,276,326,288420,341716,630136
314345,202004,46,30,16,31350,16720,48070
314350,202004,181,114,67,120175,70015,190190
314360,202004,62,38,24,39710,25080,64790
314370,202004,67,48,19,51205,19855,71060
314380,202004,92,59,33,61655,34485,96140
314390,202004,3335,2142,1193,2246751.93,1248775,3495526.93
314400,202004,697,497,200,519366.3,209000,728366.3
314410,202004,477,312,165,326040,173470,499510
314420,202004,14,7,7,7315,7315,14630
314430,202004,2442,895,1547,936320.36,1617660.5,2553980.86
314435,202004,204,126,78,132715,81510,214225
314437,202004,28,22,6,22990,6270,29260
314440,202004,96,69,27,72105,28215,100320
314450,202004,154,108,46,112860,48070,160930
314460,202004,646,306,340,319770,355300,675070
314465,202004,94,61,33,63745,34485,98230
314467,202004,69,57,12,59565,12540,72105
314470,202004,413,207,206,216316.45,215270,431586.45
314480,202004,1058,503,555,529815,582065,1111880
314490,202004,46,33,13,34485,13585,48070
314500,202004,282,193,89,201685,94050,295735
314505,202004,118,79,39,82555,40755,123310
314510,202004,241,199,42,207955,43890,251845
314520,202004,1292,683,609,718967,637451.5,1356418.5
314530,202004,739,593,146,619686.01,152570,772256.01
314535,202004,191,116,75,121220,79420,200640
314537,202004,61,36,25,37620,26125,63745
314540,202004,16,10,6,10450,6270,16720
314545,202004,54,35,19,36575,19855,56430
314550,202004,80,42,38,43890,39710,83600
314560,202004,867,472,395,493240.5,412775,906015.5
314570,202004,21,16,5,16720,5225,21945
314580,202004,12,5,7,5225,7315,12540
314585,202004,25,18,7,18810,7315,26125
314587,202004,84,72,12,75240,12540,87780
314590,202004,566,406,160,426360.75,168245,594605.75
314600,202004,934,600,334,628046,349030.79,977076.79
314610,202004,954,496,458,519365.5,479655,999020.5
314620,202004,142,106,36,111815,37620.16,149435.16
314625,202004,94,69,25,72105.5,26125,98230.5
314630,202004,1170,624,546,652080,571615,1223695
314640,202004,81,54,27,56430,28215.5,84645.5
314650,202004,183,103,80,107635,83600,191235
314655,202004,64,47,17,49115,18810,67925
314660,202004,17,14,3,14630,3135,17765
314670,202004,199,152,47,158840.5,49115,207955.5
314675,202004,211,123,88,128535,91960,220495
314690,202004,586,313,273,327085,285285,612370
314700,202004,2293,1235,1058,1292667,1107700,2400367
314710,202004,1679,980,699,1027236.75,730455.5,1757692.25
314720,202004,389,234,155,244530,163020,407550
314730,202004,512,268,244,280061,254980,535041
314740,202004,708,342,366,358435,383515,741950
314750,202004,22,19,3,19855,3135,22990
314760,202004,337,159,178,166155,186010,352165
314770,202004,106,74,32,77330,33440,110770
314780,202004,18,7,11,7315,11495,18810
314790,202004,2367,1483,884,1556006.48,924825,2480831.48
314795,202004,53,43,10,44935,10450,55385
314800,202004,2919,1708,1211,1785907.22,1269675,3055582.22
314810,202004,1534,867,667,909150,698060,1607210
314820,202004,110,62,48,64790,50160,114950
314830,202004,213,172,41,179740,42845,222585
314840,202004,86,51,35,53295,36575,89870
314850,202004,373,185,188,194370.5,196460,390830.5
314860,202004,675,517,158,541310,167200,708510
314870,202004,1521,798,723,834955.5,758670,1593625.5
314875,202004,57,49,8,51205,9405,60610
314880,202004,43,30,13,31350,13585,44935
314890,202004,57,33,24,34485,25080,59565
314900,202004,30,23,7,24035,7315,31350
314910,202004,243,160,83,167200,86735,253935
314915,202004,141,126,15,131670,15675,147345
314920,202004,102,62,40,65835,41800,107635
314930,202004,1054,517,537,541310.5,562210.5,1103521.0
314940,202004,47,37,10,38665,10450,49115
314950,202004,31,21,10,21945,10450,32395
314960,202004,38,30,8,31350,8360,39710
314970,202004,148,72,76,76285.5,79420,155705.5
314980,202004,305,197,108,206910,112860,319770
314990,202004,446,242,204,253935,213180,467115
314995,202004,207,68,139,71060,145255,216315
315000,202004,94,72,22,75240,22990,98230
315010,202004,44,28,16,29260,16720,45980
315015,202004,172,138,34,144210,35530,179740
315020,202004,72,57,15,59565,15675,75240
315030,202004,115,88,27,91960.5,28215,120175.5
315040,202004,68,49,19,51205,19855,71060
315050,202004,182,108,74,112860,77330,190190
315053,202004,45,37,8,38665,8360,47025
315057,202004,104,82,22,85690,22990,108680
315060,202004,75,64,11,66880.8,11495,78375.8
315070,202004,103,57,46,59565,48070,107635
315080,202004,380,305,75,319770,78375,398145
315090,202004,96,58,38,60610,40755,101365
315100,202004,82,41,41,42845,42845,85690
315110,202004,272,145,127,151525,133760,285285
315120,202004,1721,843,878,881980,919600.2,1801580.2
315130,202004,351,252,99,263340,103455,366795
315140,202004,513,300,213,316635.5,224675.5,541311.0
315150,202004,969,459,510,481745,533995,1015740
315160,202004,215,106,109,110770,113905,224675
315170,202004,313,208,105,217360.5,109725,327085.5
315180,202004,3283,1368,1915,1432696.68,2009536.25,3442232.93
315190,202004,326,190,136,198550,142120,340670
315200,202004,1236,731,505,763895,529815,1293710
315210,202004,1664,949,715,994840,751355,1746195
315213,202004,41,23,18,24035,18810,42845
315217,202004,216,170,46,177650,48070,225720
315220,202004,1576,1189,387,1243550.95,406505,1650055.95
315230,202004,172,122,50,128535.5,52250,180785.5
315240,202004,424,271,153,284240,159885.5,444125.5
315250,202004,2562,1260,1302,1320880,1360590.5,2681470.5
315260,202004,145,82,63,85690,65835,151525
315270,202004,128,87,41,90915,42845,133760
315280,202004,661,428,233,447260,244530,691790
315290,202004,194,119,75,125400,78375,203775
315300,202004,77,57,20,59565,20900,80465
315310,202004,73,66,7,68970,7315,76285
315320,202004,168,100,68,104500,71060,175560
315330,202004,56,47,9,49115,9405,58520
315340,202004,393,283,110,295735,114950,410685
315350,202004,154,91,63,95095,65835,160930
315360,202004,90,46,44,48070,45980,94050
315370,202004,54,34,20,36575,20900,57475
315380,202004,11,8,3,8360,3135,11495
315390,202004,67,18,49,18810,51205.5,70015.5
315400,202004,844,627,217,655215.5,226765,881980.5
315410,202004,325,190,135,198550.5,141076.5,339627.0
315415,202004,58,43,15,44935,15675,60610
315420,202004,197,142,55,148390.5,57475,205865.5
315430,202004,660,374,286,391875.5,299915,691790.5
315440,202004,94,65,29,68970,30305,99275
315445,202004,235,193,42,201685,43890,245575
315450,202004,184,139,45,145255,47025,192280
315460,202004,4008,1945,2063,2036705,2160015,4196720
315470,202004,42,17,25,17765,26125,43890
315480,202004,66,22,44,22990,45980,68970
315490,202004,658,409,249,428450,260205,688655
315500,202004,18,12,6,12540,6270,18810
315510,202004,148,100,48,104500,50160,154660
315520,202004,71,62,9,64790,9405,74195
315530,202004,48,26,22,27170,22990,50160
315540,202004,245,167,78,174515,82555,257070
315550,202004,175,142,33,148390,34485,182875
315560,202004,744,596,148,623865.5,154660,778525.5
315570,202004,314,161,153,169291.69,159885,329176.69
315580,202004,710,477,233,498465,243485.5,741950.5
315590,202004,197,105,92,109725,96140,205865
315600,202004,303,228,75,238260,78375,316635
315610,202004,99,52,47,54340,49115,103455
315620,202004,36,28,8,29260,8360,37620
315630,202004,129,86,43,89870,44935,134805
315640,202004,73,44,29,45980,30305,76285
315645,202004,46,32,14,33440,14630.75,48070.75
315650,202004,172,125,47,130626.14,49115,179741.14
315660,202004,464,205,259,214225.5,270655,484880.5
315670,202004,2389,1148,1241,1201752,1296845,2498597
315680,202004,844,593,251,619685,264385,884070
315690,202004,679,465,214,486972.08,223630,710602.08
315700,202004,1903,996,907,1040821.21,949905,1990726.21
315710,202004,342,102,240,106590,250800,357390
315720,202004,448,278,170,290510.5,178695,469205.5
315725,202004,190,153,37,159885.5,38665,198550.5
315727,202004,53,22,31,22990,32395,55385
315730,202004,45,43,2,44935,2090,47025
315733,202004,88,59,29,61655,30305,91960
315737,202004,50,37,13,38665,13585,52250
315740,202004,32,25,7,26125,7315,33440
315750,202004,159,119,40,124355,41800,166155
315760,202004,41,31,10,32395,10450,42845
315765,202004,125,74,51,77330,53295,130625
315770,202004,222,141,81,148390,84645.5,233035.5
315780,202004,3486,1747,1739,1828750.75,1819346.49,3648097.24
315790,202004,230,178,52,186010,54340,240350
315800,202004,294,207,87,216315,90915,307230
315810,202004,95,57,38,59565,39710.5,99275.5
315820,202004,740,537,203,561165.5,212135,773300.5
315830,202004,128,78,50,81510,52250,133760
315840,202004,85,56,29,58520,30305,88825
315850,202004,257,181,76,189145,79420,268565
315860,202004,15,6,9,6270,9405,15675
315870,202004,38,28,10,29260,10450,39710
315880,202004,106,67,39,70015,40755,110770
315890,202004,92,69,23,72105,24035,96140
315895,202004,447,299,148,312455,154661,467116
315900,202004,71,33,38,34485,39710,74195
315910,202004,40,24,16,25080,16720,41800
315920,202004,163,107,56,111815,58520.75,170335.75
315930,202004,49,18,31,18810,32395,51205
315935,202004,132,102,30,106590.5,31350,137940.5
315940,202004,101,74,27,77330,28215,105545
315950,202004,39,29,10,30305,10450,40755
315960,202004,536,258,278,269610,292600.5,562210.5
315970,202004,33,27,6,28215,6270,34485
315980,202004,685,337,348,352165,365750,717915
315990,202004,255,148,107,154660,111815.5,266475.5
316000,202004,50,32,18,33440,18810,52250
316010,202004,78,68,10,71060,10450,81510
316020,202004,117,100,17,105545,17765,123310
316030,202004,391,217,174,227810.5,181830.75,409641.25
316040,202004,522,220,302,229900.5,316635.5,546536.0
316045,202004,62,55,7,57475,7315,64790
316050,202004,14,11,3,11495,3135,14630
316060,202004,95,62,33,64790,34485,99275
316070,202004,1091,703,388,737770.75,406505,1144275.75
316080,202004,102,68,34,71060,35530,106590
316090,202004,42,21,21,21945,21945,43890
316095,202004,101,83,18,86735,18810,105545
316100,202004,310,178,132,187055.25,137940,324995.25
316105,202004,39,26,13,27170,13585,40755
316110,202004,1882,1496,386,1564365.62,404415,1968780.62
316120,202004,82,59,23,61655,24035,85690
316130,202004,125,94,31,98230.5,32395,130625.5
316140,202004,33,22,11,22990,11495,34485
316150,202004,205,142,63,148390,65835,214225
316160,202004,83,47,36,50160,37620,87780
316165,202004,65,49,16,51205,16720,67925
316170,202004,187,123,64,128535,66880,195415
316180,202004,203,87,116,90915,121220.5,212135.5
316190,202004,139,100,39,105545,40755,146300
316200,202004,658,364,294,380380,307230,687610
316210,202004,767,509,258,534174.74,270655,804829.74
316220,202004,116,76,40,79420,41800,121220
316225,202004,25,15,10,15675,10450,26125
316230,202004,32,18,14,18810,14630,33440
316240,202004,656,522,134,549670,140030,689700
316245,202004,128,112,16,117040,16720,133760
316250,202004,1535,1043,492,1090981.75,516230,1607211.75
316255,202004,125,99,26,103455,27170,130625
316257,202004,182,96,86,100320,89870,190190
316260,202004,197,139,58,145255.25,60610.5,205865.75
316265,202004,27,18,9,18810,9405,28215
316270,202004,686,482,204,504735.5,213180.6,717916.1
316280,202004,550,341,209,356345.29,218406,574751.29
316290,202004,748,498,250,520410.65,261250,781660.65
316292,202004,512,201,311,210045,324995,535040
316294,202004,99,60,39,62700,40755,103455
316295,202004,312,135,177,141075.5,184965,326040.5
316300,202004,105,72,33,75240,34485,109725
316310,202004,31,16,15,16720,15675,32395
316320,202004,46,26,20,27170,20900,48070
316330,202004,160,109,51,113905.25,53295,167200.25
316340,202004,133,92,41,97185,42845,140030
316350,202004,193,137,56,143165.74,58520,201685.74
316360,202004,19,13,6,13585,6270,19855
316370,202004,1109,572,537,598786.25,563255,1162041.25
316380,202004,120,91,29,95095,30305,125400
316390,202004,118,86,32,89870,33440,123310
316400,202004,130,98,32,103455,33440,136895
316410,202004,291,210,81,219450,85690,305140
316420,202004,205,140,65,147345,67925,215270
316430,202004,152,80,72,85690,75240,160930
316440,202004,88,42,46,43890,48070,91960
316443,202004,41,39,2,40755,2090,42845
316447,202004,58,42,16,43890,16720,60610
316450,202004,225,171,54,178695,56430,235125
316460,202004,76,26,50,27170,52250,79420
316470,202004,1666,1221,445,1276982.76,466070,1743052.76
316480,202004,12,8,4,8360,4180,12540
316490,202004,18,7,11,7315,11495,18810
316500,202004,150,101,49,105545,51205,156750
316510,202004,156,119,37,124355,38665,163020
316520,202004,196,121,75,126445,78375,204820
316530,202004,162,108,54,112860,56430,169290
316540,202004,140,75,65,79420,67925,147345
316550,202004,126,85,41,90915,42845,133760
316553,202004,294,135,159,141075,166155.72,307230.72
316555,202004,39,34,5,35530,5225,40755
316556,202004,12,9,3,9405,3135,12540
316557,202004,21,17,4,17765,4180,21945
316560,202004,66,47,19,49115,19855,68970
316570,202004,217,197,20,206910,20900,227810
316580,202004,18,13,5,13585,5225,18810
316590,202004,105,89,16,93005,16720,109725
316600,202004,180,146,34,152570.5,35530,188100.5
316610,202004,64,48,16,50160,16720,66880
316620,202004,139,104,35,109725,36575,146300
316630,202004,43,34,9,35530,9405,44935
316640,202004,22,14,8,14630,8360,22990
316650,202004,74,61,13,63745,13585,77330
316660,202004,8,3,5,3135,5225,8360
316670,202004,439,154,285,160930,297825,458755
316680,202004,160,111,49,115995,51205,167200
316690,202004,188,117,71,122265,74195,196460
316695,202004,64,54,10,56430,10450,66880
316700,202004,16,10,6,10450,6270,16720
316710,202004,781,588,193,614460.25,201685,816145.25
316720,202004,5022,2452,2570,2566523.24,2687741,5254264.24
316730,202004,16,16,0,16720,0,16720
316740,202004,140,90,50,94050,53295,147345
316750,202004,17,10,7,10450,7315,17765
316760,202004,328,260,68,271700,71060,342760
316770,202004,155,82,73,86735,76285,163020
316780,202004,69,43,26,44935,28215,73150
316790,202004,52,39,13,40755,13585,54340
316800,202004,1760,1089,671,1139050,702240.5,1841290.5
316805,202004,22,14,8,14630,8360,22990
316810,202004,69,45,24,47025,25080,72105
316820,202004,42,21,21,21945,21945,43890
316830,202004,93,43,50,44935,52250,97185
316840,202004,531,306,225,319770.5,236170,555940.5
316850,202004,331,221,110,230945,115995,346940
316860,202004,5962,2622,3340,2747308.9,3493435.75,6240744.65
316870,202004,1540,995,545,1042912.25,571615,1614527.25
316880,202004,124,61,63,63745,65835,129580
316890,202004,239,165,74,172425,77330,249755
316900,202004,419,297,122,311410.65,128535,439945.65
316905,202004,21,9,12,10450,12540,22990
316910,202004,66,27,39,28215,40755,68970
316920,202004,133,106,27,110770,28215,138985
316930,202004,1901,976,925,1024101.5,969760.75,1993862.25
316935,202004,920,558,362,586245.1,379335.5,965580.6
316940,202004,1094,623,471,652080.5,494285.5,1146366.0
316950,202004,179,88,91,91960,95095,187055
316960,202004,1113,622,491,653126.5,517275,1170401.5
316970,202004,655,518,137,541310.5,143165,684475.5
316980,202004,74,43,31,44935,32395,77330
316990,202004,2175,1452,723,1524655.85,759715.74,2284371.59
317000,202004,336,257,79,268565,82555,351120
317005,202004,240,167,73,174515,76285,250800
317010,202004,6392,3541,2851,3707665.23,2990790.5,6698455.73
317020,202004,16134,7069,9065,7400699.6,9505324.6,16906024.2
317030,202004,82,31,51,32395,53295,85690
317040,202004,3065,1904,1161,1996996,1214290,3211286
317043,202004,75,55,20,57475,20900,78375
317047,202004,29,16,13,16720,13585,30305
317050,202004,162,123,39,129580,40755,170335
317052,202004,136,103,33,107635,34485,142120
317057,202004,172,133,39,138985,40755,179740
317060,202004,65,41,24,42845,26125,68970
317065,202004,56,45,11,47025,11495,58520
317070,202004,1963,906,1057,949905.75,1105610.5,2055516.25
317075,202004,107,58,49,60610,51205,111815
317080,202004,916,469,447,490105.75,468160,958265.75
317090,202004,647,521,126,545490,131670,677160
317100,202004,428,322,106,336490,110770,447260
317103,202004,100,82,18,85690,18810,104500
317107,202004,45,39,6,40755,6270,47025
317110,202004,115,48,67,50160,71060,121220
317115,202004,40,35,5,36575,5225,41800
317120,202004,1911,926,985,974986.5,1029325.5,2004312.0
317130,202004,1976,1312,664,1373131,693880,2067011
317140,202004,9,7,2,7315,2090,9405
317150,202004,263,155,108,163020.5,112860,275880.5
317160,202004,317,236,81,246620.79,84645,331265.79
317170,202004,217,149,68,155705,71060,226765
317180,202004,440,304,136,319770,142120,461890
317190,202004,265,185,80,193325,83600,276925
317200,202004,816,571,245,599833.65,256025,855858.65
317210,202004,186,102,84,106590,87780,194370
317220,202004,24,13,11,13585,11495,25080
320010,202004,609,442,167,461890.25,174515,636405.25
320013,202004,127,89,38,93005,39710,132715
320016,202004,273,172,101,179740,105545,285285
320020,202004,716,416,300,434722.37,314545,749267.37
320030,202004,150,106,44,110770,45980.25,156750.25
320035,202004,138,103,35,107635,36575,144210
320040,202004,490,249,241,260205,252890,513095
320050,202004,104,76,28,79420,29260,108680
320060,202004,1662,792,870,828685.25,910197.25,1738882.50
320070,202004,101,62,39,65835,40755,106590
320080,202004,798,457,341,478610.75,358435,837045.75
320090,202004,1240,836,404,874665,423225,1297890
320100,202004,334,190,144,198550,151525,350075
320110,202004,123,80,43,83601.25,44935,128536.25
320115,202004,110,90,20,94050,20900,114950
320120,202004,3429,1849,1580,1938477.65,1655280.5,3593758.15
320130,202004,7513,3401,4112,3563452.52,4306446.5,7869899.02
320140,202004,438,290,148,304095,154661.16,458756.16
320150,202004,2055,1157,898,1211155.75,939455,2150610.75
320160,202004,649,292,357,305140,373065.5,678205.5
320170,202004,110,88,22,91960,24035,115995
320180,202004,53,31,22,32395,22990,55385
320190,202004,242,155,87,163020,90915,253935
320200,202004,57,44,13,45980,13585,59565
320210,202004,905,498,407,522501,426361,948862
320220,202004,304,107,197,112860,206910,319770
320225,202004,88,69,19,72105,19855,91960
320230,202004,604,384,220,402325,229900,632225
320240,202004,3261,1590,1671,1665732,1749330.5,3415062.5
320245,202004,477,324,153,339625.5,159885,499510.5
320250,202004,228,116,112,121220,117040,238260
320255,202004,146,113,33,118085,34485,152570
320260,202004,209,143,66,149435,68970,218405
320265,202004,167,132,35,137940,36575,174515
320270,202004,157,124,33,129580,34485,164065
320280,202004,1028,592,436,618641.07,455620,1074261.07
320290,202004,59,51,8,53295,8360,61655
320300,202004,576,395,181,413821.35,190191.6,604012.95
320305,202004,683,369,314,388740,328130.5,716870.5
320310,202004,205,117,88,122265.9,91960,214225.9
320313,202004,326,161,165,169290.25,172425.5,341715.75
320316,202004,112,87,25,90915,26125,117040
320320,202004,3444,1550,1894,1623931.15,1986611.88,3610543.03
320330,202004,256,193,63,201685,65835,267520
320332,202004,842,513,329,536086.5,343806,879892.5
320334,202004,241,147,94,153615.5,98230,251845.5
320335,202004,146,100,46,106590,48070,154660
320340,202004,551,383,168,402325.75,175560,577885.75
320350,202004,991,422,569,440990.97,594606.18,1035597.15
320360,202004,166,91,75,95095,78375,173470
320370,202004,241,182,59,190190.9,61655.5,251846.4
320380,202004,284,198,86,206910.5,89870,296780.5
320390,202004,1150,687,463,720005,483835.5,1203840.5
320400,202004,309,228,81,239305.5,84645,323950.5
320405,202004,953,401,552,421135.25,578930.5,1000065.75
320410,202004,994,505,489,527725,511005.25,1038730.25
320420,202004,502,240,262,250800.75,273790,524590.75
320425,202004,183,99,84,103455,87780,191235
320430,202004,387,212,175,222585.88,182875,405460.88
320435,202004,158,106,52,110770,54340,165110
320440,202004,194,113,81,119130,85690,204820
320450,202004,128,67,61,70015,63745,133760
320455,202004,249,202,47,211090.5,49115,260205.5
320460,202004,271,165,106,172425,110770,283195
320465,202004,116,77,39,81510,40755,122265
320470,202004,695,427,268,447260.5,280060,727320.5
320480,202004,195,126,69,131670,72105,203775
320490,202004,3078,1514,1564,1583176.26,1635428.23,3218604.49
320495,202004,108,67,41,70015,42846,112861
320500,202004,9738,4767,4971,4996151.3,5209330.2,10205481.5
320501,202004,554,282,272,294690,285285,579975
320503,202004,289,201,88,211090,91960,303050
320506,202004,261,184,77,192280,80465,272745
320510,202004,1030,457,573,479655,602965,1082620
320515,202004,85,68,17,71060,17765,88825
320517,202004,208,150,58,156750,60610,217360
320520,202004,7005,3024,3981,3164262.3,4173733.1,7337995.4
320530,202004,6130,3037,3093,3177847.22,3242635.5,6420482.72
330010,202004,3138,1595,1543,1668867.5,1614525,3283392.5
330015,202004,164,69,95,72105.9,99275,171380.9
330020,202004,3687,1581,2106,1657371.1,2209130.7,3866501.8
330022,202004,248,127,121,133760,126445.5,260205.5
330023,202004,601,191,410,199595,430540,630135
330025,202004,568,110,458,114950,478610,593560
330030,202004,1919,1221,698,1279080.12,730455.5,2009535.62
330040,202004,2437,1252,1185,1316700.75,1242505.5,2559206.25
330045,202004,8845,2707,6138,2832996,6441380.92,9274376.92
330050,202004,889,570,319,597740,335445,933185
330060,202004,1005,597,408,623866.25,426360,1050226.25
330070,202004,3644,1310,2334,1375220.4,2447390.5,3822610.9
330080,202004,1592,709,883,741951.29,925870,1667821.29
330090,202004,378,222,156,231990,163020,395010
330093,202004,264,119,145,124355,151525,275880
330095,202004,83,47,36,49115,37620,86735
330100,202004,9833,4935,4898,5169617.67,5124681.25,10294298.92
330110,202004,474,202,272,211090.75,285285,496375.75
330115,202004,533,280,253,292600,264385,556985
330120,202004,374,195,179,203775,187056,390831
330130,202004,1537,382,1155,400235,1209065,1609300
330140,202004,612,322,290,336490,303050,639540
330150,202004,513,295,218,310365,228855,539220
330160,202004,213,126,87,131670,90915,222585
330170,202004,27286,9209,18077,9631767.6,18932270.3,28564037.9
330180,202004,248,146,102,152570,106590,259160
330185,202004,957,331,626,347985,654170,1002155
330187,202004,364,111,253,115995,265430,381425
330190,202004,5762,2195,3567,2299002.15,3737965.5,6036967.65
330200,202004,4732,1407,3325,1477631.81,3488210.5,4965842.31
330205,202004,436,257,179,268565,189145.5,457710.5
330210,202004,987,608,379,635360,397101,1032461
330220,202004,2659,1588,1071,1663640.2,1121285.5,2784925.7
330225,202004,567,294,273,307230,286330,593560
330227,202004,2422,725,1697,758670,1778590.25,2537260.25
330230,202004,249,145,104,151525,108680,260205
330240,202004,3871,1918,1953,2006400.75,2045067,4051467.75
330245,202004,150,68,82,71060.1,85690,156750.1
330250,202004,6706,3395,3311,3549866.25,3469402.02,7019268.27
330260,202004,587,157,430,165110,449350,614460
330270,202004,3567,1212,2355,1268630,2469336,3737966
330280,202004,459,290,169,303050.5,176605.45,479655.95
330285,202004,7076,2211,4865,2312585.75,5104827.25,7417413.00
330290,202004,641,235,406,246620.25,427405,674025.25
330300,202004,761,490,271,514140.75,283195,797335.75
330310,202004,449,249,200,261250.75,209000,470250.75
330320,202004,7953,2947,5006,3090066.49,5244857.5,8334923.99
330330,202004,9017,3424,5593,3587486.75,5858271.5,9445758.25
330340,202004,2695,1584,1111,1656325,1165175.5,2821500.5
330350,202004,18521,7108,11413,7445631.15,11981977.42,19427608.57
330360,202004,2285,1100,1185,1150546.5,1238325,2388871.5
330370,202004,1032,513,519,536087,544445,1080532
330380,202004,890,379,511,396055,535040.01,931095.01
330385,202004,636,325,311,339625.25,324995,664620.25
330390,202004,5566,2971,2595,3116191,2724315.5,5840506.5
330395,202004,316,193,123,201685,128535.75,330220.75
330400,202004,715,374,341,391875,357390,749265
330410,202004,510,370,140,388740.25,146300.5,535040.75
330411,202004,258,138,120,144210.55,125400,269610.55
330412,202004,244,100,144,104500.5,150480,254980.5
330414,202004,5453,2189,3264,2292732.7,3421330.5,5714063.2
330415,202004,593,262,331,273791.5,347985,621776.5
330420,202004,2219,1137,1082,1190256.55,1133825.5,2324082.05
330430,202004,1789,812,977,850631,1023057.5,1873688.5
330440,202004,286,138,148,144210,155705,299915
330450,202004,120,52,68,55385,72105,127490
330452,202004,2007,883,1124,925870,1176670.5,2102540.5
330455,202004,112261,39377,72884,41247298.07,76434458.76,117681756.83
330460,202004,262,111,151,115995,157795,273790
330470,202004,1228,670,558,701197,585201.75,1286398.75
330475,202004,1511,392,1119,410685,1170400,1581085
330480,202004,812,434,378,453530,398145,851675
330490,202004,14513,4693,9820,4914636.25,10285936.5,15200572.75
330500,202004,1424,609,815,637450,851675.14,1489125.14
330510,202004,10928,3748,7180,3926067.15,7520866.25,11446933.40
330513,202004,104,52,52,54340,54340,108680
330515,202004,821,336,485,353211.25,508915.5,862126.75
330520,202004,2490,886,1604,925870.35,1683495,2609365.35
330530,202004,208,116,92,121220.25,96140,217360.25
330540,202004,376,182,194,191235.5,204820.5,396056.0
330550,202004,2899,1011,1888,1058585.7,1977141,3035726.7
330555,202004,812,312,500,326040,522500,848540
330560,202004,687,224,463,234080,483835,717915
330570,202004,265,192,73,200640,76285,276925
330575,202004,793,294,499,307230,522502.25,829732.25
330580,202004,3384,1887,1497,1972962.12,1568546,3541508.12
330590,202004,293,150,143,156750.09,149435,306185.09
330600,202004,1182,742,440,775391,460845,1236236
330610,202004,1600,856,744,894522.75,778526.5,1673049.25
330615,202004,207,162,45,169290,47025,216315
330620,202004,1077,425,652,444125,684475,1128600
330630,202004,4096,2568,1528,2692965.94,1599896.25,4292862.19
350010,202004,592,396,196,418001.49,204820,622821.49
350020,202004,53,23,30,24035,31350,55385
350030,202004,518,324,194,338580.5,203775.5,542356.0
350040,202004,125,50,75,52250,78375,130625
350050,202004,302,161,141,168245,150480,318725
350055,202004,94,50,44,52250,45980,98230
350060,202004,93,33,60,34485,62700,97185
350070,202004,793,468,325,489060.49,342760.5,831820.99
350075,202004,73,49,24,51205,26125,77330
350080,202004,59,29,30,31350,31350,62700
350090,202004,84,50,34,52250,35530,87780
350100,202004,284,176,108,183920,114950,298870
350110,202004,63,43,20,44935,20900,65835
350115,202004,145,88,57,91960,59565,151525
350120,202004,106,69,37,72105,38665,110770
350130,202004,373,167,206,174515.03,216315,390830.03
350140,202004,41,26,15,28215,15675,43890
350150,202004,73,55,18,57475,18810,76285
350160,202004,2457,956,1501,1003200.5,1572725,2575925.5
350170,202004,386,228,158,239306.85,165110.5,404417.35
350180,202004,169,97,72,101365,75240.5,176605.5
350190,202004,1008,524,484,551760.29,505781,1057541.29
350200,202004,68,25,43,26125,45980,72105
350210,202004,1299,728,571,764942,597740.29,1362682.29
350220,202004,671,554,117,579975.29,122265,702240.29
350230,202004,73,50,23,52250,24035,76285
350240,202004,61,43,18,44935,18810,63745
350250,202004,1140,544,596,568481,624911.25,1193392.25
350260,202004,94,69,25,72105.5,26125,98230.5
350270,202004,866,576,290,602966,303050.5,906016.5
350275,202004,301,125,176,131670,183920,315590
350280,202004,4612,2342,2270,2457844.4,2378420.37,4836264.77
350290,202004,440,203,237,212135,247665.5,459800.5
350300,202004,54,28,26,29260,27170,56430
350310,202004,84,53,31,55385,32395,87780
350315,202004,48,26,22,27170,22990,50160
350320,202004,3304,1617,1687,1691855,1769185,3461040
350330,202004,1689,905,784,946772.62,826596.98,1773369.60
350335,202004,17,12,5,12540,5225,17765
350340,202004,125,56,69,59565,72105.75,131670.75
350350,202004,83,42,41,43890,42845,86735
350360,202004,119,78,41,81510,43890,125400
350370,202004,88,51,37,53295.29,39710,93005.29
350380,202004,775,330,445,344850,468161,813011
350390,202004,1559,598,961,625955.37,1007380.5,1633335.87
350395,202004,25,20,5,20900,5225,26125
350400,202004,1696,866,830,910197.12,870485.29,1780682.41
350410,202004,2637,1141,1496,1195514.83,1569590.29,2765105.12
350420,202004,251,151,100,157795.79,104500,262295.79
350430,202004,72,44,28,47025,30305,77330
350440,202004,150,109,41,113905.5,42845.5,156751.0
350450,202004,1624,965,659,1010516.06,690746,1701262.06
350460,202004,391,129,262,134805,274835,409640
350470,202004,21,11,10,11495,10450,21945
350480,202004,178,100,78,104500,81510,186010
350490,202004,229,112,117,117040,123310,240350
350500,202004,49,20,29,20900,30305,51205
350510,202004,169,111,58,115995,60610,176605
350520,202004,453,227,226,238260,236170,474430
350530,202004,440,203,237,213180,248710,461890
350535,202004,82,65,17,67925,17765,85690
350540,202004,380,191,189,199595,198550,398145
350550,202004,2746,1626,1120,1701260.83,1172491.08,2873751.91
350560,202004,624,428,196,448305,204820,653125
350570,202004,4215,1735,2480,1818300.79,2595781.85,4414082.64
350580,202004,368,179,189,187055,198550,385605
350590,202004,910,496,414,520410.5,433675,954085.5
350600,202004,6091,2948,3143,3093203.25,3295930.5,6389133.75
350610,202004,1512,782,730,818235.29,769120,1587355.29
350620,202004,31,20,11,20900,11495,32395
350630,202004,244,140,104,146300.29,109725.29,256025.58
350635,202004,970,388,582,405461.35,609235.5,1014696.85
350640,202004,123,93,30,97185,32395,129580
350650,202004,1882,1252,630,1311475.95,661485,1972960.95
350660,202004,750,315,435,331265,456665,787930
350670,202004,312,154,158,160930,167200,328130
350680,202004,179,94,85,98230,88826,187056
350690,202004,199,99,100,103455,104500,207955
350700,202004,781,370,411,386651,430540,817191
350710,202004,377,139,238,145255,248710,393965
350715,202004,55,44,11,45980,11495,57475
350720,202004,18,13,5,13585,5225,18810
350730,202004,45,29,16,30305,16720,47025
350740,202004,218,124,94,129580,98230,227810
350745,202004,23,10,13,10450,13585,24035
350750,202004,2211,1373,838,1436875.75,876755,2313630.75
350760,202004,3749,1623,2126,1698125.59,2225850,3923975.59
350770,202004,61,44,17,45980,17765,63745
350775,202004,43,32,11,33440,11495,44935
350780,202004,434,221,213,231990,222585,454575
350790,202004,366,152,214,159885,224675,384560
350800,202004,472,278,194,290510,203775,494285
350810,202004,522,420,102,438900.75,107635,546535.75
350820,202004,90,53,37,55385,38665,94050
350830,202004,78,40,38,41800,39710,81510
350840,202004,766,307,459,321860.5,480700.5,802561.0
350850,202004,1739,969,770,1014695.5,808830.5,1823526.0
350860,202004,597,336,261,351120.75,272745,623865.75
350870,202004,427,284,143,297825,149435,447260
350880,202004,287,161,126,168245.25,132715,300960.25
350890,202004,41,27,14,28215,14630,42845
350900,202004,1467,460,1007,482790.75,1054405.29,1537196.04
350910,202004,29,16,13,16720,13585,30305
350920,202004,689,365,324,382470,340670,723140
350925,202004,1200,636,564,666711.45,591472.39,1258183.84
350930,202004,101,61,40,63745,41800,105545
350940,202004,717,396,321,413820,335445,749265
350945,202004,109,78,31,81510,32395,113905
350950,202004,16393,7695,8698,8059045.84,9117627.75,17176673.59
350960,202004,1371,631,740,660440,776435,1436875
350970,202004,1103,577,526,602854.19,551760.5,1154614.69
350980,202004,97,65,32,67925,33440,101365
350990,202004,374,133,241,138985,252890,391875
350995,202004,36,16,20,16720,20900,37620
351000,202004,633,432,201,453530.58,210045,663575.58
351010,202004,52,32,20,33440,20900,54340
351015,202004,48,34,14,35530,14630,50160
351020,202004,1582,952,630,995885.5,658350,1654235.5
351030,202004,341,224,117,236170,122265,358435
351040,202004,898,469,429,490105.95,448305.89,938411.84
351050,202004,3335,1519,1816,1589448.3,1902945,3492393.3
351060,202004,5283,2060,3223,2154791.7,3374305,5529096.7
351070,202004,404,255,149,267521.64,156750,424271.64
351080,202004,751,552,199,579975.5,210045,790020.5
351090,202004,55,24,31,25080,32395,57475
351100,202004,434,251,183,262295.7,191235,453530.7
351110,202004,2045,974,1071,1018876.31,1122330.5,2141206.81
351120,202004,67,34,33,35530,34485,70015
351130,202004,189,60,129,62700,134805,197505
351140,202004,325,220,105,230945,109725,340670
351150,202004,442,229,213,239305.75,224675.5,463981.25
351160,202004,271,179,92,188100.5,96140,284240.5
351170,202004,188,98,90,102410,94050,196460
351190,202004,88,61,27,63745,28215,91960
351200,202004,368,247,121,258115.5,126445,384560.5
351210,202004,118,60,58,62700,60610,123310
351220,202004,535,321,214,335446.91,224675,560121.91
351230,202004,275,189,86,197505,89870,287375
351240,202004,237,115,122,120175,127490,247665
351250,202004,81,58,23,60610.57,24035,84645.57
351260,202004,146,109,37,114950,38665,153615
351270,202004,45,19,26,19855,27170,47025
351280,202004,1002,452,550,474430.29,574750.79,1049181.08
351290,202004,249,108,141,113905,148390.5,262295.5
351300,202004,3759,1669,2090,1745069.61,2187185.29,3932254.90
351310,202004,760,380,380,398145,398145,796290
351320,202004,115,67,48,70015.29,50160,120175.29
351330,202004,41,26,15,27170,15675,42845
351340,202004,1247,733,514,769120.5,537130,1306250.5
351350,202004,2422,1401,1021,1469271.25,1071125,2540396.25
351360,202004,774,373,401,391875,419045,810920
351370,202004,391,195,196,203775.5,205865,409640.5
351380,202004,9081,4089,4992,4282415.85,5229181.79,9511597.64
351385,202004,27,17,10,17765,10450,28215
351390,202004,275,206,69,215270.35,72105,287375.35
351400,202004,66,43,23,44935,24035,68970
351410,202004,436,277,159,291555.77,166155,457710.77
351420,202004,67,50,17,53295,17765,71060
351430,202004,69,37,32,38665,33440,72105
351440,202004,795,553,242,578932.83,254980,833912.83
351450,202004,263,130,133,135850,138985,274835
351460,202004,123,56,67,58520,70015,128535
351470,202004,145,79,66,82555,68970,151525
351480,202004,498,284,214,297825.79,223630,521455.79
351490,202004,290,106,184,110770,192280,303050
351492,202004,27,20,7,20900,7315,28215
351495,202004,25,18,7,18810,7315,26125
351500,202004,3561,1494,2067,1563321.35,2170466.9,3733788.25
351510,202004,1906,743,1163,776436,1218470.5,1994906.5
351512,202004,19,14,5,15675,5225,20900
351515,202004,193,109,84,113905,87780,201685
351518,202004,757,477,280,498465,293645,792110
351519,202004,75,45,30,47025,31350,78375
351520,202004,152,92,60,96140,63745,159885
351530,202004,23,14,9,14630,9405,24035
351535,202004,132,77,55,81510,57475,138985
351540,202004,453,324,129,339625.05,134805,474430.05
351550,202004,1410,842,568,880937.08,596695,1477632.08
351560,202004,72,41,31,43890,32395,76285
351565,202004,9,7,2,7315,2090,9405
351570,202004,2721,1331,1390,1391940.5,1457775,2849715.5
351580,202004,38,34,4,35530,4180,39710
351590,202004,65,42,23,43890,24035,67925
351600,202004,183,133,50,138985,52250,191235
351610,202004,47,21,26,21945,27170,49115
351620,202004,5865,3284,2581,3437008.25,2702370.75,6139379.00
351630,202004,2813,1398,1415,1465090.5,1480765,2945855.5
351640,202004,2006,940,1066,982300.02,1117106.29,2099406.31
351650,202004,27,23,4,24035,4180,28215
351660,202004,140,91,49,96140,51205,147345
351670,202004,712,447,265,469206.5,276925.5,746132.0
351680,202004,73,62,11,64790,12540,77330
351685,202004,28,16,12,16720,12540,29260
351690,202004,298,204,94,213180.37,98230,311410.37
351700,202004,158,109,49,114950.5,52250,167200.5
351710,202004,69,45,24,47025,25080,72105
351720,202004,132,75,57,78375,59565,137940
351730,202004,110,72,38,75240,39710.29,114950.29
351740,202004,731,474,257,500555.89,269610,770165.89
351750,202004,351,144,207,151525,217360,368885
351760,202004,765,577,188,605055,196460,801515
351770,202004,306,259,47,271700.29,49115,320815.29
351780,202004,156,93,63,97185,65835,163020
351790,202004,256,135,121,141075,126445.75,267520.75
351800,202004,41,27,14,28215,14630,42845
351810,202004,121,81,40,84645,41800,126445
351820,202004,819,590,229,618640.5,239305,857945.5
351830,202004,548,194,354,203775,369930,573705
351840,202004,1915,943,972,986481.6,1015740,2002221.6
351850,202004,237,169,68,177650,71060,248710
351860,202004,669,462,207,482790.45,216315,699105.45
351870,202004,5611,2617,2994,2739992.6,3140225.62,5880218.22
351880,202004,19437,7966,11471,8338058,12033176.5,20371234.5
351885,202004,82,53,29,55385,30305,85690
351890,202004,74,60,14,62700,14630,77330
351900,202004,223,128,95,134805,99275,234080
351905,202004,80,33,47,34485,49115,83600
351907,202004,3452,1430,2022,1499575.85,2118215.5,3617791.35
351910,202004,183,76,107,79420,111815,191235
351920,202004,121,69,52,72105,54340,126445
351925,202004,91,59,32,61655,33440,95095
351930,202004,399,255,144,267520,150480,418000
351940,202004,239,104,135,108680,141075,249755
351950,202004,132,72,60,75240,62700,137940
351960,202004,913,447,466,468487.37,486970.5,955457.87
351970,202004,1891,989,902,1033505.5,943635.5,1977141.0
351980,202004,157,76,81,79420,84645,164065
351990,202004,258,169,89,176606,93005,269611
352000,202004,345,215,130,226765.5,135850,362615.5
352010,202004,391,248,143,259160,150480.5,409640.5
352020,202004,189,71,118,74195,125400,199595
352030,202004,1083,550,533,575795,558030,1133825
352040,202004,571,240,331,250800,346940,597740
352042,202004,286,86,200,89870,209001,298871
352044,202004,360,223,137,233035,144210,377245
352050,202004,3225,1252,1973,1309387.14,2067010.5,3376397.64
352060,202004,105,65,40,67925,41800,109725
352070,202004,93,68,25,71060.58,26125,97185.58
352080,202004,67,43,24,44935,25080,70015
352090,202004,157,105,52,109725,54340,164065
352100,202004,288,144,144,150480.5,152570.5,303051.0
352110,202004,114,34,80,35530,84645,120175
352115,202004,60,21,39,21945,40755,62700
352120,202004,86,60,26,62700.29,27170,89870.29
352130,202004,219,183,36,192280,37620,229900
352140,202004,182,85,97,88825,101365,190190
352150,202004,117,60,57,62700,59565,122265
352160,202004,140,89,51,93005,53295,146300
352170,202004,390,267,123,280060,128535,408595
352180,202004,621,399,222,416955.29,231990,648945.29
352190,202004,247,101,146,105545,153615,259160
352200,202004,31,16,15,16720,15675,32395
352210,202004,4104,1674,2430,1750377,2541440.5,4291817.5
352215,202004,58,33,25,34485,26125,60610
352220,202004,6760,2544,4216,2667887.46,4418262.75,7086150.21
352230,202004,3331,2152,1179,2255111.7,1232056.62,3487168.32
352240,202004,2428,1386,1042,1449415.5,1090980.5,2540396.0
352250,202004,2790,1330,1460,1391941.58,1533015.5,2924957.08
352260,202004,975,499,476,521455.5,497420.5,1018876.0
352265,202004,57,28,29,29260,30305,59565
352270,202004,402,235,167,247665,176605.25,424270.25
352280,202004,444,281,163,294690.58,170335,465025.58
352290,202004,171,102,69,106590,73150,179740
352300,202004,94,66,28,68970,29260,98230
352310,202004,6337,2837,3500,2974071.94,3676310.3,6650382.24
352320,202004,1023,536,487,561165,513095.5,1074260.5
352330,202004,541,262,279,273790,291555.5,565345.5
352340,202004,1347,616,731,646857,764941.5,1411798.5
352350,202004,342,206,136,217360,143165.5,360525.5
352360,202004,220,101,119,106590,124355,230945
352370,202004,104,69,35,72105,36575,108680
352380,202004,117,75,42,78375,43890,122265
352390,202004,2433,1038,1395,1087845.53,1463001.3,2550846.83
352400,202004,492,216,276,225720,289465.5,515185.5
352410,202004,848,594,254,620730.29,266475,887205.29
352420,202004,99,67,32,70015,33440,103455
352430,202004,1736,799,937,837046.87,981255.58,1818302.45
352440,202004,3212,1596,1616,1670956.6,1692900.5,3363857.1
352450,202004,197,164,33,175560,34485,210045
352460,202004,614,315,299,329175,313500,642675
352470,202004,651,221,430,230945,451440,682385
352480,202004,1414,783,631,818235,659396,1477631
352490,202004,62,22,40,22990,41800,64790
352500,202004,1220,521,699,544445.85,733590.5,1278036.35
352510,202004,729,391,338,408595.58,355300,763895.58
352520,202004,665,320,345,334400,360525,694925
352530,202004,1744,916,828,958265,871530.5,1829795.5
352540,202004,74,47,27,49115,28215,77330
352550,202004,189,115,74,120175,77330,197505
352560,202004,49,39,10,40755,10450,51205
352570,202004,676,346,330,362615.29,344850,707465.29
352580,202004,55,42,13,43890,13585,57475
352585,202004,20,6,14,6270,14630,20900
352590,202004,4426,2212,2214,2319900.29,2323036,4642936.29
352600,202004,347,249,98,260205,102410,362615
352610,202004,953,433,520,453530.67,545490,999020.67
352620,202004,1026,407,619,425315,648945,1074260
352630,202004,173,62,111,64790,115995,180785
352640,202004,520,352,168,367840,175560,543400
352650,202004,83,60,23,62700,24035,86735
352660,202004,67,39,28,41800,29260,71060
352670,202004,1655,891,764,933186.32,802560,1735746.32
352680,202004,935,585,350,612370,366795,979165
352690,202004,4560,2058,2502,2155837.38,2619815.29,4775652.67
352700,202004,103,62,41,64790.5,42845,107635.5
352710,202004,1385,739,646,772255,677160,1449415
352720,202004,1362,629,733,658350,768075.5,1426425.5
352725,202004,22,18,4,18810,4180,22990
352730,202004,394,200,194,212135,202730,414865
352740,202004,418,266,152,277971.9,158840.11,436812.01
352750,202004,19,12,7,12540,7315,19855
352760,202004,177,115,62,120175,64790,184965
352770,202004,84,63,21,66880,21945,88825
352780,202004,77,42,35,43890,36575,80465
352790,202004,24,19,5,19855,5225,25080
352800,202004,234,172,62,179740,66880,246620
352810,202004,154,95,59,100320.5,61655,161975.5
352820,202004,63,50,13,52250,13585,65835
352830,202004,78,53,25,55385,26125,81510
352840,202004,663,331,332,345895.25,347985,693880.25
352850,202004,1514,501,1013,527725,1060675,1588400
352860,202004,118,75,43,78375,44935,123310
352870,202004,43,28,15,29260,15675,44935
352880,202004,182,120,62,125400,66880,192280
352885,202004,32,22,10,22990,10450,33440
352890,202004,53,35,18,36575,18810.5,55385.5
352900,202004,4814,2342,2472,2454707.65,2591601.79,5046309.44
352910,202004,35,28,7,29260,7315,36575
352920,202004,660,398,262,416955.5,274835,691790.5
352930,202004,1218,583,635,611325.5,664620.75,1275946.25
352940,202004,6144,2539,3605,2662662.29,3779766,6442428.29
352950,202004,105,42,63,43890,66880,110770
352960,202004,58,40,18,42845,18810,61655
352965,202004,19,9,10,9405,10450,19855
352970,202004,515,393,122,411730.23,127490,539220.23
352980,202004,156,85,71,88825,74195,163020
352990,202004,990,449,541,471295,565345,1036640
353000,202004,67,30,37,31350,38665,70015
353010,202004,544,337,207,353210,216315,569525
353020,202004,296,213,83,224675,86735,311410
353030,202004,1250,575,675,602966.35,710600,1313566.35
353040,202004,83,54,29,56430,31350,87780
353050,202004,1335,866,469,908106.85,490105,1398211.85
353060,202004,8445,3667,4778,3837245,5002415,8839660
353070,202004,1757,1091,666,1142186.33,697873.99,1840060.32
353080,202004,1285,690,595,724185.47,628045,1352230.47
353090,202004,56,31,25,32395,26125,58520
353100,202004,51,42,9,43890,9405,53295
353110,202004,2096,638,1458,666710.5,1525700,2192410.5
353120,202004,97,51,46,53295,48070,101365
353130,202004,857,421,436,439945.41,455620,895565.41
353140,202004,554,229,325,240350.29,339625,579975.29
353150,202004,339,192,147,200640.29,153615,354255.29
353160,202004,95,77,18,80465,18810,99275
353170,202004,218,73,145,76285,151525,227810
353180,202004,1057,484,573,506825,600876.25,1107701.25
353190,202004,499,364,135,381425,141075.28,522500.28
353200,202004,216,107,109,112860,113905,226765
353205,202004,20,13,7,13585,7315,20900
353210,202004,71,41,30,42845,32395,75240
353215,202004,47,28,19,29260,19855,49115
353220,202004,78,44,34,45980,35530,81510
353230,202004,163,62,101,64790,105545,170335
353240,202004,316,163,153,170335,160930,331265
353250,202004,211,106,105,110770,109725,220495
353260,202004,457,317,140,332310.8,146300,478610.8
353270,202004,69,53,16,55385,16720,72105
353280,202004,101,51,50,53295,52250,105545
353282,202004,128,89,39,93005,40755,133760
353284,202004,23,16,7,16720,7315,24035
353286,202004,1,0,1,0,1045,1045
353290,202004,72,43,29,44935,30305,75240
353300,202004,450,243,207,253936.33,216315,470251.33
353310,202004,48,41,7,42845,7315,50160
353320,202004,56,33,23,34485,24035,58520
353325,202004,53,31,22,32395,22990.5,55385.5
353330,202004,61,41,20,42845.75,20900,63745.75
353340,202004,640,226,414,237215,433675.5,670890.5
353350,202004,911,443,468,463980,492195.5,956175.5
353360,202004,103,84,19,87780,19855,107635
353370,202004,114,64,50,66880,52250,119130
353380,202004,31,18,13,18810,13585,32395
353390,202004,1120,540,580,568480,606100,1174580
353400,202004,45,26,19,27170,19855,47025
353410,202004,108,67,41,70015,42845.25,112860.25
353420,202004,59,25,34,27170,35530,62700
353430,202004,586,395,191,412775.91,199595,612370.91
353440,202004,10948,4751,6197,4974202.44,6491541,11465743.44
353450,202004,57,31,26,32395,27170,59565
353460,202004,600,324,276,340670.75,289465,630135.75
353470,202004,2129,1122,1007,1174580.37,1057540,2232120.37
353475,202004,243,162,81,170335.5,84645,254980.5
353480,202004,188,155,33,161975,34485,196460
353490,202004,242,148,94,154660,98230.5,252890.5
353500,202004,201,117,84,122265.29,88825,211090.29
353510,202004,104,70,34,73150,35530,108680
353520,202004,206,145,61,151525,63745,215270
353530,202004,463,251,212,262295,222585,484880
353540,202004,378,251,127,263340,132715,396055
353550,202004,714,467,247,490106.47,258115,748221.47
353560,202004,590,237,353,247665,369930,617595
353570,202004,68,37,31,38665.5,32395,71060.5
353580,202004,354,263,91,275881.35,95095,370976.35
353590,202004,89,65,24,68970,25080,94050
353600,202004,279,161,118,168245.29,124355,292600.29
353610,202004,126,69,57,73150,59565,132715
353620,202004,612,321,291,335445.5,304095,639540.5
353625,202004,49,27,22,28215,22990,51205
353630,202004,231,169,62,176605.45,64790,241395.45
353640,202004,130,85,45,88825,47025,135850
353650,202004,925,349,576,366795,605055,971850
353657,202004,22,16,6,17765,6270,24035
353660,202004,270,146,124,152570,132715,285285
353670,202004,762,453,309,473385.79,322905.5,796291.29
353680,202004,104,75,29,78375.25,30305,108680.25
353690,202004,40,30,10,31350,10450,41800
353700,202004,273,196,77,205865,80465,286330
353710,202004,471,220,251,229900,262295.5,492195.5
353715,202004,46,33,13,34485,13585,48070
353720,202004,352,162,190,169290.5,198550,367840.5
353730,202004,1098,681,417,717915.5,437855.5,1155771.0
353740,202004,624,340,284,355300.5,297825,653125.5
353750,202004,80,48,32,50160,33440,83600
353760,202004,2949,1114,1835,1166220.65,1918621.65,3084842.30
353770,202004,91,74,17,77330,17765,95095
353780,202004,1209,576,633,604010.29,662530,1266540.29
353790,202004,504,306,198,320816.4,206910.5,527726.9
353800,202004,3390,1655,1735,1734720.5,1815236.5,3549957.0
353810,202004,233,134,99,140030,103455,243485
353820,202004,205,95,110,99275,114950,214225
353830,202004,50,43,7,44935,7315,52250
353850,202004,179,82,97,85690,101365,187055
353860,202004,500,224,276,235125,290510,525635
353870,202004,5354,2728,2626,2859124,2755666.75,5614790.75
353880,202004,685,476,209,497420.89,218405,715825.89
353890,202004,561,321,240,336490.5,252890.61,589381.11
353900,202004,137,72,65,75240,68970,144210
353910,202004,173,73,100,76285,104500,180785
353920,202004,437,244,193,254980.75,201685,456665.75
353930,202004,995,586,409,613415,427406.35,1040821.35
353940,202004,190,97,93,101365,99275,200640
353950,202004,506,310,196,326040,204820,530860
353960,202004,75,61,14,63745,14630,78375
353970,202004,57,32,25,33440,26125,59565
353980,202004,1689,785,904,820325,946770.5,1767095.5
353990,202004,68,41,27,42845,28215,71060
354000,202004,383,182,201,194370,210045,404415
354010,202004,90,50,40,52250,42845.5,95095.5
354020,202004,514,328,186,344850,196460,541310
354025,202004,48,40,8,42845,8360,51205
354030,202004,51,31,20,32395,20900,53295
354040,202004,101,76,25,79420,26125,105545
354050,202004,178,99,79,103455.79,83600,187055.79
354060,202004,761,366,395,386650,412775,799425
354070,202004,910,524,386,548626,403370,951996
354075,202004,222,107,115,112860,120175,233035
354080,202004,314,135,179,141075,188100,329175
354085,202004,20,13,7,13585,7315,20900
354090,202004,296,169,127,176517,132715,309232
354100,202004,5599,2290,3309,2395141.53,3466267.35,5861408.88
354105,202004,92,45,47,47025,49115,96140
354110,202004,47,22,25,22990,26125,49115
354120,202004,138,97,41,101365,42845,144210
354130,202004,724,457,267,477565,280060.5,757625.5
354140,202004,3160,1460,1700,1529881.02,1783815.5,3313696.52
354150,202004,633,381,252,398145.87,263340,661485.87
354160,202004,662,420,242,439945.5,253935.89,693881.39
354165,202004,16,14,2,14630,2090,16720
354170,202004,175,120,55,125400,57475,182875
354180,202004,62,37,25,38665.59,26125,64790.59
354190,202004,195,84,111,88825,115995,204820
354200,202004,117,61,56,63745,58520,122265
354210,202004,56,24,32,25080,33440,58520
354220,202004,644,404,240,423226.35,250800,674026.35
354230,202004,174,74,100,77330,104500,181830
354240,202004,333,215,118,224675.62,124355,349030.62
354250,202004,85,52,33,54340,34485,88825
354260,202004,2040,959,1081,1004247.32,1131736.6,2135983.92
354270,202004,91,67,24,70015,25080,95095
354280,202004,42,20,22,20900,22990,43890
354290,202004,143,99,44,103455,45980,149435
354300,202004,381,266,115,277970.29,120175,398145.29
354310,202004,90,66,24,68970.5,25080,94050.5
354320,202004,205,102,103,106590,107635,214225
354323,202004,10,9,1,9405,1045,10450
354325,202004,119,69,50,72105.83,52250,124355.83
354330,202004,2474,822,1652,859886.5,1729475.5,2589362.0
354340,202004,10367,4993,5374,5238587.63,5630462.71,10869050.34
354350,202004,126,83,43,86735,44935,131670
354360,202004,74,42,32,44935,33440,78375
354370,202004,248,132,116,137940,121220,259160
354380,202004,187,111,76,115995,79420,195415
354390,202004,2694,972,1722,1019920,1806806.27,2826726.27
354400,202004,314,173,141,180785,148390,329175
354410,202004,618,300,318,315590.85,333355.5,648946.35
354420,202004,270,172,98,180785,103455,284240
354425,202004,305,182,123,192329,128535,320864
354430,202004,181,105,76,109725,79420,189145
354440,202004,35,26,9,28215,9405,37620
354450,202004,53,37,16,38665,16720,55385
354460,202004,99,57,42,60610,43890,104500
354470,202004,36,20,16,21945,16720,38665
354480,202004,114,61,53,63745,55385,119130
354490,202004,148,93,55,97185,57475,154660
354500,202004,378,181,197,189145,205865,395010
354510,202004,95,66,29,70015,30305,100320
354515,202004,37,12,25,12540,26125,38665
354520,202004,1597,681,916,714631.75,958265.5,1672897.25
354530,202004,751,377,374,393965.5,390830,784795.5
354540,202004,271,147,124,153615,129580,283195
354550,202004,38,24,14,25080,14630,39710
354560,202004,150,79,71,82555,74195,156750
354570,202004,134,87,47,91960.25,49115,141075.25
354580,202004,1875,887,988,927961.5,1038730.5,1966692.0
354600,202004,253,140,113,146300,120175,266475
354610,202004,73,61,12,63745.15,13585,77330.15
354620,202004,65,19,46,20900,48070,68970
354625,202004,16,10,6,10450,6270,16720
354630,202004,312,200,112,210045,117040,327085
354640,202004,803,509,294,532950.75,309320,842270.75
354650,202004,73,43,30,44935,31350,76285
354660,202004,797,594,203,623865.54,213180,837045.54
354670,202004,242,90,152,94050,159885,253935
354680,202004,1265,470,795,492195,832865,1325060
354690,202004,84,58,26,60610.5,27170,87780.5
354700,202004,66,47,19,49115,19855,68970
354710,202004,47,34,13,35530,13585,49115
354720,202004,20,20,0,20900,0,20900
354730,202004,1752,732,1020,765985.55,1066945.5,1832931.05
354740,202004,72,52,20,55385,20900,76285
354750,202004,426,243,183,254980,194370,449350
354760,202004,468,284,184,297826.25,192280.5,490106.75
354765,202004,10,5,5,5225,5225,10450
354770,202004,346,228,118,238260.5,125400,363660.5
354780,202004,8199,3255,4944,3409873.54,5182156.7,8592030.24
354790,202004,99,55,44,57475,45980,103455
354800,202004,455,247,208,260205,218405,478610
354805,202004,100,45,55,47025.5,57475,104500.5
354810,202004,102,62,40,64790,41800,106590
354820,202004,208,84,124,87780.9,129580,217360.9
354830,202004,40,22,18,22990,18810,41800
354840,202004,59,41,18,42845,18810,61655
354850,202004,4525,1998,2527,2093136,2650121.25,4743257.25
354860,202004,330,159,171,166155,178695.04,344850.04
354870,202004,12242,5482,6760,5747506.28,7087192.91,12834699.19
354880,202004,2823,1060,1763,1110835.88,1849651.65,2960487.53
354890,202004,2912,1562,1350,1636471.75,1413885,3050356.75
354900,202004,63,42,21,43890,21945,65835
354910,202004,1255,660,595,691791,628045,1319836
354920,202004,45,37,8,38665,8360,47025
354925,202004,12,6,6,6270,6270,12540
354930,202004,35,32,3,33440.78,3135,36575.78
354940,202004,808,586,222,613678.04,233035,846713.04
354950,202004,200,131,69,138985.25,73150,212135.25
354960,202004,150,57,93,59565,99275,158840
354970,202004,962,637,325,666711.64,340670.5,1007382.14
354980,202004,8773,3176,5597,3326238.95,5856181.02,9182419.97
354990,202004,9272,4293,4979,4490368.5,5219775,9710143.5
354995,202004,540,178,362,186010,380380,566390
355000,202004,465,157,308,164065,324995,489060
355010,202004,598,373,225,392920.5,236170.79,629091.29
355020,202004,773,491,282,513095,295735.5,808830.5
355030,202004,208170,80550,127620,84380752.76,133775754.33,218156507.09
355040,202004,762,361,401,378290.5,420090,798380.5
355050,202004,150,95,55,100320.4,57475,157795.4
355060,202004,1619,819,800,856901.5,839135,1696036.5
355070,202004,1452,687,765,717915.77,803605.29,1521521.06
355080,202004,200,121,79,126445,83600,210045
355090,202004,286,175,111,183920,115995.19,299915.19
355100,202004,5017,2378,2639,2493269.6,2765071,5258340.6
355110,202004,257,173,84,180785.5,87780,268565.5
355120,202004,78,56,22,58520,22990,81510
355130,202004,50,29,21,30305,21945,52250
355140,202004,183,113,70,118085,73150,191235
355150,202004,675,403,272,422181,284240.5,706421.5
355160,202004,467,227,240,237215.29,250800.5,488015.79
355170,202004,2046,1078,968,1130690,1018875,2149565
355180,202004,678,290,388,303050,407550,710600
355190,202004,206,144,62,151525,64790,216315
355200,202004,112,64,48,66880,50160,117040
355210,202004,697,393,304,411730,317680,729410
355220,202004,7145,3705,3440,3883224,3605253.5,7488477.5
355230,202004,98,56,42,58520,43890,102410
355240,202004,4477,1871,2606,1960422.66,2732675,4693097.66
355250,202004,5826,2642,3184,2767179.6,3335640.25,6102819.85
355255,202004,47,28,19,29260,19855,49115
355260,202004,182,111,71,115995.5,74195,190190.5
355270,202004,164,104,60,109725,62700,172425
355280,202004,6338,2538,3800,2654302,3986676,6640978
355290,202004,75,60,15,62700,15675,78375
355300,202004,194,122,72,128535,75240.5,203775.5
355310,202004,105,56,49,60610,51205,111815
355320,202004,87,45,42,47025,43890,90915
355330,202004,282,160,122,168245,128535,296780
355340,202004,1496,517,979,540265.77,1027235,1567500.77
355350,202004,130,66,64,70015,66880,136895
355360,202004,169,115,54,120175.5,56430,176605.5
355365,202004,23,19,4,19855,4180,24035
355370,202004,1049,610,439,639541.08,458755,1098296.08
355380,202004,813,520,293,545490,307230,852720
355385,202004,74,52,22,54340,22990,77330
355390,202004,110,64,46,66880,48070,114950
355395,202004,192,111,81,115995.92,85690,201685.92
355400,202004,1640,984,656,1031332.25,685520.29,1716852.54
355410,202004,4872,2308,2564,2420223,2688785.75,5109008.75
355420,202004,49,35,14,36575,15675,52250
355430,202004,371,229,142,240350.5,148390,388740.5
355440,202004,78,44,34,45980,35530,81510
355450,202004,462,228,234,239306.2,244530.75,483836.95
355460,202004,63,47,16,49115.35,16720,65835.35
355465,202004,46,29,17,30305,17765,48070
355470,202004,175,71,104,74195.75,108680,182875.75
355475,202004,11,7,4,7315,4180,11495
355480,202004,517,220,297,230945,310365,541310
355490,202004,119,84,35,87780,36575,124355
355495,202004,61,25,36,26125,37620,63745
355500,202004,1579,883,696,924827.05,729410.5,1654237.55
355510,202004,269,200,69,209000.29,72105,281105.29
355520,202004,35,25,10,26125,10450,36575
355530,202004,20,12,8,12540,8360,20900
355535,202004,76,35,41,37620,42845,80465
355540,202004,2449,968,1481,1013797.84,1553915.79,2567713.63
355550,202004,56,35,21,37620,21945,59565
355560,202004,247,115,132,120175,140030,260205
355570,202004,24,16,8,16720,8360,25080
355580,202004,243,171,72,178695,75240.5,253935.5
355590,202004,17,11,6,11495,6270,17765
355600,202004,274,141,133,147345,140030,287375
355610,202004,229,151,78,158840,81510,240350
355620,202004,1324,606,718,635360.5,754490,1389850.5
355630,202004,446,326,120,343805,125400.29,469205.29
355635,202004,115,54,61,56430,63745,120175
355640,202004,562,319,243,335445,253935,589380
355645,202004,847,338,509,354255,535041,889296
355650,202004,1993,845,1148,886161.35,1203840,2090001.35
355660,202004,252,134,118,141075,125400,266475
355670,202004,557,224,333,235125,349030,584155
355680,202004,209,123,86,128535,90915,219450
355690,202004,94,44,50,45980,53295.66,99275.66
355695,202004,17,11,6,11495,6270,17765
355700,202004,1153,604,549,632225.65,573706.5,1205932.15
355710,202004,2235,1220,1015,1280126.53,1062765.5,2342892.03
355715,202004,19,15,4,15675,4180,19855
355720,202004,223,132,91,137940.6,95095,233035.6
355730,202004,103,60,43,62700,44935,107635
410010,202004,131,108,23,112860,24035,136895
410020,202004,112,88,24,91960,25080,117040
410030,202004,161,98,63,102410.5,65835,168245.5
410040,202004,1148,574,574,600875,601920,1202795
410045,202004,38,30,8,31350,8360,39710
410050,202004,477,270,207,282150,217360,499510
410060,202004,282,213,69,222585,73150,295735
410070,202004,300,250,50,261250,52250,313500
410080,202004,167,105,62,109725,65835,175560
410090,202004,81,71,10,74195.9,10450,84645.9
410100,202004,286,200,86,210045,89870,299915
410105,202004,48,30,18,31350,18810,50160
410110,202004,325,196,129,206910,134805,341715
410115,202004,33,25,8,26125,8360,34485
410120,202004,412,211,201,220495,210045,430540
410130,202004,48,29,19,30305,19855,50160
410140,202004,3105,1507,1598,1577952.67,1677229,3255181.67
410150,202004,2682,1053,1629,1107701.35,1709621.1,2817322.45
410160,202004,508,314,194,328130,202730,530860
410165,202004,67,42,25,43890,26125,70015
410170,202004,175,118,57,123310.5,59565,182875.5
410180,202004,2262,1264,998,1324015,1045000,2369015
410185,202004,38,33,5,34485,5225,39710
410190,202004,488,318,170,332310.89,177650,509960.89
410200,202004,941,689,252,721050,263340,984390
410210,202004,599,313,286,327085,298870.5,625955.5
410220,202004,45,22,23,22990,24035,47025
410230,202004,149,71,78,74195,81510,155705
410240,202004,755,494,261,517276.25,275880,793156.25
410250,202004,379,274,105,286330,109725,396055
410260,202004,296,166,130,173470,135850.5,309320.5
410270,202004,28,20,8,20900,8360,29260
410275,202004,58,45,13,47025,13585,60610
410280,202004,322,188,134,197505,140030,337535
410290,202004,246,152,94,158840,98230,257070
410300,202004,78,56,22,58520,22990,81510
410302,202004,19,12,7,12540,7315,19855
410304,202004,43,29,14,30305,14630,44935
410305,202004,214,115,99,121220,104500,225720
410310,202004,219,130,89,135850,93005,228855
410315,202004,49,34,15,35530,16720,52250
410320,202004,133,93,40,97185,41800,138985
410322,202004,34,22,12,22990,12540,35530
410330,202004,176,122,54,127490,56430,183920
410335,202004,101,57,44,59565,47025,106590
410337,202004,41,33,8,34485,8360,42845
410340,202004,36,31,5,32395,5225,37620
410345,202004,216,126,90,131670,95095,226765
410347,202004,50,39,11,40755,12540,53295
410350,202004,236,145,91,151525,95095,246620
410360,202004,471,298,173,311410.5,181831,493241.5
410370,202004,2356,999,1357,1046045.7,1425381.35,2471427.05
410380,202004,209,131,78,136895,81510,218405
410390,202004,384,267,117,279015,122265,401280
410395,202004,37,24,13,25080,13585,38665
410400,202004,833,390,443,407550.27,462345.25,869895.52
410405,202004,91,68,23,71060,24035,95095
410410,202004,32,24,8,25080,8360,33440
410420,202004,1660,790,870,826502.49,911240.85,1737743.34
410425,202004,168,70,98,73150,103455,176605
410430,202004,2266,1275,991,1337600,1035596.4,2373196.4
410440,202004,374,275,99,287375,103455,390830
410442,202004,358,237,121,247665,126445,374110
410445,202004,418,296,122,310365.5,128535,438900.5
410450,202004,389,196,193,205865,203775,409640
410460,202004,503,261,242,272745,253935,526680
410465,202004,214,131,83,136895,86735,223630
410470,202004,233,144,89,151525,93005,244530
410480,202004,6191,2999,3192,3139184.7,3340866.25,6480050.95
410490,202004,1423,873,550,914375.51,576840.5,1491216.01
410500,202004,260,149,111,156750,115995,272745
410510,202004,168,125,43,130625,45980,176605
410520,202004,246,183,63,191235,65835,257070
410530,202004,268,99,169,104500,177650,282150
410540,202004,315,231,84,241395,87780,329175
410550,202004,1661,722,939,755535,984391,1739926
410560,202004,142,99,43,103455,44935,148390
410570,202004,434,290,144,303051.3,150480,453531.3
410580,202004,3441,1509,1932,1578996.33,2024165.5,3603161.83
410590,202004,399,272,127,285267,132715,417982
410600,202004,193,166,27,173470,28215,201685
410610,202004,53,44,9,45980,9405,55385
410620,202004,250,171,79,180785.03,82555,263340.03
410630,202004,438,251,187,262295,195415,457710
410640,202004,1020,640,380,669845.75,399190,1069035.75
410645,202004,109,79,30,82555,31350,113905
410650,202004,352,229,123,239305,129580,368885
410655,202004,88,63,25,65835,26125,91960
410657,202004,24,9,15,9405,15675,25080
410660,202004,596,417,179,436810.52,189145,625955.52
410670,202004,72,62,10,64790,10450,75240
410680,202004,213,171,42,178695,43890,222585
410685,202004,19,11,8,11495,8360,19855
410690,202004,28351,12079,16272,12657265,17048135,29705400
410700,202004,333,246,87,257070,90915,347985
410710,202004,126,104,22,108680,22990,131670
410712,202004,33,25,8,26125,8360,34485
410715,202004,92,67,25,70015,26125,96140
410720,202004,701,398,303,416955,316635,733590
410725,202004,180,130,50,135850,52250,188100
410730,202004,95,49,46,51205,49115,100320
410740,202004,107,76,31,80465,32395,112860
410750,202004,259,174,85,181830,88825,270655
410752,202004,25,15,10,15675,10450,26125
410753,202004,53,23,30,24035,31350,55385
410754,202004,48,25,23,26125.5,24035,50160.5
410755,202004,83,51,32,53295,33440,86735
410760,202004,766,423,343,442035.5,359480,801515.5
410765,202004,1742,817,925,853765,969761,1823526
410770,202004,106,84,22,87780,24035,111815
410773,202004,56,41,15,42845,15675,58520
410775,202004,183,135,48,142120,51205,193325
410780,202004,85,47,38,49115,39710,88825
410785,202004,58,45,13,47025,13585,60610
410790,202004,75,35,40,36575,41800,78375
410800,202004,286,176,110,183920,114950.5,298870.5
410810,202004,22,17,5,17765,5225.5,22990.5
410820,202004,173,126,47,131670,49115,180785
410830,202004,8594,3740,4854,3917706.78,5087060.75,9004767.53
410832,202004,103,72,31,75240,32395,107635
410840,202004,1449,795,654,833911.44,683430.25,1517341.69
410845,202004,70,44,26,45980,27170,73150
410850,202004,194,136,58,142120,60610,202730
410855,202004,57,45,12,47025,12540,59565
410860,202004,713,397,316,414865.5,330220,745085.5
410865,202004,102,76,26,79420,27170,106590
410870,202004,151,129,22,134805,22990,157795
410880,202004,1110,569,541,594605.5,565345,1159950.5
410890,202004,90,63,27,65835,28215,94050
410895,202004,71,55,16,57475,16720,74195
410900,202004,25,18,7,18810,7315,26125
410910,202004,16,13,3,13585,3135,16720
410920,202004,38,26,12,27170,12540,39710
410930,202004,523,325,198,340670,206910,547580
410940,202004,4339,2447,1892,2563386.57,1988635.5,4552022.07
410950,202004,104,77,27,81510,28215,109725
410960,202004,813,342,471,358435,494285,852720
410965,202004,63,48,15,50160,15675,65835
410970,202004,632,446,186,467115,194370,661485
410975,202004,120,74,46,77330.91,48070,125400.91
410980,202004,1619,730,889,764940,931095.5,1696035.5
410990,202004,265,183,82,192280,85690,277970
411000,202004,69,42,27,43890,28215.5,72105.5
411005,202004,24,20,4,21945,4180,26125
411007,202004,257,154,103,161975,108680,270655
411010,202004,603,409,194,427405,202730,630135
411020,202004,290,200,90,209000.85,94050,303050.85
411030,202004,18,10,8,10450,8360,18810
411040,202004,56,39,17,40755,17765,58520
411050,202004,206,160,46,168245,48070,216315
411060,202004,516,345,171,360525,178695,539220
411065,202004,56,48,8,50160,8360,58520
411070,202004,1240,765,475,800470,499510,1299980
411080,202004,241,170,71,177650,74195,251845
411090,202004,101,76,25,79420,26125,105545
411095,202004,283,111,172,115995,180785,296780
411100,202004,116,95,21,100320,21945,122265
411110,202004,127,83,44,86735,45980,132715
411120,202004,201,141,60,147345,62700,210045
411125,202004,240,103,137,107635,143165,250800
411130,202004,132,114,18,120175,18810,138985
411140,202004,212,140,72,146300,75240,221540
411150,202004,1223,803,420,840180,439945.29,1280125.29
411155,202004,120,83,37,86735,38665,125400
411160,202004,25,12,13,12540,13585,26125
411170,202004,52,47,5,49115.5,5225,54340.5
411180,202004,969,641,328,671935,342760,1014695
411190,202004,324,191,133,199595,138985,338580
411200,202004,671,414,257,433675.29,269610,703285.29
411210,202004,688,366,322,382470,338580.65,721050.65
411220,202004,155,113,42,118085,43890,161975
411230,202004,41,34,7,35530,7315,42845
411240,202004,119,76,43,79420,45980,125400
411250,202004,428,317,111,332310,115995,448305
411260,202004,18,12,6,12540,6270,18810
411270,202004,285,151,134,157795,140030,297825
411275,202004,187,164,23,172425,24035,196460
411280,202004,214,151,63,158840.29,65835,224675.29
411290,202004,62,48,14,50160,14630,64790
411295,202004,139,108,31,112860,32395,145255
411300,202004,78,36,42,37620,43890,81510
411310,202004,92,72,20,75240,20900,96140
411320,202004,779,527,252,550715,263340,814055
411325,202004,58,40,18,41800,19855,61655
411330,202004,897,570,327,596695.5,342760.99,939456.49
411340,202004,27,19,8,20900,8360,29260
411342,202004,65,50,15,52250,15675,67925
411345,202004,119,58,61,60610,63745,124355
411350,202004,483,373,110,389785.45,114950.5,504735.95
411360,202004,53,34,19,35530,19855,55385
411370,202004,14206,5810,8396,6079815.24,8804127.33,14883942.57
411373,202004,173,126,47,132715,49115,181830
411375,202004,74,60,14,62700,14630,77330
411380,202004,85,62,23,65835,24035,89870
411390,202004,126,81,45,84645,47025,131670
411400,202004,368,276,92,289465,96140,385605
411410,202004,437,219,218,229900,227810.5,457710.5
411420,202004,982,434,548,454575,574750,1029325
411430,202004,465,271,194,284240,202730,486970
411435,202004,32,21,11,21945,11495,33440
411440,202004,456,363,93,379335,97185,476520
411450,202004,417,355,62,370975,64790,435765
411460,202004,756,293,463,306185,484881.43,791066.43
411470,202004,84,63,21,65835,21945,87780
411480,202004,671,375,296,392920.5,309320,702240.5
411490,202004,293,189,104,198550,108680,307230
411500,202004,100,83,17,86735,17765,104500
411510,202004,222,176,46,183920,48070,231990
411520,202004,6029,2292,3737,2400366,3916661.76,6317027.76
411530,202004,122,83,39,86735,40755,127490
411535,202004,49,19,30,19855,31350,51205
411540,202004,349,241,108,251845,112860,364705
411545,202004,55,41,14,42845,14630,57475
411550,202004,77,58,19,60610,19855,80465
411560,202004,392,172,220,179740,229900,409640
411570,202004,817,301,516,314545.2,540265,854810.2
411573,202004,24,15,9,15675,9405,25080
411575,202004,292,186,106,194370,110770,305140
411580,202004,1278,471,807,495330,846450,1341780
411585,202004,75,36,39,37620,40755,78375
411590,202004,24,16,8,16720,8360,25080
411600,202004,25,11,14,11495,14630,26125
411605,202004,238,95,143,99275,149435,248710
411610,202004,202,135,67,141075,71060,212135
411620,202004,371,198,173,206910,180785,387695
411630,202004,55,38,17,39710,17765,57475
411640,202004,34,25,9,26125,9405,35530
411650,202004,12,7,5,7315,5225,12540
411660,202004,36,25,11,26125,11495,37620
411670,202004,238,175,63,183920,65835,249755
411680,202004,160,132,28,138985,29260,168245
411690,202004,590,318,272,332310,284240,616550
411695,202004,58,42,16,43890,16720,60610
411700,202004,140,117,23,122265,24035,146300
411705,202004,106,70,36,73150,37620,110770
411710,202004,299,204,95,213180,99275,312455
411720,202004,131,88,43,91960,44935,136895
411721,202004,67,56,11,58520,11495,70015
411722,202004,97,41,56,42845,58520,101365
411725,202004,158,117,41,122265.5,42845,165110.5
411727,202004,84,64,20,66880,20900,87780
411729,202004,37,29,8,30305,8360,38665
411730,202004,550,349,201,365750,210045,575795
411740,202004,40,24,16,25080,16720,41800
411745,202004,70,50,20,52250,21945,74195
411750,202004,852,386,466,406505.5,488015,894520.5
411760,202004,1175,879,296,921690.6,311410,1233100.6
411770,202004,457,302,155,316635,161975,478610
411780,202004,334,222,112,231990,117040,349030
411790,202004,526,295,231,309320.22,241395,550715.22
411800,202004,155,119,36,124355,37620,161975
411810,202004,176,132,44,137940,45980,183920
411820,202004,2196,975,1221,1022011.7,1279080,2301091.7
411830,202004,12,11,1,11495,1045,12540
411840,202004,2018,1240,778,1298935,814056,2112991
411845,202004,55,20,35,20900,36575,57475
411850,202004,1211,667,544,701195.5,572660.75,1273856.25
411860,202004,46,32,14,34485.5,14630,49115.5
411870,202004,71,48,23,50160,24035,74195
411880,202004,421,269,152,282150,158840,440990
411885,202004,105,68,37,71060,39710,110770
411890,202004,310,202,108,211091.49,112860,323951.49
411900,202004,79,59,20,61655.5,21945,83600.5
411910,202004,180,144,36,150480,38665,189145
411915,202004,2149,889,1260,932140,1320880.55,2253020.55
411920,202004,116,93,23,97185,24035,121220
411925,202004,12,8,4,8360,4180,12540
411930,202004,804,586,218,613415.85,227810,841225.85
411940,202004,584,400,184,418000.85,193325,611325.85
411950,202004,983,482,501,504735.76,525635,1030370.76
411960,202004,1033,700,333,732545.75,349030,1081575.75
411965,202004,20,14,6,14630,6270,20900
411970,202004,83,74,9,77330,9405,86735
411980,202004,163,105,58,109725,60610,170335
411990,202004,5140,2946,2194,3084847.74,2294822.25,5379669.99
411995,202004,483,172,311,180785,324995,505780
412000,202004,315,205,110,214225,114950,329175
412010,202004,46,29,17,30305,17765,48070
412015,202004,40,29,11,30305,11495,41800
412020,202004,31,25,6,26125,6270,32395
412030,202004,49,46,3,48070,4180,52250
412033,202004,47,30,17,31350,17765,49115
412035,202004,67,45,22,47025,22990,70015
412040,202004,43,25,18,26125.5,18810,44935.5
412050,202004,198,152,46,159885,49115,209000
412060,202004,774,581,193,610280,201685,811965
412065,202004,49,32,17,33440,17765,51205
412070,202004,162,110,52,114950,54340,169290
412080,202004,286,147,139,154660,146300,300960
412085,202004,35,16,19,16720,19855,36575
412090,202004,807,505,302,527725.25,316635,844360.25
412100,202004,242,206,36,215270,37620,252890
412110,202004,69,54,15,56430.4,15675,72105.4
412120,202004,324,195,129,203775,135850,339625
412125,202004,83,49,34,51205,35530,86735
412130,202004,37,24,13,25080.4,13585,38665.4
412135,202004,29,17,12,18810,12540,31350
412140,202004,340,229,111,239305,117040,356345
412150,202004,256,168,88,178695,93005,271700
412160,202004,89,50,39,52250,40755,93005
412170,202004,682,476,206,497420.5,215270,712690.5
412175,202004,38,28,10,29260,10450,39710
412180,202004,196,150,46,157795,48070,205865
412190,202004,341,269,72,281105,75240,356345
412200,202004,184,118,66,123310,68970,192280
412210,202004,72,57,15,59565,15675,75240
412215,202004,229,161,68,168245,71060,239305
412217,202004,67,53,14,55385,14630,70015
412220,202004,830,592,238,620730,248710,869440
412230,202004,327,198,129,206910,134805,341715
412240,202004,1349,671,678,707465,709555,1417020
412250,202004,406,253,153,265430,160930,426360
412260,202004,105,76,29,79420,30305,109725
412265,202004,170,136,34,144210,36575,180785
412270,202004,84,56,28,58520,29260,87780
412280,202004,90,73,17,76285,17765,94050
412290,202004,93,64,29,66880,30305,97185
412300,202004,203,135,68,142120,72105,214225
412310,202004,47,41,6,42845,6270,49115
412320,202004,99,82,17,85690,17765,103455
412330,202004,187,161,26,169290,28215,197505
412340,202004,151,105,46,110770,48070.5,158840.5
412350,202004,619,303,316,316635,332310,648945
412360,202004,26,22,4,22990,4180,27170
412370,202004,155,136,19,143165.3,19855,163020.3
412380,202004,264,199,65,207955,67925,275880
412382,202004,62,33,29,34485,30305,64790
412385,202004,149,109,40,113905,41800,155705
412390,202004,284,218,66,227810,70015,297825
412395,202004,71,58,13,60610,13585,74195
412400,202004,90,61,29,63745,30305,94050
412402,202004,234,118,116,123310.5,121220,244530.5
412405,202004,859,321,538,335445,564300.5,899745.5
412410,202004,965,596,369,623865.5,386650,1010515.5
412420,202004,12,11,1,11495,1045,12540
412430,202004,19,14,5,14630,5225,19855
412440,202004,612,334,278,350075,290510,640585
412450,202004,76,66,10,68970,10450,79420
412460,202004,92,70,22,73150,22990,96140
412470,202004,216,174,42,182875,43890,226765
412480,202004,144,107,37,112860.75,38665,151525.75
412490,202004,162,145,17,152570,17765,170335
412500,202004,438,358,80,374110.06,83600,457710.06
412510,202004,177,146,31,152570.03,32395,184965.03
412520,202004,91,61,30,63745,31350,95095
412530,202004,105,55,50,57475,52250,109725
412535,202004,90,67,23,70015,24035,94050
412540,202004,82,39,43,40755,44935,85690
412545,202004,91,62,29,66880,30305,97185
412550,202004,3777,1643,2134,1724250.5,2236300.5,3960551.0
412555,202004,13,9,4,9405,4180,13585
412560,202004,606,431,175,452486.5,182875.75,635362.25
412570,202004,760,395,365,413820,384560,798380
412575,202004,89,62,27,64790,28215,93005
412580,202004,178,116,62,121220,64790,186010
412590,202004,38,33,5,34485,5225,39710
412600,202004,165,123,42,128535.85,43890,172425.85
412610,202004,35,17,18,17765,18810,36575
412620,202004,147,125,22,131670,22990,154660
412625,202004,2149,1125,1024,1176671.04,1072172.35,2248843.39
412627,202004,68,51,17,53295,17765,71060
412630,202004,409,270,139,283195,145255,428450
412635,202004,65,18,47,18810,49115,67925
412640,202004,107,74,33,77330,34485,111815
412650,202004,342,221,121,230945,126445,357390
412660,202004,471,284,187,299915,195415,495330
412665,202004,46,41,5,42845,5225,48070
412667,202004,296,202,94,211090,98230,309320
412670,202004,65,53,12,55385,12540,67925
412680,202004,293,229,64,239305,66880.7,306185.7
412690,202004,101,67,34,70015,35530.5,105545.5
412700,202004,160,107,53,112860,55385,168245
412710,202004,1391,843,548,880936.25,575795,1456731.25
412720,202004,229,146,83,152570,86735,239305
412730,202004,185,155,30,164065,31350,195415
412740,202004,430,228,202,238260,211090,449350
412750,202004,444,252,192,263340,200640,463980
412760,202004,279,146,133,153615,138985,292600
412770,202004,2146,1188,958,1245640.29,1002156,2247796.29
412780,202004,140,108,32,112860,33440,146300
412785,202004,279,138,141,144210,147345,291555
412788,202004,35,21,14,21945,14630,36575
412790,202004,126,106,20,111815,20900,132715
412795,202004,149,108,41,112860,42845,155705
412796,202004,316,209,107,219450,111815,331265
412800,202004,608,371,237,388740.25,248710,637450.25
412810,202004,2928,1597,1331,1673046.75,1392985,3066031.75
412820,202004,934,591,343,618641.75,359480,978121.75
412830,202004,14,11,3,11495,3135,14630
412840,202004,224,163,61,171380,63745,235125
412850,202004,765,499,266,522500,277970,800470
412853,202004,170,87,83,90915,86735,177650
412855,202004,193,105,88,109725.09,91960,201685.09
412860,202004,96,64,32,66880,33440,100320
412862,202004,55,40,15,42845,15675,58520
412863,202004,6,5,1,5225,1045,6270
412865,202004,43,31,12,32395,12540,44935
412870,202004,110,67,43,70015,44935,114950
412880,202004,95,71,24,74195.5,25080,99275.5
420005,202004,42,38,4,40755,4180,44935
420010,202004,361,235,126,245575.75,131670,377245.75
420020,202004,82,69,13,72105,13585,85690
420030,202004,23,21,2,21945,2090,24035
420040,202004,105,82,23,85690,24035,109725
420050,202004,57,35,22,36575,22990,59565
420055,202004,19,19,0,19855,0,19855
420060,202004,28,22,6,22990,6270,29260
420070,202004,99,83,16,87780,16720,104500
420075,202004,12,12,0,12540,0,12540
420080,202004,43,38,5,39710,5225,44935
420090,202004,34,31,3,33440,3135,36575
420100,202004,147,125,22,130625.5,22990,153615.5
420110,202004,20,20,0,20900,0,20900
420120,202004,63,46,17,49115,17765,66880
420125,202004,79,61,18,63745,18810,82555
420127,202004,30,26,4,27170,4180,31350
420130,202004,416,253,163,268565,170335,438900
420140,202004,1287,715,572,748220.75,599830,1348050.75
420150,202004,43,36,7,37620,7315,44935
420160,202004,34,32,2,33440,2090,35530
420165,202004,19,12,7,12540,7315,19855
420170,202004,77,50,27,52250,28215,80465
420180,202004,21,18,3,18810,3135,21945
420190,202004,25,22,3,22990,3135,26125
420195,202004,131,64,67,66880,70015,136895
420200,202004,1278,566,712,591470.5,746130,1337600.5
420205,202004,79,44,35,45980,36575,82555
420207,202004,122,66,56,70015,58520,128535
420208,202004,19,15,4,15675,4180,19855
420209,202004,19,16,3,16720,3135,19855
420210,202004,507,237,270,247665,283195,530860
420213,202004,47,37,10,38665,10450,49115
420215,202004,26,23,3,24035,3135,27170
420220,202004,65,43,22,44935,22990,67925
420230,202004,825,469,356,490105,376200.5,866305.5
420240,202004,2234,1467,767,1541375.9,805695,2347070.9
420243,202004,43,33,10,34485,10450,44935
420245,202004,146,78,68,81510,71060,152570
420250,202004,62,41,21,42845,21945,64790
420253,202004,37,29,8,30305,8360,38665
420257,202004,14,11,3,11495,3135,14630
420260,202004,101,85,16,88825,16720,105545
420270,202004,31,26,5,27170,5225,32395
420280,202004,291,220,71,229900.75,74195.75,304096.50
420285,202004,22,12,10,12540,10450,22990
420287,202004,48,32,16,33440,16720,50160
420290,202004,978,679,299,710600.5,313500,1024100.5
420300,202004,1429,1135,294,1188167.95,307230.65,1495398.60
420310,202004,49,33,16,34485,16720,51205
420315,202004,35,28,7,29260,7315,36575
420320,202004,898,445,453,465025.1,473385,938410.1
420325,202004,0,,,,,0.0
420330,202004,119,78,41,81510,42845,124355
420340,202004,154,102,52,106590,56430,163020
420350,202004,249,179,70,187055,73150,260205
420360,202004,738,561,177,593560,186010.25,779570.25
420370,202004,121,72,49,75240,51205.5,126445.5
420380,202004,1172,817,355,856900.25,370975.5,1227875.75
420390,202004,250,175,75,183920,79420,263340
420395,202004,194,139,55,145255,57475,202730
420400,202004,241,184,57,192280.91,59565,251845.91
420410,202004,61,46,15,48070,15675,63745
420415,202004,34,29,5,30305,5225,35530
420417,202004,51,40,11,41800,11495,53295
420419,202004,11,11,0,11495,0,11495
420420,202004,2848,1767,1081,1851743.08,1134870.5,2986613.58
420425,202004,68,56,12,58520,13585,72105
420430,202004,1178,844,334,889295.45,349030,1238325.45
420435,202004,15,13,2,13585,2090,15675
420440,202004,101,71,30,74195.5,31350,105545.5
420445,202004,22,21,1,21945,1045,22990
420450,202004,78,39,39,40755,40755,81510
420455,202004,212,162,50,169290,52250,221540
420460,202004,2324,1507,817,1577952.97,854810,2432762.97
420470,202004,106,75,31,78375,32395,110770
420475,202004,7,7,0,7315,0,7315
420480,202004,858,647,211,680296,220495.5,900791.5
420490,202004,105,77,28,80465,29260,109725
420500,202004,455,239,216,249756.09,225720,475476.09
420510,202004,17,16,1,16720,1045,17765
420515,202004,24,18,6,18810,6270,25080
420517,202004,10,10,0,10450,0,10450
420519,202004,0,,,,,0.0
420520,202004,67,51,16,53295,16720,70015
420530,202004,164,110,54,114950.75,56430,171380.75
420535,202004,20,18,2,18810,2090,20900
420540,202004,5468,3265,2203,3413236.9,2308405.5,5721642.4
420543,202004,23,22,1,22990,1045,24035
420545,202004,205,146,59,152570,61655,214225
420550,202004,850,701,149,738815.5,155705,894520.5
420555,202004,36,26,10,27170,10450,37620
420560,202004,62,52,10,54340,10450,64790
420570,202004,157,90,67,94050,70015,164065
420580,202004,276,127,149,132715,155705.5,288420.5
420590,202004,518,352,166,369930,173470,543400
420600,202004,116,63,53,66880,55385,122265
420610,202004,39,35,4,36575,4180,40755
420620,202004,85,66,19,68970,19855,88825
420630,202004,147,104,43,109725,45980,155705
420640,202004,83,74,9,77330,10450,87780
420650,202004,244,127,117,132715,123310,256025
420660,202004,49,39,10,40755.5,10450,51205.5
420665,202004,38,29,9,30305,9405,39710
420670,202004,304,234,70,245575,74195,319770
420675,202004,12,11,1,11495,1045,12540
420680,202004,39,28,11,29260,11495,40755
420690,202004,173,134,39,140030,40755,180785
420700,202004,692,471,221,492195.46,230945,723140.46
420710,202004,151,87,64,90915,66880,157795
420720,202004,108,88,20,91960,20900,112860
420730,202004,606,380,226,397100.84,236170.5,633271.34
420740,202004,52,51,1,53295,1045,54340
420750,202004,502,339,163,356345,170335,526680
420757,202004,16,14,2,14630,2090,16720
420760,202004,37,29,8,30305,8360,38665
420765,202004,78,61,17,64790,17765,82555
420768,202004,51,46,5,48070,5225,53295
420770,202004,73,63,10,65835,10450,76285
420775,202004,40,37,3,38665,3135,41800
420780,202004,225,179,46,189145,48070,237215
420785,202004,12,10,2,10450,2090,12540
420790,202004,162,134,28,140030,29260,169290
420800,202004,67,50,17,52250,17765,70015
420810,202004,254,212,42,221540,43890,265430
420820,202004,2345,1349,996,1417020.5,1040821.22,2457841.72
420830,202004,604,326,278,341715.5,291555,633270.5
420840,202004,150,110,40,114950,41800,156750
420845,202004,406,176,230,184965,243485.5,428450.5
420850,202004,261,200,61,209000.25,63745,272745.25
420860,202004,60,50,10,53295,10450,63745
420870,202004,125,87,38,90915,39710,130625
420880,202004,176,115,61,120175,63745,183920
420890,202004,929,466,463,491150.83,484880,976030.83
420895,202004,9,9,0,9405,0,9405
420900,202004,408,325,83,341715,86944,428659
420910,202004,5880,3271,2609,3427604.33,2732675,6160279.33
420915,202004,69,64,5,66880,5225,72105
420917,202004,21,14,7,14630,7315,21945
420920,202004,22,15,7,15675,7315,22990
420930,202004,2796,1743,1053,1825550,1103522.28,2929072.28
420940,202004,592,436,156,455621,165110.9,620731.9
420945,202004,9,7,2,7315,2090,9405
420950,202004,57,50,7,52250,7315,59565
420960,202004,109,87,22,90915,22990,113905
420970,202004,294,236,58,247666,60610,308276
420980,202004,23,22,1,22990,1045,24035
420985,202004,58,51,7,53295,7315,60610
420990,202004,80,59,21,61655,21945,83600
421000,202004,39,24,15,25080,15675,40755
421003,202004,52,36,16,37620,16720,54340
421005,202004,6,3,3,3135,3135,6270
421010,202004,767,529,238,554895,249755.75,804650.75
421020,202004,25,20,5,20900,5225,26125
421030,202004,121,101,20,105545.75,20900,126445.75
421040,202004,73,56,17,58520,17765,76285
421050,202004,345,241,104,251846,110770,362616
421055,202004,21,17,4,17765,4180,21945
421060,202004,88,52,36,54340,37620,91960
421070,202004,51,45,6,47025.5,6270,53295.5
421080,202004,34,30,4,32395,4180,36575
421085,202004,20,15,5,15675,5225,20900
421090,202004,38,28,10,29260,10450,39710
421100,202004,123,90,33,94050,34485,128535
421105,202004,205,169,36,176605,37620,214225
421110,202004,115,89,26,93005,27170,120175
421120,202004,162,120,42,125400.42,44935,170335.42
421125,202004,17,12,5,12540,5225,17765
421130,202004,812,511,301,536085,314545.5,850630.5
421140,202004,29,20,9,20900,10450,31350
421145,202004,41,33,8,34485,8360,42845
421150,202004,103,74,29,77330,30305,107635
421160,202004,69,47,22,50160,22990,73150
421165,202004,16,15,1,15675,1045,16720
421170,202004,185,155,30,162101.5,31350,193451.5
421175,202004,166,114,52,119130,54340,173470
421180,202004,53,35,18,36575.1,18810,55385.1
421185,202004,17,14,3,14630,3135,17765
421187,202004,0,0,0,0,0,0
421189,202004,44,31,13,32395,13585,45980
421190,202004,1669,1047,622,1097250,651035.79,1748285.79
421200,202004,95,70,25,73150,26125,99275
421205,202004,28,18,10,18810,10450,29260
421210,202004,172,118,54,124355,56430,180785
421220,202004,280,216,64,225720,67925,293645
421223,202004,48,39,9,40755,9405,50160
421225,202004,69,43,26,44935,27170,72105
421227,202004,86,66,20,68970,20900,89870
421230,202004,53,37,16,38665,16720,55385
421240,202004,18,18,0,18810,0,18810
421250,202004,374,224,150,236170.5,156750,392920.5
421260,202004,24,20,4,20900,4180,25080
421265,202004,2,2,0,2090,0,2090
421270,202004,47,42,5,43890,5225,49115
421280,202004,344,190,154,198550,160930,359480
421290,202004,335,223,112,234080,117040,351120
421300,202004,24,19,5,19855,5225,25080
421310,202004,46,33,13,34485,13585,48070
421315,202004,30,19,11,20900,11495,32395
421320,202004,129,82,47,85690,49115,134805
421330,202004,108,78,30,81510,31350,112860
421335,202004,40,28,12,29260,12540,41800
421340,202004,242,155,87,161975.25,90915,252890.25
421350,202004,187,107,80,112860.82,83600,196460.82
421360,202004,640,476,164,498465.25,172425,670890.25
421370,202004,204,154,50,160930,52250,213180
421380,202004,125,98,27,102410,28215,130625
421390,202004,19,13,6,14630,6270,20900
421400,202004,129,111,18,115995,18810,134805
421410,202004,18,16,2,16720,2090,18810
421415,202004,21,20,1,20900,1045,21945
421420,202004,137,115,22,120175,24035,144210
421430,202004,17,12,5,12540,5225,17765
421440,202004,59,50,9,52250,9405,61655
421450,202004,90,75,15,79420,15675,95095
421460,202004,60,48,12,50160,12540,62700
421470,202004,69,43,26,44935,27170,72105
421480,202004,718,547,171,573705,178695,752400
421490,202004,24,23,1,24035,1045,25080
421500,202004,485,313,172,328130.5,180785.25,508915.75
421505,202004,25,18,7,18810,7315,26125
421507,202004,30,23,7,24035,7315,31350
421510,202004,70,45,25,47025,26125,73150
421520,202004,56,47,9,49115,9405,58520
421530,202004,49,42,7,43890,7315,51205
421535,202004,26,24,2,25080,2090,27170
421540,202004,53,47,6,50160,6270,56430
421545,202004,99,74,25,77330,26125,103455
421550,202004,284,206,78,219450,81510,300960
421555,202004,21,17,4,17765,4180.5,21945.5
421560,202004,8,7,1,7315,1045,8360
421565,202004,123,83,40,86735,41800,128535
421567,202004,29,23,6,24035,6270,30305
421568,202004,30,26,4,27170,4180,31350
421569,202004,10,10,0,10450,0,10450
421570,202004,198,134,64,141075,68970,210045
421575,202004,27,22,5,22990,5225,28215
421580,202004,716,432,284,452553,298870,751423
421590,202004,19,18,1,18810,1045,19855
421600,202004,148,98,50,102410,52250.5,154660.5
421605,202004,112,77,35,80465.75,36575,117040.75
421610,202004,185,142,43,148390,44935,193325
421620,202004,1035,606,429,633270,449350,1082620
421625,202004,21,18,3,18810,3135,21945
421630,202004,302,187,115,197505.25,120176.5,317681.75
421635,202004,18,9,9,9405,9405,18810
421640,202004,98,82,16,86735,16720,103455
421650,202004,302,179,123,187055,129580,316635
421660,202004,2223,1337,886,1400301.5,927961,2328262.5
421670,202004,184,131,53,136895,55385,192280
421680,202004,178,160,18,167200,18810,186010
421690,202004,346,246,100,257070.5,105545.6,362616.1
421700,202004,55,38,17,39710,17765,57475
421710,202004,24,23,1,24035,1045,25080
421715,202004,6,5,1,5225,1045,6270
421720,202004,624,437,187,456666.25,196460,653126.25
421725,202004,16,6,10,6270,10450,16720
421730,202004,35,25,10,26125,10450,36575
421740,202004,86,34,52,36575,54340,90915
421750,202004,212,159,53,166155,56430,222585
421755,202004,23,21,2,21945,2090,24035
421760,202004,99,67,32,70015,33440,103455
421770,202004,643,411,232,431586.75,243485,675071.75
421775,202004,29,18,11,18810,11495,30305
421780,202004,194,152,42,158840.5,43890,202730.5
421790,202004,154,130,24,135850,25080,160930
421795,202004,19,15,4,15675,4180,19855
421800,202004,517,332,185,346940,194370.25,541310.25
421810,202004,70,57,13,60610,13585,74195
421820,202004,320,209,111,220495.5,115995,336490.5
421825,202004,134,115,19,121220,19855,141075
421830,202004,134,93,41,98230,42845,141075
421835,202004,6,4,2,4180,2090,6270
421840,202004,51,43,8,45980,8360,54340
421850,202004,79,68,11,71060,11495,82555
421860,202004,37,31,6,32395,6270,38665
421870,202004,1003,749,254,782713.04,266476.32,1049189.36
421875,202004,54,44,10,45980,10450,56430
421880,202004,166,116,50,121220,52250.5,173470.5
421885,202004,21,17,4,17765,4180,21945
421890,202004,134,95,39,99275,40755,140030
421895,202004,45,40,5,41800,5225,47025
421900,202004,153,120,33,125400,35530,160930
421910,202004,68,41,27,42845,28215,71060
421915,202004,31,26,5,27170,5225,32395
421917,202004,38,28,10,29260,10450,39710
421920,202004,42,38,4,39710,4180,43890
421930,202004,682,544,138,569525.87,146300,715825.87
421935,202004,48,42,6,43890,6270,50160
421940,202004,41,36,5,39710,5225,44935
421950,202004,859,574,285,604010.5,297825,901835.5
421960,202004,46,40,6,41800.5,6270,48070.5
421970,202004,357,232,125,245575.5,130625,376200.5
421985,202004,24,14,10,14630,10450,25080
422000,202004,0,,,,,0.0
430003,202004,184,55,129,58520,134805,193325
430005,202004,36,26,10,27170,10450,37620
430010,202004,264,191,73,200640,76285,276925
430020,202004,144,97,47,101365.5,49115,150480.5
430030,202004,120,97,23,101365,24035,125400
430040,202004,2918,1716,1202,1795312,1258180.5,3053492.5
430045,202004,69,58,11,60610,11495,72105
430047,202004,6,6,0,6270,0,6270
430050,202004,79,67,12,70015,12540,82555
430055,202004,12,11,1,11495,1045,12540
430057,202004,5,4,1,4180,1045,5225
430060,202004,3687,2150,1537,2253021.75,1611390,3864411.75
430063,202004,52,48,4,50160,4180,54340
430064,202004,154,124,30,129580,31350,160930
430066,202004,5,2,3,2090,3135,5225
430070,202004,44,31,13,33440,13585,47025
430080,202004,70,47,23,49115,24035,73150
430085,202004,32,10,22,10450,22990,33440
430087,202004,29,21,8,21945.75,8360,30305.75
430090,202004,70,63,7,65835,7315,73150
430100,202004,123,84,39,88825,40755,129580
430105,202004,151,84,67,87780,70015,157795
430107,202004,19,13,6,13585,6270,19855
430110,202004,434,251,183,265430,193325,458755
430120,202004,152,141,11,147345,11495,158840
430130,202004,796,487,309,511005.5,323950,834955.5
430140,202004,123,115,8,121220,8360,129580
430150,202004,109,71,38,74195,39710,113905
430155,202004,35,31,4,32395,4180,36575
430160,202004,3640,2141,1499,2244662.75,1569590.5,3814253.25
430163,202004,360,163,197,172425,205865,378290
430165,202004,29,20,9,20900,9405,30305
430170,202004,91,77,14,80465,14630,95095
430175,202004,77,59,18,62700,18810,81510
430180,202004,105,86,19,89870,19855,109725
430185,202004,32,22,10,22990,10450,33440
430187,202004,80,38,42,39710,43890,83600
430190,202004,220,120,100,125400,104500,229900
430192,202004,13,11,2,11495,2090,13585
430195,202004,16,11,5,11495,5225,16720
430200,202004,167,144,23,150480,24035,174515
430205,202004,21,20,1,20900,1045,21945
430210,202004,684,528,156,554895.5,163020.5,717916.0
430215,202004,13,10,3,10450,3135,13585
430220,202004,69,47,22,49115,22990,72105
430222,202004,12,6,6,6270,6270,12540
430223,202004,14,7,7,7315,7315,14630
430225,202004,2,1,1,1045,1045,2090
430230,202004,314,184,130,192280,137940,330220
430235,202004,56,44,12,45980,12540,58520
430237,202004,25,20,5,20900,5225,26125
430240,202004,129,86,43,89870,44935,134805
430245,202004,69,55,14,57475,14630,72105
430250,202004,189,112,77,118085,80465,198550
430258,202004,9,8,1,8360,1045,9405
430260,202004,32,28,4,29260,4180,33440
430265,202004,36,31,5,32395,5225,37620
430270,202004,519,384,135,402326.25,141075,543401.25
430280,202004,1031,632,399,660440,416955,1077395
430290,202004,397,217,180,226765,188100,414865
430300,202004,2067,1141,926,1194435.75,969760.5,2164196.25
430310,202004,1977,1008,969,1055450.5,1015741.21,2071191.71
430320,202004,57,46,11,48070,11495,59565
430330,202004,99,88,11,91960,11495,103455
430340,202004,71,57,14,60610,14630,75240
430350,202004,1656,1124,532,1177715.5,555940,1733655.5
430355,202004,20,18,2,18810,2090,20900
430360,202004,87,44,43,47025,44935,91960
430367,202004,35,27,8,28215,8360,36575
430370,202004,54,47,7,49115,7315,56430
430380,202004,135,103,32,107635,33440,141075
430390,202004,586,362,224,379335,235125,614460
430400,202004,133,99,34,104500.5,35530,140030.5
430410,202004,55,43,12,44935,12540,57475
430420,202004,507,335,172,350075.85,180785,530860.85
430430,202004,53,52,1,53644.03,1045,54689.03
430435,202004,151,113,38,118085,39710,157795
430440,202004,491,323,168,337535,177650,515185
430450,202004,1155,953,202,995885,213180,1209065
430460,202004,5200,2742,2458,2873751.4,2579060,5452811.4
430461,202004,16,15,1,15675,1045,16720
430462,202004,10,6,4,6270,4180,10450
430463,202004,1069,576,493,604010,515185,1119195
430465,202004,25,14,11,14630,11495,26125
430466,202004,676,483,193,504735.5,203775,708510.5
430467,202004,104,55,49,57475,51205,108680
430468,202004,115,69,46,72105,48070,120175
430469,202004,23,18,5,18810,5225,24035
430470,202004,1145,637,508,668067.12,530860,1198927.12
430471,202004,55,37,18,38665,18810,57475
430480,202004,100,64,36,66880,38665,105545
430485,202004,6,6,0,6270.5,0,6270.5
430490,202004,80,63,17,65835,17765,83600
430495,202004,33,26,7,27170,7315,34485
430500,202004,187,127,60,132715,62700,195415
430510,202004,3454,2247,1207,2356475.98,1268630,3625105.98
430511,202004,15,15,0,15675,0,15675
430512,202004,150,104,46,108680,48070,156750
430513,202004,53,43,10,44935,10450,55385
430515,202004,27,25,2,26125,2090,28215
430517,202004,166,146,20,152570,20900,173470
430520,202004,351,243,108,253935,112860,366795
430530,202004,86,50,36,53295,38665,91960
430535,202004,456,308,148,322905,154660,477565
430537,202004,9,9,0,9405,0,9405
430540,202004,81,55,26,58520,27170,85690
430543,202004,344,110,234,114950,246620,361570
430544,202004,43,40,3,41800,3135,44935
430545,202004,368,190,178,199595,186010,385605
430550,202004,40,33,7,34485,7315,41800
430558,202004,3,2,1,2090,1045,3135
430560,202004,56,30,26,31350,27170,58520
430570,202004,106,40,66,41800,68970,110770
430580,202004,129,106,23,110770,24035,134805
430583,202004,13,13,0,13585,0,13585
430585,202004,12,5,7,5225,7315,12540
430587,202004,14,7,7,7315,7315,14630
430590,202004,141,116,25,121220,26125,147345
430593,202004,2,2,0,2090,0,2090
430595,202004,17,14,3,14630,3135,17765
430597,202004,43,23,20,25080,22990,48070
430600,202004,218,159,59,166155,61655,227810
430605,202004,160,101,59,105545,61655,167200
430607,202004,23,20,3,20900,3135,24035
430610,202004,1620,765,855,801515,897655.5,1699170.5
430613,202004,2,2,0,2090,0,2090
430620,202004,108,77,31,80465,32395,112860
430630,202004,48,42,6,43890,6270,50160
430632,202004,32,27,5,28215,5225,33440
430635,202004,33,30,3,32395,3135,35530
430637,202004,56,30,26,31350,27170,58520
430640,202004,178,100,78,105545,82555,188100
430642,202004,20,17,3,18810,3135,21945
430645,202004,36,29,7,30305,7315,37620
430650,202004,248,203,45,212135.5,47025,259160.5
430655,202004,2,2,0,2090,0,2090
430660,202004,968,481,487,502645,508915.5,1011560.5
430670,202004,75,51,24,53295,25080,78375
430673,202004,67,40,27,41800,28215,70015
430675,202004,11,9,2,9405,2090,11495
430676,202004,514,304,210,317680,219450,537130
430680,202004,240,165,75,173471,78375,251846
430690,202004,532,329,203,343805,213180.29,556985.29
430692,202004,9,6,3,6270,3135,9405
430693,202004,135,89,46,93005,48070,141075
430695,202004,68,56,12,58520,12540,71060
430697,202004,55,35,20,36575,21945,58520
430700,202004,1511,1052,459,1101430.9,480700,1582130.9
430705,202004,22,20,2,20900,2090,22990
430710,202004,260,166,94,173470,98230,271700
430720,202004,107,91,16,96140,16720,112860
430730,202004,138,119,19,124355,19855,144210
430740,202004,73,49,24,51205,25080,76285
430745,202004,30,23,7,24035,7315,31350
430750,202004,319,211,108,222585,112860,335445
430755,202004,86,48,38,50160,39710,89870
430760,202004,375,219,156,228855.6,165110,393965.6
430770,202004,1489,785,704,823460.5,739860.5,1563321.0
430780,202004,291,185,106,193325,111815,305140
430781,202004,26,22,4,22990,4180,27170
430783,202004,60,48,12,50160,12540,62700
430786,202004,5,3,2,3135,2090,5225
430790,202004,514,339,175,355300,184965.5,540265.5
430800,202004,152,125,27,130625.76,28215,158840.76
430805,202004,39,35,4,36575,4180,40755
430807,202004,43,24,19,25080,19855,44935
430810,202004,73,45,28,48070,29260,77330
430820,202004,146,87,59,90915,61655,152570
430825,202004,10,8,2,8360,2090,10450
430830,202004,237,219,18,228855.5,19855,248710.5
430840,202004,126,85,41,88825,42845,131670
430843,202004,6,4,2,4180,2090,6270
430845,202004,72,41,31,42845,32395,75240
430850,202004,586,412,174,430540,181830,612370
430860,202004,160,101,59,106590,61655,168245
430865,202004,71,40,31,41800,32395,74195
430870,202004,78,63,15,66880,15675,82555
430880,202004,151,113,38,119130,39710,158840
430885,202004,8,6,2,6270,2090,8360
430890,202004,345,208,137,217360,144210,361570
430900,202004,503,353,150,368885,157795,526680
430905,202004,116,49,67,51205,71060,122265
430910,202004,281,154,127,163020,132715,295735
430912,202004,5,5,0,5225,0,5225
430915,202004,34,29,5,30305,5225,35530
430920,202004,4257,2285,1972,2391029.66,2072235,4463264.66
430925,202004,4,3,1,3135,1045,4180
430930,202004,2091,1217,874,1274902.25,920645,2195547.25
430940,202004,258,167,91,174515,95095,269610
430950,202004,151,125,26,130625,27170,157795
430955,202004,23,12,11,12540,11495,24035
430957,202004,17,15,2,15675,2090,17765
430960,202004,245,167,78,174515,81510,256025
430965,202004,115,72,43,75240,44935,120175
430970,202004,82,69,13,72105,13585,85690
430975,202004,42,38,4,39710,4180,43890
430980,202004,46,29,17,30305,17765,48070
430990,202004,111,86,25,89870,26125,115995
430995,202004,115,109,6,113905,6270,120175
431000,202004,299,141,158,147346.1,166155,313501.1
431010,202004,354,203,151,213180,158840,372020
431020,202004,1863,1084,779,1133825.5,819280,1953105.5
431030,202004,41,34,7,35530,7315,42845
431033,202004,394,191,203,200640,212135,412775
431036,202004,12,7,5,7315,5225,12540
431040,202004,140,85,55,88825,57475,146300
431041,202004,40,27,13,28215.5,13585,41800.5
431043,202004,44,26,18,27170,18810,45980
431046,202004,10,6,4,6270,4180,10450
431050,202004,200,128,72,133760,75240,209000
431053,202004,69,41,28,42845,29260,72105
431055,202004,62,42,20,43890,20900,64790
431057,202004,18,18,0,18810,0,18810
431060,202004,1615,1050,565,1099341.34,591470.75,1690812.09
431065,202004,17,11,6,11495,7315,18810
431070,202004,63,57,6,60610,6270,66880
431075,202004,7,7,0,7315,0,7315
431080,202004,133,82,51,85690,53295,138985
431085,202004,33,30,3,31350,3135,34485
431087,202004,14,12,2,12540,2090,14630
431090,202004,55,43,12,44935,12540,57475
431100,202004,1208,731,477,764941.55,498465,1263406.55
431110,202004,230,140,90,146300,94050.5,240350.5
431112,202004,28,16,12,16720,12540,29260
431113,202004,33,24,9,25080,9405,34485
431115,202004,153,108,45,113905,47025,160930
431120,202004,603,360,243,377245,256025,633270
431123,202004,3,2,1,2090,1045,3135
431125,202004,95,86,9,89870,9405,99275
431127,202004,10,5,5,5225,5225,10450
431130,202004,686,452,234,474430,245575,720005
431140,202004,751,517,234,545490.5,244530,790020.5
431142,202004,26,22,4,24035.67,4180,28215.67
431150,202004,195,149,46,155705,48070,203775
431160,202004,50,45,5,47025,5225,52250
431162,202004,5,4,1,4180,1045,5225
431164,202004,5,5,0,5225,0,5225
431170,202004,105,83,22,86735,22990,109725
431171,202004,69,41,28,42845,29260,72105
431173,202004,1,1,0,1045,0,1045
431175,202004,198,102,96,106590.5,100320,206910.5
431177,202004,81,58,23,60610,24035,84645
431179,202004,12,10,2,11495,2090,13585
431180,202004,433,261,172,275880,180785,456665
431190,202004,77,59,18,61655,18810,80465
431198,202004,75,55,20,57475,20900,78375
431200,202004,21,17,4,17765,4180,21945
431205,202004,20,19,1,19855,1045,20900
431210,202004,96,59,37,61655,38665,100320
431213,202004,30,26,4,28215,4180,32395
431215,202004,21,18,3,18810,3135,21945
431217,202004,4,3,1,3135,1045,4180
431220,202004,66,57,9,59565.87,9405,68970.87
431225,202004,146,95,51,99275,53295,152570
431230,202004,100,86,14,89870,14630,104500
431235,202004,7,7,0,7315,0,7315
431237,202004,22,16,6,16720,6270,22990
431238,202004,9,6,3,6270,3135,9405
431240,202004,1000,639,361,668869.66,378290,1047159.66
431242,202004,38,37,1,38665,1045,39710
431244,202004,13,9,4,9405,4180,13585
431245,202004,48,36,12,37620,14630,52250
431247,202004,10,7,3,7315,3135,10450
431250,202004,281,145,136,151525,142120,293645
431260,202004,58,45,13,47025,13585,60610
431261,202004,17,11,6,11495,6270,17765
431262,202004,17,16,1,16720,1045,17765
431265,202004,149,80,69,83600,72105,155705
431267,202004,17,15,2,15675,2090,17765
431270,202004,321,262,59,273790,61655,335445
431275,202004,37,34,3,35530,3135,38665
431280,202004,19,15,4,15675,4180,19855
431290,202004,23,21,2,21945,3135,25080
431295,202004,2,2,0,2090,0,2090
431300,202004,19,17,2,17765,2090,19855
431301,202004,6,6,0,6270,0,6270
431303,202004,57,38,19,39710,19855,59565
431306,202004,238,127,111,132528.99,115995,248523.99
431308,202004,7,5,2,5225,2090,7315
431310,202004,65,54,11,56430,11495,67925
431320,202004,143,85,58,88825,60610,149435
431330,202004,171,111,60,115995,62700,178695
431333,202004,24,20,4,20900,4180,25080
431335,202004,10,6,4,6270,4180,10450
431337,202004,349,157,192,164065,201685,365750
431339,202004,21,18,3,18810,3135,21945
431340,202004,2989,1650,1339,1732528.67,1401346.25,3133874.92
431342,202004,36,23,13,24035,13585,37620
431344,202004,18,18,0,18810,0,18810
431346,202004,5,5,0,5225,0,5225
431349,202004,34,30,4,31350,4180,35530
431350,202004,927,536,391,563255.75,409640.38,972896.13
431360,202004,47,40,7,41800,7315,49115
431365,202004,331,157,174,165110,182875,347985
431370,202004,1331,778,553,813010.5,578930,1391940.5
431380,202004,96,83,13,86735,13585,100320
431390,202004,496,266,230,277970,241395,519365
431395,202004,289,128,161,133760,169290,303050
431400,202004,42,29,13,30305,13585,43890
431402,202004,102,71,31,75240,32395,107635
431403,202004,25,14,11,14630,11495,26125
431405,202004,663,362,301,378290.25,315590,693880.25
431406,202004,29,25,4,26125,4180,30305
431407,202004,55,43,12,44935,12540,57475
431410,202004,3382,2067,1315,2164195.5,1379400.75,3543596.25
431413,202004,15,12,3,12540,3135,15675
431415,202004,71,51,20,53295,20900,74195
431417,202004,23,12,11,12540,11495,24035
431420,202004,316,215,101,226765,105545,332310
431430,202004,48,22,26,22990,27170,50160
431440,202004,8843,6167,2676,6451838.15,2800601.76,9252439.91
431442,202004,30,14,16,14630,16720,31350
431445,202004,23,21,2,21945,2090,24035
431446,202004,4,4,0,4180,0,4180
431447,202004,83,59,24,61655,25080,86735
431449,202004,54,47,7,49115,7315,56430
431450,202004,408,275,133,287375,138985,426360
431454,202004,0,,,,,0.0
431455,202004,53,41,12,42845,12540,55385
431460,202004,519,357,162,373065,169290,542355
431470,202004,118,90,28,94050,29260,123310
431475,202004,11,9,2,9405,2090,11495
431477,202004,35,24,11,26125,12540,38665
431478,202004,9,8,1,8360,1045,9405
431480,202004,507,306,201,319770,210045,529815
431490,202004,28455,16024,12431,16781665.59,13021749,29803414.59
431500,202004,75,61,14,63745,14630,78375
431505,202004,26,16,10,16720,10450,27170
431507,202004,10,8,2,8360,2090,10450
431510,202004,257,182,75,190190.25,78375,268565.25
431513,202004,24,21,3,21945,3135,25080
431514,202004,6,5,1,5225,1045,6270
431515,202004,82,68,14,72105,14630,86735
431517,202004,4,3,1,3135,1045,4180
431520,202004,39,34,5,35530,5225,40755
431530,202004,1458,663,795,694925,832865,1527790
431531,202004,24,23,1,24035,1045,25080
431532,202004,33,24,9,26125,9405,35530
431535,202004,27,16,11,16720,11495,28215
431540,202004,137,116,21,122265,21945,144210
431545,202004,14,12,2,12540,2090,14630
431550,202004,351,196,155,204820,163020,367840
431555,202004,13,13,0,13585,0,13585
431560,202004,4520,3099,1421,3246818.85,1488080,4734898.85
431570,202004,818,428,390,448306,408595,856901
431575,202004,39,22,17,22990,17765,40755
431580,202004,96,64,32,66880,33440,100320
431590,202004,143,122,21,127490,21945,149435
431595,202004,18,15,3,15675,3135,18810
431600,202004,243,140,103,147345,108680,256025
431610,202004,114,83,31,86735,32395,119130
431620,202004,43,36,7,37620,7315,44935
431630,202004,126,106,20,110770,20900,131670
431640,202004,1329,850,479,889295.5,500555.5,1389851.0
431642,202004,36,34,2,35530,2090,37620
431643,202004,44,21,23,21945,24035,45980
431645,202004,321,190,131,199595,136895,336490
431647,202004,9,9,0,9405,0,9405
431650,202004,33,23,10,24035,10450,34485
431660,202004,320,207,113,216315,118085,334400
431670,202004,226,103,123,107635,128535,236170
431673,202004,3,3,0,3135,0,3135
431675,202004,27,21,6,21945,6270,28215
431680,202004,1102,813,289,853765,302005,1155770
431690,202004,4703,2842,1861,2973028.1,1952061,4925089.1
431695,202004,22,16,6,16720,6270,22990
431697,202004,1,0,1,0,1045,1045
431700,202004,176,137,39,143165,40755,183920
431710,202004,3976,1749,2227,1835020.5,2331395,4166415.5
431720,202004,1317,814,503,851153,525635,1376788
431725,202004,1,1,0,1045,0,1045
431730,202004,1160,793,367,831822.9,385605,1217427.9
431740,202004,1336,659,677,688655,708510.5,1397165.5
431750,202004,1812,1187,625,1242505.55,657305,1899810.55
431755,202004,5,4,1,4180,1045,5225
431760,202004,1027,655,372,686567,389785,1076352
431770,202004,412,299,113,312455,118085,430540
431775,202004,30,22,8,22990,8360,31350
431780,202004,542,333,209,350075,218405,568480
431790,202004,164,127,37,132715,38665,171380
431795,202004,12,10,2,10450,2090,12540
431800,202004,3239,1703,1536,1781727.7,1611391,3393118.7
431805,202004,18,16,2,16720,2090,18810
431810,202004,595,395,200,412775,210045,622820
431820,202004,325,197,128,205865,135850,341715
431830,202004,2313,1391,922,1453595.42,965580,2419175.42
431840,202004,484,322,162,336490,169290,505780
431842,202004,36,29,7,30305,7315,37620
431843,202004,10,8,2,8360,2090,10450
431844,202004,16,13,3,13585,3135,16720
431845,202004,27,24,3,25080,3135,28215
431846,202004,26,22,4,22990,4180,27170
431848,202004,11,9,2,9405,2090,11495
431849,202004,8,6,2,6270,2090,8360
431850,202004,790,646,144,675070,150480,825550
431860,202004,110,74,36,77330,37620,114950
431861,202004,7,2,5,2090,5225,7315
431862,202004,55,37,18,38665,19855,58520
431870,202004,3469,2014,1455,2110900.5,1523610,3634510.5
431880,202004,917,672,245,702240,257070,959310
431890,202004,1288,782,506,820325.5,529815,1350140.5
431900,202004,179,128,51,133760,54340,188100
431910,202004,54,39,15,41800,15675,57475
431912,202004,42,25,17,26125,17765,43890
431915,202004,121,94,27,98230,28215,126445
431920,202004,154,112,42,118085,43890,161975
431930,202004,80,65,15,67925,15675,83600
431935,202004,3,3,0,3135,0,3135
431936,202004,12,11,1,11495,1045,12540
431937,202004,17,13,4,13585,4180,17765
431940,202004,461,309,152,322905,158840.25,481745.25
431950,202004,499,313,186,328130.5,196460,524590.5
431960,202004,728,400,328,418000.5,343805,761805.5
431970,202004,70,63,7,65835,7315,73150
431971,202004,3,3,0,3135,0,3135
431973,202004,21,17,4,17765,4180,21945
431975,202004,9,8,1,8360,1045,9405
431980,202004,212,133,79,138985,82555,221540
431990,202004,1143,615,528,642607.52,553850,1196457.52
432000,202004,1692,901,791,942591.75,831821,1774412.75
432010,202004,277,189,88,198550,91960,290510
432020,202004,169,141,28,147345,29260,176605
432023,202004,15,13,2,13585,2090,15675
432026,202004,67,62,5,64790,5225,70015
432030,202004,70,36,34,37620,35530,73150
432032,202004,20,16,4,16720,4180,20900
432035,202004,53,43,10,44935,10450,55385
432040,202004,97,67,30,71060,31350,102410
432045,202004,5,4,1,4180,1045,5225
432050,202004,81,48,33,50160,34485,84645
432055,202004,119,87,32,90915,33440,124355
432057,202004,6,5,1,5225.5,1045,6270.5
432060,202004,34,31,3,32395,3135,35530
432065,202004,33,29,4,30305,4180,34485
432067,202004,90,81,9,84645,9405,94050
432070,202004,393,302,91,317942.5,95095,413037.5
432080,202004,809,565,244,591470,258115,849585
432085,202004,12,8,4,8360,4180,12540
432090,202004,264,179,85,188100,88825,276925
432100,202004,174,115,59,120175,62700,182875
432110,202004,566,381,185,399190,193325,592515
432120,202004,934,549,385,575795,403370,979165
432130,202004,495,355,140,372020,147345,519365
432132,202004,23,20,3,20900,3135,24035
432135,202004,80,66,14,70015,14630,84645
432140,202004,262,205,57,214225,59565,273790
432143,202004,204,130,74,135850,77330,213180
432145,202004,276,189,87,201685,90915,292600
432146,202004,14,13,1,13585,1045,14630
432147,202004,97,55,42,57475,43890,101365
432149,202004,15,10,5,10450,5225,15675
432150,202004,878,534,344,560120.5,361570,921690.5
432160,202004,1475,760,715,795245.22,748220,1543465.22
432162,202004,4,3,1,3135,1045,4180
432163,202004,19,14,5,14630,5225,19855
432166,202004,115,83,32,86997.5,33440,120437.5
432170,202004,225,115,110,120175,114950,235125
432180,202004,540,337,203,353210,212135.5,565345.5
432183,202004,7,7,0,7315,0,7315
432185,202004,77,68,9,71060,9405,80465
432190,202004,475,280,195,293645,204820,498465
432195,202004,86,72,14,75240,14630,89870
432200,202004,401,256,145,267520,152570,420090
432210,202004,120,76,44,79420,45980,125400
432215,202004,44,40,4,41800,4180,45980
432218,202004,20,19,1,19855,1045,20900
432220,202004,669,349,320,364705,336490.29,701195.29
432225,202004,14,8,6,8360,6270,14630
432230,202004,132,92,40,96140,41800,137940
432232,202004,12,11,1,11495,1045,12540
432234,202004,3,2,1,2090,1045,3135
432235,202004,3,3,0,3135,0,3135
432237,202004,28,16,12,16720,12540,29260
432240,202004,4311,2421,1890,2534126,1976096.5,4510222.5
432250,202004,1102,720,382,753445,401280,1154725
432252,202004,43,40,3,41800,3135,44935
432253,202004,61,49,12,51205,12540,63745
432254,202004,26,11,15,11495,15675,27170
432255,202004,13,12,1,12540,1045,13585
432260,202004,814,640,174,669845.5,181830,851675.5
432270,202004,241,182,59,190190,61655,251845
432280,202004,140,106,34,111815,36575,148390
432285,202004,2,2,0,2090,0,2090
432290,202004,67,59,8,61655,8360,70015
432300,202004,4644,2558,2086,2683492.07,2187186.27,4870678.34
432310,202004,128,104,24,108680,25080,133760
432320,202004,22,17,5,17765,5225,22990
432330,202004,17,12,5,12540,5225,17765
432335,202004,8,6,2,6270,2090,8360
432340,202004,38,33,5,34485,5225,39710
432345,202004,101,69,32,72105,33440,105545
432350,202004,20,19,1,19855,1045,20900
432360,202004,6,5,1,5225,1045,6270
432370,202004,25,24,1,25080,1045,26125
432375,202004,30,27,3,28215,3135,31350
432377,202004,8,8,0,9405,0,9405
432380,202004,166,78,88,82555,91960,174515
500020,202004,240,132,108,138985,112860,251845
500025,202004,135,68,67,71060,70015,141075
500060,202004,1448,905,543,947815,569525.5,1517340.5
500070,202004,800,380,420,398145.29,440990,839135.29
500080,202004,132,102,30,107635,31350,138985
500085,202004,136,112,24,117040.5,25080,142120.5
500090,202004,345,154,191,160930,199595,360525
500100,202004,720,374,346,393965,366796,760761
500110,202004,2257,1046,1211,1095161,1269675.75,2364836.75
500124,202004,263,148,115,154660,120175,274835
500150,202004,340,135,205,141075,214225,355300
500190,202004,521,353,168,368885,175560.5,544445.5
500200,202004,187,162,25,169290.2,26125,195415.2
500210,202004,1542,539,1003,564300,1049180.25,1613480.25
500215,202004,242,138,104,144210,108680,252890
500220,202004,747,481,266,502645.77,277970,780615.77
500230,202004,240,154,86,160930,89870,250800
500240,202004,679,468,211,490105.4,221540,711645.4
500260,202004,589,226,363,236170,380380,616550
500270,202004,29768,12709,17059,13305349.27,17875775.75,31181125.02
500280,202004,202,69,133,72105,138985,211090
500290,202004,1177,710,467,744040.5,489060,1233100.5
500295,202004,443,285,158,298870.5,165110,463980.5
500310,202004,75,24,51,25080,53295,78375
500315,202004,724,423,301,443080,314545,757625
500320,202004,3639,1791,1848,1875776.04,1939520,3815296.04
500325,202004,934,509,425,532951,445170.5,978121.5
500330,202004,1477,687,790,717915.5,827640,1545555.5
500345,202004,310,235,75,247665.5,78375,326040.5
500348,202004,249,148,101,154660,105545,260205
500350,202004,117,55,62,58520,64790,123310
500370,202004,5580,2509,3071,2627131,3216511.5,5843642.5
500375,202004,342,241,101,251845,106590,358435
500380,202004,589,338,251,353210,263340,616550
500390,202004,78,37,41,38665,42845,81510
500400,202004,213,141,72,148390,75240,223630
500410,202004,545,225,320,235125,334400,569525
500430,202004,518,368,150,385605,156750,542355
500440,202004,195,102,93,107635,97185,204820
500450,202004,393,172,221,179740,231990,411730
500460,202004,274,145,129,151525.5,134805,286330.5
500470,202004,429,340,89,356345.5,95095,451440.5
500480,202004,107,63,44,66880,45980,112860
500490,202004,109,46,63,48070,65835,113905
500500,202004,1445,523,922,546535,965580,1512115
500510,202004,43,35,8,36575,8360,44935
500515,202004,103,72,31,75240,32395,107635
500520,202004,325,173,152,180785,158840.5,339625.5
500525,202004,89,48,41,50160,42845,93005
500540,202004,890,376,514,395010,538175.5,933185.5
500560,202004,927,523,404,546535,423226,969761
500568,202004,979,556,423,583110,444125.5,1027235.5
500570,202004,1199,688,511,720005.5,535040,1255045.5
500580,202004,341,173,168,180785,175560,356345
500600,202004,328,161,167,169290,174515,343805
500620,202004,899,635,264,666710.42,276925,943635.42
500625,202004,78,61,17,63745,17765,81510
500627,202004,21,10,11,10450,11495,21945
500630,202004,1564,860,704,898702.54,739860.5,1638563.04
500635,202004,520,307,213,320815,223630,544445
500640,202004,382,203,179,212135,189145,401280
500660,202004,5482,2016,3466,2111945.5,3629286.5,5741232.0
500690,202004,592,207,385,216315,403370,619685
500710,202004,400,205,195,214225,204820,419045
500720,202004,960,547,413,573705.73,432630,1006335.73
500730,202004,194,117,77,122265,80465,202730
500740,202004,891,375,516,392920,539220,932140
500750,202004,141,44,97,45980,102410,148390
500755,202004,125,89,36,93005.5,38665,131670.5
500769,202004,745,411,334,430540.5,350075,780615.5
500770,202004,399,215,184,224675,192280,416955
500780,202004,154,102,52,106590,54340.5,160930.5
500790,202004,1073,543,530,567435,555940,1123375
500793,202004,277,151,126,157795,131670.5,289465.5
500795,202004,168,116,52,121220,54340,175560
500797,202004,52,37,15,38665,15675,54340
500800,202004,422,186,236,195415,246620,442035
500830,202004,2219,1238,981,1294755,1027235,2321990
500840,202004,138,103,35,107635,36575,144210
510010,202004,170,91,79,95095,82555,177650
510020,202004,499,222,277,231990,293645,525635
510025,202004,1685,960,725,1003200.2,759715.5,1762915.7
510030,202004,668,345,323,361570,339625.5,701195.5
510035,202004,125,61,64,63745,66880,130625
510040,202004,398,179,219,187055,229900.3,416955.3
510050,202004,408,217,191,226765,200640.73,427405.73
510060,202004,122,61,61,63745,63745,127490
510080,202004,233,87,146,90915,152570,243485
510100,202004,66,28,38,29260,39710,68970
510120,202004,38,23,15,24035,15675,39710
510125,202004,382,237,145,247665,152570,400235
510130,202004,557,322,235,336490,246620.5,583110.5
510140,202004,427,125,302,131670,315590,447260
510160,202004,113,37,76,38665,79420,118085
510170,202004,805,490,315,515185.03,329175,844360.03
510180,202004,2927,1385,1542,1448371,1614526.25,3062897.25
510185,202004,20,8,12,8360,12540,20900
510190,202004,233,84,149,88825,155705,244530
510250,202004,2573,1510,1063,1583175.5,1115016,2698191.5
510260,202004,176,129,47,134805,49115,183920
510263,202004,472,265,207,276925.5,216315,493240.5
510267,202004,676,379,297,398145.5,311410,709555.5
510268,202004,61,27,34,28215,35530,63745
510269,202004,74,35,39,36575,40755,77330
510270,202004,389,196,193,204820,201685,406505
510279,202004,213,159,54,166155,56430,222585
510285,202004,185,74,111,77330,115995,193325
510300,202004,518,274,244,287375,254980,542355
510305,202004,206,98,108,103455,112860,216315
510310,202004,102,53,49,55385,51205,106590
510320,202004,843,526,317,550715,331265,881980
510325,202004,405,172,233,179740,243485,423225
510330,202004,425,234,191,245575,199595,445170
510335,202004,636,361,275,378290,287375,665665
510336,202004,54,39,15,40755,15675,56430
510337,202004,107,46,61,48070,63745,111815
510340,202004,17370,7922,9448,8297302.29,9891971.75,18189274.04
510343,202004,64,46,18,49115,18810,67925
510345,202004,161,104,57,108680,59565.5,168245.5
510350,202004,644,360,284,376200,296780.5,672980.5
510360,202004,200,121,79,126445,83600,210045
510370,202004,148,72,76,75240,79420,154660
510380,202004,86,64,22,66880,22990,89870
510385,202004,61,26,35,27170,37620,64790
510390,202004,106,47,59,49115,61655,110770
510395,202004,46,33,13,34485,13585,48070
510410,202004,718,466,252,486970,263340,750310
510420,202004,577,278,299,290510,312455,602965
510450,202004,47,24,23,25080,24035,49115
510452,202004,49,23,26,24035,27170,51205
510454,202004,50,24,26,25080,27170,52250
510455,202004,131,77,54,80465,56430,136895
510460,202004,175,86,89,89870.75,93005,182875.75
510480,202004,721,423,298,442035.2,312455,754490.2
510490,202004,349,178,171,187055,179740,366795
510500,202004,235,175,60,182875,62700,245575
510510,202004,784,461,323,481745.5,338580,820325.5
510515,202004,1195,631,564,659395,589380,1248775
510517,202004,253,108,145,112860,152570.5,265430.5
510520,202004,231,151,80,157795,83600,241395
510523,202004,98,74,24,77330,25080,102410
510525,202004,804,473,331,498465,346940,845405
510530,202004,21,15,6,15675,6270,21945
510550,202004,254,113,141,118085,147345,265430
510558,202004,292,143,149,149435,156750,306185
510560,202004,412,243,169,253935.5,176605,430540.5
510562,202004,643,465,178,485925,187055,672980
510590,202004,763,393,370,410685,386650,797335
510600,202004,244,129,115,135850,120175,256025
510610,202004,202,84,118,87780,123310,211090
510615,202004,183,81,102,84645,106590,191235
510617,202004,18,11,7,11495,7315,18810
510618,202004,116,55,61,57475,63745,121220
510619,202004,97,69,28,72105,29260,101365
510620,202004,169,95,74,99275,77330,176605
510621,202004,177,116,61,121220,63745,184965
510622,202004,495,303,192,317680,200640,518320
510623,202004,328,225,103,235125,108680,343805
510624,202004,89,45,44,48070,48070,96140
510625,202004,532,326,206,340670,215270.29,555940.29
510626,202004,111,69,42,73150,43890,117040
510627,202004,70,48,22,50160,22990,73150
510628,202004,151,91,60,95095,62700,157795
510629,202004,261,161,100,169290,104500,273790
510630,202004,443,226,217,236170,229900,466070
510631,202004,13,3,10,3135,10450,13585
510637,202004,349,201,148,210045,155705,365750
510642,202004,984,533,451,556985,471295,1028280
510645,202004,1,0,1,0,1045,1045
510650,202004,1427,933,494,974985.5,517275,1492260.5
510665,202004,79,37,42,38665,43890,82555
510670,202004,60,34,26,35530,27170,62700
510675,202004,1140,717,423,750310.5,442035,1192345.5
510677,202004,346,178,168,186010,175560,361570
510680,202004,105,60,45,62700,47025,109725
510682,202004,201,101,100,105545,104500,210045
510685,202004,54,40,14,41800,14630,56430
510700,202004,590,334,256,350075,268565,618640
510704,202004,1148,605,543,632225,568480,1200705
510706,202004,135,68,67,71060,70015,141075
510710,202004,381,266,115,277970,121220,399190
510715,202004,59,43,16,44935,16720,61655
510718,202004,211,105,106,109725,110770,220495
510719,202004,39,17,22,17765,22990,40755
510720,202004,190,130,60,135850,62700,198550
510724,202004,89,35,54,36575,56430,93005
510726,202004,49,25,24,26125,25080,51205
510729,202004,69,31,38,32395,39710,72105
510730,202004,472,262,210,273790,219450,493240
510735,202004,118,48,70,50160,73150,123310
510740,202004,22,11,11,11495,11495,22990
510757,202004,19,15,4,15675,4180,19855
510760,202004,7174,3698,3476,3867546.5,3641826.75,7509373.25
510770,202004,687,321,366,336490,384560,721050
510774,202004,19,7,12,7315,12540,19855
510775,202004,105,80,25,83600,26125,109725
510776,202004,29,10,19,10450,19855,30305
510777,202004,193,83,110,86735,115995,202730
510779,202004,51,23,28,24035,29260,53295
510780,202004,288,158,130,165110,135850,300960
510785,202004,392,213,179,222585,188100,410685
510787,202004,191,93,98,97185,102410,199595
510788,202004,3,0,3,0,3135,3135
510790,202004,2468,1297,1171,1356459.75,1228920,2585379.75
510792,202004,1148,645,503,675070,525635.66,1200705.66
510794,202004,113,59,54,61655,56430,118085
510795,202004,2351,1363,988,1426425.5,1035596,2462021.5
510800,202004,173,103,70,107635,73150,180785
510805,202004,177,117,60,122265,62700,184965
510810,202004,98,43,55,44935,57475,102410
510820,202004,237,118,119,124355.45,125400.12,249755.57
510830,202004,70,42,28,43890,29260,73150
510835,202004,15,10,5,10450,5225,15675
510840,202004,9152,4372,4780,4571878,5004505.5,9576383.5
510850,202004,216,86,130,89870,135850,225720
510860,202004,380,172,208,179740,217360.5,397100.5
510880,202004,66,50,16,52250,16720,68970
510885,202004,74,41,33,42845,34485,77330
510890,202004,66,39,27,40755,28215,68970
510895,202004,182,106,76,110770,79420.5,190190.5
520005,202004,103,49,54,51205,56430,107635
520010,202004,277,127,150,132715,156750.5,289465.5
520013,202004,704,451,253,471295,265430,736725
520015,202004,54,40,14,41800,14630,56430
520017,202004,86,48,38,50160.5,39710,89870.5
520020,202004,19,10,9,10450,9405,19855
520025,202004,2208,1142,1066,1197571,1116060,2313631
520030,202004,788,416,372,434720,389785,824505
520050,202004,69,49,20,51205,20900,72105
520055,202004,48,29,19,30305,19855,50160
520060,202004,171,114,57,119130,59565,178695
520080,202004,577,410,167,428450,174515,602965
520082,202004,19,13,6,13585,6270,19855
520085,202004,94,70,24,73150,25080,98230
520090,202004,91,62,29,64790,30305,95095
520110,202004,9203,3940,5263,4121481.5,5513422,9634903.5
520120,202004,14,8,6,8360,6270,14630
520130,202004,790,553,237,578930,248710.5,827640.5
520140,202004,11949,6640,5309,6955522.5,5557311.3,12512833.8
520145,202004,53,32,21,33440,21945,55385
520150,202004,165,131,34,137940,35530,173470
520160,202004,36,26,10,27170,10450,37620
520170,202004,252,145,107,151525,112860,264385
520180,202004,160,77,83,80465,86735,167200
520215,202004,203,134,69,140030,72105,212135
520235,202004,78,59,19,61655,19855,81510
520250,202004,130,77,53,80465,55385,135850
520260,202004,116,73,43,76285,44935,121220
520280,202004,48,32,16,33440,16720,50160
520310,202004,39,26,13,27170,13585,40755
520320,202004,169,108,61,112860,63745,176605
520330,202004,784,414,370,432630,386650,819280
520340,202004,347,204,143,213180,149435,362615
520350,202004,513,236,277,246620,289465,536085
520355,202004,89,53,36,55385,37620,93005
520357,202004,23,17,6,18810,6270,25080
520360,202004,1,1,0,1045,0,1045
520380,202004,137,73,64,76285,66880,143165
520390,202004,262,109,153,113905.5,159885,273790.5
520393,202004,15,11,4,11495,4180,15675
520396,202004,78,48,30,50160,31350,81510
520400,202004,203,120,83,126445,86735,213180
520410,202004,194,95,99,100320,103455,203775
520420,202004,20,13,7,13585,7315,20900
520425,202004,289,142,147,148390,153615,302005
520430,202004,475,245,230,256121.14,240350.25,496471.39
520440,202004,670,475,195,498465,203775,702240
520450,202004,1954,855,1099,894520,1149500,2044020
520455,202004,51,32,19,34485,19855,54340
520460,202004,34,20,14,20900,14630,35530
520465,202004,30,26,4,27170,4180,31350
520470,202004,429,272,157,284240,165110,449350
520480,202004,79,48,31,50160,32395,82555
520485,202004,117,40,77,41800,81510.5,123310.5
520490,202004,410,303,107,317680,111815,429495
520495,202004,163,98,65,102410,68970,171380
520500,202004,181,140,41,146300,42845,189145
520505,202004,183,104,79,108680,82555,191235
520510,202004,1807,859,948,897655.5,991707.25,1889362.75
520520,202004,41,30,11,31350,11495,42845
520530,202004,228,174,54,181830,56430,238260
520540,202004,567,391,176,408595,183920,592515
520545,202004,132,81,51,84645,54340,138985
520547,202004,55,32,23,33440,24035,57475
520549,202004,1216,572,644,598785.3,674025,1272810.3
520551,202004,294,156,138,163020,145255.5,308275.5
520552,202004,39,26,13,27170,13585,40755
520570,202004,16,10,6,10450,6270,16720
520580,202004,282,174,108,182875,112860,295735
520590,202004,152,94,58,98230,60610,158840
520620,202004,1146,530,616,555940.5,643720.25,1199660.75
520630,202004,38,22,16,22990,16720,39710
520640,202004,387,225,162,235125,169290,404415
520650,202004,67,37,30,38665,32395,71060
520660,202004,44,23,21,24035,21945,45980
520670,202004,35,29,6,30305,6270,36575
520680,202004,50,34,16,35530,17765,53295
520690,202004,38,11,27,11495,28215,39710
520710,202004,33,30,3,31350,3135,34485
520725,202004,185,134,51,140030,53295,193325
520735,202004,55,37,18,38665,18810,57475
520740,202004,418,199,219,209000,228855,437855
520750,202004,36,25,11,26125,11495,37620
520753,202004,60,41,19,42845,19855,62700
520760,202004,101,68,33,71060,34485,105545
520780,202004,287,213,74,222585,77330,299915
520790,202004,154,86,68,89870,71060,160930
520800,202004,3414,1843,1571,1929070.5,1642740.2,3571810.7
520810,202004,158,119,39,125400,40755,166155
520815,202004,5,4,1,4180,1045,5225
520830,202004,147,101,46,105545,48070,153615
520840,202004,348,229,119,239305,124355,363660
520850,202004,102,62,40,64790,41800,106590
520860,202004,1727,1112,615,1163085.5,644765.5,1807851.0
520870,202004,31761,15041,16720,15750248.97,17522568,33272816.97
520880,202004,1159,620,539,651035.5,565345.5,1216381.0
520890,202004,789,475,314,497420,329175,826595
520910,202004,971,518,453,542355.93,473385,1015740.93
520915,202004,97,73,24,76285,25080,101365
520920,202004,414,199,215,207955,224675,432630
520929,202004,17,16,1,16720,1045,17765
520940,202004,72,49,23,51205,24035,75240
520945,202004,18,12,6,12540,6270,18810
520960,202004,45,30,15,31350,15675,47025
520970,202004,337,206,131,215270,136895,352165
520980,202004,94,68,26,71060,27170,98230
520990,202004,450,306,144,319770,150480,470250
520993,202004,129,61,68,63745,72105,135850
520995,202004,246,142,104,148390.65,109725.5,258116.15
521000,202004,1545,904,641,945725,674025.5,1619750.5
521010,202004,670,324,346,338580.63,361570,700150.63
521015,202004,14,9,5,9405,5225,14630
521020,202004,1423,1004,419,1050225,440990.5,1491215.5
521030,202004,49,32,17,34485,17765,52250
521040,202004,949,597,352,627000.25,369930.5,996930.75
521056,202004,46,32,14,33440,14630,48070
521060,202004,130,86,44,89870,45980,135850
521080,202004,429,328,101,342760.5,106590,449350.5
521090,202004,539,343,196,359480,205865,565345
521100,202004,275,206,69,215270,72105,287375
521120,202004,1062,745,317,779570.5,332310,1111880.5
521130,202004,351,252,99,263340,104500.5,367840.5
521140,202004,179,97,82,101365,85690,187055
521150,202004,2664,1159,1505,1212200.5,1578995,2791195.5
521160,202004,31,16,15,16720,15675,32395
521170,202004,207,114,93,120175,97185,217360
521180,202004,1181,751,430,785840,450395.25,1236235.25
521190,202004,2534,1065,1469,1117105,1539285.5,2656390.5
521200,202004,55,41,14,42845,14630,57475
521205,202004,11,8,3,8360,3135,11495
521210,202004,124,73,51,76285,53295,129580
521220,202004,790,548,242,573705,252890.25,826595.25
521225,202004,34,22,12,22990,12540,35530
521230,202004,105,69,36,72105,37620,109725
521250,202004,6199,3504,2695,3672134.8,2824638,6496772.8
521260,202004,27,14,13,14630,13585,28215
521270,202004,144,112,32,117040,33440,150480
521280,202004,430,260,170,272745,177650,450395
521290,202004,27,12,15,12540,15675,28215
521295,202004,97,63,34,65835,35530,101365
521300,202004,213,114,99,119130,103455.5,222585.5
521305,202004,37,25,12,26125,12540,38665
521308,202004,1078,822,256,861080,268565,1129645
521310,202004,1330,761,569,795245,597740.5,1392985.5
521340,202004,19,15,4,15675,4180,19855
521350,202004,125,93,32,97185,33440,130625
521370,202004,172,120,52,125400,54340,179740
521375,202004,172,93,79,97185,83600,180785
521377,202004,45,34,11,35530,11495,47025
521380,202004,1046,662,384,691791.05,404415,1096206.05
521385,202004,13,8,5,8360,5225,13585
521390,202004,100,81,19,84645,19855,104500
521400,202004,340,225,115,235125,120175,355300
521405,202004,140,76,64,79420,66880,146300
521410,202004,66,44,22,45980,22990,68970
521440,202004,188,140,48,146300,50160,196460
521450,202004,725,408,317,426360,333355,759715
521460,202004,1159,738,421,771210,439945,1211155
521470,202004,12,8,4,8360,4180,12540
521480,202004,43,30,13,31350,13585.25,44935.25
521483,202004,312,182,130,190190.5,136895,327085.5
521486,202004,280,182,98,190190,102410,292600
521487,202004,23,11,12,11495,12540,24035
521490,202004,26,14,12,14630,12540,27170
521500,202004,114,74,40,77330,43890,121220
521520,202004,44,31,13,32395,13585,45980
521523,202004,704,415,289,434720,303050,737770
521525,202004,47,30,17,31350,17765,49115
521530,202004,248,133,115,138985,120175,259160
521540,202004,28,15,13,15675,13585,29260
521550,202004,87,37,50,38665,52250,90915
521560,202004,811,550,261,577885.5,272745.75,850631.25
521565,202004,57,37,20,38665,20900,59565
521570,202004,527,348,179,364705.5,187055.25,551760.75
521580,202004,58,33,25,34485,26125,60610
521590,202004,37,18,19,18810,19855,38665
521600,202004,22,12,10,12540,10450,22990
521630,202004,242,128,114,133760,119130.25,252890.25
521640,202004,299,161,138,170335,144210,314545
521645,202004,29,16,13,16720,13585,30305
521680,202004,230,142,88,148390,91960,240350
521690,202004,2,2,0,2090,0,2090
521710,202004,1156,552,604,577885,634315,1212200
521720,202004,540,372,168,388740,176605.85,565345.85
521730,202004,637,308,329,321861,343805,665666
521740,202004,904,386,518,403370,544445.5,947815.5
521760,202004,1892,989,903,1035003.78,946770.5,1981774.28
521770,202004,826,521,305,545490,319770,865260
521800,202004,1995,1273,722,1332376.5,759715,2092091.5
521805,202004,32,18,14,18810,14630,33440
521810,202004,86,54,32,56430,33440,89870
521830,202004,942,673,269,703285.09,282150,985435.09
521839,202004,86,53,33,55385,34485,89870
521850,202004,1098,578,520,604010.36,545490.5,1149500.86
521860,202004,341,214,127,223630,133760,357390
521870,202004,73,43,30,44935,31350,76285
521878,202004,33,16,17,16720,17765,34485
521880,202004,4735,2113,2622,2212266.5,2747307.5,4959574.0
521890,202004,598,427,171,446215,178695,624910
521900,202004,281,230,51,241395,53295,294690
521910,202004,161,113,48,119130,50160,169290
521920,202004,45,21,24,21945,25080,47025
521925,202004,50,27,23,28215,24035,52250
521930,202004,1162,646,516,675070.5,539220.5,1214291.0
521935,202004,35,25,10,26125,10450,36575
521940,202004,200,99,101,103455,106590,210045
521945,202004,16,14,2,14630,2090,16720
521950,202004,9,5,4,5225,4180,9405
521960,202004,69,52,17,54340,18810,73150
521970,202004,394,254,140,265430,148390,413820
521971,202004,94,48,46,50160,48070,98230
521973,202004,32,17,15,17765,15675,33440
521975,202004,1410,704,706,735680.41,740906.47,1476586.88
521980,202004,240,161,79,169115.83,82555,251670.83
521990,202004,77,54,23,56430,24035,80465
522000,202004,285,178,107,185645.29,111815,297460.29
522005,202004,19,11,8,11495,8360,19855
522010,202004,1130,631,499,662530,524590,1187120
522015,202004,62,38,24,39710,25080,64790
522020,202004,876,502,374,524590,392920.5,917510.5
522026,202004,21,13,8,13585,8360,21945
522028,202004,16,12,4,12540,4180,16720
522040,202004,785,319,466,333355.25,486970,820325.25
522045,202004,2319,1421,898,1491216.25,939456.25,2430672.50
522050,202004,157,77,80,81510,84645,166155
522060,202004,539,341,198,357390,206910,564300
522068,202004,114,80,34,83600,35530,119130
522070,202004,10,10,0,10450,0,10450
522100,202004,39,21,18,21945,18810,40755
522108,202004,44,32,12,33440,12540,45980
522119,202004,51,26,25,27170,26125,53295
522130,202004,79,32,47,33440,49115,82555
522140,202004,4043,2089,1954,2187186.1,2048200.5,4235386.6
522145,202004,49,34,15,35530,15675,51205
522150,202004,89,65,24,67925,25080,93005
522155,202004,53,34,19,35530,19855,55385
522157,202004,6,3,3,3135,3135,6270
522160,202004,1684,996,688,1042910,718960,1761870
522170,202004,396,267,129,279015,134805,413820
522180,202004,41,19,22,19855,22990,42845
522185,202004,2062,819,1243,856901,1301025,2157926
522190,202004,47,26,21,27170,21945,49115
522200,202004,296,174,122,181830,127490,309320
522205,202004,146,100,46,104500,48070,152570
522220,202004,154,110,44,114950,45980,160930
522230,202004,33,26,7,27170,7315,34485
530010,202004,54507,27558,26949,28851870.81,28227556.6,57079427.41
110001,202005,504,402,102,420090,107635,527725
110002,202005,2793,1714,1079,1795310.5,1131735.5,2927046.0
110003,202005,87,73,14,76285,14630,90915
110004,202005,2009,1307,702,1369996.5,735680,2105676.5
110005,202005,446,352,94,367840.5,98230,466070.5
110006,202005,445,342,103,357390.5,107635,465025.5
110007,202005,67,56,11,58520,11495,70015
110008,202005,236,134,102,140030,107635,247665
110009,202005,860,613,247,640585,258115,898700
110010,202005,1766,1068,698,1121285.5,731500,1852785.5
110011,202005,1762,1369,393,1431650,410685,1842335
110012,202005,4090,2370,1720,2478740,1802625.5,4281365.5
110013,202005,769,612,157,640585,165110,805695
110014,202005,373,324,49,338580.5,52250,390830.5
110015,202005,1378,1108,270,1157861.66,283195,1441056.66
110018,202005,1100,683,417,713735,435765,1149500
110020,202005,15592,8897,6695,9314093.16,7012997.1,16327090.26
110025,202005,617,452,165,473385.5,172425,645810.5
110026,202005,37,27,10,28215,10450,38665
110028,202005,1630,1177,453,1231010.85,473386.5,1704397.35
110029,202005,137,123,14,129580,14630,144210
110030,202005,2430,1613,817,1688553.22,856901.35,2545454.57
110032,202005,305,234,71,246620.17,74195,320815.17
110033,202005,653,481,172,503690,180785,684475
110034,202005,356,265,91,276925.67,96140,373065.67
110037,202005,98,85,13,88825,13585,102410
110040,202005,368,253,115,265430,120175,385605
110045,202005,923,634,289,665666,303050.1,968716.1
110050,202005,90,78,12,81510.5,12540,94050.5
110060,202005,69,39,30,40755,31350,72105
110070,202005,108,70,38,73150,39710,112860
110080,202005,455,251,204,264385,214225,478610
110090,202005,30,25,5,26125,5225,31350
110092,202005,95,49,46,52250,49115,101365
110094,202005,196,139,57,145255,59565,204820
110100,202005,36,29,7,30305,7315,37620
110110,202005,81,45,36,47025,37620,84645
110120,202005,70,58,12,61655,12540,74195
110130,202005,290,236,54,246620,56430,303050
110140,202005,240,165,75,172425,78375,250800
110143,202005,47,39,8,40755,8360,49115
110145,202005,25,20,5,20900,5225,26125
110146,202005,23,12,11,12540,11495,24035
110147,202005,37,26,11,27170,11495,38665
110148,202005,34,23,11,24035,11495,35530
110149,202005,306,213,93,222585,97185,319770
110150,202005,131,100,31,104500,33440,137940
110155,202005,10,8,2,8360,2090,10450
110160,202005,67,53,14,55385,14630,70015
110170,202005,212,167,45,175560,47025,222585
110175,202005,68,51,17,53295,17765,71060
110180,202005,90,76,14,79420,14630,94050
120001,202005,204,152,52,159885,54340,214225
120005,202005,196,112,84,117040,88825,205865
120010,202005,1090,681,409,711645.72,429495,1141140.72
120013,202005,145,99,46,103455,48070,151525
120017,202005,104,57,47,59565,49115,108680
120020,202005,3533,2846,687,2974071.18,717915.5,3691986.68
120025,202005,535,306,229,319770.77,242440,562210.77
120030,202005,1064,908,156,949906.36,163020,1112926.36
120032,202005,37,35,2,36575,2090,38665
120033,202005,214,188,26,196460,27170,223630
120034,202005,164,120,44,125400,45980,171380
120035,202005,37,30,7,31350,7315,38665
120038,202005,401,257,144,269610,150480,420090
120039,202005,29,28,1,29260,1045,30305
120040,202005,13992,9540,4452,9984281.02,4669060,14653341.02
120042,202005,43,40,3,41800,3135,44935
120043,202005,11,3,8,3135,8360,11495
120045,202005,549,352,197,368885,205865,574750
120050,202005,1278,977,301,1020965.69,317680,1338645.69
120060,202005,1461,1196,265,1249820,277970,1527790
120070,202005,435,309,126,322905.82,131670,454575.82
120080,202005,170,103,67,107635,70015,177650
130002,202005,148,106,42,110770,43890,154660
130006,202005,98,63,35,65835,36575,102410
130008,202005,132,71,61,74195,63745,137940
130010,202005,143,81,62,84645,64790,149435
130014,202005,274,196,78,204820,81510,286330
130020,202005,101,61,40,63745,41800,105545
130030,202005,958,570,388,595650,405460,1001110
130040,202005,336,165,171,172425,179740.4,352165.4
130050,202005,573,295,278,308275,291555,599830
130060,202005,861,585,276,612370,290510,902880
130063,202005,592,338,254,355300,267520,622820
130068,202005,189,120,69,125400,72105,197505
130070,202005,1331,906,425,947815,446215,1394030
130080,202005,705,461,244,482790,254980,737770
130083,202005,71,39,32,40755,33440,74195
130090,202005,338,170,168,177650,176605,354255
130100,202005,1108,477,631,500555,674025,1174580
130110,202005,736,307,429,324995,449350,774345
130115,202005,160,67,93,70015,97185,167200
130120,202005,1633,1037,596,1087845,628045,1715890
130130,202005,618,420,198,438900,206910,645810
130140,202005,1492,1147,345,1200705,361570,1562275
130150,202005,417,364,53,380380,55385,435765
130160,202005,456,264,192,275880,200640,476520
130165,202005,52,42,10,43890,10450,54340
130170,202005,968,663,305,692768.12,318725,1011493.12
130180,202005,224,166,58,173470,60610,234080
130185,202005,2350,1091,1259,1143230,1324016,2467246
130190,202005,3437,2148,1289,2247795.2,1355365,3603160.2
130195,202005,277,220,57,229900,59565,289465
130200,202005,185,83,102,86735,107635,194370
130210,202005,78,39,39,40755,40755,81510
130220,202005,181,123,58,128535,60610,189145
130230,202005,387,248,139,259160,146300,405460
130240,202005,1338,834,504,872575.5,529815,1402390.5
130250,202005,4743,3026,1717,3164260,1800535,4964795
130255,202005,433,206,227,215270,237215,452485
130260,202005,57139,26927,30212,28210744.52,31770094.5,59980839.02
130270,202005,1530,1027,503,1073309.05,525635,1598944.05
130280,202005,124,70,54,73150,56430,129580
130290,202005,2122,1482,640,1548690,669845,2218535
130300,202005,430,302,128,315590,133760,449350
130310,202005,914,478,436,499510,457710,957220
130320,202005,513,273,240,285285,252890,538175
130330,202005,749,469,280,490105,293645,783750
130340,202005,3528,2015,1513,2110901,1584220.5,3695121.5
130350,202005,479,318,161,332310,168245,500555
130353,202005,944,400,544,420090,571615,991705
130356,202005,813,365,448,383515,471295,854810
130360,202005,86,64,22,66880,22990,89870
130370,202005,711,548,163,573705,170335,744040
130380,202005,685,526,159,549670,167200,716870
130390,202005,493,396,97,415910,102410,518320
130395,202005,165,37,128,38665,133760,172425
130400,202005,66,44,22,45980,22990,68970
130406,202005,2098,1263,835,1321925.5,879890,2201815.5
130410,202005,442,202,240,211090,250800,461890
130420,202005,2972,2402,570,2510090.75,598785,3108875.75
130423,202005,154,79,75,82555,79420,161975
130426,202005,150,81,69,84645,72105,156750
130430,202005,410,256,154,267520,160930,428450
130440,202005,197,66,131,68970,136895,205865
140002,202005,30,10,20,10450,20900,31350
140005,202005,199,120,79,125400,83600,209000
140010,202005,10461,6663,3798,6978515.4,3986677.15,10965192.55
140015,202005,130,55,75,57475,78375,135850
140017,202005,126,82,44,85690,47025,132715
140020,202005,475,310,165,323950,173470,497420
140023,202005,49,22,27,22990.35,28215,51205.35
140028,202005,20,11,9,11495,9405,20900
140030,202005,347,243,104,254980,108680,363660
140040,202005,62,41,21,42845,21945,64790
140045,202005,253,99,154,104500,160930,265430
140047,202005,625,404,221,423225.5,231990,655215.5
140050,202005,155,93,62,97185,64790,161975
140060,202005,46,32,14,33440,14630,48070
140070,202005,33,31,2,32395,2090,34485
150010,202005,4686,2854,1832,2984520.5,1917575,4902095.5
150013,202005,160,109,51,113905,53295,167200
150020,202005,1081,577,504,604010,526680,1130690
150030,202005,675,280,395,292600,413820,706420
150034,202005,195,124,71,129580,74195,203775
150040,202005,1466,842,624,879890,652080,1531970
150050,202005,663,378,285,396055,297825,693880
150060,202005,4867,3076,1791,3223737.75,1877252.63,5100990.38
150070,202005,332,146,186,152570,194370,346940
150080,202005,15151,7134,8017,7468617.7,8403893,15872510.7
150085,202005,425,265,160,276925,167200,444125
150090,202005,740,622,118,649990,123310,773300
150095,202005,359,221,138,230945,144210,375155
150100,202005,60,38,22,39710,24035.5,63745.5
150110,202005,181,86,95,89870,99275,189145
150120,202005,413,300,113,313500,118085,431585
150125,202005,48,18,30,18810,32395,51205
150130,202005,2009,1057,952,1106655,996930,2103585
150140,202005,54913,24846,30067,26011103.75,31522432.71,57533536.46
150145,202005,197,105,92,109725,96140,205865
150150,202005,2949,1289,1660,1350140,1738881,3089021
150157,202005,390,275,115,287375.5,120175,407550.5
150160,202005,131,100,31,104500,32395,136895
150170,202005,3625,2678,947,2801645,992750,3794395
150172,202005,335,230,105,240350,109725,350075
150175,202005,78,47,31,49115,32395,81510
150178,202005,781,513,268,537130,280060,817190
150180,202005,3176,1553,1623,1622885.25,1698125.5,3321010.75
150190,202005,345,215,130,224675,135850,360525
150195,202005,109,57,52,59565,54340,113905
150200,202005,192,91,101,95095,105545,200640
150210,202005,3122,2494,628,2609365,657305,3266670
150215,202005,559,357,202,374110,211090,585200
150220,202005,3630,2428,1202,2538306.32,1257135.6,3795441.92
150230,202005,1186,950,236,992750.37,246620,1239370.37
150240,202005,6316,3607,2709,3775585.85,2842400,6617985.85
150250,202005,40,18,22,18810,22990,41800
150260,202005,87,55,32,57475,33440,90915
150270,202005,2248,1453,795,1519430,831820.5,2351250.5
150275,202005,530,330,200,344850,210045,554895
150276,202005,108,42,66,44935,70015,114950
150277,202005,767,330,437,344850,456665,801515
150280,202005,327,210,117,219450,123310,342760
150285,202005,101,51,50,53295,52250,105545
150290,202005,1022,608,414,635360,432630.5,1067990.5
150293,202005,663,308,355,321860,370975,692835
150295,202005,493,225,268,235125,280060.5,515185.5
150300,202005,82,38,44,39710,45980,85690
150304,202005,173,104,69,108680,72105,180785
150307,202005,397,328,69,343805,72105,415910
150309,202005,575,410,165,429495,173470,602965
150310,202005,238,157,81,164065,84645,248710
150320,202005,1912,1334,578,1395075,606100,2001175
150330,202005,2015,1162,853,1215335,892430,2107765
150340,202005,197,132,65,137940,67925,205865
150345,202005,630,348,282,364705,297825,662530
150350,202005,409,319,90,333355,94050,427405
150360,202005,4689,2897,1792,3034680.75,1877865,4912545.75
150370,202005,821,558,263,584155,274835,858990
150375,202005,192,90,102,94050,106590,200640
150380,202005,1484,983,501,1027235,525635,1552870
150390,202005,793,457,336,478610,352165,830775
150400,202005,107,89,18,93005,18810,111815
150405,202005,1245,790,455,825550,476520,1302070
150410,202005,122,80,42,83600,43890,127490
150420,202005,7365,3973,3392,4159271.5,3555090.5,7714362.0
150430,202005,599,385,214,402325,223630,625955
150440,202005,554,333,221,347985,230945,578930
150442,202005,2303,1218,1085,1273856,1139050,2412906
150445,202005,543,348,195,363660,204820,568480
150450,202005,230,123,107,128535,111815,240350
150460,202005,730,546,184,571615,192280,763895
150470,202005,1309,782,527,818235,550715,1368950
150475,202005,229,173,56,180785,58520,239305
150480,202005,1315,906,409,946770,427405,1374175
150490,202005,601,335,266,350075,277970,628045
150495,202005,331,244,87,254980,91960,346940
150497,202005,285,193,92,201685,96140,297825
150500,202005,218,135,83,143165,86735,229900
150503,202005,1035,509,526,531905.5,552805,1084710.5
150506,202005,925,611,314,638495,328130,966625
150510,202005,1243,688,555,718960.5,582065,1301025.5
150520,202005,273,180,93,188100,97185,285285
150530,202005,1716,937,779,979165.75,814055,1793220.75
150540,202005,226,164,62,171380,64790,236170
150543,202005,821,426,395,445170,412775,857945
150548,202005,469,331,138,345895,144210,490105
150549,202005,61,42,19,43890,19855,63745
150550,202005,2925,1473,1452,1540330.25,1523610,3063940.25
150553,202005,3369,1914,1455,2005356.5,1522565,3527921.5
150555,202005,142,77,65,80465,67925,148390
150560,202005,30,14,16,14630,16720,31350
150563,202005,93,47,46,49115,48070,97185
150565,202005,184,110,74,114950,78375,193325
150570,202005,404,263,141,274835,147345,422180
150580,202005,1630,765,865,799425,904970,1704395
150590,202005,805,526,279,550715,292600,843315
150600,202005,474,282,192,294690,200640,495330
150610,202005,141,119,22,124355,22990,147345
150611,202005,122,83,39,86735,40755,127490
150613,202005,3225,1922,1303,2010580,1369995.5,3380575.5
150616,202005,520,301,219,315590,228855,544445
150618,202005,1319,697,622,728365,649990,1378355
150619,202005,389,296,93,309320,98230,407550
150620,202005,1254,732,522,765985,546535,1312520
150630,202005,311,196,115,204820,120175,324995
150635,202005,463,190,273,198550,285285,483835
150640,202005,55,27,28,28215,29260,57475
150650,202005,2370,1363,1007,1428515.5,1057540.5,2486056.0
150655,202005,241,182,59,190190,61655,251845
150658,202005,88,48,40,50160,43890,94050
150660,202005,532,346,186,361570,195415,556985
150670,202005,1072,372,700,389785,733590,1123375
150680,202005,10065,5263,4802,5506106.19,5031675.5,10537781.69
150690,202005,18,9,9,9405,9405,18810
150700,202005,479,313,166,328130,174515,502645
150710,202005,280,151,129,157795,134805,292600
150715,202005,811,501,310,524590,327085,851675
150720,202005,407,315,92,329175,96140,425315
150730,202005,1013,511,502,533995,525635,1059630
150740,202005,228,152,76,158840,79420,238260
150745,202005,805,439,366,459800,383515,843315
150746,202005,62,36,26,37620,28215,65835
150747,202005,233,177,56,186010,58520,244530
150750,202005,138,76,62,79420,64790,144210
150760,202005,1817,1176,641,1228920.62,672980,1901900.62
150770,202005,392,214,178,223630,187055,410685
150775,202005,98,46,52,48070,54340,102410
150780,202005,192,110,82,114950,85690,200640
150790,202005,835,457,378,479655,396055,875710
150795,202005,1528,901,627,941545,655215,1596760
150796,202005,360,208,152,217360,159885,377245
150797,202005,325,160,165,167200,172425,339625
150800,202005,1467,847,620,886160,648945,1535105
150803,202005,547,443,104,462935,108680,571615
150805,202005,200,121,79,126445,82555,209000
150808,202005,986,533,453,558030,474430,1032460
150810,202005,3289,2242,1047,2346025.97,1094115.5,3440141.47
150812,202005,438,224,214,234080,223630,457710
150815,202005,1028,640,388,668800,405460,1074260
150820,202005,1546,918,628,960355,657305,1617660
150830,202005,739,545,194,569525,202730,772255
150835,202005,204,117,87,122265,90915,213180
150840,202005,1380,844,536,883025,560120,1443145
160005,202005,59,40,19,41800,19855,61655
160010,202005,198,126,72,131670,75240,206910
160015,202005,130,73,57,76285,60610,136895
160020,202005,131,74,57,77330,59565,136895
160021,202005,59,28,31,29260,32395,61655
160023,202005,68,45,23,47025,25080,72105
160025,202005,26,11,15,11495,15675,27170
160027,202005,1514,852,662,892430.25,692835,1585265.25
160030,202005,15970,8157,7813,8532428.1,8190710.71,16723138.81
160040,202005,297,171,126,178695,131670,310365
160050,202005,722,358,364,374110,381425,755535
160053,202005,288,167,121,174515.5,126445,300960.5
160055,202005,29,20,9,20900,9405,30305
160060,202005,6587,3454,3133,3611521.25,3282345.5,6893866.75
160070,202005,177,104,73,108680,76285,184965
160080,202005,109,50,59,52250,61655,113905
170025,202005,30,17,13,17765,13585,31350
170030,202005,212,172,40,180785.62,41800,222585.62
170035,202005,228,108,120,112860,125400,238260
170040,202005,184,139,45,145255.08,47025,192280.08
170070,202005,317,194,123,202730,128535,331265
170100,202005,356,258,98,269610,102410,372020
170105,202005,56,45,11,47025,11495,58520
170110,202005,114,72,42,75240,44935,120175
170130,202005,69,33,36,34485,37620.5,72105.5
170190,202005,97,59,38,61655,40755,102410
170200,202005,375,258,117,269610,122265,391875
170210,202005,6117,3216,2901,3362811.88,3041997.43,6404809.31
170215,202005,116,47,69,49115,72105,121220
170220,202005,1389,1019,370,1065900,387695,1453595
170230,202005,147,96,51,100320,53295,153615
170240,202005,528,354,174,369930,181830,551760
170255,202005,1089,881,208,921690,219450,1141140
170270,202005,44,31,13,32395,13585,45980
170290,202005,117,79,38,82555,39710,122265
170300,202005,94,61,33,63745,34485,98230
170305,202005,49,37,12,38665,12540,51205
170307,202005,64,49,15,51205,15675,66880
170310,202005,114,62,52,64790,54340,119130
170320,202005,26,17,9,17765,9405,27170
170330,202005,24,22,2,22990,2090,25080
170360,202005,29,18,11,18810,11495,30305
170370,202005,98,45,53,47025,55385,102410
170380,202005,74,56,18,58520,18810,77330
170382,202005,44,36,8,37620,8360,45980
170384,202005,143,109,34,114950,36575,151525
170386,202005,64,25,39,26125,40755,66880
170388,202005,48,18,30,18810,31350,50160
170389,202005,26,21,5,21945,5225,27170
170390,202005,69,39,30,40755,31350,72105
170410,202005,32,24,8,25080,8360,33440
170460,202005,17,12,5,12540,5225,17765
170510,202005,34,27,7,28215,7315,35530
170550,202005,1549,902,647,942590,678205,1620795
170555,202005,114,80,34,83600,35530,119130
170560,202005,101,70,31,73150,32395,105545
170600,202005,34,15,19,15675,19855,35530
170610,202005,197,104,93,108680,97185.5,205865.5
170625,202005,36,20,16,20900,16720,37620
170650,202005,80,58,22,60610,22990,83600
170700,202005,581,439,142,458755.25,148390,607145.25
170710,202005,159,98,61,102410,63745,166155
170720,202005,89,71,18,74195,18810,93005
170730,202005,82,48,34,50160,37620,87780
170740,202005,83,60,23,62700,24035,86735
170755,202005,65,34,31,35530,32395,67925
170765,202005,141,75,66,78375,68970,147345
170770,202005,208,130,78,135850,81510,217360
170820,202005,595,396,199,414865,210045.5,624910.5
170825,202005,33,17,16,17765,16720,34485
170830,202005,82,68,14,71060,14630,85690
170900,202005,182,142,40,149435,41800,191235
170930,202005,905,472,433,493240.8,453530.5,946771.3
170950,202005,3134,1422,1712,1488080,1791130.88,3279210.88
170980,202005,16,10,6,10450,6270,16720
171050,202005,144,114,30,120175,31350,151525
171070,202005,36,31,5,32395,5225,37620
171090,202005,43,31,12,32395,12540,44935
171110,202005,22,15,7,15675,7315,22990
171150,202005,40,20,20,20900,20900,41800
171180,202005,27,14,13,14630,13585,28215
171190,202005,151,85,66,88825,68970,157795
171195,202005,66,55,11,57475,11495,68970
171200,202005,49,25,24,26125,26125,52250
171215,202005,4,3,1,3135,1045,4180
171240,202005,59,42,17,43890,17765,61655
171245,202005,56,48,8,50160,8360,58520
171250,202005,73,40,33,41800,34485,76285
171270,202005,14,10,4,10450,4180,14630
171280,202005,43,37,6,38665,6270,44935
171320,202005,987,571,416,597740,434720,1032460
171330,202005,423,209,214,220495,223630,444125
171360,202005,86,62,24,64790,25080,89870
171370,202005,36,17,19,17765,19855,37620
171380,202005,132,111,21,115995,21945,137940
171395,202005,54,33,21,34485,21945,56430
171420,202005,283,181,102,189145,106590,295735
171430,202005,70,58,12,60610,13585,74195
171488,202005,177,98,79,102410,82555,184965
171500,202005,57,32,25,33440,26125,59565
171510,202005,71,44,27,45980,28215,74195
171515,202005,41,34,7,35530,7315,42845
171525,202005,30,28,2,29260,2090,31350
171550,202005,13,9,4,9405,4180,13585
171570,202005,52,27,25,29260,26125,55385
171575,202005,309,201,108,211090,113905,324995
171610,202005,1771,892,879,935275,919600,1854875
171620,202005,140,96,44,100320,45980,146300
171630,202005,60,31,29,32395,30305,62700
171650,202005,279,187,92,195415,98230,293645
171660,202005,270,151,119,157795,124355.5,282150.5
171665,202005,63,43,20,44935,20900,65835
171670,202005,425,249,176,260205.25,186010,446215.25
171700,202005,65,59,6,61655,6270,67925
171720,202005,28,10,18,10450,18810,29260
171750,202005,103,52,51,54340,53295,107635
171780,202005,73,58,15,60610,15675,76285
171790,202005,77,67,10,70015,10450,80465
171800,202005,33,25,8,26125,8360,34485
171820,202005,2110,1205,905,1260270.46,947815.5,2208085.96
171830,202005,34,26,8,27170,8360,35530
171840,202005,63,41,22,42845,22990,65835
171845,202005,31,20,11,20900,11495,32395
171850,202005,39,28,11,30305,12540,42845
171855,202005,77,60,17,62700,17765,80465
171865,202005,7,6,1,6270,1045,7315
171870,202005,31,22,9,22990,9405,32395
171875,202005,77,53,24,55385,25080,80465
171880,202005,35,23,12,24035,12540,36575
171884,202005,52,27,25,28215,26125,54340
171886,202005,136,55,81,57475,85690,143165
171888,202005,26,20,6,20900,6270,27170
171889,202005,19,13,6,13585,6270,19855
171890,202005,56,48,8,50160,8360,58520
171900,202005,34,24,10,25080,10450,35530
172000,202005,41,32,9,33440,9405,42845
172010,202005,52,41,11,42845,11495,54340
172015,202005,28,17,11,17765.45,11495,29260.45
172020,202005,143,89,54,93005,56430,149435
172025,202005,36,22,14,22990,14630,37620
172030,202005,43,24,19,25080,19855,44935
172049,202005,84,56,28,58520,29260,87780
172065,202005,140,90,50,94050,52250,146300
172080,202005,105,69,36,72105,37620,109725
172085,202005,28,14,14,15675,14630,30305
172090,202005,428,327,101,342760.03,105545,448305.03
172093,202005,17,15,2,15675,2090,17765
172097,202005,19,12,7,12540,7315.5,19855.5
172100,202005,5072,2869,2203,3003331.47,2307360.7,5310692.17
172110,202005,80,50,30,52250,31350,83600
172120,202005,1660,1393,267,1455688.11,279015,1734703.11
172125,202005,5,4,1,4180,1045,5225
172130,202005,20,13,7,13585,7315,20900
172208,202005,201,123,78,128535,81510,210045
172210,202005,390,186,204,194370,213180,407550
210005,202005,2984,1873,1111,1958330.15,1163090.5,3121420.65
210010,202005,162,91,71,95095,74195,169290
210015,202005,39,29,10,30305,10450,40755
210020,202005,345,197,148,205865,156750,362615
210030,202005,327,212,115,221540,121220,342760
210040,202005,139,111,28,115995,29260,145255
210043,202005,250,186,64,194370,66880,261250
210047,202005,522,309,213,322905,222585,545490
210050,202005,287,211,76,220495,79420,299915
210055,202005,48,37,11,38665,11495,50160
210060,202005,549,438,111,457710,115995,573705
210070,202005,409,312,97,326040,102410,428450
210080,202005,119,108,11,112860,11495,124355
210083,202005,303,148,155,154660.5,161975,316635.5
210087,202005,2,1,1,1045,1045,2090
210090,202005,446,321,125,336490,130625,467115
210095,202005,438,332,106,346940,110770,457710
210100,202005,698,544,154,569525,160930,730455
210110,202005,129,81,48,84645,51205,135850
210120,202005,5051,3924,1127,4104762.35,1179805.12,5284567.47
210125,202005,198,121,77,126445,80465,206910
210130,202005,478,272,206,284240,215270,499510
210135,202005,27,19,8,19855,8360,28215
210140,202005,4379,3419,960,3575990,1006335,4582325
210150,202005,379,241,138,251845,144210,396055
210160,202005,3281,2779,502,2905101.36,525635,3430736.36
210170,202005,1153,926,227,968715,238260,1206975
210173,202005,126,111,15,115995,15675,131670
210177,202005,365,204,161,213180,169290,382470
210180,202005,32,17,15,17765,15675,33440
210190,202005,421,283,138,295735,144210,439945
210193,202005,1,1,0,1045,0,1045
210197,202005,74,54,20,56430,20900,77330
210200,202005,619,509,110,531905,114950,646855
210203,202005,227,153,74,159885,78375,238260
210207,202005,365,298,67,311410,70015,381425
210210,202005,754,696,58,727320,60610,787930
210215,202005,73,65,8,67925,8360,76285
210220,202005,391,330,61,345895,63745,409640
210230,202005,311,248,63,259160,65835,324995
210232,202005,1381,938,443,980210,465025,1445235
210235,202005,168,127,41,132715,42845,175560
210237,202005,35,22,13,24035,13585,37620
210240,202005,86,73,13,76285,13585,89870
210250,202005,182,156,26,163020,27170,190190
210255,202005,354,266,88,277970,93005,370975
210260,202005,393,271,122,283195,127490,410685
210270,202005,645,431,214,450395,223630,674025
210275,202005,72,55,17,57475,17765,75240
210280,202005,1052,699,353,731500.7,369930,1101430.7
210290,202005,538,360,178,376200,186010,562210
210300,202005,5339,3355,1984,3509110.93,2077460,5586570.93
210310,202005,112,77,35,80465,36575,117040
210312,202005,116,80,36,83600,37620,121220
210315,202005,106,84,22,87780,22990,110770
210317,202005,127,96,31,100320,32395,132715
210320,202005,2332,1978,354,2068055,372020,2440075
210325,202005,139,88,51,91960.5,53295.5,145256.0
210330,202005,4545,2599,1946,2718045.75,2037750,4755795.75
210340,202005,1254,937,317,979165,334400.5,1313565.5
210350,202005,629,527,102,550715,106590,657305
210355,202005,150,122,28,127490,29260,156750
210360,202005,2233,1544,689,1614525,724185,2338710
210370,202005,1219,594,625,620730,654170,1274900
210375,202005,185,95,90,99275,94050,193325
210380,202005,711,543,168,567435,175560,742995
210390,202005,189,161,28,168245,29260,197505
210400,202005,395,343,52,358435,54340,412775
210405,202005,992,687,305,718960,319770,1038730
210407,202005,51,41,10,42845,10450,53295
210408,202005,60,53,7,56430,7315,63745
210409,202005,325,282,43,294690,44935,339625
210410,202005,440,342,98,358435,102410,460845
210420,202005,202,167,35,175560,36575,212135
210430,202005,51,34,17,35530,17765,53295
210440,202005,336,227,109,237215,113905,351120
210450,202005,143,113,30,118085,31350,149435
210455,202005,231,122,109,127490.5,113905,241395.5
210460,202005,306,206,100,215270,105545,320815
210462,202005,65,54,11,56430,11495,67925
210465,202005,142,109,33,113905,34485,148390
210467,202005,536,392,144,410685,150480,561165
210470,202005,50,43,7,44935,7315,52250
210480,202005,1265,907,358,947815,374110,1321925
210490,202005,202,136,66,143165,68970,212135
210500,202005,510,309,201,322905,210045,532950
210510,202005,559,442,117,461890,122265,584155
210515,202005,370,229,141,240350,147345,387695
210520,202005,402,362,40,378290,41800,420090
210530,202005,9391,4947,4444,5179025.55,4657568.08,9836593.63
210535,202005,128,96,32,100320,33440,133760
210540,202005,1491,988,503,1033505,526680,1560185
210542,202005,1200,615,585,642675,612371,1255046
210545,202005,17,16,1,16720,1045,17765
210547,202005,131,113,18,118085,18810,136895
210550,202005,685,496,189,518320.6,197505,715825.6
210560,202005,159,141,18,147345,18810,166155
210565,202005,21,16,5,16720,5225,21945
210570,202005,1302,1052,250,1101430.11,262295,1363725.11
210580,202005,121,103,18,107635,18810,126445
210590,202005,728,596,132,622820,137940,760760
210592,202005,37,33,4,34485,4180,38665
210594,202005,108,92,16,96140,16720,112860
210596,202005,97,81,16,84645,16720,101365
210598,202005,133,99,34,103455,35530,138985
210600,202005,321,274,47,286330,49115,335445
210610,202005,255,240,15,250800,15675,266475
210620,202005,43,28,15,29260,15675,44935
210630,202005,72,71,1,74195,1045,75240
210632,202005,1021,713,308,745085,321860,1066945
210635,202005,22,19,3,19855,3135,22990
210637,202005,109,79,30,82555,31350,113905
210640,202005,588,518,70,542355,73150,615505
210650,202005,398,332,66,346940,68970,415910
210660,202005,378,295,83,308275,87780,396055
210663,202005,35,24,11,25080,11495,36575
210667,202005,98,38,60,39710,63745,103455
210670,202005,249,221,28,230945,29260,260205
210675,202005,533,298,235,311410,246620,558030
210680,202005,236,143,93,149435,97185,246620
210690,202005,622,513,109,536085,113905,649990
210700,202005,161,122,39,127490,40755,168245
210710,202005,246,156,90,163020,94050,257070
210720,202005,130,116,14,121220,14630,135850
210725,202005,67,59,8,61655,8360,70015
210730,202005,25,18,7,18810,7315,26125
210735,202005,286,201,85,210045,88825.5,298870.5
210740,202005,526,454,72,474430,75240,549670
210745,202005,154,114,40,119130,41800,160930
210750,202005,2374,1211,1163,1265495.25,1219516,2485011.25
210760,202005,257,196,61,204820,63745,268565
210770,202005,382,300,82,314545,86735,401280
210780,202005,446,332,114,346940,120175,467115
210790,202005,184,151,33,157795,34485,192280
210800,202005,174,133,41,138985,42845,181830
210805,202005,52,47,5,49115,5225,54340
210810,202005,463,372,91,388740,95095,483835
210820,202005,2121,1759,362,1841290.9,378290,2219580.9
210825,202005,153,88,65,91960,68970,160930
210830,202005,725,482,243,503690,254980,758670
210840,202005,196,137,59,143165,61655,204820
210845,202005,233,166,67,173470,70015,243485
210850,202005,757,516,241,542355,251845,794200
210860,202005,3721,2096,1625,2190320.25,1700215,3890535.25
210870,202005,430,338,92,354255,96140,450395
210880,202005,73,55,18,57475,18810,76285
210890,202005,318,275,43,288420,44935,333355
210900,202005,626,407,219,426360,228855,655215
210905,202005,63,32,31,33440,32395,65835
210910,202005,1957,1477,480,1548691.06,501600,2050291.06
210920,202005,165,64,101,66880,106590,173470
210923,202005,80,63,17,65835,17765,83600
210927,202005,400,186,214,194370,223630,418000
210930,202005,74,59,15,61655,15675,77330
210940,202005,83,65,18,67925,18810,86735
210945,202005,192,101,91,105545,95095,200640
210950,202005,536,389,147,406505,153615,560120
210955,202005,80,52,28,54340,29260,83600
210960,202005,2169,1086,1083,1135132,1135915,2271047
210970,202005,116,102,14,107635,14630,122265
210975,202005,79,73,6,76285,6270,82555
210980,202005,1075,520,555,543400,579975.5,1123375.5
210990,202005,4052,2675,1377,2797465,1443145,4240610
211000,202005,1318,1065,253,1112925.5,264385,1377310.5
211003,202005,1003,715,288,748220,300960,1049180
211010,202005,497,443,54,462935,56430,519365
211020,202005,1458,617,841,645810,880935,1526745
211023,202005,33,30,3,31350,3135,34485
211027,202005,70,52,18,54340,18810,73150
211030,202005,370,262,108,273790,112860,386650
211040,202005,300,250,50,261250.5,52250,313500.5
211050,202005,1155,766,389,800470,406505.5,1206975.5
211060,202005,635,550,85,574750.5,88825.46,663575.96
211065,202005,21,17,4,18810,4180,22990
211070,202005,897,744,153,777481.15,160930,938411.15
211080,202005,87,83,4,86735,4180,90915
211085,202005,55,28,27,29260,28215,57475
211090,202005,88,72,16,75240,16720,91960
211100,202005,490,406,84,424270,87780.5,512050.5
211102,202005,249,176,73,183920,76285,260205
211105,202005,218,154,64,161975,67925,229900
211107,202005,130,82,48,85690,50160,135850
211110,202005,817,531,286,554895,298870,853765
211120,202005,5346,2652,2694,2777611.05,2821500.4,5599111.45
211125,202005,34,25,9,26125,9405,35530
211130,202005,41675,19066,22609,19969955.6,23721503.25,43691458.85
211140,202005,393,342,51,358435,53295,411730
211150,202005,1210,812,398,848540,418000.5,1266540.5
211153,202005,174,105,69,109725,72105,181830
211157,202005,66,52,14,54340,14630,68970
211160,202005,705,601,104,628045,108680,736725
211163,202005,0,,,,,0.0
211167,202005,10,9,1,9405,1045,10450
211170,202005,422,314,108,329175,112860,442035
211172,202005,116,79,37,82555,38665,121220
211174,202005,251,155,96,161975,100320,262295
211176,202005,484,360,124,376200.5,131670,507870.5
211178,202005,93,61,32,63745,33440,97185
211180,202005,205,164,41,171380,42845,214225
211190,202005,72,67,5,70015,5225,75240
211195,202005,35,24,11,25080,11495,36575
211200,202005,151,129,22,134805,22990,157795
211210,202005,449,329,120,343805,125400,469205
211220,202005,4073,2364,1709,2472472.07,1792176.5,4264648.57
211223,202005,94,91,3,95095,3135,98230
211227,202005,70,55,15,57475,15675,73150
211230,202005,737,608,129,635360,134805,770165
211240,202005,405,316,89,330220,93005,423225
211245,202005,184,89,95,93005,99275,192280
211250,202005,1556,1339,217,1400300,226765,1627065
211260,202005,807,664,143,693880,149435,843315
211270,202005,1953,1601,352,1673045.5,367840.5,2040886.0
211280,202005,1737,1114,623,1164130,651035,1815165
211285,202005,201,125,76,130625,79420,210045
211290,202005,685,480,205,501600,215270,716870
211300,202005,764,607,157,635360,164065,799425
211400,202005,1525,946,579,988570,607145,1595715
220005,202005,15,14,1,14630,1045,15675
220010,202005,88,67,21,70015,21945,91960
220020,202005,697,552,145,576840,151525,728365
220025,202005,110,108,2,112860,2090,114950
220027,202005,43,35,8,36575,8360,44935
220030,202005,111,89,22,93005,22990,115995
220040,202005,1229,933,296,977075,310365,1287440
220045,202005,34,22,12,22990,12540,35530
220050,202005,675,571,104,596695.61,108680,705375.61
220060,202005,170,149,21,155705,21945,177650
220070,202005,111,101,10,105545,10450,115995
220080,202005,15,13,2,13585,2090,15675
220090,202005,33,27,6,28215,6270,34485
220095,202005,2,1,1,1045,1045,2090
220100,202005,20,16,4,16720,4180,20900
220105,202005,24,22,2,22990.5,2090,25080.5
220110,202005,221,202,19,211090,19855,230945
220115,202005,35,34,1,35530,1045,36575
220117,202005,20,19,1,19855,1045,20900
220120,202005,1479,1126,353,1178760,369930,1548690
220130,202005,31,30,1,31350,1045,32395
220140,202005,107,82,25,85690,26125,111815
220150,202005,495,363,132,379335,137940,517275
220155,202005,6,6,0,6270,0,6270
220157,202005,19,15,4,15675,4180,19855
220160,202005,88,78,10,81510,10450,91960
220170,202005,30,30,0,31350,0,31350
220173,202005,7,7,0,7315,0,7315
220177,202005,6,6,0,6270,0,6270
220180,202005,67,66,1,68970,1045,70015
220190,202005,1056,941,115,984390,120175,1104565
220191,202005,44,39,5,40755,5225,45980
220192,202005,79,76,3,79420,3135,82555
220194,202005,52,50,2,52250,2090,54340
220196,202005,98,82,16,85690,16720,102410
220198,202005,3,2,1,2090,1045,3135
220200,202005,412,345,67,360525.25,70015,430540.25
220202,202005,40,35,5,36575,5225,41800
220205,202005,51,45,6,47025,6270,53295
220207,202005,11,11,0,11495,0,11495
220208,202005,79,41,38,42845,39710,82555
220209,202005,32,29,3,30305,3135,33440
220210,202005,19,14,5,14630,5225,19855
220211,202005,29,27,2,28215,2090,30305
220213,202005,40,36,4,37620,4180.5,41800.5
220217,202005,41,32,9,33440,9405,42845
220220,202005,2162,1409,753,1473450,788975.5,2262425.5
220225,202005,10,4,6,4180,6270,10450
220230,202005,961,749,212,782705,221540,1004245
220240,202005,161,145,16,151525,16720,168245
220245,202005,33,30,3,31350.97,3135,34485.97
220250,202005,121,108,13,112860,13585,126445
220253,202005,44,37,7,38665,7315,45980
220255,202005,29,27,2,28215,2090,30305
220260,202005,697,520,177,543400,187055,730455
220265,202005,9,7,2,7315,2090,9405
220270,202005,756,679,77,709555,81510,791065
220271,202005,39,32,7,34485,7315,41800
220272,202005,25,25,0,26125,0,26125
220273,202005,17,15,2,15675,2090,17765
220275,202005,58,48,10,50160,10450,60610
220277,202005,17,14,3,14630,3135,17765
220280,202005,15,12,3,12540,3135,15675
220285,202005,44,41,3,42845,3135,45980
220290,202005,1472,1259,213,1315656,222585.25,1538241.25
220300,202005,35,34,1,35530,1045,36575
220310,202005,322,274,48,286330,50160,336490
220320,202005,443,410,33,428450.5,34485,462935.5
220323,202005,0,,,,,0.0
220325,202005,14,12,2,12540,2090,14630
220327,202005,11,11,0,11495,0,11495
220330,202005,229,166,63,173470,65835,239305
220335,202005,139,122,17,127490,17765,145255
220340,202005,40,27,13,29260,13585,42845
220342,202005,58,50,8,52250,8360,60610
220345,202005,81,74,7,77330,7315,84645
220350,202005,443,382,61,399190,63745,462935
220360,202005,41,30,11,32395,11495,43890
220370,202005,1228,1012,216,1057540,226765,1284305
220375,202005,20,18,2,18810,2090,20900
220380,202005,20,17,3,17765,3135,20900
220385,202005,15,13,2,13585,2090,15675
220390,202005,2317,1322,995,1383580.6,1041865.75,2425446.35
220400,202005,32,28,4,29260,4180,33440
220410,202005,21,18,3,18810,3135,21945
220415,202005,13,11,2,11495,2090,13585
220420,202005,126,106,20,110770,20900,131670
220430,202005,127,115,12,120175,12540,132715
220435,202005,23,16,7,16720,7315,24035
220440,202005,289,244,45,256025,47025,303050
220450,202005,328,169,159,176605,166155,342760
220455,202005,53,52,1,54340,1045,55385
220460,202005,20,19,1,19855,1045,20900
220465,202005,95,64,31,66880,32395,99275
220470,202005,244,214,30,223630,31350,254980
220480,202005,72,64,8,66880,8360,75240
220490,202005,90,77,13,80465,13585,94050
220500,202005,107,92,15,96140,15675,111815
220510,202005,419,326,93,340670,97185,437855
220515,202005,22,20,2,20900,2090,22990
220520,202005,366,329,37,344850.85,38665,383515.85
220525,202005,10,7,3,7315,3135,10450
220527,202005,20,14,6,14630,6270,20900
220530,202005,32,13,19,13585,19855,33440
220535,202005,5,4,1,4180,1045,5225
220540,202005,67,55,12,57475,12540,70015
220545,202005,40,27,13,28215,13585,41800
220550,202005,698,550,148,574750,155705,730455
220551,202005,12,9,3,9405,3135,12540
220552,202005,15,15,0,16720,0,16720
220553,202005,54,49,5,51205,5225,56430
220554,202005,10,8,2,8360,2090,10450
220555,202005,33,30,3,31350,3135,34485
220556,202005,46,44,2,45980,2090,48070
220557,202005,56,53,3,55385,3135,58520
220558,202005,8,3,5,3135,5225,8360
220559,202005,2,2,0,2090,0,2090
220560,202005,68,45,23,47025,24035,71060
220570,202005,745,459,286,479655.5,298870,778525.5
220580,202005,559,511,48,533995,51205,585200
220585,202005,7,6,1,6270,1045,7315
220590,202005,15,15,0,15675,0,15675
220595,202005,64,48,16,50160,16720,66880
220600,202005,20,12,8,12540,8360,20900
220605,202005,25,23,2,25080,2090,27170
220610,202005,72,63,9,65835,9405,75240
220620,202005,563,466,97,486970,102410,589380
220630,202005,5,4,1,4180,1045,5225
220635,202005,37,32,5,33440,5225,38665
220640,202005,105,87,18,90915,18810,109725
220650,202005,113,106,7,110770,7315,118085
220660,202005,52,41,11,42845,11495,54340
220665,202005,4,4,0,4180,0,4180
220667,202005,22,20,2,20900,2090,22990
220669,202005,27,24,3,25080,3135,28215
220670,202005,65,52,13,54340,13585,67925
220672,202005,68,46,22,48070,22990,71060
220675,202005,35,28,7,29260,7315,36575
220680,202005,38,33,5,34485,5225,39710
220690,202005,47,43,4,44935,4180,49115
220695,202005,33,16,17,16720,17765,34485
220700,202005,1697,1317,380,1378355.63,399190,1777545.63
220710,202005,5,4,1,4180,1045,5225
220720,202005,103,87,16,90915,16720,107635
220730,202005,15,15,0,15675,0,15675
220735,202005,5,1,4,1045,4180,5225
220740,202005,48,44,4,45980,4180,50160
220750,202005,110,93,17,98230,18810,117040
220755,202005,15,14,1,14630,1045,15675
220760,202005,68,62,6,64790,6270,71060
220770,202005,5568,3032,2536,3168442.01,2652210.5,5820652.51
220775,202005,18,11,7,11495,7315,18810
220777,202005,18,17,1,17765,1045,18810
220779,202005,1,0,1,0,1045,1045
220780,202005,898,766,132,800470,137940.5,938410.5
220785,202005,4,1,3,1045,3135,4180
220790,202005,1079,856,223,894520.05,234080,1128600.05
220793,202005,7,6,1,6270,1045,7315
220795,202005,14,13,1,13585,1045,14630
220800,202005,3997,3079,918,3221735.81,961400,4183135.81
220810,202005,65,57,8,59565.5,8360,67925.5
220820,202005,241,220,21,229900,21945,251845
220830,202005,1223,1053,170,1100385,177650,1278035
220840,202005,2429,1685,744,1765007.59,779570.95,2544578.54
220850,202005,53,43,10,44935,10450,55385
220855,202005,8,5,3,5225,3135,8360
220860,202005,15,12,3,12540,3135,15675
220865,202005,31,29,2,30305,2090,32395
220870,202005,73,65,8,67925,8360,76285
220880,202005,321,257,64,268565,67925,336490
220885,202005,33,30,3,31350,3135,34485
220887,202005,13,12,1,12540,1045,13585
220890,202005,97,86,11,89870,11495,101365
220900,202005,22,15,7,15675,7315,22990
220910,202005,51,42,9,43890,9405,53295
220915,202005,10,9,1,9405,1045,10450
220920,202005,52,47,5,49115,5225,54340
220930,202005,41,40,1,41800,1045,42845
220935,202005,15,15,0,15675,0,15675
220937,202005,35,34,1,35530,1045,36575
220940,202005,55,51,4,53295,4180,57475
220945,202005,1,1,0,1045,0,1045
220950,202005,43,37,6,38665,6270,44935
220955,202005,22,21,1,21945,1045,22990
220960,202005,11,10,1,10450,1045,11495
220965,202005,37,33,4,34485,4180,38665
220970,202005,60,49,11,51205,11495,62700
220975,202005,16,14,2,14630,2090,16720
220980,202005,30,28,2,29260,2090,31350
220985,202005,64,57,7,59565,7315,66880
220987,202005,28,27,1,28215,1045,29260
220990,202005,19,18,1,18810,1045,19855
220995,202005,18,14,4,14630,4180,18810
220997,202005,64,53,11,55385,11495,66880
221000,202005,1174,1059,115,1106655,120175,1226830
221005,202005,53,46,7,48070,7315,55385
221010,202005,16,12,4,12540,4180,16720
221020,202005,40,38,2,39710,2090,41800
221030,202005,38,30,8,31350,8360,39710
221035,202005,23,23,0,24035,0,24035
221037,202005,12,8,4,8360,4180,12540
221038,202005,26,23,3,24035,3135,27170
221039,202005,24,24,0,25080,0,25080
221040,202005,247,213,34,222585,35530,258115
221050,202005,235,199,36,207955,37620,245575
221060,202005,1861,1626,235,1699170,247665,1946835
221062,202005,33,33,0,34485,0,34485
221063,202005,13,9,4,9405,4180,13585
221065,202005,58,47,11,49115,11495,60610
221070,202005,139,120,19,125400,19855,145255
221080,202005,372,323,49,337535,51205,388740
221090,202005,27,25,2,27170,2090,29260
221093,202005,48,33,15,34485,15675,50160
221095,202005,7,7,0,7315,0,7315
221097,202005,13,10,3,10450,3135,13585
221100,202005,25240,14933,10307,15631114.44,10794850.45,26425964.89
221110,202005,1079,812,267,849585,279015,1128600
221120,202005,539,394,145,411730.5,151525,563255.5
221130,202005,981,793,188,828685,196460,1025145
221135,202005,34,31,3,32395,3135,35530
221140,202005,45,39,6,40755,6270,47025
221150,202005,11,9,2,9405,2090,11495
221160,202005,13,13,0,13585,0,13585
221170,202005,15,15,0,15675,0,15675
230010,202005,167,152,15,158840,15675,174515
230015,202005,129,104,25,108680,27170,135850
230020,202005,1640,1392,248,1455685.5,259160,1714845.5
230030,202005,1685,1210,475,1267586,498465,1766051
230040,202005,223,191,32,199595,33440.5,233035.5
230050,202005,230,170,60,177650,62700,240350
230060,202005,167,133,34,138985,35530,174515
230070,202005,302,264,38,275880,39710,315590
230075,202005,849,734,115,767031.5,121220,888251.5
230080,202005,197,170,27,177650,28215,205865
230090,202005,124,88,36,91960,37620,129580
230100,202005,2150,1230,920,1287441,967670,2255111
230110,202005,2906,1886,1020,1972960.5,1071125.5,3044086.0
230120,202005,1009,793,216,831820,226765,1058585
230125,202005,154,128,26,133760,27170,160930
230130,202005,477,427,50,447260,52250,499510
230140,202005,224,185,39,193325,40755,234080
230150,202005,148,114,34,119130,35530,154660
230160,202005,936,793,143,828685.5,149435,978120.5
230170,202005,611,551,60,575795.5,62700,638495.5
230180,202005,73,68,5,71060,5225,76285
230185,202005,405,349,56,364705,59565,424270
230190,202005,2326,1844,482,1928025.15,504735,2432760.15
230195,202005,491,426,65,445170,67925,513095
230200,202005,400,337,63,353210,65835,419045
230205,202005,391,259,132,270655,137940,408595
230210,202005,1374,1067,307,1117105.38,320815,1437920.38
230220,202005,1579,1079,500,1127555,522500,1650055
230230,202005,906,778,128,815100,133760,948860
230240,202005,1741,1503,238,1572988.25,249755,1822743.25
230250,202005,1803,1487,316,1553915,330220,1884135
230260,202005,3257,2027,1230,2120305,1289530,3409835
230270,202005,1368,1101,267,1153681.38,279015.5,1432696.88
230280,202005,2762,2073,689,2169420,721050.5,2890470.5
230290,202005,410,366,44,382470.72,45980,428450.72
230300,202005,528,386,142,403370,148390,551760
230310,202005,425,320,105,334400,109725,444125
230320,202005,930,795,135,831821,141075,972896
230330,202005,314,254,60,265430,62700,328130
230340,202005,451,365,86,381425,89870,471295
230350,202005,3172,2008,1164,2100450,1219515,3319965
230360,202005,277,223,54,233035,56430,289465
230365,202005,135,115,20,120175,20900,141075
230370,202005,10118,4921,5197,5157078.42,5464306,10621384.42
230380,202005,474,407,67,425315.5,70015,495330.5
230390,202005,541,302,239,315590,249755,565345
230393,202005,248,205,43,214225,44935,259160
230395,202005,354,284,70,296780.7,73150,369930.7
230400,202005,624,493,131,515185,136895,652080
230410,202005,2711,1688,1023,1767095.97,1074260.5,2841356.47
230420,202005,6316,4184,2132,4376463.04,2231075.2,6607538.24
230423,202005,334,293,41,308275,42845,351120
230425,202005,418,344,74,359480.85,79420,438900.85
230426,202005,119,96,23,100320,24035,124355
230427,202005,77,74,3,77330,3135,80465
230428,202005,1510,751,759,788975,798380,1587355
230430,202005,454,371,83,387695,86735,474430
230435,202005,902,648,254,680295,265430.77,945725.77
230440,202005,88781,39464,49317,41382018.35,51896805.82,93278824.17
230445,202005,313,221,92,230945,96140,327085
230450,202005,553,438,115,459800,121220,581020
230460,202005,66,52,14,54340,14630,68970
230465,202005,309,251,58,262295,60610,322905
230470,202005,2017,1592,425,1665730,444125.25,2109855.25
230480,202005,157,148,9,154660,9405,164065
230490,202005,302,241,61,251845,63745,315590
230495,202005,450,331,119,346940,124355,471295
230500,202005,1025,756,269,790020,281105,1071125
230510,202005,59,46,13,48070,13585,61655
230520,202005,381,299,82,312455,85690,398145
230523,202005,2346,1469,877,1535105,916465.5,2451570.5
230526,202005,269,229,40,239305,42845,282150
230530,202005,695,520,175,543400,182875,726275
230533,202005,206,193,13,201685,13585,215270
230535,202005,369,273,96,287375,100320,387695
230540,202005,1806,1591,215,1663640,224675,1888315
230550,202005,3823,2451,1372,2564432.4,1435830,4000262.4
230560,202005,583,443,140,463980,146300,610280
230565,202005,228,166,62,173470,65835,239305
230570,202005,289,256,33,267520,34485,302005
230580,202005,1180,862,318,900790,332310,1233100
230590,202005,1005,783,222,818235.25,231990,1050225.25
230600,202005,242,220,22,229900,24035,253935
230610,202005,379,294,85,307230,88825,396055
230620,202005,189,158,31,166155.5,32395,198550.5
230625,202005,765,536,229,560120.25,240350,800470.25
230630,202005,1335,1044,291,1093070,306185,1399255
230640,202005,3779,3210,569,3355496,594605.8,3950101.8
230650,202005,455,390,65,407550,67925,475475
230655,202005,692,588,104,614460,108680,723140
230660,202005,369,307,62,320815,64790,385605
230670,202005,438,378,60,396055,62700,458755
230680,202005,206,188,18,196460,18810,215270
230690,202005,908,771,137,805695,143165,948860
230700,202005,842,704,138,735680,144210.5,879890.5
230710,202005,695,660,35,690745,37620,728365
230720,202005,154,134,20,140030,20900,160930
230725,202005,263,210,53,220495,55385,275880
230730,202005,12269,6674,5595,6981582.05,5859317.62,12840899.67
230740,202005,673,543,130,567435.5,135850,703285.5
230750,202005,828,699,129,731500,134805,866305
230760,202005,1454,1255,199,1311475,207955,1519430
230763,202005,325,269,56,281105,58520,339625
230765,202005,7468,3447,4021,3608385.51,4236431.25,7844816.76
230770,202005,5130,2606,2524,2727451.9,2656390.5,5383842.4
230780,202005,733,643,90,671935.5,94050,765985.5
230790,202005,284,237,47,248710,49115,297825
230800,202005,1134,820,314,856900,328130,1185030
230810,202005,1347,1189,158,1244595,165110,1409705
230820,202005,364,253,111,264385.5,115995,380380.5
230830,202005,963,823,140,860035,147345,1007380
230835,202005,277,241,36,251845,37620,289465
230837,202005,165,139,26,145255,27170,172425
230840,202005,925,733,192,765985.5,201685.5,967671.0
230850,202005,1476,1277,199,1335510,209000,1544510
230860,202005,300,227,73,237215,76285.21,313500.21
230870,202005,1831,1563,268,1636470,283195,1919665
230880,202005,69,52,17,54340,17765,72105
230890,202005,539,494,45,519365,47025,566390
230900,202005,281,206,75,215270,78375.31,293645.31
230910,202005,216,169,47,177650,49115,226765
230920,202005,426,338,88,353210,91960,445170
230930,202005,981,688,293,718960.2,306185,1025145.2
230940,202005,862,672,190,703285,198550,901835
230945,202005,519,427,92,446215.5,96140,542355.5
230950,202005,413,355,58,370975,60610,431585
230960,202005,2673,1788,885,1869505.5,926915.5,2796421.0
230970,202005,1720,959,761,1003200,802560,1805760
230980,202005,208,170,38,177650,39710,217360
230990,202005,136,111,25,115995,26125,142120
231000,202005,205,187,18,195415,19855,215270
231010,202005,149,113,36,118085,37620,155705
231020,202005,1351,936,415,980210,434720,1414930
231025,202005,1067,789,278,824505,293645.5,1118150.5
231030,202005,1101,915,186,957220.4,194370,1151590.4
231040,202005,137,95,42,99275,43890,143165
231050,202005,956,845,111,884174.5,117040,1001214.5
231060,202005,157,131,26,136895,27170,164065
231070,202005,1501,1044,457,1094115.75,477565,1571680.75
231080,202005,260,239,21,249755,21945,271700
231085,202005,609,366,243,383515,253935,637450
231090,202005,245,200,45,209000,47025,256025
231095,202005,169,133,36,138985,37620,176605
231100,202005,150,124,26,129580,27170,156750
231110,202005,368,314,54,329175,56430,385605
231120,202005,272,231,41,241395,42845,284240
231123,202005,151,144,7,150480,7315,157795
231126,202005,336,263,73,274835.5,76285,351120.5
231130,202005,4642,3613,1029,3779765.5,1076350.5,4856116.0
231135,202005,211,183,28,191235,29260,220495
231140,202005,3071,2252,819,2355430.5,857945,3213375.5
231150,202005,369,351,18,366795,18810,385605
231160,202005,1210,959,251,1005290,262295,1267585
231170,202005,520,361,159,377245,166155,543400
231180,202005,1697,1454,243,1522565,253935,1776500
231190,202005,206,173,33,180785,34485,215270
231195,202005,214,183,31,192280,32395,224675
231200,202005,806,657,149,686565,156750,843315
231210,202005,582,490,92,514140,96140,610280
231220,202005,1052,767,285,803605.75,297825,1101430.75
231230,202005,1477,1168,309,1222650,322905,1545555
231240,202005,1461,1041,420,1087845,444125.5,1531970.5
231250,202005,111,102,9,107635,9405,117040
231260,202005,276,179,97,187055,102410,289465
231270,202005,1008,822,186,862126.44,194370,1056496.44
231280,202005,76,59,17,61655,17765,79420
231290,202005,7691,4305,3386,4503951.46,3543595.94,8047547.40
231300,202005,610,566,44,592515,45980,638495
231310,202005,751,695,56,727320.56,58520,785840.56
231320,202005,589,448,141,469206.5,147345,616551.5
231325,202005,97,86,11,90915,11495,102410
231330,202005,2005,1555,450,1625239.4,470250.5,2095489.9
231335,202005,254,225,29,235125,30305,265430
231340,202005,1724,1265,459,1322970,481745,1804715
231350,202005,1288,1050,238,1100385,248712,1349097
231355,202005,434,372,62,388740,64790,453530
231360,202005,509,376,133,392920.86,138985,531905.86
231370,202005,88,76,12,79420,12540,91960
231375,202005,292,212,80,221540,84645,306185
231380,202005,497,400,97,419045,102410,521455
231390,202005,207,165,42,172425,43890,216315
231395,202005,737,462,275,483835,288420,772255
231400,202005,1121,933,188,976030.25,196460.5,1172490.75
231410,202005,1325,1085,240,1134870,250800,1385670
240010,202005,392,173,219,180785.67,229900,410685.67
240020,202005,2271,1830,441,1916531.68,460845,2377376.68
240030,202005,121,102,19,107635,19855,127490
240040,202005,33,33,0,34485,0,34485
240050,202005,531,453,78,473385,81510,554895
240060,202005,67,63,4,65835,4180,70015
240070,202005,218,170,48,177650,50160,227810
240080,202005,518,352,166,368885,173470.01,542355.01
240090,202005,105,94,11,98230,11495,109725
240100,202005,1501,1420,81,1483900.25,84645,1568545.25
240110,202005,1058,694,364,726275.5,380380.75,1106656.25
240120,202005,132,107,25,111815,26125,137940
240130,202005,282,261,21,272745,21945,294690
240140,202005,76,57,19,59565,19855,79420
240145,202005,738,657,81,688655,84645,773300
240150,202005,20,16,4,16720,4180,20900
240160,202005,41,35,6,36575,6270,42845
240165,202005,36,28,8,29260.25,8360,37620.25
240170,202005,108,79,29,82555,30305,112860
240180,202005,86,68,18,71060,18810,89870
240185,202005,42,39,3,40755,3135,43890
240190,202005,16,14,2,14630,2090,16720
240200,202005,3095,1733,1362,1812032.5,1425380.5,3237413.0
240210,202005,173,134,39,140030,40755,180785
240220,202005,1116,811,305,848540.75,319770,1168310.75
240230,202005,847,781,66,817190.75,68970,886160.75
240240,202005,72,52,20,54340,20900,75240
240250,202005,89,77,12,80465,12540,93005
240260,202005,1817,1339,478,1399255,499510,1898765
240270,202005,185,163,22,170335,22990,193325
240280,202005,44,35,9,36575,9405,45980
240290,202005,51,49,2,51205,2090,53295
240300,202005,174,95,79,99275,82555,181830
240310,202005,2304,1278,1026,1338646.48,1078440.85,2417087.33
240320,202005,193,181,12,189145,12540,201685
240325,202005,4552,2708,1844,2836132.79,1928025.7,4764158.49
240330,202005,71,68,3,71060,4180,75240
240340,202005,68,44,24,45980,25080,71060
240350,202005,98,86,12,89870,12540,102410
240360,202005,557,348,209,366795,219450,586245
240370,202005,51,47,4,49115,4180,53295
240375,202005,67,40,27,41800,28215,70015
240380,202005,226,188,38,196460,39710.5,236170.5
240390,202005,13,12,1,12540,1045,13585
240400,202005,81,75,6,79420,6270,85690
240410,202005,13,8,5,8360,5225,13585
240420,202005,995,736,259,771210,271700,1042910
240430,202005,262,245,17,256025,17765,273790
240440,202005,117,66,51,68970,53295,122265
240450,202005,224,152,72,158840.5,75240,234080.5
240460,202005,67,50,17,52250,17765,70015
240470,202005,236,210,26,219450,27170,246620
240480,202005,16,14,2,14630,2090,16720
240485,202005,79,66,13,68970,13585,82555
240490,202005,48,46,2,48070,2090,50160
240500,202005,83,63,20,65835,20900,86735
240510,202005,43,32,11,33440,11495,44935
240520,202005,116,111,5,115995,5225,121220
240530,202005,54,47,7,49115,7315,56430
240540,202005,78,66,12,68970,12540,81510
240550,202005,13,12,1,12540,1045,13585
240560,202005,378,276,102,288420.5,106590,395010.5
240570,202005,450,287,163,299915,170335.5,470250.5
240580,202005,1291,1023,268,1070080.25,282150,1352230.25
240590,202005,31,29,2,30305,2090,32395
240600,202005,107,103,4,108680,4180,112860
240610,202005,518,434,84,453530.5,87780,541310.5
240615,202005,19,18,1,18810,1045,19855
240620,202005,87,83,4,86735,4180,90915
240630,202005,38,33,5,34485,5225,39710
240640,202005,25,20,5,20900,5225,26125
240650,202005,241,200,41,209000,42845,251845
240660,202005,111,95,16,99275,16720,115995
240670,202005,303,178,125,187055.75,130625,317680.75
240680,202005,51,38,13,39710,13585,53295
240690,202005,47,44,3,45980,3135,49115
240700,202005,184,153,31,159885,32395,192280
240710,202005,2024,1252,772,1309385.75,806740,2116125.75
240720,202005,1068,787,281,823460,293645,1117105
240725,202005,64,59,5,61655,5225,66880
240730,202005,146,126,20,131670,20900,152570
240740,202005,235,201,34,211090,35530.85,246620.85
240750,202005,49,26,23,27170,24035,51205
240760,202005,47,42,5,43890,5225,49115
240770,202005,144,112,32,117040,33440,150480
240780,202005,681,558,123,583110,129580,712690
240790,202005,41,39,2,40755,2090,42845
240800,202005,9251,6296,2955,6582464.14,3093202.75,9675666.89
240810,202005,20472,11085,9387,11599510.7,9827183.9,21426694.6
240820,202005,236,140,96,146300.09,101365,247665.09
240830,202005,1632,1342,290,1403435.75,303050,1706485.75
240840,202005,78,68,10,71060,10450,81510
240850,202005,88,77,11,80465,11495,91960
240860,202005,107,103,4,107635,4180,111815
240870,202005,60,52,8,54340,8360,62700
240880,202005,32,28,4,29260,4180,33440
240890,202005,1123,646,477,675070.4,498465,1173535.4
240895,202005,63,41,22,42845,22990,65835
240910,202005,159,142,17,148390,17765,166155
240920,202005,13,10,3,10450,3135,13585
240930,202005,413,370,43,387695,44935,432630
240933,202005,45,31,14,32395,14630,47025
240940,202005,2389,2116,273,2215400.45,286330,2501730.45
240950,202005,47,43,4,44935,4180,49115
240960,202005,26,22,4,22990,4180,27170
240970,202005,114,84,30,87780,31350,119130
240980,202005,200,159,41,166155,42845,209000
240990,202005,129,86,43,89870,44935,134805
241000,202005,61,57,4,59565,4180,63745
241010,202005,71,54,17,56430,17765,74195
241020,202005,115,106,9,110770,9405,120175
241025,202005,12,6,6,6270,6270,12540
241030,202005,110,89,21,93005,21945,114950
241040,202005,45,32,13,33440,13585,47025
241050,202005,81,74,7,77330.5,7315,84645.5
241060,202005,29,24,5,25080,5225,30305
241070,202005,16,16,0,16720,0,16720
241080,202005,61,54,7,56430,7315,63745
241090,202005,58,46,12,48070,12540,60610
241100,202005,72,61,11,63745,11495,75240
241105,202005,8,2,6,2090,6270,8360
241110,202005,47,44,3,45980,3135,49115
241120,202005,1479,1126,353,1178760.5,369930,1548690.5
241140,202005,223,185,38,193325.5,39710,233035.5
241142,202005,41,36,5,37620,5225,42845
241150,202005,1181,1037,144,1084710,151525,1236235
241160,202005,19,17,2,17765,2090,19855
241170,202005,43,38,5,39710,5225,44935
241180,202005,42,36,6,37620,6270,43890
241190,202005,37,36,1,37620,1045,38665
241200,202005,3918,2047,1871,2139116.15,1956240,4095356.15
241210,202005,69,59,10,61655,10450,72105
241220,202005,1425,961,464,1005291.57,484880,1490171.57
241230,202005,240,201,39,210045,40755,250800
241240,202005,54,43,11,44935,11495,56430
241250,202005,1139,1047,92,1095160.5,96140,1191300.5
241255,202005,50,40,10,41800,10450,52250
241260,202005,683,530,153,553850,159885,713735
241270,202005,60,40,20,41800,20900,62700
241280,202005,94,82,12,85690,12540,98230
241290,202005,124,89,35,94050,36575,130625
241300,202005,77,56,21,58520,21945,80465
241310,202005,51,37,14,38665.75,14630,53295.75
241320,202005,30,18,12,18810,12540,31350
241330,202005,59,55,4,57475,4180,61655
241335,202005,73,65,8,67925,8360,76285
241340,202005,180,133,47,138985,50160,189145
241350,202005,61,52,9,54340,9405,63745
241355,202005,50,43,7,44935,7315,52250
241360,202005,52,50,2,52250,2090,54340
241370,202005,53,43,10,44935,10450,55385
241380,202005,37,33,4,34485,4180,38665
241390,202005,85,65,20,67925,20900,88825
241400,202005,225,180,45,188100,47025,235125
241410,202005,185,167,18,174515,18810,193325
241415,202005,100,80,20,83600,21945,105545
241420,202005,105,74,31,77330,32395.1,109725.1
241430,202005,28,25,3,26125,3135,29260
241440,202005,544,435,109,454575,113905,568480
241445,202005,34,32,2,33440,2090,35530
241450,202005,279,230,49,241395,51205,292600
241460,202005,139,125,14,130625.25,14630,145255.25
241470,202005,37,32,5,33440,5225,38665
241475,202005,55,52,3,54340,3135,57475
241480,202005,95,68,27,71060,28215,99275
241490,202005,11,10,1,10450,1045,11495
241500,202005,47,36,11,37620,11495,49115
250010,202005,102,87,15,90915,15675,106590
250020,202005,33,30,3,31350,3135,34485
250030,202005,862,650,212,679250,221540,900790
250040,202005,372,306,66,319770,68970,388740
250050,202005,261,214,47,223630,49115,272745
250053,202005,56,42,14,43890,14630,58520
250057,202005,1,1,0,1045,0,1045
250060,202005,577,413,164,432630,172425,605055
250070,202005,709,567,142,593560.1,148390,741950.1
250073,202005,8,8,0,8360,0,8360
250077,202005,179,136,43,142120,44935,187055
250080,202005,427,333,94,349030.3,98230,447260.3
250090,202005,218,142,76,148390,79420,227810
250100,202005,514,425,89,444125,94050,538175
250110,202005,613,468,145,489060,152570,641630
250115,202005,20,7,13,7315,13585,20900
250120,202005,123,88,35,91960,37620,129580
250130,202005,577,471,106,492195,110770,602965
250135,202005,17,10,7,10450,7315,17765
250140,202005,85,75,10,79420,10450,89870
250150,202005,590,423,167,443080,175560,618640
250153,202005,9,6,3,6270,3135,9405
250157,202005,32,25,7,26125,7315,33440
250160,202005,232,180,52,188100,54340,242440
250170,202005,62,40,22,41800,22990,64790
250180,202005,4273,2923,1350,3055580.3,1414930,4470510.3
250190,202005,841,555,286,579975,298870.25,878845.25
250200,202005,51,43,8,44935,8360,53295
250205,202005,24,20,4,20900,4180,25080
250210,202005,85,75,10,78375,10450,88825
250215,202005,66,54,12,56430,12540,68970
250220,202005,24,18,6,18810,6270,25080
250230,202005,78,71,7,74195,7315,81510
250240,202005,232,194,38,202730,39710,242440
250250,202005,390,336,54,352165,56430,408595
250260,202005,44,38,6,39710,6270,45980
250270,202005,68,49,19,51205,19855,71060
250280,202005,386,317,69,332310,73150,405460
250290,202005,95,88,7,91960,7315,99275
250300,202005,558,376,182,392920,192280,585200
250310,202005,49,44,5,45980,5225,51205
250320,202005,1966,1326,640,1386715.85,669845.9,2056561.75
250330,202005,101,85,16,88825,16720,105545
250340,202005,26,24,2,25080,2090,27170
250350,202005,163,107,56,111815,59565,171380
250355,202005,33,25,8,26125,8360,34485
250360,202005,197,162,35,169290,36575,205865
250370,202005,2404,1609,795,1684540,831820,2516360
250375,202005,11,7,4,7315,4180,11495
250380,202005,57,43,14,44935,14630,59565
250390,202005,44,33,11,34485,11495,45980
250400,202005,16422,8321,8101,8709015.57,8496896.4,17205911.97
250403,202005,333,270,63,283195,65835,349030
250407,202005,59,49,10,51205,10450,61655
250410,202005,30,26,4,27170,4180,31350
250415,202005,42,28,14,29260,14630,43890
250420,202005,43,37,6,38665,6270,44935
250430,202005,1454,1249,205,1309646.25,214225,1523871.25
250435,202005,18,14,4,14630,4180,18810
250440,202005,678,568,110,594605,114950,709555
250450,202005,84,67,17,71060,17765,88825
250460,202005,472,317,155,332310,163020,495330
250470,202005,91,64,27,66880,28215,95095
250480,202005,329,263,66,275880,68970,344850
250485,202005,3,2,1,2090,1045,3135
250490,202005,224,181,43,190190,44935,235125
250500,202005,89,66,23,68970,24035,93005
250510,202005,759,601,158,628045,165110,793155
250520,202005,183,125,58,130625,61655,192280
250523,202005,116,93,23,98230,24035,122265
250527,202005,102,79,23,82555,24035,106590
250530,202005,10,6,4,6270,4180,10450
250535,202005,34,24,10,25080,10450,35530
250540,202005,132,103,29,107635,30305,137940
250550,202005,72,69,3,72105,3135,75240
250560,202005,51,35,16,37620,16720,54340
250570,202005,165,135,30,141075,31350,172425
250580,202005,108,83,25,86802,26125,112927
250590,202005,26,16,10,16720,10450,27170
250600,202005,1381,909,472,949906.46,495330,1445236.46
250610,202005,160,132,28,138985,29260,168245
250620,202005,23,18,5,18810,5225,24035
250625,202005,73,54,19,56430,19855,76285
250630,202005,3041,1933,1108,2024167.43,1159950,3184117.43
250640,202005,218,174,44,181830,45980,227810
250650,202005,30,20,10,20900,10450,31350
250660,202005,49,38,11,39710,11495,51205
250670,202005,64,43,21,44935,21945,66880
250680,202005,406,326,80,340670,84645,425315
250690,202005,2015,1397,618,1463000.96,646855,2109855.96
250700,202005,942,814,128,850630.25,133760,984390.25
250710,202005,432,338,94,354255,98230,452485
250720,202005,115,86,29,89870,30305,120175
250730,202005,387,324,63,338580,65835,404415
250740,202005,54,50,4,52250,4180,56430
250750,202005,22233,13357,8876,13989309.78,9310951.5,23300261.28
250760,202005,94,76,18,79420,18810,98230
250770,202005,363,238,125,249755.6,130625,380380.6
250780,202005,64,44,20,47025,20900,67925
250790,202005,462,301,161,314545,168245,482790
250800,202005,152,137,15,143165,15675,158840
250810,202005,79,61,18,63745,19855,83600
250820,202005,153,128,25,133760,26125,159885
250830,202005,435,294,141,307230.5,147345,454575.5
250840,202005,55,49,6,51205,6270,57475
250850,202005,56,47,9,50160,9405,59565
250855,202005,13,11,2,11495,2090,13585
250860,202005,215,147,68,153615,71060,224675
250870,202005,31,27,4,28215,4180,32395
250880,202005,81,62,19,64790,19855,84645
250890,202005,2825,2113,712,2209130.5,746130,2955260.5
250900,202005,50,41,9,43890,9405,53295
250905,202005,117,91,26,95095,27170,122265
250910,202005,1139,825,314,862125,329175,1191300
250915,202005,106,75,31,78375,32395,110770
250920,202005,140,102,38,106590,39710,146300
250930,202005,169,101,68,105545,71060,176605
250933,202005,5,3,2,3135,2090,5225
250937,202005,11,10,1,10450,1045,11495
250939,202005,34,25,9,26125,9405,35530
250940,202005,102,77,25,80465,27170,107635
250950,202005,71,49,22,51205,22990,74195
250960,202005,90,50,40,52250,41800,94050
250970,202005,1224,860,364,899745,381425,1281170
250980,202005,106,72,34,75240,35530,110770
250990,202005,163,127,36,132715,39710,172425
251000,202005,75,67,8,71060,8360,79420
251010,202005,117,86,31,89870,32395,122265
251020,202005,74,61,13,63745,13585,77330
251030,202005,46,34,12,35530,12540,48070
251040,202005,56,39,17,40755,17765,58520
251050,202005,25,22,3,22990,3135,26125
251060,202005,51,40,11,41800,11495,53295
251065,202005,4,4,0,4180,0,4180
251070,202005,20,16,4,16720,4180,20900
251080,202005,5015,2397,2618,2510090.75,2743127.14,5253217.89
251090,202005,192,164,28,171380,29260,200640
251100,202005,18,18,0,18810,0,18810
251110,202005,47,38,9,39710,9405,49115
251120,202005,1864,1142,722,1195482,757625.2,1953107.2
251130,202005,400,327,73,342760,77330,420090
251140,202005,558,363,195,379335,203775,583110
251150,202005,337,287,50,299915,52250,352165
251160,202005,90,73,17,76285,17765,94050
251170,202005,104,82,22,85690,22990,108680
251180,202005,291,177,114,184965,119130,304095
251190,202005,201,132,69,138985,74195,213180
251200,202005,270,220,50,229900,53295,283195
251203,202005,35,33,2,34485,2090,36575
251207,202005,89,73,16,76285,16720,93005
251210,202005,1482,1080,402,1130690,421135,1551825
251220,202005,49,36,13,37620,13585,51205
251230,202005,594,500,94,523545,98230,621775
251240,202005,97,67,30,70015,31350,101365
251250,202005,1406,1000,406,1045000.75,426360.75,1471361.50
251260,202005,13,7,6,7315,6270,13585
251270,202005,326,246,80,257070,83600,340670
251272,202005,66,60,6,62700,6270,68970
251274,202005,30,23,7,24035,7315,31350
251275,202005,34,20,14,20900,14630,35530
251276,202005,13,10,3,10450,3135,13585
251278,202005,11,9,2,9405,2090,11495
251280,202005,101,96,5,100320,5225,105545
251290,202005,797,580,217,607145,227810,834955
251300,202005,14,12,2,12540,2090,14630
251310,202005,371,269,102,282150,107635,389785
251315,202005,31,28,3,29260,3135,32395
251320,202005,63,50,13,52250,13585,65835
251330,202005,81,72,9,75240,9405,84645
251335,202005,14,9,5,9405,5225,14630
251340,202005,734,435,299,454575,313500,768075
251350,202005,34,33,1,34485,1045,35530
251360,202005,81,71,10,74195,10450,84645
251365,202005,15,15,0,15675,0,15675
251370,202005,5564,3756,1808,3930245.65,1890405,5820650.65
251380,202005,45,37,8,38665,8360,47025
251385,202005,3,3,0,3135,0,3135
251390,202005,807,611,196,638495,205865.5,844360.5
251392,202005,16,8,8,8360,8360,16720
251394,202005,11,11,0,11495,0,11495
251396,202005,11,7,4,7315,4180,11495
251398,202005,18,16,2,16720,2090,18810
251400,202005,39,33,6,34485,6270,40755
251410,202005,37,31,6,32395,6270,38665
251420,202005,101,72,29,75240,30305,105545
251430,202005,43,38,5,39710,5225,44935
251440,202005,40,24,16,25080,16720,41800
251445,202005,51,46,5,48070.25,5225,53295.25
251450,202005,410,356,54,372020,56430,428450
251455,202005,4,2,2,2090,2090,4180
251460,202005,15,13,2,13585,2090,15675
251465,202005,5,3,2,3135,2090,5225
251470,202005,48,39,9,40755,9405,50160
251480,202005,26,21,5,21945,5225,27170
251490,202005,128,85,43,88825,44935.5,133760.5
251500,202005,127,104,23,108680,24035,132715
251510,202005,50,32,18,33440,18810,52250
251520,202005,29,29,0,30305,0,30305
251530,202005,4524,3186,1338,3332505.5,1402390,4734895.5
251540,202005,74,63,11,65835,12540,78375
251550,202005,413,315,98,329175,102410.75,431585.75
251560,202005,23,15,8,15675,8360,24035
251570,202005,20,19,1,19855,1045,20900
251580,202005,127,101,26,105545,27170,132715
251590,202005,117,86,31,90067.5,32395,122462.5
251593,202005,26,16,10,16720,10450,27170
251597,202005,99,76,23,79420,24035,103455
251600,202005,1110,787,323,824505.5,337535,1162040.5
251610,202005,239,182,57,190190,59565,249755
251615,202005,7,7,0,7315,0,7315
251620,202005,4256,2782,1474,2911371.6,1542421.5,4453793.1
251630,202005,456,337,119,352165,124355,476520
251640,202005,145,103,42,107635,43890,151525
251650,202005,281,204,77,213180.75,80465,293645.75
251660,202005,192,170,22,178695,22990,201685
251670,202005,373,291,82,304095,85690,389785
251675,202005,8,6,2,6270,2090,8360
251680,202005,95,88,7,91960,7315,99275
251690,202005,328,267,61,279015,63745,342760
251700,202005,284,245,39,256025.9,40755,296780.9
251710,202005,23,15,8,15675,8360,24035
251720,202005,22,15,7,15675,7315.5,22990.5
251740,202005,11,8,3,8360,3135,11495
260005,202005,3268,1787,1481,1870554.21,1547645,3418199.21
260010,202005,1611,1178,433,1231010.55,454575.1,1685585.65
260020,202005,416,364,52,383515,55385,438900
260030,202005,616,429,187,448305,195415,643720
260040,202005,816,503,313,525635,327085,852720
260050,202005,1169,838,331,875710,346941,1222651
260060,202005,381,347,34,362615,35530,398145
260070,202005,1384,859,525,898700.5,553850.3,1452550.8
260080,202005,738,569,169,596695,177650,774345
260090,202005,502,327,175,342760,183920,526680
260100,202005,215,150,65,156750,67925,224675
260105,202005,238,129,109,136895,113905,250800
260110,202005,2878,2109,769,2208086,804650.5,3012736.5
260120,202005,2841,1454,1387,1520476.8,1453595.75,2974072.55
260130,202005,167,112,55,118085,57475,175560
260140,202005,2140,1389,751,1452551.8,787930,2240481.8
260150,202005,213,137,76,143165,79420,222585
260160,202005,331,274,57,286330,59565,345895
260170,202005,3407,2057,1350,2151656.45,1413885.5,3565541.95
260180,202005,157,126,31,131670,32395,164065
260190,202005,2335,1589,746,1662595,781660,2444255
260200,202005,971,778,193,814055.29,201685.5,1015740.79
260210,202005,1439,1026,413,1072170,431585,1503755
260220,202005,696,625,71,655215.5,75240,730455.5
260230,202005,1216,913,303,955130,318725,1273855
260240,202005,220,165,55,172425,57475,229900
260250,202005,94,70,24,73150,25080,98230
260260,202005,1054,740,314,773300,328130,1101430
260270,202005,421,329,92,343805,97185,440990
260280,202005,1300,917,383,958265.5,401280.5,1359546.0
260290,202005,6568,3537,3031,3704527,3182027.46,6886554.46
260300,202005,949,820,129,857945.5,135850,993795.5
260310,202005,516,408,108,426360,113905,540265
260320,202005,876,641,235,670890,245575,916465
260330,202005,61,43,18,44935,18810,63745
260340,202005,77,56,21,58520,21945,80465
260345,202005,5541,3028,2513,3176801.43,2642805,5819606.43
260350,202005,494,353,141,368885.5,147345,516230.5
260360,202005,258,141,117,147345,123310,270655
260370,202005,719,471,248,492195.25,260205,752400.25
260380,202005,597,435,162,454575,170335.47,624910.47
260390,202005,293,246,47,257070,49115,306185
260392,202005,110,95,15,99275,15675,114950
260400,202005,4167,2377,1790,2486056.22,1871595,4357651.22
260410,202005,14891,7787,7104,8148912.22,7443536.01,15592448.23
260415,202005,140,122,18,127490,18810,146300
260420,202005,1738,1061,677,1110836.77,710600,1821436.77
260430,202005,189,173,16,180785.35,16720,197505.35
260440,202005,203,145,58,151525,60610,212135
260450,202005,427,316,111,332310.96,118085,450395.96
260460,202005,828,435,393,454575.5,414865,869440.5
260470,202005,346,213,133,222585,140030.5,362615.5
260480,202005,238,154,84,161975,87780,249755
260490,202005,216,178,38,186010,39710,225720
260500,202005,1124,754,370,788975,387695,1176670
260510,202005,777,620,157,647900,164065,811965
260515,202005,243,218,25,227810,26125,253935
260520,202005,3275,2004,1271,2101495,1333420.95,3434915.95
260530,202005,795,658,137,687610,143165,830775
260540,202005,558,437,121,457710,127490,585200
260545,202005,15,10,5,10450,5225,15675
260550,202005,328,204,124,213180,129580,342760
260560,202005,523,393,130,411730.5,136895,548625.5
260570,202005,981,796,185,834955,194370,1029325
260580,202005,242,211,31,220495,32395,252890
260590,202005,646,371,275,389785,287375.5,677160.5
260600,202005,8053,4353,3700,4555157.84,3869636,8424793.84
260610,202005,487,325,162,339625,170335,509960
260620,202005,3703,1930,1773,2024166.65,1856966.08,3881132.73
260630,202005,87,82,5,85690,5225,90915
260640,202005,3564,1976,1588,2068055.8,1662595,3730650.8
260650,202005,330,240,90,250800,94050,344850
260660,202005,553,369,184,386650,193325,579975
260670,202005,106,78,28,81510,29260,110770
260680,202005,3719,2073,1646,2171510.22,1728430.5,3899940.72
260690,202005,129,93,36,97185,37620,134805
260700,202005,312,207,105,216315,110770,327085
260710,202005,44,37,7,38665,7315,45980
260720,202005,2414,1434,980,1506891,1033505,2540396
260730,202005,704,527,177,551760,184965,736725
260740,202005,62,57,5,60610,5225,65835
260750,202005,590,422,168,440990,175560,616550
260760,202005,663,343,320,359480.23,334400,693880.23
260765,202005,978,499,479,522500,504735,1027235
260770,202005,221,163,58,170317,61655.5,231972.5
260775,202005,792,446,346,466071.25,363660,829731.25
260780,202005,255,167,88,175560,94050,269610
260790,202005,13074,6780,6294,7100779.47,6609627.28,13710406.75
260795,202005,166,109,57,113905,59565,173470
260800,202005,286,238,48,248710.5,50160,298870.5
260805,202005,170,112,58,118085,61655,179740
260810,202005,749,649,100,679250,104500,783750
260820,202005,294,188,106,196460.85,110770,307230.85
260825,202005,208,148,60,154660,62700,217360
260830,202005,282,178,104,186010,110770,296780
260840,202005,240,176,64,183920,66880,250800
260845,202005,174,119,55,124355,58520,182875
260850,202005,446,328,118,345895,123310,469205
260860,202005,252,188,64,196460,66880,263340
260870,202005,371,278,93,290510.29,97185,387695.29
260875,202005,733,522,211,545490,220495,765985
260880,202005,1602,1016,586,1063810,614460,1678270
260890,202005,2380,1680,700,1757691,736725,2494416
260900,202005,994,705,289,737770,304095,1041865
260910,202005,258,204,54,213180,56430,269610
260915,202005,291,212,79,221540,82555,304095
260920,202005,178,95,83,99275,86735,186010
260930,202005,403,344,59,359480,61655,421135
260940,202005,2722,1471,1251,1539286.4,1313566,2852852.4
260950,202005,2023,1163,860,1216380.75,899745,2116125.75
260960,202005,13806,6995,6811,7324413.45,7146757.45,14471170.90
260970,202005,422,352,70,367840,73150,440990
260980,202005,193,173,20,180785,20900,201685
260990,202005,2620,2119,501,2215401.35,524590,2739991.35
261000,202005,4315,2585,1730,2706550.97,1809940,4516490.97
261010,202005,165,125,40,130625,41800,172425
261020,202005,611,458,153,478610.99,159885,638495.99
261030,202005,249,181,68,189145,71060,260205
261040,202005,370,323,47,337535,50160,387695
261050,202005,510,440,70,459800,73150,532950
261060,202005,1404,904,500,944680.25,522500,1467180.25
261070,202005,8796,4351,4445,4563518.15,4664883.12,9228401.27
261080,202005,379,291,88,304095,91960,396055
261090,202005,2199,1684,515,1769189.7,547580.83,2316770.53
261100,202005,1149,806,343,842270.75,358435,1200705.75
261110,202005,8640,5290,3350,5530140.8,3508066,9038206.8
261120,202005,257,221,36,230945,38665,269610
261130,202005,577,342,235,358435,248710.55,607145.55
261140,202005,197,126,71,131670,74195,205865
261150,202005,684,421,263,439945.03,274835,714780.03
261153,202005,66,61,5,63745,5225,68970
261160,202005,76235,37902,38333,39695420.2,40229859.77,79925279.97
261170,202005,476,360,116,377245,121220,498465
261180,202005,1809,1127,682,1179805,714780,1894585
261190,202005,633,440,193,459800.9,204820,664620.9
261200,202005,217,186,31,194370,32395,226765
261210,202005,32,26,6,27170,6270,33440
261220,202005,2691,1894,797,1982366.12,832865,2815231.12
261230,202005,343,256,87,267520,91960,359480
261240,202005,460,403,57,421135,59565,480700
261245,202005,233,193,40,202730,41800,244530
261247,202005,172,136,36,142120,37620,179740
261250,202005,3112,1530,1582,1598850.75,1655280,3254130.75
261255,202005,245,223,22,233035,22990,256025
261260,202005,857,744,113,777480.06,118085,895565.06
261270,202005,204,146,58,152570,60610,213180
261280,202005,177,145,32,151525,34485,186010
261290,202005,117,85,32,88825,33440,122265
261300,202005,1297,942,355,986480,372020,1358500
261310,202005,814,548,266,572660,279015,851675
261320,202005,555,377,178,395010,186010,581020
261330,202005,976,745,231,778525,242440.29,1020965.29
261340,202005,299,165,134,172425,140030,312455
261350,202005,852,605,247,633270.5,259160,892430.5
261360,202005,1293,845,448,883025,470250,1353275
261370,202005,4851,2900,1951,3040324.5,2042976,5083300.5
261380,202005,553,419,134,438900.69,141075.5,579976.19
261390,202005,3600,2423,1177,2534125.5,1236235.75,3770361.25
261400,202005,294,268,26,281105,28215,309320
261410,202005,1107,732,375,765985,393965,1159950
261420,202005,877,542,335,567435.75,354255,921690.75
261430,202005,331,299,32,312455,33440,345895
261440,202005,119,110,9,114950,9405,124355
261450,202005,2526,2053,473,2149566.25,494285.5,2643851.75
261460,202005,725,579,146,606100.85,152570,758670.85
261470,202005,248,198,50,206910,52250,259160
261480,202005,442,342,100,358435,104453,462888
261485,202005,348,209,139,218405,146300,364705
261500,202005,603,410,193,429495,201685,631180
261510,202005,48,32,16,33440,16720,50160
261520,202005,112,101,11,105545,11495,117040
261530,202005,4149,2627,1522,2752531.23,1597805.75,4350336.98
261540,202005,1349,795,554,831820,581020,1412840
261550,202005,273,139,134,145255.5,140030,285285.5
261560,202005,856,562,294,588336.75,307231,895567.75
261570,202005,398,311,87,324995,93005,418000
261580,202005,377,295,82,308275,85690,393965
261590,202005,192,156,36,164065,37620,201685
261600,202005,293,234,59,244530,61655.5,306185.5
261610,202005,90,77,13,80465,13585,94050
261618,202005,73,60,13,62700,13585,76285
261620,202005,207,129,78,134805,81510,216315
261630,202005,556,434,122,455620,128535,584155
261640,202005,6416,3390,3026,3550913.09,3175756.25,6726669.34
261650,202005,486,310,176,323950,186010,509960
270010,202005,525,465,60,485925,62700,548625
270020,202005,287,232,55,243485,58520,302005
270030,202005,8908,5755,3153,6022129.27,3305335.5,9327464.77
270040,202005,2004,1254,750,1310464.83,784795,2095259.83
270050,202005,154,115,39,121220,42845,164065
270060,202005,112,62,50,64790,52250,117040
270070,202005,873,641,232,669845,243485,913330
270080,202005,35,30,5,31350,5225,36575
270090,202005,20,15,5,15675,5225,20900
270100,202005,1238,823,415,862125,433675,1295800
270110,202005,125,97,28,101365,29260,130625
270120,202005,230,190,40,198550,42845,241395
270130,202005,253,172,81,181098.5,84645,265743.5
270135,202005,118,74,44,77330,45980,123310
270140,202005,1373,871,502,911240.5,525635,1436875.5
270150,202005,257,203,54,213180,56430,269610
270160,202005,506,398,108,415910,112860,528770
270170,202005,799,524,275,548625,288420,837045
270180,202005,71,55,16,57475,16720,74195
270190,202005,90,78,12,81510,12540,94050
270200,202005,104,91,13,95095,13585,108680
270210,202005,506,287,219,299915,229900.5,529815.5
270220,202005,180,142,38,148390,40755,189145
270230,202005,2108,1289,819,1349096.6,856900,2205996.6
270235,202005,712,556,156,581020,163020,744040
270240,202005,3061,2423,638,2535171.42,670890.85,3206062.27
270250,202005,157,114,43,119130,44935,164065
270255,202005,212,180,32,188100,33440,221540
270260,202005,368,299,69,313500,72105,385605
270270,202005,96,43,53,44935,56430,101365
270280,202005,241,133,108,138985,112860,251845
270290,202005,1168,892,276,934230,288420,1222650
270300,202005,315,218,97,227810,101365,329175
270310,202005,854,697,157,728365,164065,892430
270320,202005,834,710,124,743030.62,129580,872610.62
270330,202005,291,246,45,257070,47025,304095
270340,202005,60,47,13,49115,13585,62700
270350,202005,93,49,44,51205,45980,97185
270360,202005,63,35,28,36575,30305,66880
270370,202005,52,44,8,45980,8360,54340
270375,202005,71,44,27,45980,28215,74195
270380,202005,1012,634,378,662530,396055,1058585
270390,202005,190,115,75,120175,78375,198550
270400,202005,708,524,184,547580.79,192280,739860.79
270410,202005,656,482,174,504735,181830,686565
270420,202005,405,281,124,293645,129580,423225
270430,202005,32919,23636,9283,24746132.54,9748703.39,34494835.93
270440,202005,486,385,101,402325,105545,507870
270450,202005,791,446,345,467115,360525,827640
270460,202005,193,153,40,160930,41800,202730
270470,202005,1451,1007,444,1055763.5,465025,1520788.5
270480,202005,548,452,96,472340.5,100320,572660.5
270490,202005,24,19,5,19855,5225,25080
270500,202005,490,408,82,426360,85690,512050
270510,202005,804,498,306,522500,322905,845405
270520,202005,295,191,104,199595,109725,309320
270530,202005,66,57,9,59565,9405,68970
270540,202005,109,85,24,88825,25080,113905
270550,202005,1755,1343,412,1406570,431585,1838155
270560,202005,267,143,124,149435,131670,281105
270570,202005,516,364,152,380380,158840,539220
270580,202005,94,70,24,73150,25080,98230
270590,202005,71,56,15,58520,15675,74195
270600,202005,176,146,30,152570,31350,183920
270610,202005,225,177,48,184965,50160,235125
270620,202005,28,27,1,28215,1045,29260
270630,202005,3761,2860,901,2990825.83,942590.9,3933416.73
270640,202005,876,650,226,680295,237215,917510
270642,202005,222,188,34,196460,35530,231990
270644,202005,252,164,88,172425,91960,264385
270650,202005,327,193,134,202730,140030,342760
270660,202005,249,205,44,214225,45980,260205
270670,202005,3056,2334,722,2446348.55,757625,3203973.55
270680,202005,443,263,180,274835,189145,463980
270690,202005,1168,760,408,794200.95,428450,1222650.95
270700,202005,28,23,5,24035,5225,29260
270710,202005,880,682,198,712690,206910,919600
270720,202005,244,193,51,202730,54340,257070
270730,202005,1855,1114,741,1168902.66,781660.25,1950562.91
270740,202005,41,28,13,29260,13585,42845
270750,202005,636,478,158,499510,165110,664620
270760,202005,291,213,78,222619.83,81510,304129.83
270770,202005,2750,1818,932,1902946.55,978120,2881066.55
270780,202005,77,48,29,50160,30305,80465
270790,202005,266,174,92,181830,96140,277970
270800,202005,1973,1589,384,1661550,402325,2063875
270810,202005,281,221,60,231990,63745,295735
270820,202005,143,96,47,100320,49115.5,149435.5
270830,202005,790,590,200,616550,209000,825550
270840,202005,1385,1049,336,1099340,352165.85,1451505.85
270850,202005,1513,944,569,990660.5,604010,1594670.5
270860,202005,2533,1675,858,1751420.46,898700,2650120.46
270870,202005,124,65,59,68238.5,61655,129893.5
270880,202005,900,699,201,731500,210045,941545
270890,202005,291,217,74,226765,77330,304095
270895,202005,63,54,9,56430,9405,65835
270900,202005,92,71,21,74195,21945,96140
270910,202005,304,248,56,259160,59565,318725
270915,202005,1917,1212,705,1268630.75,741950.6,2010581.35
270920,202005,470,395,75,412775,78375,491150
270930,202005,5949,4458,1491,4662824.83,1565410.03,6228234.86
270940,202005,2316,1803,513,1888315,537130,2425445
280010,202005,40,34,6,35530,6270,41800
280020,202005,472,410,62,428450.69,65835,494285.69
280030,202005,20473,13226,7247,13840007.72,7585661.99,21425669.71
280040,202005,330,215,115,224675,120175,344850
280050,202005,398,306,92,319770,97185,416955
280060,202005,354,225,129,235125.7,135850,370975.7
280067,202005,1061,761,300,797335,313500.62,1110835.62
280070,202005,123,99,24,103455,25080,128535
280100,202005,625,488,137,511005.5,143165,654170.5
280110,202005,76,71,5,74195,5225,79420
280120,202005,651,533,118,556985,123310,680295
280130,202005,1711,1115,596,1166220,623865.5,1790085.5
280140,202005,479,393,86,410685.5,89870,500555.5
280150,202005,393,285,108,297825,112860,410685
280160,202005,106,88,18,91960,19855,111815
280170,202005,400,275,125,288420.72,131670,420090.72
280190,202005,30,28,2,29260,2090,31350
280200,202005,28,24,4,25080,4180,29260
280210,202005,2940,2111,829,2205872.36,867350.5,3073222.86
280220,202005,39,31,8,32395,8360,40755
280230,202005,328,270,58,282150,60610,342760
280240,202005,117,111,6,115995,6270,122265
280250,202005,16,10,6,10450,6270,16720
280260,202005,82,74,8,77330,8360,85690
280270,202005,147,115,32,120175,33440,153615
280280,202005,193,122,71,127490.37,76285,203775.37
280290,202005,3341,2419,922,2529879.16,966625.1,3496504.26
280300,202005,1607,1252,355,1308340.5,370975,1679315.5
280310,202005,101,96,5,100320.5,5225,105545.5
280320,202005,662,464,198,485925,206910,692835
280330,202005,329,236,93,249755,97185,346940
280340,202005,406,328,78,343805.5,81510,425315.5
280350,202005,3664,2855,809,2985567.04,849585.75,3835152.79
280360,202005,458,299,159,312455,167200,479655
280370,202005,98,86,12,89870.65,12540,102410.65
280380,202005,54,42,12,43890,12540,56430
280390,202005,168,145,23,152570,24035,176605
280400,202005,357,244,113,256026.4,118085,374111.4
280410,202005,288,235,53,245575,55385,300960
280420,202005,171,143,28,149435,29260,178695
280430,202005,36,27,9,28215,9405,37620
280440,202005,696,546,150,570570.65,156750,727320.65
280445,202005,117,107,10,111815,10450,122265
280450,202005,1193,1031,162,1077395,170335,1247730
280460,202005,618,450,168,470251.63,176605,646856.63
280470,202005,185,172,13,179740,13585.75,193325.75
280480,202005,2632,1844,788,1926983.21,824505.32,2751488.53
280490,202005,264,251,13,262295.66,14630,276925.66
280500,202005,43,38,5,39710,5225,44935
280510,202005,143,116,27,121220,28215.5,149435.5
280520,202005,54,40,14,41800,14630,56430
280530,202005,74,49,25,51205,26125,77330
280540,202005,534,445,89,467115,93005,560120
280550,202005,727,672,55,702241.71,57475,759716.71
280560,202005,497,438,59,457710,61655,519365
280570,202005,2222,1738,484,1816210.95,505780,2321990.95
280580,202005,599,461,138,482790,144210.5,627000.5
280590,202005,202,124,78,129580,81510,211090
280600,202005,388,324,64,338580,66880,405460
280610,202005,115,88,27,91960,28215,120175
280620,202005,554,456,98,476520,102410,578930
280630,202005,148,123,25,128535,26125,154660
280640,202005,191,150,41,156750,42845,199595
280650,202005,89,60,29,62700,30305,93005
280660,202005,142,107,35,111815,37620,149435
280670,202005,1826,1150,676,1203843.33,708511,1912354.33
280680,202005,180,157,23,164065.22,24035,188100.22
280690,202005,80,71,9,74195,9405,83600
280700,202005,22,22,0,22990,0,22990
280710,202005,1473,1133,340,1183985,355300,1539285
280720,202005,112,72,40,75240,41800,117040
280730,202005,25,20,5,20900,5225,26125
280740,202005,2525,1882,643,1970870.5,671935,2642805.5
280750,202005,233,204,29,214225,30305,244530
280760,202005,777,532,245,555940,256025,811965
290010,202005,205,142,63,148390,65835,214225
290020,202005,180,163,17,170335,17765,188100
290030,202005,627,400,227,418000,237215,655215
290035,202005,128,104,24,109725,26125,135850
290040,202005,301,201,100,210045,104500,314545
290050,202005,87,67,20,70015,21945,91960
290060,202005,269,119,150,124355,156750,281105
290070,202005,5767,2787,2980,2916596.1,3123505.75,6040101.85
290080,202005,462,211,251,220495,265430,485925
290090,202005,390,176,214,183920,224675,408595
290100,202005,1653,1072,581,1120240,607146,1727386
290110,202005,827,481,346,506825.75,361570,868395.75
290115,202005,197,182,15,190190,15675,205865
290120,202005,764,503,261,525635,273790,799425
290130,202005,429,263,166,274835,173470,448305
290135,202005,300,228,72,238260,75240,313500
290140,202005,317,262,55,273790,57475,331265
290150,202005,140,100,40,104500,41800,146300
290160,202005,244,186,58,194370,61655,256025
290170,202005,94,67,27,70015,28215,98230
290180,202005,177,130,47,135850,49115,184965
290190,202005,439,360,79,377245,84645,461890
290195,202005,318,203,115,212135,120175,332310
290200,202005,270,220,50,229900,52250,282150
290205,202005,151,92,59,96140,61655,157795
290210,202005,1169,859,310,897655.5,323950,1221605.5
290220,202005,223,123,100,128535,104500,233035
290225,202005,294,113,181,118085,190190,308275
290230,202005,75,49,26,51205,27170,78375
290240,202005,361,135,226,141075,237215,378290
290250,202005,255,235,20,245575,20900,266475
290260,202005,319,261,58,272745.5,61655,334400.5
290265,202005,187,162,25,169290,26125,195415
290270,202005,1425,1183,242,1236235,253935.5,1490170.5
290280,202005,479,340,139,355300,145255,500555
290290,202005,1319,784,535,819281.09,560120.5,1379401.59
290300,202005,440,374,66,390830.5,68970,459800.5
290310,202005,298,136,162,142120,170335,312455
290320,202005,4037,2498,1539,2614590.3,1611390.1,4225980.4
290323,202005,190,165,25,172425,26125,198550
290327,202005,167,133,34,138985,35530,174515
290330,202005,104,58,46,60610,48070,108680
290340,202005,838,344,494,360525,516230,876755
290350,202005,628,382,246,399190,257070,656260
290360,202005,352,271,81,285286.64,84645,369931.64
290370,202005,918,391,527,408595.75,552805,961400.75
290380,202005,318,197,121,205865,126445,332310
290390,202005,2442,1525,917,1594671.75,960355,2555026.75
290395,202005,247,143,104,149435.25,108680,258115.25
290400,202005,274,203,71,213180.5,74195,287375.5
290405,202005,250,217,33,226765,35530,262295
290410,202005,631,528,103,553850.53,107635,661485.53
290420,202005,251,202,49,211090,51205,262295
290430,202005,478,309,169,322905,176605,499510
290440,202005,75,67,8,70015,8360,78375
290450,202005,210,160,50,167200,52250,219450
290460,202005,1953,1183,770,1238325,807785,2046110
290470,202005,1408,606,802,636405,843315,1479720
290475,202005,560,523,37,546535.2,38665,585200.2
290480,202005,290,162,128,169290,133760,303050
290485,202005,239,221,18,230945,19855,250800
290490,202005,1213,872,341,911240,359480,1270720
290500,202005,734,380,354,397100,369930,767030
290510,202005,226,176,50,183920,52250,236170
290515,202005,151,92,59,96140,61655,157795
290520,202005,1427,941,486,986480,507871.44,1494351.44
290530,202005,300,277,23,290510,25080,315590
290540,202005,107,56,51,58520,53295,111815
290550,202005,162,136,26,142120,27170,169290
290560,202005,3219,1361,1858,1422245,1943700,3365945
290570,202005,6203,3012,3191,3150676.4,3346091.5,6496767.9
290580,202005,1293,770,523,804650,547580,1352230
290590,202005,567,468,99,489060,104500,593560
290600,202005,1772,1222,550,1276990.63,575795,1852785.63
290610,202005,209,188,21,196460,21945,218405
290620,202005,357,318,39,332310,40755,373065
290630,202005,2032,858,1174,896610,1226830.5,2123440.5
290640,202005,153,123,30,128535,31350,159885
290650,202005,1793,825,968,862125.84,1013650,1875775.84
290660,202005,279,225,54,235125,56430,291555
290670,202005,945,487,458,509961.21,479655,989616.21
290680,202005,1231,989,242,1035595,254980,1290575
290682,202005,308,231,77,241395.8,80465,321860.8
290685,202005,238,155,83,161975,87780,249755
290687,202005,1042,673,369,703455.1,386650,1090105.1
290689,202005,146,80,66,83600,68970,152570
290690,202005,610,254,356,265430,373065,638495
290700,202005,250,124,126,129580,131670,261250
290710,202005,747,510,237,532950,247665,780615
290720,202005,1028,833,195,871530,204820,1076350
290730,202005,1155,666,489,698060.75,513095,1211155.75
290740,202005,17,14,3,14630,3135,17765
290750,202005,1429,629,800,657305,836001.54,1493306.54
290755,202005,71,64,7,66880,7315,74195
290760,202005,300,261,39,273790,40755,314545
290770,202005,187,176,11,183920,11495.5,195415.5
290780,202005,1106,845,261,883026,272745,1155771
290790,202005,365,257,108,268565,112860.5,381425.5
290800,202005,2519,1015,1504,1061720.5,1576905,2638625.5
290810,202005,466,322,144,336490,152570,489060
290820,202005,398,232,166,243485,175560,419045
290830,202005,417,296,121,310365,126445,436810
290840,202005,1757,1094,663,1143231.7,692835.5,1836067.2
290850,202005,834,445,389,467115,408595,875710
290860,202005,651,294,357,307230,373065.5,680295.5
290870,202005,641,453,188,474430.6,196460.6,670891.2
290880,202005,122,66,56,68970,58520,127490
290890,202005,387,261,126,272745,131670,404415
290900,202005,166,127,39,132715,40755,173470
290910,202005,386,295,91,308275,95095,403370
290920,202005,215,185,30,193325,31350,224675
290930,202005,824,625,199,653125.5,209000,862125.5
290940,202005,248,206,42,215270,43890,259160
290950,202005,156,96,60,100320,62700,163020
290960,202005,474,331,143,346940,151525,498465
290970,202005,254,223,31,233035,32395,265430
290980,202005,1632,1149,483,1200705.7,505781,1706486.7
290990,202005,394,332,62,347985,64790,412775
291000,202005,869,253,616,264385,644765,909150
291005,202005,2320,1029,1291,1076350,1350140,2426490
291010,202005,158,142,16,148390,16720,165110
291020,202005,102,81,21,84645,21945,106590
291030,202005,97,71,26,74195,27170,101365
291040,202005,610,338,272,353210,285285,638495
291050,202005,1432,786,646,822415,676115,1498530
291060,202005,1540,849,691,887205,722095,1609300
291070,202005,1970,1462,508,1528836,530860.12,2059696.12
291072,202005,7276,2703,4573,2829861.1,4794462,7624323.1
291075,202005,238,194,44,202730,45980,248710
291077,202005,55,37,18,38665,18810,57475
291080,202005,20377,8919,11458,9334988.06,11992421.77,21327409.83
291085,202005,299,245,54,256025,56430,312455
291090,202005,303,126,177,131670.5,184965,316635.5
291100,202005,660,198,462,206910,483835,690745
291110,202005,419,320,99,334400,103455,437855
291120,202005,2450,1213,1237,1268630.75,1294755,2563385.75
291125,202005,63,30,33,31350,34485,65835
291130,202005,203,180,23,188100,24035,212135
291140,202005,137,110,27,114950,28215.5,143165.5
291150,202005,387,150,237,156750,249755,406505
291160,202005,386,316,70,331265.25,73150,404415.25
291165,202005,39,31,8,32395,8360,40755
291170,202005,3132,1570,1562,1645877.92,1638560.5,3284438.42
291180,202005,1276,506,770,529815.31,805695,1335510.31
291185,202005,91,86,5,89870,5225,95095
291190,202005,1376,615,761,642675.25,795245,1437920.25
291200,202005,169,126,43,131670,44935,176605
291210,202005,2289,918,1371,960355.2,1436875.5,2397230.7
291220,202005,273,206,67,215270,70015,285285
291230,202005,985,341,644,357390.5,676115,1033505.5
291240,202005,431,404,27,422180.5,28215,450395.5
291250,202005,443,358,85,375155,88825,463980
291260,202005,57,46,11,48070,11495,59565
291270,202005,1168,486,682,507870,712690,1220560
291280,202005,363,172,191,180785,199595,380380
291290,202005,1737,896,841,937365.5,881981,1819346.5
291300,202005,233,184,49,192280,51205,243485
291310,202005,220,200,20,209000,20900,229900
291320,202005,1374,967,407,1010515,425315,1435830
291330,202005,130,111,19,115995,19855,135850
291340,202005,204,117,87,122265,91960,214225
291345,202005,133,93,40,97185,42845,140030
291350,202005,1646,576,1070,604010,1119195.75,1723205.75
291360,202005,8508,4110,4398,4301221.25,4610541.25,8911762.50
291370,202005,1123,646,477,675070.5,500555,1175625.5
291380,202005,266,210,56,220495,58520,279015
291390,202005,3911,1724,2187,1803672.08,2291686,4095358.08
291400,202005,2090,1483,607,1549735,635360.84,2185095.84
291410,202005,186,164,22,171380,22990,194370
291420,202005,120,87,33,90915,34485,125400
291430,202005,165,90,75,94050,78375.02,172425.02
291440,202005,522,428,94,448306,98230,546536
291450,202005,908,578,330,606100.25,344850,950950.25
291460,202005,1847,1504,343,1574816,359480.5,1934296.5
291465,202005,2186,1032,1154,1079485.5,1206975,2286460.5
291470,202005,2869,1447,1422,1512115.97,1488080.5,3000196.47
291480,202005,11896,5255,6641,5497749.88,6960749.21,12458499.09
291490,202005,606,243,363,256025,379335,635360
291500,202005,377,219,158,228855,165110,393965
291510,202005,1231,479,752,501600,785840,1287440
291520,202005,947,429,518,450395,541310,991705
291530,202005,944,255,689,266475,721050,987525
291535,202005,126,104,22,108680,22990,131670
291540,202005,345,102,243,106590.5,253935,360525.5
291550,202005,1227,579,648,605055,680295.5,1285350.5
291560,202005,5312,2674,2638,2796420,2760891,5557311
291570,202005,199,104,95,108680,99275,207955
291580,202005,1225,755,470,788975.05,492195,1281170.05
291590,202005,88,36,52,37620,54340.5,91960.5
291600,202005,1153,566,587,592515.75,613415,1205930.75
291610,202005,1465,707,758,741950,792110,1534060
291620,202005,580,267,313,279015,327085,606100
291630,202005,486,149,337,156750,354255,511005
291640,202005,4012,2049,1963,2142252.2,2052381.5,4194633.7
291650,202005,421,288,133,302006.12,140030,442036.12
291660,202005,398,161,237,168245.29,249755,418000.29
291670,202005,224,135,89,141075,93005,234080
291680,202005,667,396,271,413820,283195.5,697015.5
291685,202005,589,329,260,344850,272745,617595
291690,202005,538,323,215,337535,224675.27,562210.27
291700,202005,973,757,216,792110,226765,1018875
291710,202005,1654,790,864,825550.25,904970,1730520.25
291720,202005,428,285,143,297825,149435,447260
291730,202005,942,556,386,581020,404415,985435
291733,202005,287,195,92,203775,96140,299915
291735,202005,76,57,19,59565,19855,79420
291740,202005,359,276,83,288420,86735,375155
291750,202005,2146,1391,755,1455685.38,791065,2246750.38
291760,202005,3002,1654,1348,1728430,1408660,3137090
291770,202005,786,533,253,556986.05,265430,822416.05
291780,202005,59,36,23,37620,24035,61655
291790,202005,163,81,82,84645,85690,170335
291800,202005,10123,4168,5955,4363923.09,6233426.75,10597349.84
291810,202005,1108,827,281,864215.5,293645,1157860.5
291820,202005,280,201,79,210045,82555,292600
291830,202005,1074,429,645,448306.46,674025,1122331.46
291835,202005,580,538,42,562210,43890,606100
291840,202005,4893,2478,2415,2592646.21,2529945.5,5122591.71
291845,202005,269,88,181,91960,191235,283195
291850,202005,328,291,37,304095,38665,342760
291855,202005,269,106,163,110770,171380,282150
291860,202005,171,108,63,112860,65835,178695
291870,202005,86,35,51,36575,53295,89870
291875,202005,183,169,14,176605,14630,191235
291880,202005,457,361,96,378290,100320,478610
291890,202005,242,77,165,80465,173470.5,253935.5
291900,202005,59,34,25,35530,27170,62700
291905,202005,130,95,35,99275.5,36575,135850.5
291910,202005,164,133,31,140030,32395,172425
291915,202005,425,377,48,396055.25,50160,446215.25
291920,202005,5095,2565,2530,2684605,2650120.5,5334725.5
291930,202005,172,102,70,106590.55,73150,179740.55
291940,202005,361,207,154,216315.5,161975,378290.5
291950,202005,1154,933,221,978121,230945.5,1209066.5
291955,202005,1255,744,511,777480,537130,1314610
291960,202005,190,137,53,143165,55385,198550
291970,202005,760,580,180,606100.01,188100,794200.01
291980,202005,1497,1328,169,1388806.23,178695.5,1567501.73
291990,202005,133,124,9,129580,9405,138985
291992,202005,172,88,84,91960,87780,179740
291995,202005,170,113,57,118085,59565,177650
292000,202005,399,307,92,320815,96140,416955
292010,202005,315,219,96,228855,100320,329175
292020,202005,301,222,79,231990,82555,314545
292030,202005,146,113,33,119130,34485,153615
292040,202005,634,320,314,334400,328130,662530
292045,202005,105,96,9,100320,9405,109725
292050,202005,944,690,254,722095,265430.5,987525.5
292060,202005,909,752,157,787930.65,165110,953040.65
292070,202005,56,21,35,21945,36575,58520
292080,202005,143,99,44,103455,45980,149435
292090,202005,536,186,350,194370,365750,560120
292100,202005,1494,637,857,665665,898700,1564365
292105,202005,196,172,24,179740,25080,204820
292110,202005,2264,828,1436,867350,1503755,2371105
292120,202005,698,549,149,573705,155705,729410
292130,202005,441,251,190,262295,198550,460845
292140,202005,209,168,41,175560,43890,219450
292145,202005,161,87,74,90915.5,77330,168245.5
292150,202005,1482,1207,275,1261315,287375,1548690
292160,202005,172,141,31,147345,32395,179740
292170,202005,1217,1053,164,1100385,172425,1272810
292180,202005,222,161,61,168245,63745,231990
292190,202005,162,104,58,108680,60610,169290
292200,202005,1344,493,851,515185,890340.5,1405525.5
292205,202005,125,110,15,114950,15675,130625
292210,202005,365,254,111,265430,117040.25,382470.25
292220,202005,27,21,6,21945,6270,28215
292225,202005,41,35,6,36575,6270,42845
292230,202005,969,773,196,807785.75,206910,1014695.75
292240,202005,618,442,176,461890.75,183920,645810.75
292250,202005,1751,1153,598,1204885,624910,1829795
292260,202005,413,249,164,260205,171380,431585
292265,202005,252,179,73,187055,77330,264385
292270,202005,740,339,401,354255,419045,773300
292273,202005,205,113,92,118085,96140,214225
292275,202005,172,85,87,88825,90915,179740
292280,202005,141,97,44,101365,45980,147345
292285,202005,75,62,13,64790,13585,78375
292290,202005,571,384,187,401280,195415.5,596695.5
292300,202005,1683,629,1054,658350,1102475.3,1760825.3
292303,202005,111,72,39,75240,40755,115995
292305,202005,114,84,30,87780,31350,119130
292310,202005,931,611,320,639541.25,334400.9,973942.15
292320,202005,600,456,144,478610,150480,629090
292330,202005,178,102,76,106590,79420,186010
292335,202005,281,219,62,228855,64790,293645
292340,202005,575,403,172,421135,179740,600875
292350,202005,271,145,126,151525,131670,283195
292360,202005,707,540,167,564300.9,175560,739860.9
292370,202005,739,566,173,591470,180785,772255
292380,202005,643,515,128,538175.35,134805,672980.35
292390,202005,482,190,292,198550,305140,503690
292400,202005,3631,2230,1401,2332442.61,1465090,3797532.61
292405,202005,259,171,88,178695,91960,270655
292410,202005,141,86,55,89870,57475,147345
292420,202005,293,254,39,265430,40755,306185
292430,202005,539,410,129,428450,134805,563255
292440,202005,593,514,79,538175.16,83600,621775.16
292450,202005,250,193,57,202730,59565,262295
292460,202005,554,412,142,430540.95,148390,578930.95
292465,202005,212,176,36,183920,37620,221540
292467,202005,128,76,52,79420,54340,133760
292470,202005,290,197,93,205865,97185,303050
292480,202005,370,254,116,265430,121220.5,386650.5
292490,202005,235,164,71,172425,74195,246620
292500,202005,880,389,491,406505.15,514140,920645.15
292510,202005,3456,1600,1856,1674090.6,1942655,3616745.6
292520,202005,1093,515,578,539220,606100,1145320
292525,202005,393,277,116,289465,122265,411730
292530,202005,4380,1766,2614,1848605.96,2734766.5,4583372.46
292540,202005,473,264,209,275880,218405,494285
292550,202005,1095,581,514,607145.5,537130,1144275.5
292560,202005,330,310,20,323950,20900,344850
292570,202005,306,239,67,249755,70015,319770
292575,202005,498,327,171,341715.5,178695.79,520411.29
292580,202005,996,656,340,685520,355300.5,1040820.5
292590,202005,568,492,76,516230,80465,596695
292593,202005,141,111,30,115995,31350,147345
292595,202005,199,156,43,163020,44935,207955
292600,202005,1264,918,346,959310.29,361570,1320880.29
292610,202005,135,104,31,108680,32395,141075
292620,202005,530,443,87,462935.79,90915,553850.79
292630,202005,1437,807,630,844360.42,658350.25,1502710.67
292640,202005,816,563,253,588335,264385,852720
292650,202005,190,157,33,165110.5,34485,199595.5
292660,202005,2032,1458,574,1526745,604010.42,2130755.42
292665,202005,141,99,42,103455,43890,147345
292670,202005,390,315,75,331265,78375,409640
292680,202005,255,193,62,201685,64790.5,266475.5
292690,202005,195,145,50,151525,52250,203775
292700,202005,969,642,327,672980,342760,1015740
292710,202005,114,98,16,102410,16720,119130
292720,202005,931,529,402,552805,420090,972895
292730,202005,198,91,107,95095,111815,206910
292740,202005,69304,33787,35517,35376404.86,37231270.66,72607675.52
292750,202005,391,276,115,288420.95,120175,408595.95
292760,202005,333,278,55,291556.45,58520,350076.45
292770,202005,822,351,471,366795,492195,858990
292780,202005,408,162,246,169290,258115,427405
292790,202005,766,390,376,408595,393965,802560
292800,202005,1255,755,500,788975,524590,1313565
292805,202005,396,117,279,122265,292600,414865
292810,202005,1500,848,652,887206.5,682385,1569591.5
292820,202005,714,592,122,619686.25,127490,747176.25
292830,202005,111,91,20,95095,20900,115995
292840,202005,685,563,122,588335,127490,715825
292850,202005,143,95,48,99275,50160,149435
292860,202005,2180,1271,909,1330285.5,950950,2281235.5
292870,202005,3499,2334,1165,2440075.45,1219515,3659590.45
292880,202005,1500,986,514,1032460.05,539220,1571680.05
292890,202005,519,443,76,462935,79420,542355
292895,202005,143,94,49,98230,51205,149435
292900,202005,390,280,110,292600.4,117040,409640.4
292905,202005,474,241,233,251845,243485,495330
292910,202005,458,346,112,361570.75,117040,478610.75
292920,202005,527,229,298,239305,311410,550715
292925,202005,488,449,39,469205,40755,509960
292930,202005,607,369,238,387695,249755,637450
292935,202005,281,122,159,127490,167200,294690
292937,202005,222,158,64,166155,67925,234080
292940,202005,190,147,43,154660,44935,199595
292950,202005,1169,586,583,612370.75,611325.6,1223696.35
292960,202005,585,414,171,433675,178695,612370
292970,202005,248,175,73,182875,77330,260205
292975,202005,119,68,51,71060,53295,124355
292980,202005,285,194,91,202730.52,95095,297825.52
292990,202005,1334,990,344,1035596.55,359480,1395076.55
293000,202005,111,77,34,80465,35530,115995
293010,202005,2820,1681,1139,1756645.75,1192345.72,2948991.47
293015,202005,637,519,118,543400,124355,667755
293020,202005,328,269,59,281105,61655,342760
293030,202005,601,523,78,546535,81510,628045
293040,202005,352,277,75,292600,78375,370975
293050,202005,2872,1702,1170,1778590.5,1223695.5,3002286.0
293060,202005,262,210,52,219450.6,54340,273790.6
293070,202005,3487,1759,1728,1842337.22,1810986.75,3653323.97
293075,202005,91,61,30,63745,31350,95095
293076,202005,74,52,22,54340,22990,77330
293077,202005,506,296,210,310365.5,219450,529815.5
293080,202005,440,395,45,412775.85,47025,459800.85
293090,202005,130,115,15,121220,15675,136895
293100,202005,523,366,157,382470,166155,548625
293105,202005,347,251,96,262295,100320,362615
293110,202005,167,118,49,123310,51205,174515
293120,202005,318,215,103,225720,107635,333355
293130,202005,242,168,74,175560,77330,252890
293135,202005,8063,3161,4902,3307426.75,5129909.5,8437336.25
293140,202005,210,132,78,137940,81510,219450
293150,202005,330,285,45,298870,47025,345895
293160,202005,422,247,175,258115,183920,442035
293170,202005,177,123,54,128535,56430,184965
293180,202005,510,361,149,378290.5,155705,533995.5
293190,202005,1346,937,409,979165.61,427405,1406570.61
293200,202005,546,484,62,505780,64790,570570
293210,202005,399,303,96,316635,101365,418000
293220,202005,2504,1053,1451,1101430,1528835,2630265
293230,202005,1739,643,1096,672980.94,1147410,1820390.94
293240,202005,233,215,18,224675,18810,243485
293245,202005,126,107,19,111815,19855,131670
293250,202005,725,260,465,271700.9,486970,758670.9
293260,202005,302,251,51,262295,53295,315590
293270,202005,1169,540,629,566390.25,659395,1225785.25
293280,202005,270,149,121,155705,127490,283195
293290,202005,3055,1984,1071,2075370,1119195,3194565
293300,202005,734,524,210,548625.75,219450,768075.75
293305,202005,191,154,37,160930,38665,199595
293310,202005,152,113,39,118085,40755,158840
293315,202005,164,129,35,134805,37620,172425
293317,202005,87,63,24,65835,25080,90915
293320,202005,1058,587,471,613415.92,495330,1108745.92
293325,202005,183,68,115,71060,120175,191235
293330,202005,13694,6399,7295,6690092.91,7626413.75,14316506.66
293340,202005,264,188,76,197505,79420,276925
293345,202005,245,200,45,209000,47025,256025
293350,202005,621,358,263,374110,274835,648945
293360,202005,1532,1099,433,1149500,452485,1601985
310010,202005,138,76,62,79420,64790.5,144210.5
310020,202005,1037,577,460,602965,480700,1083665
310030,202005,333,266,67,280060,70015,350075
310040,202005,44,30,14,31350,14630,45980
310050,202005,182,115,67,120175.5,70015,190190.5
310060,202005,243,168,75,175560.5,78375,253935.5
310070,202005,14,9,5,9405,5225,14630
310080,202005,42,26,16,27170,17765,44935
310090,202005,1022,528,494,551762,516231,1067993
310100,202005,301,223,78,233035,81510,314545
310110,202005,704,387,317,405460,333355,738815
310120,202005,374,214,160,223630,167200,390830
310130,202005,32,19,13,19855,13585,33440
310140,202005,26,13,13,13585,13585,27170
310150,202005,1213,829,384,867350.5,402326,1269676.5
310160,202005,2072,1012,1060,1057542.15,1107700.5,2165242.65
310163,202005,87,50,37,52250,38665,90915
310170,202005,2553,1129,1424,1180851.08,1489127,2669978.08
310180,202005,148,54,94,56430.5,98230,154660.5
310190,202005,477,329,148,343805,154660,498465
310200,202005,488,311,177,324995,184965,509960
310205,202005,57,39,18,40755,18810,59565
310210,202005,283,228,55,239305,57475,296780
310220,202005,62,34,28,35530,29260,64790
310230,202005,273,187,86,196460,89870,286330
310240,202005,106,94,12,98230,12540,110770
310250,202005,95,79,16,83600,16720,100320
310260,202005,767,407,360,427406.17,377245,804651.17
310270,202005,267,172,95,179740.6,99275,279015.6
310280,202005,375,275,100,287375,104500,391875
310285,202005,211,153,58,159885,60610,220495
310290,202005,244,131,113,138985,120175,259160
310300,202005,156,130,26,135850,28215,164065
310310,202005,10,8,2,8360,2090,10450
310320,202005,29,12,17,13585,18810,32395
310330,202005,41,27,14,28215,14630,42845
310340,202005,1752,1151,601,1202797,628045.5,1830842.5
310350,202005,2808,1499,1309,1571680,1371040,2942720
310360,202005,40,34,6,35530,6270,41800
310370,202005,115,95,20,99275,20900.5,120175.5
310375,202005,104,38,66,39710,68970,108680
310380,202005,47,27,20,28215,20900,49115
310390,202005,93,62,31,64790,32395,97185
310400,202005,2358,1523,835,1593626,873620,2467246
310410,202005,129,72,57,76285,59565,135850
310420,202005,669,354,315,370975,329175,700150
310430,202005,309,196,113,204820,118085,322905
310440,202005,77,45,32,47025,33440,80465
310445,202005,80,67,13,70015,13585,83600
310450,202005,631,388,243,407550,253935,661485
310460,202005,263,184,79,193325,82555,275880
310470,202005,506,319,187,333355.5,197505,530860.5
310480,202005,74,52,22,54340,24035,78375
310490,202005,535,252,283,263340,295735,559075
310500,202005,133,53,80,55385,83600,138985
310510,202005,599,413,186,431585,194370,625955
310520,202005,135,94,41,98230,42845,141075
310530,202005,106,46,60,48070,62700,110770
310540,202005,466,272,194,284240,203775,488015
310550,202005,77,49,28,51205,30305,81510
310560,202005,2976,2049,927,2144341,969760,3114101
310570,202005,103,68,35,71060,36575,107635
310590,202005,372,236,136,246620.25,142120,388740.25
310600,202005,152,83,69,86735.5,72105,158840.5
310610,202005,60,24,36,25080,37620,62700
310620,202005,47267,22518,24749,23565731.92,25943176.65,49508908.57
310630,202005,638,393,245,413820,256025.5,669845.5
310640,202005,130,101,29,105545,31350,136895
310650,202005,161,144,17,150480,17765,168245
310660,202005,99,64,35,66880,38665,105545
310665,202005,59,45,14,47025,14630,61655
310670,202005,6677,2882,3795,3015872.5,3976226,6992098.5
310680,202005,57,36,21,37620,21945,59565
310690,202005,615,431,184,450395.25,193325,643720.25
310700,202005,57,38,19,39710,19855,59565
310710,202005,1329,906,423,949905.5,442035.5,1391941.0
310720,202005,127,37,90,38665,94050,132715
310730,202005,1447,1000,447,1047091.25,472340.01,1519431.26
310740,202005,981,545,436,571616,456665.25,1028281.25
310750,202005,242,145,97,151525.65,101365,252890.65
310760,202005,63,46,17,48070,18810.5,66880.5
310770,202005,103,48,55,50160,57475,107635
310780,202005,369,296,73,309320,76285,385605
310790,202005,101,83,18,86735,18810,105545
310800,202005,446,210,236,222585.25,246620,469205.25
310810,202005,171,122,49,127491.22,51205,178696.22
310820,202005,340,268,72,280060,75240,355300
310825,202005,192,163,29,170335,30305,200640
310830,202005,472,226,246,237215.5,257070,494285.5
310840,202005,365,210,155,219450,161975,381425
310850,202005,103,82,21,85690,21945,107635
310855,202005,394,312,82,326040,85690,411730
310860,202005,1595,1178,417,1232058,435766.25,1667824.25
310870,202005,53,43,10,44935,10450,55385
310880,202005,81,63,18,65835,18810,84645
310890,202005,306,178,128,186010,133760,319770
310900,202005,654,302,352,315599.86,367852.96,683452.82
310910,202005,237,161,76,168245.5,79420,247665.5
310920,202005,458,272,186,284241.45,194370.5,478611.95
310925,202005,37,31,6,32395,6270,38665
310930,202005,1306,822,484,861080,506825,1367905
310940,202005,706,349,357,365750,376200,741950
310945,202005,118,74,44,77330,45980,123310
310950,202005,234,188,46,196460,48070,244530
310960,202005,78,25,53,26125,55385,81510
310970,202005,158,99,59,104500,61655.5,166155.5
310980,202005,51,32,19,33440,19855,53295
310990,202005,159,81,78,84645,81510,166155
311000,202005,820,406,414,424271.49,432630.5,856901.99
311010,202005,44,39,5,40755,5225,45980
311020,202005,45,27,18,28215,18810,47025
311030,202005,384,223,161,234080.5,168245,402325.5
311040,202005,43,32,11,33440,11495,44935
311050,202005,492,190,302,199595,315590,515185
311060,202005,786,434,352,454575,368885.5,823460.5
311070,202005,341,154,187,160930,195415,356345
311080,202005,109,60,49,62700,51205,113905
311090,202005,337,158,179,165110,187055,352165
311100,202005,590,354,236,370975,247665,618640
311110,202005,694,485,209,506825,219450,726275
311115,202005,76,54,22,56430,22990,79420
311120,202005,1084,576,508,601920.5,535040,1136960.5
311130,202005,355,214,141,223630,147345,370975
311140,202005,170,91,79,95095,82555,177650
311150,202005,350,227,123,237215,128535,365750
311160,202005,698,497,201,519365.5,210045,729410.5
311170,202005,86,68,18,71060,18810,89870
311180,202005,328,221,107,231990,112860.5,344850.5
311190,202005,41,20,21,20900,21945,42845
311200,202005,326,229,97,240350,102410,342760
311205,202005,35,24,11,25080,11495,36575
311210,202005,48,42,6,43890.5,6270,50160.5
311220,202005,23,20,3,20900,3135,24035
311230,202005,1636,1073,563,1122330.5,589380,1711710.5
311240,202005,183,118,65,123310,67925,191235
311250,202005,95,27,68,28215,71060,99275
311260,202005,555,348,207,364705,216315,581020
311265,202005,123,83,40,86735,41800,128535
311270,202005,285,195,90,203775,94050,297825
311280,202005,214,98,116,102410,121220,223630
311290,202005,103,85,18,88825,18810,107635
311300,202005,586,368,218,386650,227810,614460
311310,202005,21,16,5,16720,5225,21945
311320,202005,667,494,173,516230,181830,698060
311330,202005,1092,801,291,838090,306185.5,1144275.5
311340,202005,2638,1862,776,1947881,811965,2759846
311350,202005,276,214,62,224675,64790,289465
311360,202005,172,106,66,110770,68970,179740
311370,202005,1216,499,717,521455.25,750310,1271765.25
311380,202005,7,6,1,6270,1045,7315
311390,202005,258,141,117,147345,122265,269610
311400,202005,140,89,51,93005,53295,146300
311410,202005,111,60,51,62700,53295,115995
311420,202005,304,164,140,171380,147345,318725
311430,202005,852,566,286,591470,298870.5,890340.5
311440,202005,460,325,135,339625,141075,480700
311450,202005,314,192,122,200640,127490,328130
311455,202005,280,193,87,201685,90915,292600
311460,202005,141,61,80,63745,83600,147345
311470,202005,22,12,10,12540,10450,22990
311480,202005,48,22,26,22990,27170,50160
311490,202005,13,9,4,9405,4180,13585
311500,202005,24,11,13,11495,13585,25080
311510,202005,637,438,199,459800,211090,670890
311520,202005,41,33,8,34485,8360,42845
311530,202005,1814,1334,480,1395076.7,501600,1896676.7
311535,202005,67,47,20,49115,20900,70015
311540,202005,34,30,4,31350,4180,35530
311545,202005,178,133,45,138985,48070,187055
311547,202005,38,31,7,32395,7315,39710
311550,202005,695,323,372,337535,389785,727320
311560,202005,43,29,14,30305,14630,44935
311570,202005,284,190,94,198550,98230,296780
311580,202005,334,198,136,206910,142120,349030
311590,202005,32,29,3,30305,3135,33440
311600,202005,107,83,24,86735,26125,112860
311610,202005,255,221,34,230945.25,35530,266475.25
311615,202005,79,63,16,65835,16720,82555
311620,202005,26,14,12,14630,12540,27170
311630,202005,84,71,13,74195,13585,87780
311640,202005,136,65,71,67925,74195,142120
311650,202005,125,87,38,90915,39710,130625
311660,202005,402,198,204,206910,214225,421135
311670,202005,148,100,48,104500.66,50160,154660.66
311680,202005,211,156,55,163020,57475,220495
311690,202005,14,10,4,10450,4180,14630
311700,202005,197,138,59,144210,61655,205865
311710,202005,200,132,68,137940,71060,209000
311720,202005,40,29,11,30305.5,11495,41800.5
311730,202005,578,389,189,407550,197505,605055
311740,202005,36,26,10,27170,10450,37620
311750,202005,724,489,235,511005.76,245575,756580.76
311760,202005,64,29,35,30305,36575,66880
311770,202005,397,197,200,205866.35,209000,414866.35
311780,202005,180,92,88,96140.5,91960,188100.5
311783,202005,87,78,9,81510,9405,90915
311787,202005,37,13,24,13585,25080,38665
311790,202005,262,116,146,121220,152570,273790
311800,202005,684,449,235,469205.95,245575,714780.95
311810,202005,49,40,9,41800,9405,51205
311820,202005,120,99,21,103455,21945,125400
311830,202005,1905,1173,732,1226830.75,769120,1995950.75
311840,202005,1007,559,448,587291,469205.25,1056496.25
311850,202005,12,8,4,8360,4180,12540
311860,202005,9622,4194,5428,4384822.25,5688981,10073803.25
311870,202005,124,65,59,67925,61655,129580
311880,202005,931,677,254,707465,265430,972895
311890,202005,209,101,108,105459,112860,218319
311900,202005,73,29,44,30305,45980,76285
311910,202005,1405,886,519,927960.75,542355.5,1470316.25
311920,202005,233,150,83,157795,86735,244530
311930,202005,907,516,391,541310.5,408595,949905.5
311940,202005,2514,1328,1186,1388805,1240415.15,2629220.15
311950,202005,56,42,14,43890,14630,58520
311960,202005,58,43,15,44935,15675,60610
311970,202005,23,14,9,14630,9405,24035
311980,202005,45,35,10,36575,10450,47025
311990,202005,39,30,9,31350,9405,40755
311995,202005,58,37,21,38665,21945,60610
312000,202005,29,22,7,22990,7315,30305
312010,202005,76,60,16,62700,16720,79420
312015,202005,76,58,18,60610,18810,79420
312020,202005,128,83,45,86735,47025,133760
312030,202005,58,43,15,44935,15675,60610
312040,202005,85,51,34,53295.5,35530,88825.5
312050,202005,212,116,96,121220,100320,221540
312060,202005,22,12,10,12540,10450,22990
312070,202005,75,50,25,52250,26125,78375
312080,202005,535,241,294,251845,307230,559075
312083,202005,59,38,21,39710,21945,61655
312087,202005,105,83,22,86735,22990,109725
312090,202005,3184,1906,1278,1991772.1,1338645.5,3330417.6
312100,202005,149,104,45,108440.15,47025,155465.15
312110,202005,118,71,47,74195,49115,123310
312120,202005,141,103,38,108681.14,39710,148391.14
312125,202005,90,49,41,51205,42845,94050
312130,202005,127,84,43,87780,44935,132715
312140,202005,136,106,30,110770.5,31350,142120.5
312150,202005,43,33,10,34485,10450,44935
312160,202005,1563,1028,535,1075401.5,559075.5,1634477.0
312170,202005,10,8,2,9405,2090,11495
312180,202005,115,69,46,72105,49115.5,121220.5
312190,202005,35,31,4,32395,4180,36575
312200,202005,754,641,113,669845.5,118085,787930.5
312210,202005,111,59,52,61655,54340,115995
312220,202005,137,102,35,107635.25,36575,144210.25
312230,202005,3642,1695,1947,1772320.4,2039841,3812161.4
312235,202005,169,113,56,118085,58520,176605
312240,202005,100,70,30,73150,31350,104500
312245,202005,187,129,58,134805,60610,195415
312247,202005,70,49,21,51205,21945,73150
312250,202005,175,85,90,88825,94050,182875
312260,202005,108,72,36,76285,37620,113905
312270,202005,131,77,54,80465,56430,136895
312280,202005,26,12,14,12540,14630,27170
312290,202005,146,105,41,109725,42845,152570
312300,202005,212,133,79,138985,82555,221540
312310,202005,62,55,7,58520,7315,65835
312320,202005,427,272,155,284240,163020.75,447260.75
312330,202005,90,79,11,82555,11495,94050
312340,202005,36,17,19,17765,19855,37620
312350,202005,18,11,7,11495,7315,18810
312352,202005,92,69,23,72105,24035,96140
312360,202005,579,251,328,262295,342760,605055
312370,202005,307,169,138,176605,144210,320815
312380,202005,147,95,52,99275,54340,153615
312385,202005,165,131,34,136895,35530,172425
312390,202005,300,186,114,194370,119130.5,313500.5
312400,202005,380,283,97,296780,101365.5,398145.5
312410,202005,992,315,677,330220,708510,1038730
312420,202005,629,482,147,504735.5,154660,659395.5
312430,202005,867,633,234,661486.11,244530,906016.11
312440,202005,42,31,11,32395,11495,43890
312450,202005,209,131,78,136895,81510,218405
312460,202005,33,16,17,16720,17765,34485
312470,202005,47,32,15,33440,15675,49115
312480,202005,189,117,72,122265,75240,197505
312490,202005,269,186,83,196460,86735,283195
312500,202005,36,21,15,21945,15675,37620
312510,202005,531,204,327,213180,342760,555940
312520,202005,32,9,23,9405,24035,33440
312530,202005,48,33,15,34485,15675,50160
312540,202005,97,85,12,88825,12540,101365
312550,202005,34,28,6,29260,6270,35530
312560,202005,215,164,51,171380.5,53295,224675.5
312570,202005,441,263,178,274835,187055,461890
312580,202005,88,48,40,50160,41800,91960
312590,202005,247,198,49,206910,51205,258115
312595,202005,135,121,14,127490,14630,142120
312600,202005,70,38,32,39710.25,33440,73150.25
312610,202005,1592,818,774,854812,808830.5,1663642.5
312620,202005,211,149,62,155705,65835,221540
312630,202005,63,53,10,55385,10450,65835
312640,202005,46,14,32,14630,33440,48070
312650,202005,145,120,25,125400.5,26125,151525.5
312660,202005,91,64,27,66880.76,28215,95095.76
312670,202005,919,591,328,619685,342760,962445
312675,202005,30,24,6,25080,6270,31350
312680,202005,77,49,28,51205,29260,80465
312690,202005,248,129,119,134805,124355,259160
312695,202005,35,29,6,30305,6270,36575
312700,202005,230,133,97,138985,101365,240350
312705,202005,85,67,18,70015,18810,88825
312707,202005,127,89,38,93005,39710,132715
312710,202005,1901,1009,892,1059631.41,935275,1994906.41
312720,202005,58,31,27,32395,28215,60610
312730,202005,286,165,121,172425,126445,298870
312733,202005,55,45,10,47025,10450,57475
312735,202005,22,14,8,14630,8360,22990
312737,202005,71,39,32,40755,33440,74195
312738,202005,60,40,20,41800,20900,62700
312740,202005,82,53,29,55385,30305,85690
312750,202005,81,57,24,60610,25080,85690
312760,202005,289,207,82,217360,86735,304095
312770,202005,7923,3626,4297,3795444.25,4498725,8294169.25
312780,202005,423,321,102,336490,106590,443080
312790,202005,23,17,6,17765,6270,24035
312800,202005,1598,1110,488,1160995.75,509960,1670955.75
312810,202005,370,234,136,244530,142120,386650
312820,202005,188,144,44,150480,45980,196460
312825,202005,25,16,9,16720,9405,26125
312830,202005,232,133,99,138985,103455,242440
312840,202005,158,107,51,112860,53295,166155
312850,202005,44,39,5,40755,5225,45980
312860,202005,152,95,57,99275,59565,158840
312870,202005,1056,548,508,572660.75,532950,1105610.75
312880,202005,129,90,39,94050,40755,134805
312890,202005,156,113,43,118085,44935,163020
312900,202005,193,144,49,150480,51205,201685
312910,202005,179,94,85,98230,88825,187055
312920,202005,158,86,72,89870,75240,165110
312930,202005,329,227,102,237215,107635,344850
312940,202005,115,81,34,84645,35530,120175
312950,202005,705,479,226,500555,238260,738815
312960,202005,172,129,43,134805.4,44935,179740.4
312965,202005,73,62,11,65835,11495,77330
312970,202005,272,221,51,230945.25,53295,284240.25
312980,202005,2453,1233,1220,1291621,1280125,2571746
312990,202005,43,22,21,22990,21945,44935
313000,202005,51,28,23,29260,24035,53295
313005,202005,174,135,39,141075,40755.5,181830.5
313010,202005,915,360,555,377245.5,579975.5,957221.0
313020,202005,191,101,90,105545,94050,199595
313030,202005,194,130,64,135850.35,66880,202730.35
313040,202005,75,23,52,24035,54340,78375
313050,202005,184,133,51,138985,53295,192280
313055,202005,38,28,10,30305,10450,40755
313060,202005,130,89,41,93005,42845,135850
313065,202005,62,44,18,45980,18810.5,64790.5
313070,202005,133,68,65,71060,67925,138985
313080,202005,40,17,23,17765,24035,41800
313090,202005,651,430,221,449350,230945,680295
313100,202005,179,65,114,67925,121220,189145
313110,202005,139,74,65,77330,67925,145255
313115,202005,205,113,92,118085,96140,214225
313120,202005,819,464,355,484880,370975.5,855855.5
313130,202005,5693,3097,2596,3240546.7,2719091.75,5959638.45
313140,202005,142,76,66,79420,68970,148390
313150,202005,309,247,62,258115,64790,322905
313160,202005,187,138,49,145255.5,51205,196460.5
313170,202005,1393,945,448,989615.5,468160,1457775.5
313180,202005,300,177,123,184965.5,128535,313500.5
313190,202005,756,451,305,471295.5,318725,790020.5
313200,202005,30,24,6,25080,6270,31350
313210,202005,998,845,153,883027.55,159885,1042912.55
313220,202005,268,171,97,178695,101365.5,280060.5
313230,202005,265,201,64,210045.87,66880,276925.87
313240,202005,2132,1099,1033,1149503,1081575,2231078
313250,202005,1254,957,297,1001111,311410.8,1312521.8
313260,202005,91,48,43,51205,44935,96140
313270,202005,978,565,413,591470.75,431586,1023056.75
313280,202005,51,43,8,44935,8360,53295
313290,202005,217,174,43,181830,44935,226765
313300,202005,350,181,169,190190,176605,366795
313310,202005,258,125,133,130625,138985,269610
313320,202005,378,281,97,294690,101365,396055
313330,202005,1396,860,536,898700,561165,1459865
313340,202005,326,232,94,242440,98230,340670
313350,202005,503,333,170,350075,177650,527725
313360,202005,131,69,62,72105,64790,136895
313370,202005,210,69,141,72105,147345,219450
313375,202005,282,166,116,174515,121220,295735
313380,202005,1359,712,647,746130.5,677160,1423290.5
313390,202005,53,47,6,49115,6270,55385
313400,202005,403,274,129,286330,134806,421136
313410,202005,23,13,10,13585,10450,24035
313420,202005,4609,2454,2155,2570701,2253020.5,4823721.5
313430,202005,143,68,75,71060,78375,149435
313440,202005,1442,986,456,1031416.81,478612,1510028.81
313450,202005,68,27,41,28215,42845,71060
313460,202005,391,173,218,180785.5,228855,409640.5
313470,202005,530,247,283,258115.5,296780.5,554896.0
313480,202005,146,107,39,111815.5,40755,152570.5
313490,202005,518,239,279,250800.5,291555.25,542355.75
313500,202005,24,14,10,14630,10450,25080
313505,202005,1021,805,216,842270,226765,1069035
313507,202005,101,56,45,58520,47025,105545
313510,202005,2816,1779,1037,1862191.97,1085755,2947946.97
313520,202005,3479,2706,773,2830907.91,808830,3639737.91
313530,202005,34,23,11,24035,11495,35530
313535,202005,63,49,14,51205,15675,66880
313540,202005,69,51,18,53295,18810.5,72105.5
313545,202005,112,93,19,97185,19855,117040
313550,202005,230,194,36,203775,37620.5,241395.5
313560,202005,341,167,174,174515,181830,356345
313570,202005,69,28,41,29260,42845,72105
313580,202005,1311,738,573,771211.25,600876.5,1372087.75
313590,202005,68,37,31,38665,32395,71060
313600,202005,679,412,267,430540,279015.5,709555.5
313610,202005,59,46,13,48070,13585,61655
313620,202005,1393,704,689,735681,722095,1457776
313630,202005,1616,1231,385,1289531,403370,1692901
313640,202005,119,73,46,76285,48070,124355
313650,202005,239,110,129,114950,134805.5,249755.5
313652,202005,17,17,0,17765,0,17765
313655,202005,66,44,22,45980,22990,68970
313657,202005,49,45,4,47025,4180,51205
313660,202005,133,93,40,97185,41818.81,139003.81
313665,202005,646,303,343,317680.75,359480,677160.75
313670,202005,10369,7081,3288,7406964.37,3450591,10857555.37
313680,202005,42,31,11,32395,11495.95,43890.95
313690,202005,143,109,34,113905,35530,149435
313695,202005,77,59,18,61655,18810,80465
313700,202005,308,250,58,261250.5,61655,322905.5
313710,202005,143,99,44,103455,45980,149435
313720,202005,1119,523,596,547580.5,622821.5,1170402.0
313730,202005,76,45,31,47025,32395,79420
313740,202005,149,122,27,127490,28215,155705
313750,202005,430,313,117,327085,122265,449350
313753,202005,233,173,60,180785,62700,243485
313760,202005,1290,468,822,490105,862126.25,1352231.25
313770,202005,379,276,103,288420.25,108680,397100.25
313780,202005,769,406,363,424270,379335,803605
313790,202005,28,27,1,28215,1045,29260
313800,202005,137,84,53,88825,55385,144210
313810,202005,77,44,33,45980,35530,81510
313820,202005,1310,626,684,654171,716870.5,1371041.5
313830,202005,59,41,18,42845,18810,61655
313835,202005,61,51,10,53295,10450,63745
313840,202005,1673,1005,668,1052316.5,699105.5,1751422.0
313850,202005,206,75,131,78375,136895,215270
313860,202005,475,359,116,375155.5,121220,496375.5
313862,202005,165,111,54,115995,56430,172425
313865,202005,118,88,30,91960,31350,123310
313867,202005,47,37,10,38665,10450,49115
313868,202005,33,20,13,20900,13585,34485
313870,202005,119,62,57,65835,59565,125400
313880,202005,375,230,145,240350,151525,391875
313890,202005,336,178,158,186010,165110,351120
313900,202005,886,478,408,500555.25,426360.25,926915.50
313910,202005,141,102,39,106590,40755,147345
313920,202005,641,451,190,472340,198550.94,670890.94
313925,202005,31,28,3,29260,3135,32395
313930,202005,862,670,192,705375,202730,908105
313940,202005,1848,1158,690,1210110,722095,1932205
313950,202005,876,550,326,574750,340670,915420
313960,202005,1404,805,599,841225.9,628047,1469272.9
313970,202005,149,98,51,102410,53295,155705
313980,202005,208,130,78,135850.25,81510,217360.25
313990,202005,241,162,79,169290,82555,251845
314000,202005,910,604,306,631180.85,319770,950950.85
314010,202005,88,55,33,57475,34485,91960
314015,202005,65,18,47,18810,49115,67925
314020,202005,54,34,20,37620,20900,58520
314030,202005,75,36,39,37620,40755,78375
314040,202005,44,25,19,26125,19855,45980
314050,202005,285,169,116,176605,121220,297825
314053,202005,98,64,34,66880,36575,103455
314055,202005,301,186,115,195415,120175,315590
314060,202005,136,117,19,122265.04,19855,142120.04
314070,202005,1071,551,520,575795,543400,1119195
314080,202005,205,132,73,138985,78375.4,217360.4
314085,202005,143,97,46,101365,48070,149435
314090,202005,381,271,110,283195.25,115995,399190.25
314100,202005,491,394,97,412775.75,101365,514140.75
314110,202005,753,389,364,407550.5,380380,787930.5
314120,202005,91,55,36,57475,39710,97185
314130,202005,20,11,9,11495,9405,20900
314140,202005,1108,678,430,710600,449350,1159950
314150,202005,173,109,64,113905,66880,180785
314160,202005,332,252,80,263340.5,83600,346940.5
314170,202005,85,65,20,67925,20900,88825
314180,202005,729,646,83,675070.5,86735.25,761805.75
314190,202005,100,59,41,61655,42845,104500
314200,202005,483,330,153,346940,161975,508915
314210,202005,245,190,55,198550,59565.5,258115.5
314220,202005,302,223,79,234080.5,83600,317680.5
314225,202005,64,47,17,49115,17765,66880
314230,202005,117,52,65,54340,67925,122265
314240,202005,144,109,35,113905,36575,150480
314250,202005,52,29,23,30305,24035,54340
314260,202005,211,104,107,108680,111815,220495
314270,202005,360,280,80,292600,83600,376200
314280,202005,705,384,321,402325,338580,740905
314290,202005,541,438,103,457710,108680,566390
314300,202005,361,261,100,272745.75,105545.25,378291.00
314310,202005,1373,931,442,973157.57,461890,1435047.57
314315,202005,33,26,7,27170,7315,34485
314320,202005,593,389,204,406505.5,215270,621775.5
314330,202005,11075,5394,5681,5641957,5952321,11594278
314340,202005,601,274,327,286330,342761,629091
314345,202005,46,30,16,31350,16720,48070
314350,202005,181,114,67,119130,70015,189145
314360,202005,62,38,24,39710,25080,64790
314370,202005,67,48,19,50160,19855,70015
314380,202005,92,59,33,61655,34485,96140
314390,202005,3334,2140,1194,2237347.35,1250865,3488212.35
314400,202005,697,498,199,520411.3,209000,729411.3
314410,202005,478,312,166,326040,173470,499510
314420,202005,14,7,7,7315,7315,14630
314430,202005,2443,892,1551,934230.36,1627065.5,2561295.86
314435,202005,204,124,80,130625,83600,214225
314437,202005,28,22,6,22990,6270,29260
314440,202005,96,69,27,72105,28215,100320
314450,202005,156,108,48,112860,50160,163020
314460,202005,643,304,339,319770,355300,675070
314465,202005,96,61,35,63745,36575,100320
314467,202005,69,57,12,59565,12540,72105
314470,202005,411,205,206,214226.45,215270,429496.45
314480,202005,1060,501,559,524590,585200,1109790
314490,202005,46,32,14,33440,14630,48070
314500,202005,279,192,87,200640,91960,292600
314505,202005,118,78,40,81510,41800,123310
314510,202005,236,196,40,204820,42845,247665
314520,202005,1301,685,616,715831.5,645811.5,1361643.0
314530,202005,742,594,148,620731.01,154660,775391.01
314535,202005,191,115,76,120175,79420,199595
314537,202005,60,36,24,37620,26125,63745
314540,202005,16,10,6,10450,6270,16720
314545,202005,54,35,19,36575,19855,56430
314550,202005,81,42,39,43890,40755,84645
314560,202005,863,468,395,489060.5,413820,902880.5
314570,202005,21,16,5,16720,5225,21945
314580,202005,12,5,7,5225,7315,12540
314585,202005,24,17,7,17765,7315,25080
314587,202005,85,72,13,75240,13585,88825
314590,202005,569,408,161,427405.75,169290,596695.75
314600,202005,942,602,340,630136,356345.29,986481.29
314610,202005,957,494,463,517275.5,484880,1002155.5
314620,202005,141,105,36,109725,37620,147345
314625,202005,95,69,26,72105.5,27170,99275.5
314630,202005,1182,628,554,657305,578930,1236235
314640,202005,81,54,27,56430,28215.5,84645.5
314650,202005,183,103,80,107635,83600,191235
314655,202005,63,46,17,48070,17765,65835
314660,202005,17,14,3,14630,3135,17765
314670,202005,199,151,48,157795.5,50160,207955.5
314675,202005,210,122,88,128535,91960,220495
314690,202005,585,311,274,326040,287375,613415
314700,202005,2284,1229,1055,1287442,1103520,2390962
314710,202005,1682,976,706,1023056.75,739860.5,1762917.25
314720,202005,392,235,157,245575,165110,410685
314730,202005,515,266,249,279016,260205,539221
314740,202005,711,341,370,357390,386650,744040
314750,202005,22,19,3,19855,3135,22990
314760,202005,339,158,181,165110,189145,354255
314770,202005,105,73,32,76285,33440,109725
314780,202005,19,7,12,7315,12540,19855
314790,202005,2368,1478,890,1547645.5,935275,2482920.5
314795,202005,52,42,10,43890,10450,54340
314800,202005,2931,1710,1221,1789042.22,1276990,3066032.22
314810,202005,1525,855,670,893475,700150,1593625
314820,202005,108,60,48,62700,50160,112860
314830,202005,212,171,41,178695,42845,221540
314840,202005,85,52,33,54340,34485,88825
314850,202005,375,186,189,194370.5,198550,392920.5
314860,202005,673,514,159,538175,166155,704330
314870,202005,1532,802,730,839135.5,764940,1604075.5
314875,202005,57,49,8,51205,8360,59565
314880,202005,43,30,13,31350,13585,44935
314890,202005,56,33,23,34485,24035,58520
314900,202005,30,23,7,24035,7315,31350
314910,202005,243,159,84,167200,87780,254980
314915,202005,141,126,15,131670,15675,147345
314920,202005,103,63,40,65835,41800,107635
314930,202005,1055,516,539,540265.5,564300.5,1104566.0
314940,202005,47,37,10,38665,10450,49115
314950,202005,29,20,9,20900,9405,30305
314960,202005,37,29,8,30305,8360,38665
314970,202005,147,72,75,75240.5,78375,153615.5
314980,202005,309,196,113,204820,118085,322905
314990,202005,447,242,205,252890,214225,467115
314995,202005,206,67,139,70015,145255,215270
315000,202005,93,72,21,75240,21945,97185
315010,202005,43,27,16,28215,16720,44935
315015,202005,172,137,35,144210,36575,180785
315020,202005,72,57,15,59565,15675,75240
315030,202005,114,88,26,91960.5,28215,120175.5
315040,202005,70,50,20,52250,20900,73150
315050,202005,183,107,76,111815,79420,191235
315053,202005,45,37,8,38665,8360,47025
315057,202005,103,82,21,85690,22990,108680
315060,202005,75,64,11,66880.8,11495,78375.8
315070,202005,102,57,45,60610,48070,108680
315080,202005,378,304,74,317680,77330,395010
315090,202005,95,57,38,60610,39710,100320
315100,202005,83,41,42,42845,43890,86735
315110,202005,275,145,130,151525,135850,287375
315120,202005,1725,840,885,879890,924825.2,1804715.2
315130,202005,350,251,99,263340,103455,366795
315140,202005,519,299,220,312455.5,229900.5,542356.0
315150,202005,975,463,512,483835,539220,1023055
315160,202005,214,106,108,110770,114950,225720
315170,202005,319,210,109,219450.5,113905,333355.5
315180,202005,3278,1359,1919,1426426.5,2016851.25,3443277.75
315190,202005,327,192,135,200640,142120,342760
315200,202005,1247,735,512,768075,535040,1303115
315210,202005,1658,942,716,986480,748220,1734700
315213,202005,42,23,19,24035,19855,43890
315217,202005,215,169,46,176605,48070,224675
315220,202005,1584,1191,393,1244595.95,410685,1655280.95
315230,202005,174,123,51,128535.5,53295,181830.5
315240,202005,424,269,155,281105,161975.5,443080.5
315250,202005,2568,1260,1308,1316700,1368950.5,2685650.5
315260,202005,145,82,63,85690,65835,151525
315270,202005,129,88,41,91960,42845,134805
315280,202005,660,428,232,447260,243485,690745
315290,202005,191,118,73,124355,77330,201685
315300,202005,79,58,21,60610,21945,82555
315310,202005,72,65,7,67925,7315,75240
315320,202005,168,100,68,104500,71060,175560
315330,202005,57,47,10,49115,10450,59565
315340,202005,393,282,111,295735,115995,411730
315350,202005,154,91,63,95095,65835,160930
315360,202005,92,45,47,47025,49115,96140
315370,202005,54,34,20,35530,20900,56430
315380,202005,11,8,3,8360,3135,11495
315390,202005,69,18,51,18810,53295.5,72105.5
315400,202005,842,625,217,654170.5,226765,880935.5
315410,202005,326,191,135,199595.5,142121.5,341717.0
315415,202005,56,42,14,43890,15675,59565
315420,202005,198,142,56,148390.5,58520,206910.5
315430,202005,656,372,284,389785.5,298870,688655.5
315440,202005,94,63,31,66880,32395,99275
315445,202005,235,193,42,201685,43890,245575
315450,202005,184,139,45,145255,47025,192280
315460,202005,4048,1953,2095,2042975,2194500,4237475
315470,202005,43,17,26,17765,27170,44935
315480,202005,68,21,47,21945,49115,71060
315490,202005,664,411,253,429495,265430,694925
315500,202005,18,12,6,12540,6270,18810
315510,202005,150,101,49,105545,51205,156750
315520,202005,70,61,9,63745,9405,73150
315530,202005,48,27,21,28215,21945,50160
315540,202005,245,167,78,174515,81510,256025
315550,202005,177,142,35,148390,36575,184965
315560,202005,746,595,151,621775.5,157795,779570.5
315570,202005,315,159,156,166157.19,163020,329177.19
315580,202005,709,477,232,499510,243485.5,742995.5
315590,202005,196,105,91,109725,96140,205865
315600,202005,302,227,75,238260,78375,316635
315610,202005,98,52,46,54340,48070,102410
315620,202005,36,28,8,29260,8360,37620
315630,202005,128,85,43,88825,44935,133760
315640,202005,73,44,29,45980,30305,76285
315645,202005,46,32,14,33440,14630.5,48070.5
315650,202005,172,124,48,129580.5,50160,179740.5
315660,202005,462,204,258,213180.5,271700,484880.5
315670,202005,2393,1147,1246,1199662,1304160,2503822
315680,202005,847,594,253,621775,264385,886160
315690,202005,678,465,213,486972.08,225720,712692.08
315700,202005,1899,993,906,1039776.21,950950,1990726.21
315710,202005,344,102,242,106590,252890,359480
315720,202005,454,280,174,293645.5,181830,475475.5
315725,202005,190,153,37,159885.5,38665,198550.5
315727,202005,52,22,30,22990,31350,54340
315730,202005,46,43,3,44935,3135,48070
315733,202005,89,58,31,60610,32395,93005
315737,202005,50,37,13,38665,13585,52250
315740,202005,32,25,7,26125,7315,33440
315750,202005,162,120,42,125400,43890,169290
315760,202005,41,31,10,32395,10450,42845
315765,202005,125,74,51,77330,53295,130625
315770,202005,222,141,81,147345,84645.5,231990.5
315780,202005,3505,1751,1754,1830840.75,1838156.49,3668997.24
315790,202005,231,179,52,187055,54340,241395
315800,202005,295,207,88,216315,91960,308275
315810,202005,96,57,39,59565,40755.5,100320.5
315820,202005,745,539,206,563255.5,215270,778525.5
315830,202005,129,79,50,82555,52250,134805
315840,202005,85,56,29,58520,30305,88825
315850,202005,259,182,77,190190,80465,270655
315860,202005,15,6,9,6270,9405,15675
315870,202005,39,29,10,30305,10450,40755
315880,202005,107,68,39,71060,40755,111815
315890,202005,92,70,22,73150,24035,97185
315895,202005,444,296,148,310365,154661,465026
315900,202005,72,34,38,35530,39710,75240
315910,202005,41,24,17,25080,17765,42845
315920,202005,165,107,58,111815,60610.75,172425.75
315930,202005,49,18,31,18810,32395,51205
315935,202005,132,102,30,106590.5,31350,137940.5
315940,202005,100,74,26,77330,28215,105545
315950,202005,40,30,10,31350,10450,41800
315960,202005,540,258,282,270655,294690.5,565345.5
315970,202005,34,27,7,28215,7315,35530
315980,202005,684,337,347,352165,364705,716870
315990,202005,255,148,107,154660,112860.5,267520.5
316000,202005,51,33,18,34485,18810,53295
316010,202005,78,68,10,71060,10450,81510
316020,202005,117,100,17,104500,17765,122265
316030,202005,390,216,174,226765.5,182875.75,409641.25
316040,202005,524,220,304,230945.5,317680.5,548626.0
316045,202005,62,55,7,57475,7315,64790
316050,202005,14,11,3,11495,3135,14630
316060,202005,94,61,33,63745,34485,98230
316070,202005,1092,700,392,732545.75,411730,1144275.75
316080,202005,101,68,33,71060,34485,105545
316090,202005,43,21,22,21945,22990,44935
316095,202005,100,82,18,85690,18810,104500
316100,202005,310,178,132,188100.25,137940,326040.25
316105,202005,39,26,13,27170,13585,40755
316110,202005,1881,1489,392,1561230.62,410685,1971915.62
316120,202005,82,59,23,61655,24035,85690
316130,202005,124,93,31,98230.5,32395,130625.5
316140,202005,31,20,11,20900,11495,32395
316150,202005,204,142,62,148390,64790,213180
316160,202005,83,48,35,50160,36575,86735
316165,202005,64,48,16,51205,16720,67925
316170,202005,186,123,63,128535,66880,195415
316180,202005,201,86,115,89870,121220.5,211090.5
316190,202005,136,98,38,102410,39710,142120
316200,202005,662,363,299,380380,312455,692835
316210,202005,769,510,259,534174.74,271700,805874.74
316220,202005,116,76,40,79420,41800,121220
316225,202005,26,15,11,15675,11495,27170
316230,202005,32,18,14,18810,14630,33440
316240,202005,651,519,132,543400,140030,683430
316245,202005,128,111,17,115995,17765,133760
316250,202005,1532,1038,494,1088891.5,518320,1607211.5
316255,202005,129,100,29,104500,30305,134805
316257,202005,182,95,87,99275,90915,190190
316260,202005,198,140,58,146300.25,60610.5,206910.75
316265,202005,27,18,9,18810,9405,28215
316270,202005,685,483,202,504735.5,211090.6,715826.1
316280,202005,552,340,212,355300.29,221541,576841.29
316290,202005,749,498,251,522500.65,262295,784795.65
316292,202005,512,198,314,206910,328130,535040
316294,202005,99,60,39,62700,40755,103455
316295,202005,312,134,178,142120.5,187055,329175.5
316300,202005,105,72,33,75240,34485,109725
316310,202005,30,16,14,16720,14630,31350
316320,202005,48,26,22,27170,22990,50160
316330,202005,160,109,51,113905.25,53295,167200.25
316340,202005,134,92,42,96140,43890,140030
316350,202005,193,136,57,143165.74,59565,202730.74
316360,202005,19,13,6,13585,6270,19855
316370,202005,1110,571,539,597741.25,567435,1165176.25
316380,202005,119,89,30,94293.83,31350,125643.83
316390,202005,117,85,32,88825,33440,122265
316400,202005,130,99,31,103455,32395,135850
316410,202005,292,211,81,220495,84645,305140
316420,202005,204,139,65,146300,67925,214225
316430,202005,153,80,73,83600,76285,159885
316440,202005,87,41,46,42845,48070,90915
316443,202005,41,39,2,40755,2090,42845
316447,202005,58,42,16,43890,16720,60610
316450,202005,225,171,54,178695,56430,235125
316460,202005,77,26,51,27170,53295,80465
316470,202005,1671,1220,451,1276982.76,472340,1749322.76
316480,202005,12,8,4,8360,4180,12540
316490,202005,19,7,12,7315,12540,19855
316500,202005,151,102,49,106590,51205,157795
316510,202005,155,118,37,124355,38665,163020
316520,202005,197,121,76,126445,79420,205865
316530,202005,163,108,55,112860,57475,170335
316540,202005,139,74,65,77330,67925,145255
316550,202005,126,85,41,88825,42845,131670
316553,202005,297,134,163,140030,171380.72,311410.72
316555,202005,40,34,6,35530,6270,41800
316556,202005,12,9,3,9405,3135,12540
316557,202005,22,18,4,18810,4180,22990
316560,202005,68,48,20,50160,20900,71060
316570,202005,216,196,20,204820,20900,225720
316580,202005,18,13,5,13585,5225,18810
316590,202005,105,89,16,93005,16720,109725
316600,202005,180,146,34,152570.5,35530,188100.5
316610,202005,65,48,17,50160,17765,67925
316620,202005,141,104,37,108680,38665,147345
316630,202005,43,34,9,35530,9405,44935
316640,202005,22,14,8,14630,8360,22990
316650,202005,74,61,13,63745,13585,77330
316660,202005,8,3,5,3135,5225,8360
316670,202005,443,155,288,161975,300960,462935
316680,202005,159,110,49,115995,51205,167200
316690,202005,187,116,71,122265,74195,196460
316695,202005,63,54,9,56430,9405,65835
316700,202005,16,10,6,10450,6270,16720
316710,202005,782,587,195,615505.25,203775,819280.25
316720,202005,5033,2457,2576,2568612.74,2698191,5266803.74
316730,202005,17,16,1,16720,1045,17765
316740,202005,139,89,50,93005,52250,145255
316750,202005,18,10,8,10450,8360,18810
316760,202005,324,258,66,269610,68970,338580
316770,202005,156,81,75,85690,78375,164065
316780,202005,68,43,25,44935,26125,71060
316790,202005,52,39,13,40755,13585,54340
316800,202005,1762,1092,670,1141140,700150.5,1841290.5
316805,202005,23,15,8,15675,8360,24035
316810,202005,68,44,24,45980,25080,71060
316820,202005,42,21,21,21945,21945,43890
316830,202005,96,43,53,44935,55385,100320
316840,202005,530,305,225,318725.5,235125,553850.5
316850,202005,330,221,109,230945,114950,345895
316860,202005,5953,2616,3337,2741038.9,3498660.75,6239699.65
316870,202005,1543,990,553,1037687.25,577885,1615572.25
316880,202005,125,62,63,64790,66880,131670
316890,202005,239,165,74,172425,77330,249755
316900,202005,422,298,124,311410.65,129580,440990.65
316905,202005,22,10,12,10450,12540,22990
316910,202005,67,27,40,28215,41800,70015
316920,202005,137,109,28,113905,29260,143165
316930,202005,1900,971,929,1017831.5,976030.75,1993862.25
316935,202005,919,556,363,583110.1,379335.5,962445.6
316940,202005,1097,619,478,647900.5,501600.5,1149501.0
316950,202005,177,88,89,91960,94050,186010
316960,202005,1113,622,491,649991,514140,1164131
316970,202005,655,518,137,541310.5,143165,684475.5
316980,202005,76,43,33,44935,34485,79420
316990,202005,2171,1449,722,1517340.85,755535.74,2272876.59
317000,202005,334,255,79,266475,82555,349030
317005,202005,239,166,73,173470,77330,250800
317010,202005,6404,3543,2861,3705575.73,2996015.5,6701591.23
317020,202005,16138,7055,9083,7382087.6,9509504.6,16891592.2
317030,202005,81,31,50,32395,52250,84645
317040,202005,3062,1904,1158,1989681,1212200,3201881
317043,202005,76,55,21,57475,21945,79420
317047,202005,31,16,15,16720,15675,32395
317050,202005,163,125,38,130625,40755,171380
317052,202005,135,103,32,107635,34485,142120
317057,202005,170,133,37,138985,39710,178695
317060,202005,65,40,25,41800,26125,67925
317065,202005,56,45,11,47025,11495,58520
317070,202005,1965,905,1060,949905.75,1113970.5,2063876.25
317075,202005,107,58,49,60610,51205,111815
317080,202005,922,469,453,491150.75,473385,964535.75
317090,202005,652,521,131,544445,136895,681340
317100,202005,427,322,105,337535,110770,448305
317103,202005,100,82,18,85690,18810,104500
317107,202005,44,39,5,40755,5225,45980
317110,202005,112,48,64,50160,66880,117040
317115,202005,40,35,5,36575,5225,41800
317120,202005,1921,929,992,972896.5,1039775.5,2012672.0
317130,202005,1978,1313,665,1373131,694925,2068056
317140,202005,9,7,2,7315,2090,9405
317150,202005,260,153,107,160930.5,112860,273790.5
317160,202005,318,237,81,247665.79,85690,333355.79
317170,202005,217,149,68,155705,71060,226765
317180,202005,441,303,138,317680,144210,461890
317190,202005,264,184,80,192280,83600,275880
317200,202005,821,574,247,599832.9,258115,857947.9
317210,202005,187,102,85,106590,88825,195415
317220,202005,24,13,11,13585,11495,25080
320010,202005,606,441,165,460845.25,174515,635360.25
320013,202005,125,89,36,93005,38665,131670
320016,202005,274,171,103,178695,107635,286330
320020,202005,717,418,299,438902.37,313500,752402.37
320030,202005,152,105,47,109725,49115.25,158840.25
320035,202005,140,103,37,107635,38665,146300
320040,202005,493,250,243,262295,254980,517275
320050,202005,106,76,30,79420,31350,110770
320060,202005,1665,791,874,827640.25,914377.16,1742017.41
320070,202005,103,64,39,66880,40755,107635
320080,202005,798,456,342,477565.75,358435,836000.75
320090,202005,1240,835,405,873620,425315,1298935
320100,202005,332,188,144,197505,151525,349030
320110,202005,124,80,44,83601.25,45980,129581.25
320115,202005,110,90,20,94050,20900,114950
320120,202005,3439,1846,1593,1935342.65,1674090.5,3609433.15
320130,202005,7538,3400,4138,3557182.52,4345111.5,7902294.02
320140,202005,437,290,147,304095,153616.16,457711.16
320150,202005,2062,1159,903,1214290.75,948860,2163150.75
320160,202005,652,298,354,311410,372020.5,683430.5
320170,202005,110,89,21,93005,22990,115995
320180,202005,54,31,23,32395,24035,56430
320190,202005,242,155,87,161975,91960,253935
320200,202005,58,44,14,45980,14630,60610
320210,202005,901,495,406,518321,425315.57,943636.57
320220,202005,301,105,196,109725,205865,315590
320225,202005,88,69,19,72105,19855,91960
320230,202005,608,385,223,402325,233035,635360
320240,202005,3261,1584,1677,1658417.5,1757690.5,3416108.0
320245,202005,472,319,153,334400.5,159885,494285.5
320250,202005,231,116,115,121220,120175.5,241395.5
320255,202005,147,114,33,119130,34485,153615
320260,202005,207,143,64,149435,66880,216315
320265,202005,168,132,36,137940,37620,175560
320270,202005,157,124,33,129580,34485,164065
320280,202005,1034,591,443,618641.07,465025,1083666.07
320290,202005,58,50,8,53295,8360,61655
320300,202005,576,396,180,414866.35,188101.6,602967.95
320305,202005,685,371,314,389785,329175.5,718960.5
320310,202005,200,114,86,120175.9,89870,210045.9
320313,202005,326,161,165,168245.25,173470.5,341715.75
320316,202005,112,87,25,90915,26125,117040
320320,202005,3451,1552,1899,1623931.15,1987656.88,3611588.03
320330,202005,254,192,62,201685,65835,267520
320332,202005,836,512,324,536086.5,341715.25,877801.75
320334,202005,241,146,95,152570.5,99275,251845.5
320335,202005,147,101,46,105545,48070,153615
320340,202005,552,384,168,401280.75,175560,576840.75
320350,202005,989,424,565,443080.97,592515.5,1035596.47
320360,202005,167,91,76,95095,79420,174515
320370,202005,241,182,59,190190.9,61655.5,251846.4
320380,202005,284,198,86,206910.5,89870,296780.5
320390,202005,1150,688,462,718960,483835.5,1202795.5
320400,202005,312,230,82,240350.5,85690,326040.5
320405,202005,955,403,552,421135.25,576840.5,997975.75
320410,202005,997,505,492,527725,514140.25,1041865.25
320420,202005,505,240,265,250800.75,276925,527725.75
320425,202005,186,101,85,105545,88825,194370
320430,202005,384,211,173,221540.88,181830,403370.88
320435,202005,157,105,52,109725,54340,164065
320440,202005,195,113,82,118085,85690,203775
320450,202005,126,67,59,70015,61655,131670
320455,202005,250,203,47,212135.5,49115,261250.5
320460,202005,272,167,105,174515,109725,284240
320465,202005,115,77,38,80465,40755,121220
320470,202005,694,423,271,444125.5,284240,728365.5
320480,202005,196,128,68,133760,71060,204820
320490,202005,3083,1516,1567,1590491.26,1640653.23,3231144.49
320495,202005,110,69,41,72105,42846,114951
320500,202005,9719,4760,4959,4988836.3,5209330.95,10198167.25
320501,202005,552,281,271,294690,283195,577885
320503,202005,289,201,88,211090,91960,303050
320506,202005,262,185,77,193325,80465,273790
320510,202005,1034,458,576,480700,604010.5,1084710.5
320515,202005,85,67,18,71060,18810,89870
320517,202005,210,149,61,155705,63745,219450
320520,202005,7002,3014,3988,3155902.3,4180003,7335905.3
320530,202005,6153,3041,3112,3187252.22,3262490.5,6449742.72
330010,202005,3136,1591,1545,1667822.5,1622885,3290707.5
330015,202005,166,69,97,72105.9,102410,174515.9
330020,202005,3701,1578,2123,1652146.1,2222715,3874861.1
330022,202005,248,125,123,131670,129580.5,261250.5
330023,202005,603,190,413,198550,432630,631180
330025,202005,569,110,459,114950,483835,598785
330030,202005,1923,1224,699,1282215.62,731500.5,2013716.12
330040,202005,2444,1254,1190,1311475.5,1247730.5,2559206.0
330045,202005,8881,2706,6175,2832996,6477955,9310951
330050,202005,890,571,319,596695,334400,931095
330060,202005,1010,600,410,628046.25,428450,1056496.25
330070,202005,3673,1314,2359,1374175.4,2474560.5,3848735.9
330080,202005,1595,705,890,740905.75,932140,1673045.75
330090,202005,377,222,155,233035,163020,396055
330093,202005,264,118,146,123310,153615,276925
330095,202005,82,47,35,49115,37620,86735
330100,202005,9877,4943,4934,5171707.67,5166481.25,10338188.92
330110,202005,475,202,273,211090.75,286330,497420.75
330115,202005,531,276,255,288420,266475,554895
330120,202005,375,194,181,202730,189146,391876
330130,202005,1533,382,1151,400235,1202795,1603030
330140,202005,616,323,293,337535,306185,643720
330150,202005,512,295,217,309320,226765,536085
330160,202005,213,126,87,131670,90915,222585
330170,202005,27373,9200,18173,9628633.1,19062895.3,28691528.4
330180,202005,247,146,101,152570,107635,260205
330185,202005,959,333,626,347985,657305,1005290
330187,202005,366,111,255,115995,267520,383515
330190,202005,5776,2204,3572,2307362.15,3751550.5,6058912.65
330200,202005,4736,1403,3333,1473451.81,3503885.5,4977337.31
330205,202005,439,257,182,268565,190190.5,458755.5
330210,202005,983,600,383,630135,401281,1031416
330220,202005,2664,1589,1075,1661550.2,1125465.5,2787015.7
330225,202005,568,294,274,308275,286330,594605
330227,202005,2423,725,1698,759715,1782770.25,2542485.25
330230,202005,250,144,106,150480,110770,261250
330240,202005,3869,1916,1953,2005355.75,2052382,4057737.75
330245,202005,148,67,81,71060.1,85690,156750.1
330250,202005,6711,3387,3324,3546731.25,3482987.02,7029718.27
330260,202005,592,156,436,163020,455620,618640
330270,202005,3575,1208,2367,1265495,2482921,3748416
330280,202005,456,287,169,300960.5,176605.45,477565.95
330285,202005,7071,2200,4871,2304225.75,5109007.25,7413233.00
330290,202005,649,236,413,246620.25,433675,680295.25
330300,202005,762,490,272,512050.75,284240,796290.75
330310,202005,448,248,200,259160.75,209000,468160.75
330320,202005,7933,2941,4992,3079616.49,5245902,8325518.49
330330,202005,9055,3421,5634,3581216.75,5911566.5,9492783.25
330340,202005,2695,1581,1114,1655280,1168310.5,2823590.5
330350,202005,18562,7093,11469,7427866.15,12044677.17,19472543.32
330360,202005,2280,1094,1186,1147411.5,1240415,2387826.5
330370,202005,1042,516,526,541312,551760,1093072
330380,202005,892,380,512,397100,541310.01,938410.01
330385,202005,639,323,316,338580.25,330220,668800.25
330390,202005,5605,2969,2636,3106786,2768205.5,5874991.5
330395,202005,315,193,122,201685,128535.75,330220.75
330400,202005,712,372,340,389785,357390,747175
330410,202005,511,370,141,386650.25,147345.5,533995.75
330411,202005,257,139,118,145255.55,125400,270655.55
330412,202005,246,99,147,103455.5,153615,257070.5
330414,202005,5438,2188,3250,2289597.7,3424465.5,5714063.2
330415,202005,601,263,338,275881.5,353210,629091.5
330420,202005,2216,1136,1080,1187121.55,1133825.5,2320947.05
330430,202005,1792,815,977,851676,1026192.5,1877868.5
330440,202005,289,138,151,144210,158840,303050
330450,202005,121,53,68,55385,71060,126445
330452,202005,2023,880,1143,922735,1196525.5,2119260.5
330455,202005,112474,39266,73208,41136529.29,76806478.17,117943007.46
330460,202005,262,111,151,115995,157795,273790
330470,202005,1237,673,564,703287,589381.75,1292668.75
330475,202005,1527,396,1131,413820,1183985,1597805
330480,202005,813,433,380,453530,397100,850630
330490,202005,14602,4687,9915,4907321.25,10402976.5,15310297.75
330500,202005,1426,609,817,637450,855855.14,1493305.14
330510,202005,10930,3743,7187,3919797.15,7549081.75,11468878.90
330513,202005,103,52,51,54340,54340,108680
330515,202005,821,335,486,351121.25,508915.5,860036.75
330520,202005,2501,883,1618,922735.35,1694990,2617725.35
330530,202005,206,116,90,121220.25,95095,216315.25
330540,202005,378,181,197,189145.5,205865.5,395011.0
330550,202005,2892,1004,1888,1053360.7,1985501,3038861.7
330555,202005,808,312,496,326040,520410,846450
330560,202005,693,222,471,231990,492195,724185
330570,202005,268,193,75,201685,78375,280060
330575,202005,792,293,499,306185,525637.25,831822.25
330580,202005,3401,1895,1506,1983412.62,1577951,3561363.62
330590,202005,293,150,143,156750.09,149435,306185.09
330600,202005,1194,745,449,778526,469205,1247731
330610,202005,1595,849,746,895567.75,792111.5,1687679.25
330615,202005,208,163,45,170335,47025,217360
330620,202005,1079,420,659,439945,690745,1130690
330630,202005,4110,2554,1556,2676245.94,1628111.25,4304357.19
350010,202005,597,397,200,416955.97,209000,625955.97
350020,202005,52,22,30,22990,31350,54340
350030,202005,518,321,197,337535.5,205865.5,543401.0
350040,202005,125,50,75,52250,78375,130625
350050,202005,305,160,145,169290,151525,320815
350055,202005,95,49,46,51205,48070,99275
350060,202005,92,33,59,34485,62700,97185
350070,202005,797,468,329,490105.49,344850.5,834955.99
350075,202005,72,48,24,50160,25080,75240
350080,202005,64,29,35,30305,36575,66880
350090,202005,82,49,33,51205,35530,86735
350100,202005,284,175,109,182875,113905,296780
350110,202005,63,43,20,44935,20900,65835
350115,202005,147,89,58,93005,60610,153615
350120,202005,109,69,40,72105,41800,113905
350130,202005,369,165,204,174515.03,213180,387695.03
350140,202005,43,27,16,28215,16720,44935
350150,202005,72,55,17,57475,18810,76285
350160,202005,2471,958,1513,1002155.97,1585265,2587420.97
350170,202005,387,226,161,236171.85,168245.5,404417.35
350180,202005,169,97,72,101365,75240.5,176605.5
350190,202005,1008,524,484,548625.29,507871,1056496.29
350200,202005,69,25,44,26125,45980,72105
350210,202005,1302,728,574,761807,600875.29,1362682.29
350220,202005,675,554,121,579975.29,126445,706420.29
350230,202005,73,50,23,52250,24035,76285
350240,202005,61,43,18,44935,18810,63745
350250,202005,1142,541,601,567436.51,630136.25,1197572.76
350260,202005,94,69,25,72105.5,26125,98230.5
350270,202005,876,578,298,604011,311410.5,915421.5
350275,202005,303,125,178,130625,186010,316635
350280,202005,4630,2345,2285,2452620.25,2395140,4847760.25
350290,202005,446,201,245,210045,257070.5,467115.5
350300,202005,54,28,26,29260,27170,56430
350310,202005,86,54,32,56430,33440,89870
350315,202005,48,26,22,27170,22990,50160
350320,202005,3320,1614,1706,1688720.3,1787995,3476715.3
350330,202005,1688,900,788,942592.62,825551,1768143.62
350335,202005,17,12,5,12540,5225,17765
350340,202005,122,54,68,56430,71060.75,127490.75
350350,202005,89,44,45,45980,47025,93005
350360,202005,120,78,42,81510,43890,125400
350370,202005,89,51,38,53295.29,39710,93005.29
350380,202005,779,331,448,345895,469206,815101
350390,202005,1570,601,969,628045.37,1013650.5,1641695.87
350395,202005,25,20,5,20900,5225,26125
350400,202005,1702,862,840,904972.12,883025.79,1787997.91
350410,202005,2671,1147,1524,1200705,1595715.29,2796420.29
350420,202005,252,152,100,159885.79,104500,264385.79
350430,202005,74,44,30,45980,31350,77330
350440,202005,150,110,40,114950.5,41800.5,156751.0
350450,202005,1633,964,669,1009470.7,699106,1708576.7
350460,202005,394,128,266,135850,279015,414865
350470,202005,21,10,11,10450,11495,21945
350480,202005,176,99,77,103455,80465,183920
350490,202005,229,112,117,117040,122265,239305
350500,202005,48,19,29,19855,30305,50160
350510,202005,167,111,56,115995,60610,176605
350520,202005,454,228,226,239305,236170,475475
350530,202005,443,205,238,214225,249755,463980
350535,202005,82,65,17,67925,17765,85690
350540,202005,381,190,191,198550,199595,398145
350550,202005,2736,1618,1118,1693945,1171446.08,2865391.08
350560,202005,625,428,197,447260,206910,654170
350570,202005,4213,1726,2487,1805760.79,2614591.35,4420352.14
350580,202005,366,178,188,187055,197505,384560
350590,202005,905,492,413,515185.5,431585,946770.5
350600,202005,6112,2936,3176,3074393.25,3327280.5,6401673.75
350610,202005,1514,785,729,822415.29,764940,1587355.29
350620,202005,32,21,11,21945,11495,33440
350630,202005,243,138,105,144210.29,109725.29,253935.58
350635,202005,979,386,593,403371.35,619685.5,1023056.85
350640,202005,120,91,29,95095,31350,126445
350650,202005,1895,1257,638,1315655.95,667755,1983410.95
350660,202005,752,313,439,327085,460845,787930
350670,202005,311,152,159,159885,166155,326040
350680,202005,180,94,86,98230,89871,188101
350690,202005,199,100,99,104500,104500,209000
350700,202005,788,374,414,391876,432630,824506
350710,202005,381,140,241,146300,252890,399190
350715,202005,55,44,11,45980,11495,57475
350720,202005,18,13,5,13585,5225,18810
350730,202005,45,29,16,30305,16720,47025
350740,202005,219,126,93,131670,98230,229900
350745,202005,25,11,14,11495,14630,26125
350750,202005,2213,1367,846,1432695.75,887205,2319900.75
350760,202005,3758,1621,2137,1697080.59,2237345,3934425.59
350770,202005,60,43,17,45980,17765,63745
350775,202005,43,32,11,33440,11495,44935
350780,202005,433,221,212,230945,222585,453530
350790,202005,371,154,217,160930,226765,387695
350800,202005,475,277,198,291555,207955,499510
350810,202005,519,418,101,436810.75,105545,542355.75
350820,202005,88,51,37,53295,38665,91960
350830,202005,78,39,39,40755,40755,81510
350840,202005,774,307,467,321860.5,489060.5,810921.0
350850,202005,1751,967,784,1013650.5,820325.5,1833976.0
350860,202005,595,334,261,350075.75,272745,622820.75
350870,202005,425,284,141,297825,148390,446215
350880,202005,289,162,127,169290.25,134805,304095.25
350890,202005,40,27,13,28215,13585,41800
350900,202005,1473,459,1014,481745.75,1064855.29,1546601.04
350910,202005,29,16,13,16720,13585,30305
350920,202005,698,367,331,384560,345895,730455
350925,202005,1208,639,569,668801.45,594607.39,1263408.84
350930,202005,101,61,40,63745,42845,106590
350940,202005,715,394,321,413820,337535,751355
350945,202005,109,78,31,81510,32395,113905
350950,202005,16494,7691,8803,8047551.11,9223172.75,17270723.86
350960,202005,1390,627,763,656260,799425,1455685
350970,202005,1104,577,527,604944.19,551760.5,1156704.69
350980,202005,98,66,32,68970,34485,103455
350990,202005,376,133,243,138985,253935,392920
350995,202005,36,17,19,17765,19855,37620
351000,202005,638,432,206,454575.58,216315,670890.58
351010,202005,52,31,21,32395,21945,54340
351015,202005,49,34,15,35530,15675,51205
351020,202005,1584,953,631,996930.5,660440,1657370.5
351030,202005,336,220,116,233035,121220,354255
351040,202005,901,467,434,489060.95,454575.89,943636.84
351050,202005,3342,1510,1832,1581088.3,1920710,3501798.3
351060,202005,5327,2063,3264,2157926.7,3425510,5583436.7
351070,202005,403,255,148,267521.64,154660,422181.64
351080,202005,738,540,198,566390.5,209000,775390.5
351090,202005,55,24,31,25080,32395,57475
351100,202005,436,251,185,263340.7,193325,456665.7
351110,202005,2054,972,1082,1017831.31,1133825.5,2151656.81
351120,202005,68,35,33,36575,34485,71060
351130,202005,194,59,135,62700,141075,203775
351140,202005,322,217,105,227810,109725,337535
351150,202005,444,230,214,241395.75,224675.5,466071.25
351160,202005,272,180,92,188100.5,96140,284240.5
351170,202005,190,99,91,103455,96140,199595
351190,202005,88,61,27,64790,28215,93005
351200,202005,365,243,122,256025.5,127490,383515.5
351210,202005,118,60,58,62700,60610,123310
351220,202005,539,323,216,337536.91,227810,565346.91
351230,202005,272,188,84,197505,87780,285285
351240,202005,240,116,124,121220,129580,250800
351250,202005,83,59,24,61655.57,25080,86735.57
351260,202005,148,110,38,114950,39710,154660
351270,202005,46,19,27,19855,28215,48070
351280,202005,1004,450,554,472340.29,579975.79,1052316.08
351290,202005,255,109,146,113905,152570.5,266475.5
351300,202005,3793,1666,2127,1742979.61,2225850.29,3968829.90
351310,202005,767,379,388,396055,405460,801515
351320,202005,115,67,48,70015.29,50160,120175.29
351330,202005,41,26,15,27170,15675,42845
351340,202005,1252,734,518,769120.5,545490,1314610.5
351350,202005,2424,1396,1028,1459866.25,1076350,2536216.25
351360,202005,778,373,405,389785,423225,813010
351370,202005,394,196,198,204820.5,207955,412775.5
351380,202005,9080,4068,5012,4264650.85,5252171.79,9516822.64
351385,202005,28,17,11,17765,11495,29260
351390,202005,275,206,69,216315.35,72105,288420.35
351400,202005,65,42,23,43890,24035,67925
351410,202005,438,276,162,288420.77,170335,458755.77
351420,202005,68,51,17,53295,17765,71060
351430,202005,72,39,33,40755,34485,75240
351440,202005,793,553,240,577888.11,251845,829733.11
351450,202005,264,130,134,135850,140030,275880
351460,202005,125,56,69,58520,72105,130625
351470,202005,143,78,65,81510,67925,149435
351480,202005,502,284,218,296780.79,227810,524590.79
351490,202005,290,106,184,110770,194370,305140
351492,202005,27,20,7,20900,7315,28215
351495,202005,25,18,7,18810,7315,26125
351500,202005,3568,1488,2080,1556006.35,2178826.9,3734833.25
351510,202005,1928,741,1187,777481,1244595.5,2022076.5
351512,202005,19,14,5,14630,5225,19855
351515,202005,190,107,83,112860,86735,199595
351518,202005,757,476,281,498465,293645,792110
351519,202005,77,46,31,48070,32395,80465
351520,202005,152,92,60,96140,62700,158840
351530,202005,24,14,10,14630,10450,25080
351535,202005,132,77,55,80465,57475,137940
351540,202005,449,322,127,337535.05,134805,472340.05
351550,202005,1409,840,569,878847.08,595650,1474497.08
351560,202005,72,41,31,42845,32395,75240
351565,202005,9,7,2,7315,2090,9405
351570,202005,2733,1330,1403,1392985.5,1472405,2865390.5
351580,202005,38,34,4,36575,4180,40755
351590,202005,64,41,23,43890,24035,67925
351600,202005,183,132,51,138985,53295,192280
351610,202005,45,21,24,21945,26125,48070
351620,202005,5879,3284,2595,3442233.25,2722225.75,6164459.00
351630,202005,2837,1397,1440,1460911.16,1511070,2971981.16
351640,202005,2017,935,1082,981255.02,1134871.29,2116126.31
351650,202005,27,23,4,24035,4180,28215
351660,202005,141,92,49,96140,51205,147345
351670,202005,717,445,272,468161.5,284240.5,752402.0
351680,202005,71,60,11,62700,11495,74195
351685,202005,29,16,13,16720,13585,30305
351690,202005,299,204,95,214225.37,99275,313500.37
351700,202005,159,108,51,112860.5,53295,166155.5
351710,202005,69,46,23,48070,25080,73150
351720,202005,132,75,57,78375,60610,138985
351730,202005,109,72,37,75240,38665.29,113905.29
351740,202005,729,471,258,493240.89,269610,762850.89
351750,202005,356,146,210,152570,219450,372020
351760,202005,765,578,187,604010,195415,799425
351770,202005,303,257,46,268565.29,49115,317680.29
351780,202005,157,93,64,97185,66880,164065
351790,202005,256,136,120,142120,126445.75,268565.75
351800,202005,38,24,14,27170,14630,41800
351810,202005,121,82,39,85690,40755,126445
351820,202005,820,591,229,617595.5,239305,856900.5
351830,202005,548,193,355,202730,373065,575795
351840,202005,1919,938,981,984391.6,1027235,2011626.6
351850,202005,240,170,70,177650,73150,250800
351860,202005,664,461,203,483835.45,212135,695970.45
351870,202005,5610,2611,2999,2737902.6,3155900.62,5893803.22
351880,202005,19525,7948,11577,8326563,12153351.5,20479914.5
351885,202005,84,53,31,55385,32395,87780
351890,202005,73,59,14,61655,14630,76285
351900,202005,228,130,98,135850,102410,238260
351905,202005,80,32,48,33440,50160,83600
351907,202005,3460,1427,2033,1494351.35,2132845.5,3627196.85
351910,202005,182,76,106,79420,110770,190190
351920,202005,120,68,52,71060,54340,125400
351925,202005,91,59,32,61655,33440,95095
351930,202005,395,253,142,265430,148390,413820
351940,202005,238,104,134,108680,140030,248710
351950,202005,131,72,59,75240,61655,136895
351960,202005,920,450,470,470577.37,491150.5,961727.87
351970,202005,1904,994,910,1038730.5,953040.5,1991771.0
351980,202005,158,76,82,80465,85690,166155
351990,202005,258,169,89,176606,93005,269611
352000,202005,345,217,128,227810.5,135850,363660.5
352010,202005,391,247,144,259160,151525,410685
352020,202005,189,71,118,74195,124355,198550
352030,202005,1093,551,542,576840,566390,1143230
352040,202005,580,240,340,251845,355300,607145
352042,202005,286,87,199,90915,207956,298871
352044,202005,360,222,138,231990,145255,377245
352050,202005,3232,1254,1978,1311477.14,2073280.5,3384757.64
352060,202005,106,65,41,67925,42845,110770
352070,202005,93,68,25,72105.58,26125,98230.58
352080,202005,67,43,24,44935,25080,70015
352090,202005,160,107,53,111815,55385,167200
352100,202005,286,139,147,146300.5,153615.5,299916.0
352110,202005,114,34,80,35530,84645,120175
352115,202005,61,20,41,20900,42845,63745
352120,202005,87,60,27,62700.29,28215,90915.29
352130,202005,221,184,37,192280,38665,230945
352140,202005,187,87,100,90915,104500,195415
352150,202005,119,61,58,63745,60610,124355
352160,202005,140,88,52,93005,54340,147345
352170,202005,391,266,125,280060,130625,410685
352180,202005,621,396,225,415910.29,236170,652080.29
352190,202005,244,99,145,103455,151525,254980
352200,202005,31,16,15,16720,15675,32395
352210,202005,4133,1682,2451,1761872,2571745.5,4333617.5
352215,202005,58,33,25,34485,26125,60610
352220,202005,6762,2538,4224,2658481.55,4432893.12,7091374.67
352230,202005,3337,2153,1184,2253021.7,1242506.62,3495528.32
352240,202005,2453,1397,1056,1464045.5,1106655.5,2570701.0
352250,202005,2784,1327,1457,1390896.58,1539285.5,2930182.08
352260,202005,983,507,476,529815.5,498465.5,1028281.0
352265,202005,57,28,29,29260,31350,60610
352270,202005,400,233,167,244530,174515.25,419045.25
352280,202005,446,281,165,293645.58,172425,466070.58
352290,202005,171,102,69,106590,72105,178695
352300,202005,94,66,28,68970,29260,98230
352310,202005,6391,2840,3551,2969891.19,3728561.05,6698452.24
352320,202005,1026,538,488,563255.05,513095.24,1076350.29
352330,202005,545,261,284,272745,296780.5,569525.5
352340,202005,1357,617,740,646857,776437,1423294
352350,202005,346,207,139,216315,146300.5,362615.5
352360,202005,220,101,119,105545,124355,229900
352370,202005,105,69,36,72105,37620,109725
352380,202005,117,75,42,78375,43890,122265
352390,202005,2457,1047,1410,1097250.5,1477631.3,2574881.8
352400,202005,497,217,280,226765,293645.5,520410.5
352410,202005,862,604,258,631180.29,270655,901835.29
352420,202005,97,67,30,70015,33440,103455
352430,202005,1742,797,945,832866.87,993795.58,1826662.45
352440,202005,3232,1598,1634,1670956.6,1708575,3379531.6
352450,202005,196,162,34,169290,36575,205865
352460,202005,620,319,301,333355,315590,648945
352470,202005,652,220,432,230945,452485,683430
352480,202005,1421,784,637,820325,666710.5,1487035.5
352490,202005,64,24,40,25080,41800,66880
352500,202005,1228,521,707,544445.85,738815.5,1283261.35
352510,202005,732,389,343,406505.58,360525,767030.58
352520,202005,669,320,349,334400,366795,701195
352530,202005,1746,911,835,956175,875710.5,1831885.5
352540,202005,74,47,27,49115,28215,77330
352550,202005,189,114,75,119130,78375,197505
352560,202005,49,39,10,40755,10450,51205
352570,202005,677,345,332,360525.29,347985,708510.29
352580,202005,57,44,13,45980,13585,59565
352585,202005,20,6,14,6270,14630,20900
352590,202005,4448,2206,2242,2311540.79,2348116,4659656.79
352600,202005,347,250,97,262295,101365,363660
352610,202005,951,434,517,454575.67,541310,995885.67
352620,202005,1036,404,632,423225,662530,1085755
352630,202005,174,62,112,64790,118085,182875
352640,202005,520,351,169,366795,177650,544445
352650,202005,85,62,23,64790,24035,88825
352660,202005,65,39,26,40755,28215,68970
352670,202005,1666,895,771,935276.32,806740,1742016.32
352680,202005,934,586,348,614460,367840,982300
352690,202005,4569,2049,2520,2146432.38,2640715.29,4787147.67
352700,202005,103,62,41,64790.5,42845,107635.5
352710,202005,1381,733,648,769120,680295,1449415
352720,202005,1374,632,742,662530,776435.5,1438965.5
352725,202005,23,18,5,18810,5225,24035
352730,202005,397,201,196,210045,206910,416955
352740,202005,420,266,154,277971.9,163020.11,440992.01
352750,202005,19,12,7,12540,7315,19855
352760,202005,176,116,60,121220,62700,183920
352770,202005,87,64,23,66880,24035,90915
352780,202005,80,43,37,44935,38665,83600
352790,202005,24,19,5,19855,5225,25080
352800,202005,235,172,63,179740,66880,246620
352810,202005,155,95,60,99275.5,62700,161975.5
352820,202005,62,49,13,51205,13585,64790
352830,202005,78,53,25,55385,26125,81510
352840,202005,664,330,334,345895.25,349030,694925.25
352850,202005,1530,499,1031,524590,1081575,1606165
352860,202005,117,75,42,78375,44935,123310
352870,202005,46,30,16,31350,16720,48070
352880,202005,183,121,62,126445,64790,191235
352885,202005,32,22,10,22990,10450,33440
352890,202005,53,35,18,36575,18810.5,55385.5
352900,202005,4811,2334,2477,2450527.65,2593691.29,5044218.94
352910,202005,36,29,7,30305,7315,37620
352920,202005,661,399,262,416955.5,274835,691790.5
352930,202005,1228,585,643,611325.5,674025.75,1285351.25
352940,202005,6175,2537,3638,2656440.36,3815295.56,6471735.92
352950,202005,108,42,66,43890,68970,112860
352960,202005,58,40,18,41800,18810,60610
352965,202005,19,9,10,9405,10450,19855
352970,202005,514,392,122,409640.23,128535,538175.23
352980,202005,157,86,71,89870,74195,164065
352990,202005,993,449,544,469205,569525,1038730
353000,202005,67,30,37,31350,38665,70015
353010,202005,546,338,208,354255,217360,571615
353020,202005,297,215,82,224675,86735,311410
353030,202005,1254,576,678,601920.85,710600,1312520.85
353040,202005,85,54,31,56430,32395,88825
353050,202005,1336,862,474,902881.19,496375,1399256.19
353060,202005,8471,3659,4812,3829930,5050485,8880415
353070,202005,1762,1087,675,1140096.33,708323.99,1848420.32
353080,202005,1291,689,602,720005.47,631180,1351185.47
353090,202005,57,31,26,32395,27170,59565
353100,202005,53,43,10,44935,10450,55385
353110,202005,2104,637,1467,667755.5,1534060,2201815.5
353120,202005,98,51,47,54340,49115,103455
353130,202005,859,419,440,438900.41,459800,898700.41
353140,202005,554,229,325,239305.29,339625,578930.29
353150,202005,339,192,147,200640.29,153615,354255.29
353160,202005,95,77,18,80465,18810,99275
353170,202005,218,71,147,75240,153615,228855
353180,202005,1074,486,588,507870.75,614461.25,1122332.00
353190,202005,502,364,138,381425,146300,527725
353200,202005,217,106,111,110770,117040,227810
353205,202005,20,13,7,13585,7315,20900
353210,202005,72,41,31,42845,32395,75240
353215,202005,46,27,19,28215,19855,48070
353220,202005,78,44,34,45980,35530,81510
353230,202005,165,62,103,64790,107635,172425
353240,202005,318,162,156,169290,163020,332310
353250,202005,210,104,106,108680,110770,219450
353260,202005,458,316,142,330220.8,149435,479655.8
353270,202005,71,53,18,55385,18810,74195
353280,202005,101,51,50,53295,52250,105545
353282,202005,131,92,39,96140,40755,136895
353284,202005,24,16,8,17765,8360,26125
353286,202005,1,0,1,0,1045,1045
353290,202005,72,43,29,44935,30305,75240
353300,202005,452,242,210,253936.33,219450,473386.33
353310,202005,48,41,7,42845,7315,50160
353320,202005,55,32,23,33440,24035,57475
353325,202005,52,31,21,32395,21945.5,54340.5
353330,202005,59,40,19,41800.75,20900,62700.75
353340,202005,646,228,418,239305,436810.5,676115.5
353350,202005,914,442,472,463980,493240.5,957220.5
353360,202005,103,84,19,87780,19855,107635
353370,202005,114,65,49,67925,51205,119130
353380,202005,32,18,14,18810,14630,33440
353390,202005,1129,543,586,568480,614460.5,1182940.5
353400,202005,44,25,19,27170,19855,47025
353410,202005,109,66,43,68970,44935.25,113905.25
353420,202005,58,24,34,26125,35530,61655
353430,202005,584,391,193,410685.91,201685,612370.91
353440,202005,11036,4766,6270,4990922.44,6573051,11563973.44
353450,202005,56,31,25,32395,26125,58520
353460,202005,603,326,277,340670.75,292600,633270.75
353470,202005,2144,1126,1018,1178760.37,1066945,2245705.37
353475,202005,244,163,81,170335.5,84645,254980.5
353480,202005,189,156,33,163020,34485,197505
353490,202005,242,146,96,152570,100320.5,252890.5
353500,202005,202,116,86,121220.29,89870,211090.29
353510,202005,104,72,32,75240,34485,109725
353520,202005,208,146,62,153615,64790,218405
353530,202005,465,252,213,263340,223630,486970
353540,202005,381,252,129,263340,135850,399190
353550,202005,715,465,250,489061.47,261250,750311.47
353560,202005,592,237,355,247665,370975,618640
353570,202005,66,36,30,37620.5,31350,68970.5
353580,202005,353,260,93,272746.35,98230,370976.35
353590,202005,89,65,24,67925,25080,93005
353600,202005,279,160,119,167200.29,124355,291555.29
353610,202005,126,69,57,72105,60610,132715
353620,202005,614,322,292,336490.5,307230,643720.5
353625,202005,52,27,25,28215,26125,54340
353630,202005,229,170,59,177650.45,61655,239305.45
353640,202005,130,84,46,87780,48070,135850
353650,202005,934,349,585,364705,611325,976030
353657,202005,22,16,6,16720,6270,22990
353660,202005,272,146,126,152570,131670,284240
353670,202005,765,454,311,475475.79,326040.5,801516.29
353680,202005,104,74,30,78375.25,31350,109725.25
353690,202005,42,30,12,31350,12540,43890
353700,202005,270,193,77,202730,80465,283195
353710,202005,472,220,252,229900,263340.5,493240.5
353715,202005,46,33,13,34485,13585,48070
353720,202005,354,162,192,169290.5,200640,369930.5
353730,202005,1098,676,422,709555.81,442035.5,1151591.31
353740,202005,620,338,282,355300.5,296780,652080.5
353750,202005,80,48,32,50160,33440,83600
353760,202005,2976,1116,1860,1167202.65,1948926.65,3116129.30
353770,202005,90,73,17,76285,17765,94050
353780,202005,1221,578,643,605055.29,672980,1278035.29
353790,202005,506,306,200,319770.9,209000.5,528771.4
353800,202005,3413,1649,1764,1728450.5,1846586.5,3575037.0
353810,202005,231,132,99,137940,103455,241395
353820,202005,209,94,115,98230,120175,218405
353830,202005,51,44,7,45980,7315,53295
353850,202005,179,83,96,86735,100320,187055
353860,202005,504,223,281,233035,293645,526680
353870,202005,5371,2719,2652,2848673.5,2783881.75,5632555.25
353880,202005,689,475,214,497420.89,224675,722095.89
353890,202005,562,321,241,336490.5,257070.61,593561.11
353900,202005,134,70,64,73150,67925,141075
353910,202005,180,75,105,78375,109725,188100
353920,202005,439,242,197,253935.75,205865,459800.75
353930,202005,998,585,413,613415,434721.35,1048136.35
353940,202005,191,97,94,101365,98230,199595
353950,202005,509,309,200,323950,209000,532950
353960,202005,75,61,14,63745,14630,78375
353970,202005,57,31,26,32395,27170,59565
353980,202005,1694,786,908,821370,954085.5,1775455.5
353990,202005,71,43,28,44935,29260,74195
354000,202005,382,181,201,190190,212135,402325
354010,202005,90,50,40,52250,41800.5,94050.5
354020,202005,515,329,186,344850,194370,539220
354025,202005,49,40,9,41800,9405,51205
354030,202005,51,31,20,32395,20900,53295
354040,202005,100,75,25,78375,26125,104500
354050,202005,177,99,78,104500.79,81510,186010.79
354060,202005,762,368,394,385605,413820,799425
354070,202005,921,528,393,552806,411730,964536
354075,202005,222,105,117,109725,122265,231990
354080,202005,314,136,178,142120,188100,330220
354085,202005,20,13,7,13585,7315,20900
354090,202005,295,168,127,175472,133760,309232
354100,202005,5630,2279,3351,2387826.53,3515382.35,5903208.88
354105,202005,92,45,47,47025,49115,96140
354110,202005,47,22,25,22990,26125,49115
354120,202005,139,97,42,101365,43890,145255
354130,202005,724,456,268,477565,280060.5,757625.5
354140,202005,3177,1461,1716,1530926.02,1797400.86,3328326.88
354150,202005,635,377,258,397100.87,269610,666710.87
354160,202005,661,421,240,439945.5,252890.89,692836.39
354165,202005,17,14,3,14630,3135,17765
354170,202005,176,121,55,126445,57475,183920
354180,202005,62,36,26,37620.59,27170,64790.59
354190,202005,194,82,112,86735,118085,204820
354200,202005,117,61,56,63745,58520,122265
354210,202005,58,24,34,25080,35530,60610
354220,202005,647,405,242,423226.09,253935,677161.09
354230,202005,172,74,98,77330,104500,181830
354240,202005,334,215,119,226765.62,124355,351120.62
354250,202005,85,52,33,54340,34485,88825
354260,202005,2064,962,1102,1007382.32,1154726.6,2162108.92
354270,202005,93,67,26,70015,27170,97185
354280,202005,43,21,22,21945,22990,44935
354290,202005,148,103,45,107635,47025,154660
354300,202005,376,265,111,276925.29,118085,395010.29
354310,202005,92,68,24,71060.5,25080,96140.5
354320,202005,207,102,105,106590,109725,216315
354323,202005,10,9,1,9405,1045,10450
354325,202005,118,68,50,71060.83,52250,123310.83
354330,202005,2462,823,1639,860931.5,1717980.5,2578912.0
354340,202005,10427,4995,5432,5231272.63,5688983.21,10920255.84
354350,202005,128,85,43,88825,44935,133760
354360,202005,75,42,33,43890,34485,78375
354370,202005,248,132,116,137940,121220,259160
354380,202005,186,111,75,115995,78375,194370
354390,202005,2710,971,1739,1016785,1821435.45,2838220.45
354400,202005,311,170,141,177650,148390,326040
354410,202005,621,300,321,313500.85,336490.5,649991.35
354420,202005,272,172,100,179740,104500,284240
354425,202005,308,184,124,193374,129580,322954
354430,202005,182,105,77,109725,80465,190190
354440,202005,35,26,9,27170,9405,36575
354450,202005,53,36,17,38665,17765,56430
354460,202005,101,57,44,59565,45980,105545
354470,202005,35,19,16,19855,16720,36575
354480,202005,114,61,53,63745,56430,120175
354490,202005,149,92,57,97185,59565,156750
354500,202005,379,179,200,188100,209000,397100
354510,202005,95,66,29,70015,30305,100320
354515,202005,38,12,26,12540,27170,39710
354520,202005,1601,680,921,713586.75,963490.5,1677077.25
354530,202005,754,377,377,396055.5,395010,791065.5
354540,202005,271,147,124,153615,129580,283195
354550,202005,37,23,14,25080,14630,39710
354560,202005,149,78,71,81510,74195,155705
354570,202005,136,89,47,93005.25,49115,142120.25
354580,202005,1878,882,996,922736.5,1045000.5,1967737.0
354600,202005,253,139,114,145255,119130,264385
354610,202005,72,61,11,63745.15,11495,75240.15
354620,202005,65,19,46,19855,48070,67925
354625,202005,16,10,6,10450,6270,16720
354630,202005,311,200,111,209000,115995,324995
354640,202005,801,507,294,530860.75,308275,839135.75
354650,202005,74,44,30,45980,31350,77330
354660,202005,801,595,206,624910.25,216315,841225.25
354670,202005,240,88,152,91960,158840,250800
354680,202005,1272,471,801,492195,839135,1331330
354690,202005,84,58,26,60610.5,27170,87780.5
354700,202005,66,47,19,49115,19855,68970
354710,202005,48,35,13,36575,13585,50160
354720,202005,20,20,0,20900,0,20900
354730,202005,1748,728,1020,762850.55,1070080.5,1832931.05
354740,202005,72,52,20,54340,20900,75240
354750,202005,424,242,182,252890,190190,443080
354760,202005,467,283,184,295736.25,192280.5,488016.75
354765,202005,10,5,5,5225,5225,10450
354770,202005,344,227,117,237215.5,122265,359480.5
354780,202005,8242,3251,4991,3402523.47,5235451.7,8637975.17
354790,202005,101,56,45,58520,47025,105545
354800,202005,455,245,210,257070,219450,476520
354805,202005,102,46,56,48070.5,58520,106590.5
354810,202005,101,61,40,64790,42845,107635
354820,202005,207,84,123,87780.9,128535,216315.9
354830,202005,40,22,18,22990,18810,41800
354840,202005,57,40,17,41800,17765,59565
354850,202005,4529,1991,2538,2083731,2663706.25,4747437.25
354860,202005,332,160,172,167200,179740.04,346940.04
354870,202005,12243,5455,6788,5718246.28,7118543.16,12836789.44
354880,202005,2819,1057,1762,1110835.88,1853831.65,2964667.53
354890,202005,2928,1561,1367,1637516.75,1431650,3069166.75
354900,202005,62,42,20,43890,21945,65835
354910,202005,1247,654,593,685521,620730,1306251
354920,202005,45,37,8,38665,8360,47025
354925,202005,12,6,6,6270,6270,12540
354930,202005,36,32,4,33440.78,4180,37620.78
354940,202005,809,586,223,613678.04,233035,846713.04
354950,202005,202,131,71,137940.25,74195,212135.25
354960,202005,151,58,93,60610,97185,157795
354970,202005,965,638,327,666711.64,346940.5,1013652.14
354980,202005,8806,3170,5636,3318923.45,5907386.02,9226309.47
354990,202005,9324,4296,5028,4496638.5,5270980,9767618.5
354995,202005,545,178,367,186010,383515,569525
355000,202005,470,159,311,166155,324995,491150
355010,202005,601,371,230,389785.5,240350.79,630136.29
355020,202005,779,493,286,515185,298870.5,814055.5
355030,202005,209140,80488,128652,84294015.66,134973922.86,219267938.52
355040,202005,772,361,411,377245.5,430540,807785.5
355050,202005,150,94,56,98230,58520,156750
355060,202005,1634,817,817,853766.5,853765,1707531.5
355070,202005,1453,685,768,716870.77,806740.29,1523611.06
355080,202005,198,121,77,127490,82555,210045
355090,202005,285,171,114,179740,119130.19,298870.19
355100,202005,5049,2382,2667,2489089.6,2798511,5287600.6
355110,202005,256,173,83,180785.5,87780,268565.5
355120,202005,76,54,22,56430,22990,79420
355130,202005,52,29,23,30305,24035,54340
355140,202005,185,114,71,119130,74195,193325
355150,202005,677,404,273,422181,286331.26,708512.26
355160,202005,470,226,244,237215.29,254980.5,492195.79
355170,202005,2049,1074,975,1126510,1018875,2145385
355180,202005,676,288,388,302005,406505,708510
355190,202005,208,143,65,150480,67925,218405
355200,202005,112,64,48,66880,50160,117040
355210,202005,696,393,303,411730,317680,729410
355220,202005,7187,3702,3485,3874864,3652278.05,7527142.05
355230,202005,99,57,42,59565,43890,103455
355240,202005,4499,1869,2630,1956242.66,2756710,4712952.66
355250,202005,5851,2630,3221,2758819.6,3371170.25,6129989.85
355255,202005,48,28,20,29260,20900,50160
355260,202005,183,111,72,115995.5,75240,191235.5
355270,202005,162,102,60,106590,62700,169290
355280,202005,6398,2526,3872,2643852,4062961,6706813
355290,202005,76,60,16,62700,16720,79420
355300,202005,195,120,75,125400,79420.5,204820.5
355310,202005,108,59,49,61655,51205,112860
355320,202005,88,45,43,47025,44935,91960
355330,202005,283,161,122,168245,127490,295735
355340,202005,1493,517,976,540265.77,1022010,1562275.77
355350,202005,131,66,65,68970,67925,136895
355360,202005,168,113,55,118085.5,57475,175560.5
355365,202005,23,19,4,19855,4180,24035
355370,202005,1045,608,437,636406.08,459800,1096206.08
355380,202005,822,520,302,545490,315590,861080
355385,202005,74,52,22,54340,22990,77330
355390,202005,109,62,47,66880,49115,115995
355395,202005,191,110,81,115995.92,84645,200640.92
355400,202005,1665,988,677,1035512.25,708510.29,1744022.54
355410,202005,4879,2303,2576,2411863.5,2698190.75,5110054.25
355420,202005,49,34,15,35530,15675,51205
355430,202005,378,233,145,243485.5,152570,396055.5
355440,202005,80,45,35,47025,36575,83600
355450,202005,464,226,238,238261.2,248710.75,486971.95
355460,202005,64,47,17,49115.35,17765,66880.35
355465,202005,46,29,17,30305,17765,48070
355470,202005,175,72,103,75240.75,108680,183920.75
355475,202005,11,7,4,7315,4180,11495
355480,202005,520,219,301,230945,316635,547580
355490,202005,118,85,33,88825,35530,124355
355495,202005,62,25,37,26125,38665,64790
355500,202005,1577,879,698,920647.05,731500.5,1652147.55
355510,202005,268,199,69,207955.29,72105,280060.29
355520,202005,35,25,10,26125,10450,36575
355530,202005,20,12,8,12540,8360,20900
355535,202005,76,35,41,36575,42845,79420
355540,202005,2468,969,1499,1014842.84,1569590.79,2584433.63
355550,202005,57,35,22,36575,22990,59565
355560,202005,249,115,134,120175,140030,260205
355570,202005,24,16,8,16720,8360,25080
355580,202005,244,172,72,179740,75240.5,254980.5
355590,202005,16,10,6,10450,6270,16720
355600,202005,279,142,137,148390,143165,291555
355610,202005,231,153,78,160930,81510,242440
355620,202005,1332,602,730,631180.5,765985,1397165.5
355630,202005,446,326,120,344850,125400.29,470250.29
355635,202005,115,54,61,56430,64790,121220
355640,202005,565,320,245,334400,257070,591470
355645,202005,856,336,520,351120,543401,894521
355650,202005,1998,841,1157,883026.35,1211155,2094181.35
355660,202005,250,133,117,138985,122265,261250
355670,202005,563,227,336,237215,352165,589380
355680,202005,205,118,87,123310,91960,215270
355690,202005,94,44,50,45980,52250.66,98230.66
355695,202005,17,11,6,11495,6270,17765
355700,202005,1157,600,557,627000.65,584156,1211156.65
355710,202005,2232,1215,1017,1274901.55,1064855.5,2339757.05
355715,202005,19,15,4,15675,4180,19855
355720,202005,225,132,93,137940.6,97185,235125.6
355730,202005,103,58,45,60610,47025,107635
410010,202005,131,108,23,112860,24035,136895
410020,202005,113,87,26,91960,27170,119130
410030,202005,163,97,66,102410.5,68970,171380.5
410040,202005,1167,577,590,604010,616550,1220560
410045,202005,38,29,9,30305,9405,39710
410050,202005,479,269,210,282150,219450,501600
410060,202005,285,213,72,223630,75240,298870
410070,202005,298,249,49,262295,51205,313500
410080,202005,168,105,63,110770,66880,177650
410090,202005,80,69,11,72105.9,11495,83600.9
410100,202005,287,200,87,209000,90915,299915
410105,202005,49,30,19,31350,19855,51205
410110,202005,325,195,130,203775,136895,340670
410115,202005,33,25,8,26125,8360,34485
410120,202005,415,210,205,220495,214225,434720
410130,202005,48,29,19,30305,19855,50160
410140,202005,3131,1514,1617,1583177.67,1691859.33,3275037.00
410150,202005,2691,1049,1642,1099341.35,1720071.1,2819412.45
410160,202005,510,316,194,331265,202730,533995
410165,202005,67,42,25,43890,26125,70015
410170,202005,174,116,58,123310.5,60610,183920.5
410180,202005,2267,1264,1003,1326105,1049180,2375285
410185,202005,38,33,5,34485,5225,39710
410190,202005,491,322,169,336490.89,176605,513095.89
410200,202005,947,690,257,721050,269610,990660
410210,202005,606,316,290,330220,305140.5,635360.5
410220,202005,45,22,23,22990,24035,47025
410230,202005,147,71,76,74195,79420,153615
410240,202005,752,490,262,513095.75,274835,787930.75
410250,202005,382,277,105,289465,109725,399190
410260,202005,298,167,131,174515,136895.5,311410.5
410270,202005,28,20,8,20900,8360,29260
410275,202005,58,45,13,47025,13585,60610
410280,202005,323,188,135,196460,141075,337535
410290,202005,248,153,95,159885,99275,259160
410300,202005,80,57,23,59565,24035,83600
410302,202005,19,12,7,12540,7315,19855
410304,202005,42,29,13,30305,14630,44935
410305,202005,217,115,102,120175,107635,227810
410310,202005,220,129,91,135850,95095,230945
410315,202005,48,34,14,35530,15675,51205
410320,202005,134,94,40,98230,41800,140030
410322,202005,34,22,12,22990,12540,35530
410330,202005,177,122,55,127490,57475,184965
410335,202005,101,57,44,59565,45980,105545
410337,202005,42,33,9,34485,9405,43890
410340,202005,36,31,5,32395,5225,37620
410345,202005,215,126,89,131670,94050,225720
410347,202005,49,38,11,39710,11495,51205
410350,202005,236,143,93,150480,97185,247665
410360,202005,471,298,173,311410.5,180786,492196.5
410370,202005,2348,994,1354,1039775.45,1424336.35,2464111.80
410380,202005,207,131,76,136895,81510,218405
410390,202005,388,269,119,281105,124355,405460
410395,202005,37,24,13,25080,13585,38665
410400,202005,840,388,452,405460.27,472795,878255.27
410405,202005,92,69,23,72105,24035,96140
410410,202005,31,23,8,24035,8360,32395
410420,202005,1673,790,883,825457.49,925870.85,1751328.34
410425,202005,171,72,99,75240.69,104500,179740.69
410430,202005,2284,1277,1007,1336555,1055451.4,2392006.4
410440,202005,378,275,103,287375,107635,395010
410442,202005,361,239,122,249755,127490,377245
410445,202005,421,297,124,311410.5,130625,442035.5
410450,202005,391,195,196,203775,204820,408595
410460,202005,509,260,249,271700,260205,531905
410465,202005,216,131,85,137940,90915,228855
410470,202005,238,144,94,150480,98230,248710
410480,202005,6196,2992,3204,3137094.62,3362811.25,6499905.87
410490,202005,1427,873,554,913330.51,582065.5,1495396.01
410500,202005,261,146,115,152570,120175,272745
410510,202005,169,126,43,131670,44935,176605
410520,202005,252,186,66,194370,68970,263340
410530,202005,272,99,173,104500,180785,285285
410540,202005,321,234,87,244530,90915,335445
410550,202005,1679,726,953,759715,1000066,1759781
410560,202005,144,102,42,106590,43890,150480
410570,202005,435,290,145,303051.3,151525,454576.3
410580,202005,3485,1515,1970,1587356.33,2061785.5,3649141.83
410590,202005,402,272,130,285267,136895,422162
410600,202005,192,165,27,172425,28215,200640
410610,202005,53,43,10,44935,10450,55385
410620,202005,248,168,80,175560.03,83600,259160.03
410630,202005,438,251,187,262295,196460,458755
410640,202005,1023,636,387,666711,405460,1072171
410645,202005,109,79,30,82555,31350,113905
410650,202005,354,231,123,241395,128535,369930
410655,202005,87,63,24,65835,25080,90915
410657,202005,25,9,16,9405,16720,26125
410660,202005,598,418,180,437855.52,190190,628045.52
410670,202005,73,61,12,63745,12540,76285
410680,202005,214,171,43,178695,44935,223630
410685,202005,18,10,8,10450,8360,18810
410690,202005,28503,12071,16432,12643366.5,17220561.61,29863928.11
410700,202005,330,242,88,253935,93005,346940
410710,202005,128,104,24,108680,25080,133760
410712,202005,33,25,8,26125,8360,34485
410715,202005,90,65,25,67925,26125,94050
410720,202005,702,397,305,414865,320815,735680
410725,202005,182,132,50,137940,52250,190190
410730,202005,96,49,47,51205,49115,100320
410740,202005,107,76,31,79420,32395,111815
410750,202005,258,173,85,181830,89870,271700
410752,202005,25,15,10,15675,10450,26125
410753,202005,56,25,31,26125,32395,58520
410754,202005,48,25,23,26125.5,24035,50160.5
410755,202005,83,50,33,52250,34485,86735
410760,202005,776,426,350,445170.5,366795,811965.5
410765,202005,1767,820,947,856900,994841,1851741
410770,202005,108,84,24,87780,25080,112860
410773,202005,57,41,16,42845,16720,59565
410775,202005,185,136,49,142120,51205,193325
410780,202005,87,48,39,50160,40755,90915
410785,202005,59,46,13,48070,13585,61655
410790,202005,78,36,42,37620,43890,81510
410800,202005,291,177,114,184965,119130.5,304095.5
410810,202005,23,17,6,17765,6270.5,24035.5
410820,202005,172,126,46,131670,49115,180785
410830,202005,8656,3741,4915,3915617.43,5149760.5,9065377.93
410832,202005,104,73,31,76285,32395,108680
410840,202005,1459,793,666,832866.44,698060.25,1530926.69
410845,202005,69,43,26,44935,27170,72105
410850,202005,196,137,59,143165,61655,204820
410855,202005,58,46,12,48070,13585,61655
410860,202005,721,399,322,418000.5,339625,757625.5
410865,202005,101,76,25,79420,26125,105545
410870,202005,152,129,23,134805,24035,158840
410880,202005,1115,567,548,592515.5,574750,1167265.5
410890,202005,90,64,26,66880,27170,94050
410895,202005,72,55,17,57475,17765,75240
410900,202005,24,17,7,17765,7315,25080
410910,202005,16,13,3,13585,3135,16720
410920,202005,39,26,13,27170,13585,40755
410930,202005,523,325,198,340670,207955,548625
410940,202005,4370,2450,1920,2566521.57,2011625.5,4578147.07
410950,202005,105,77,28,80465,29260,109725
410960,202005,821,342,479,358435,500555,858990
410965,202005,62,47,15,50160,15675,65835
410970,202005,635,445,190,466070,198550,664620
410975,202005,123,75,48,78375.91,50160,128535.91
410980,202005,1623,730,893,763895,937365.5,1701260.5
410990,202005,269,185,84,193325,87780,281105
411000,202005,68,42,26,43890,28215.5,72105.5
411005,202005,27,22,5,22990,5225,28215
411007,202005,259,154,105,161975,109725,271700
411010,202005,605,409,196,428450,204820,633270
411020,202005,290,201,89,210045.85,93005,303050.85
411030,202005,18,10,8,10450,8360,18810
411040,202005,57,39,18,40755,18810,59565
411050,202005,206,159,47,166155,49115,215270
411060,202005,519,347,172,364705,180785,545490
411065,202005,56,48,8,50160,8360,58520
411070,202005,1246,763,483,799425,505780,1305205
411080,202005,244,172,72,179740,75240,254980
411090,202005,100,76,24,79420,25080,104500
411095,202005,284,111,173,115995,180785,296780
411100,202005,117,95,22,99275,22990,122265
411110,202005,128,84,44,87780,45980,133760
411120,202005,205,143,62,149435,65835,215270
411125,202005,240,103,137,107635,144210,251845
411130,202005,134,116,18,121220,18810,140030
411140,202005,211,139,72,146300,76285,222585
411150,202005,1222,803,419,840180,437855.54,1278035.54
411155,202005,122,83,39,86735,40755,127490
411160,202005,24,11,13,11495,13585,25080
411170,202005,52,47,5,49115.5,5225,54340.5
411180,202005,973,642,331,670994.5,345895,1016889.5
411190,202005,330,194,136,202730,143165,345895
411200,202005,672,412,260,431585.29,271700,703285.29
411210,202005,688,367,321,384560,336490.5,721050.5
411220,202005,154,112,42,118085,43890,161975
411230,202005,39,33,6,35530,7315,42845
411240,202005,120,77,43,80465,44935,125400
411250,202005,428,314,114,329175,119130,448305
411260,202005,18,12,6,12540,6270,18810
411270,202005,280,151,129,157795,136895,294690
411275,202005,185,163,22,171380,22990,194370
411280,202005,212,150,62,156750.29,64790,221540.29
411290,202005,61,47,14,50160,14630,64790
411295,202005,140,109,31,113905,32395,146300
411300,202005,79,36,43,37620,44935,82555
411310,202005,93,72,21,75240,21945,97185
411320,202005,779,527,252,551760,266475,818235
411325,202005,59,40,19,41800,19855,61655
411330,202005,900,572,328,597740.5,343805.99,941546.49
411340,202005,27,19,8,19855,8360,28215
411342,202005,66,51,15,53295,15675,68970
411345,202005,121,58,63,60610,65835,126445
411350,202005,485,371,114,389785.45,119130.5,508915.95
411360,202005,53,35,18,36575,19855,56430
411370,202005,14257,5815,8442,6088175.24,8840703.25,14928878.49
411373,202005,176,128,48,133760,50160,183920
411375,202005,77,61,16,63745,16720,80465
411380,202005,86,63,23,65835,24035,89870
411390,202005,126,80,46,83600,48070,131670
411400,202005,372,276,96,288420,100320,388740
411410,202005,439,223,216,233035,231990.5,465025.5
411420,202005,985,431,554,451440,578930,1030370
411430,202005,468,270,198,282150,206910,489060
411435,202005,33,21,12,21945,12540,34485
411440,202005,454,359,95,375155,99275,474430
411450,202005,419,356,63,372020,65835,437855
411460,202005,762,293,469,307230,491150.57,798380.57
411470,202005,85,63,22,65835,22990,88825
411480,202005,672,377,295,395010.5,309320,704330.5
411490,202005,295,189,106,197505,110770,308275
411500,202005,100,82,18,85690,18810,104500
411510,202005,223,178,45,186010,47025,233035
411520,202005,6065,2290,3775,2397231,3954281.76,6351512.76
411530,202005,123,83,40,86735,41800,128535
411535,202005,49,19,30,19855,31350,51205
411540,202005,351,241,110,251845,114950,366795
411545,202005,56,42,14,43890,14630,58520
411550,202005,79,61,18,63745,18810,82555
411560,202005,400,172,228,179740,238260,418000
411570,202005,829,301,528,315590.2,553850,869440.2
411573,202005,24,15,9,15675,9405,25080
411575,202005,293,188,105,196460,110770,307230
411580,202005,1284,465,819,488015,857945,1345960
411585,202005,75,36,39,37620,40755,78375
411590,202005,24,16,8,16720,8360,25080
411600,202005,26,12,14,12540,14630,27170
411605,202005,235,94,141,99275,148390,247665
411610,202005,204,135,69,141075,73150,214225
411620,202005,372,200,172,210045,179740,389785
411630,202005,55,38,17,39710,17765,57475
411640,202005,34,25,9,26125,9405,35530
411650,202005,12,7,5,7315,5225,12540
411660,202005,35,23,12,24035,12540,36575
411670,202005,239,174,65,182875,67925,250800
411680,202005,162,133,29,138985,30305,169290
411690,202005,589,316,273,332310,285285,617595
411695,202005,59,43,16,44935,16720,61655
411700,202005,139,116,23,122265,24035,146300
411705,202005,106,70,36,73150,37620,110770
411710,202005,304,206,98,216315,102410,318725
411720,202005,132,89,43,93005,44935,137940
411721,202005,65,54,11,57475,11495,68970
411722,202005,101,42,59,43890,61655,105545
411725,202005,155,117,38,122265.5,40755,163020.5
411727,202005,87,65,22,67925,22990,90915
411729,202005,37,29,8,31350,8360,39710
411730,202005,550,349,201,364705,212135,576840
411740,202005,40,24,16,25080,16720,41800
411745,202005,69,49,20,51205,20900,72105
411750,202005,859,386,473,404415.5,496375,900790.5
411760,202005,1185,879,306,919600.6,319770,1239370.6
411770,202005,459,304,155,317680,163020,480700
411780,202005,344,226,118,236170,123310,359480
411790,202005,523,292,231,307230.22,242440,549670.22
411800,202005,156,120,36,125400.46,38665,164065.46
411810,202005,177,133,44,140030,45980,186010
411820,202005,2212,971,1241,1017831.7,1304160,2321991.7
411830,202005,12,11,1,11495,1045,12540
411840,202005,2026,1234,792,1292665,832866,2125531
411845,202005,54,20,34,20900,35530,56430
411850,202005,1215,669,546,700150.5,571615.75,1271766.25
411860,202005,48,32,16,33440.5,16720,50160.5
411870,202005,71,47,24,49115,25080,74195
411880,202005,421,268,153,280060,159885,439945
411885,202005,105,69,36,72105,38665,110770
411890,202005,311,202,109,211091.49,113905,324996.49
411900,202005,78,59,19,61655.5,20900,82555.5
411910,202005,181,144,37,150480,38665,189145
411915,202005,2168,887,1281,930050,1340735.55,2270785.55
411920,202005,118,95,23,99275,24035,123310
411925,202005,12,8,4,8360,4180,12540
411930,202005,805,585,220,612370.85,229900,842270.85
411940,202005,584,399,185,418000.85,195415,613415.85
411950,202005,995,484,511,505780.76,533995,1039775.76
411960,202005,1037,700,337,731500.75,353210,1084710.75
411965,202005,20,14,6,14630,6270,20900
411970,202005,83,74,9,77330,9405,86735
411980,202005,170,107,63,111815,65835,177650
411990,202005,5164,2942,2222,3079623.49,2324082.75,5403706.24
411995,202005,491,171,320,178695,336490,515185
412000,202005,317,201,116,212135,121220,333355
412010,202005,45,28,17,29260,17765,47025
412015,202005,41,29,12,30305,12540,42845
412020,202005,31,25,6,26125,6270,32395
412030,202005,49,46,3,48070,3135,51205
412033,202005,48,30,18,31350,18810,50160
412035,202005,72,46,26,48070,27170,75240
412040,202005,43,25,18,26125.5,18810,44935.5
412050,202005,199,153,46,159885,48070,207955
412060,202005,780,582,198,608190,206910,815100
412065,202005,47,31,16,33440,16720,50160
412070,202005,163,110,53,114950,55385,170335
412080,202005,289,145,144,151525,151525,303050
412085,202005,35,16,19,16720,19855,36575
412090,202005,803,504,299,526680.25,313500,840180.25
412100,202005,240,205,35,215270,36575,251845
412110,202005,70,54,16,56430.5,16720,73150.5
412120,202005,325,195,130,203775,136895,340670
412125,202005,82,49,33,51205,34485,85690
412130,202005,36,23,13,24035.4,13585,37620.4
412135,202005,29,17,12,17765,12540,30305
412140,202005,347,230,117,240350,122265,362615
412150,202005,255,168,87,175560,90915,266475
412160,202005,91,51,40,53295,41800,95095
412170,202005,682,474,208,496375.5,218405,714780.5
412175,202005,38,28,10,29260,10450,39710
412180,202005,197,150,47,157795,49115,206910
412190,202005,338,268,70,281105,74195,355300
412200,202005,185,119,66,124355,68970,193325
412210,202005,72,57,15,59565,15675,75240
412215,202005,231,162,69,169290,72105,241395
412217,202005,67,53,14,55385,14630,70015
412220,202005,832,591,241,618640,251845,870485
412230,202005,328,198,130,206910,136895,343805
412240,202005,1347,669,678,700150,710600,1410750
412250,202005,408,254,154,266475,163020,429495
412260,202005,107,77,30,80465,31350,111815
412265,202005,175,138,37,144210,38665,182875
412270,202005,84,57,27,59565,28215,87780
412280,202005,90,73,17,76285,17765,94050
412290,202005,93,64,29,66880,31350,98230
412300,202005,203,135,68,141075,72105,213180
412310,202005,47,41,6,42845,6270,49115
412320,202005,99,81,18,84645,18810,103455
412330,202005,186,159,27,166155,28215,194370
412340,202005,154,108,46,113905,48070.5,161975.5
412350,202005,628,304,324,317680,338580,656260
412360,202005,26,22,4,22990,4180,27170
412370,202005,158,138,20,145255.3,20900,166155.3
412380,202005,263,199,64,207955,66880,274835
412382,202005,63,33,30,34485,31350,65835
412385,202005,151,109,42,113905,43890,157795
412390,202005,284,219,65,228855,67925,296780
412395,202005,71,58,13,60610,13585,74195
412400,202005,92,62,30,64790,31350,96140
412402,202005,232,117,115,122265.5,120175,242440.5
412405,202005,867,321,546,335445,570570,906015
412410,202005,969,597,372,627000.5,389785,1016785.5
412420,202005,13,12,1,12540,1045,13585
412430,202005,19,14,5,14630,5225,19855
412440,202005,619,336,283,351120,296780,647900
412450,202005,77,67,10,70015,10450,80465
412460,202005,92,70,22,73150,22990,96140
412470,202005,220,176,44,183920,45980,229900
412480,202005,145,107,38,111815.75,39710,151525.75
412490,202005,160,143,17,149435,17765,167200
412500,202005,436,356,80,373065.74,83600,456665.74
412510,202005,178,147,31,153615,32395,186010
412520,202005,91,61,30,63745,31350,95095
412530,202005,106,54,52,57475,54340,111815
412535,202005,91,68,23,71060,24035,95095
412540,202005,84,40,44,41800,45980,87780
412545,202005,91,62,29,64790,30305,95095
412550,202005,3806,1641,2165,1720070.5,2268695.5,3988766.0
412555,202005,13,9,4,9405,4180,13585
412560,202005,611,432,179,453531.5,188100.75,641632.25
412570,202005,764,394,370,412775,388740,801515
412575,202005,89,62,27,64790,28215,93005
412580,202005,178,116,62,121220,64790,186010
412590,202005,38,33,5,34485,5225,39710
412600,202005,166,124,42,130625.85,43890,174515.85
412610,202005,35,17,18,17765,18810,36575
412620,202005,146,124,22,130625,22990,153615
412625,202005,2145,1120,1025,1173536.04,1075307.35,2248843.39
412627,202005,68,51,17,53295,17765,71060
412630,202005,409,270,139,283195,145255,428450
412635,202005,65,18,47,18810,49115,67925
412640,202005,107,74,33,77330,34485,111815
412650,202005,342,222,120,233035,127490,360525
412660,202005,477,286,191,298870,199595,498465
412665,202005,46,41,5,42845,5225,48070
412667,202005,294,201,93,210045,98230,308275
412670,202005,64,52,12,54340,12540,66880
412680,202005,297,232,65,242440,67925.7,310365.7
412690,202005,101,67,34,72105,35530.5,107635.5
412700,202005,160,107,53,111815,55385,167200
412710,202005,1397,839,558,879891.25,587290,1467181.25
412720,202005,229,146,83,152570,86735,239305
412730,202005,187,157,30,164065,31350,195415
412740,202005,431,227,204,238260,213180,451440
412750,202005,438,247,191,260205,200640,460845
412760,202005,282,145,137,152570,143165,295735
412770,202005,2157,1194,963,1248775.29,1011561,2260336.29
412780,202005,140,108,32,112860,33440,146300
412785,202005,282,138,144,144210,150480,294690
412788,202005,36,21,15,21945,15675,37620
412790,202005,125,106,19,110770,20900,131670
412795,202005,151,109,42,113905,43890,157795
412796,202005,319,210,109,219450,113905,333355
412800,202005,611,372,239,388740.25,250800,639540.25
412810,202005,2939,1601,1338,1676182.4,1402390,3078572.4
412820,202005,941,592,349,618641.75,365750,984391.75
412830,202005,14,11,3,11495,3135,14630
412840,202005,225,163,62,170335,64790,235125
412850,202005,766,495,271,519365,283195,802560
412853,202005,172,87,85,90915,88825,179740
412855,202005,194,104,90,108680.09,94050,202730.09
412860,202005,94,64,30,66880,31350,98230
412862,202005,56,39,17,41800,17765,59565
412863,202005,6,5,1,5225,1045,6270
412865,202005,44,31,13,32395,13585,45980
412870,202005,112,67,45,70015,47025,117040
412880,202005,95,71,24,74195.5,25080,99275.5
420005,202005,42,38,4,39710,4180,43890
420010,202005,360,234,126,244530.75,131670,376200.75
420020,202005,84,70,14,73150,14630,87780
420030,202005,23,21,2,21945,2090,24035
420040,202005,105,82,23,85690,24035,109725
420050,202005,57,35,22,36575,22990,59565
420055,202005,19,19,0,19855,0,19855
420060,202005,28,22,6,22990,6270,29260
420070,202005,99,83,16,87780,16720,104500
420075,202005,11,11,0,11495,0,11495
420080,202005,44,38,6,39710,7315,47025
420090,202005,34,31,3,32395,3135,35530
420100,202005,149,126,23,131670.5,24035,155705.5
420110,202005,19,19,0,19855,0,19855
420120,202005,63,46,17,48070,17765,65835
420125,202005,79,62,17,64790,17765,82555
420127,202005,31,26,5,27170,5225,32395
420130,202005,425,255,170,266475,177650,444125
420140,202005,1302,721,581,753445.75,608190,1361635.75
420150,202005,43,36,7,37620,7315,44935
420160,202005,34,32,2,33440,2090,35530
420165,202005,18,12,6,12540,6270,18810
420170,202005,76,50,26,52250,27170,79420
420180,202005,21,18,3,18810,3135,21945
420190,202005,25,22,3,22990,3135,26125
420195,202005,131,63,68,65835,71060,136895
420200,202005,1277,564,713,591470.5,747175,1338645.5
420205,202005,81,45,36,47025,37620,84645
420207,202005,122,66,56,68970,58520,127490
420208,202005,19,15,4,15675,4180,19855
420209,202005,18,15,3,16720,3135,19855
420210,202005,513,236,277,247665,289465,537130
420213,202005,46,36,10,37620,10450,48070
420215,202005,26,23,3,24035,3135,27170
420220,202005,64,42,22,43890,22990,66880
420230,202005,829,468,361,493240,378290.5,871530.5
420240,202005,2257,1476,781,1545555.9,817190,2362745.9
420243,202005,42,32,10,33440,10450,43890
420245,202005,153,81,72,84645,75240,159885
420250,202005,62,41,21,42845,21945,64790
420253,202005,36,30,6,31350,6270,37620
420257,202005,14,11,3,11495,3135,14630
420260,202005,101,85,16,88825,16720,105545
420270,202005,31,26,5,27170,5225,32395
420280,202005,294,223,71,233035.75,74195.75,307231.50
420285,202005,22,12,10,12540,10450,22990
420287,202005,48,32,16,33440,16720,50160
420290,202005,969,671,298,704330.5,314545,1018875.5
420300,202005,1432,1134,298,1187122.95,311410.65,1498533.60
420310,202005,52,35,17,36575,17765,54340
420315,202005,35,28,7,29260,7315,36575
420320,202005,915,449,466,469205.1,489060,958265.1
420325,202005,0,,,,,0.0
420330,202005,119,78,41,81510,42845,124355
420340,202005,157,104,53,108680,55385,164065
420350,202005,255,181,74,189145,77330,266475
420360,202005,738,563,175,590425.33,183920.25,774345.58
420370,202005,120,71,49,74195,51205.5,125400.5
420380,202005,1183,820,363,857945.25,380380.5,1238325.75
420390,202005,250,175,75,182875,79420,262295
420395,202005,196,140,56,146300,58520,204820
420400,202005,242,185,57,193326.15,59565,252891.15
420410,202005,61,46,15,48070,15675,63745
420415,202005,34,29,5,30305,5225,35530
420417,202005,51,40,11,41800,11495,53295
420419,202005,11,11,0,11495,0,11495
420420,202005,2861,1766,1095,1850698.24,1147410.5,2998108.74
420425,202005,68,56,12,58520,12540,71060
420430,202005,1180,846,334,885115.45,349030,1234145.45
420435,202005,15,13,2,13585,2090,15675
420440,202005,102,72,30,75240.5,31350,106590.5
420445,202005,22,21,1,21945,1045,22990
420450,202005,77,38,39,39710,40755,80465
420455,202005,213,162,51,169290,53295,222585
420460,202005,2337,1512,825,1584222.57,863170,2447392.57
420470,202005,106,75,31,78375,32395,110770
420475,202005,7,7,0,7315,0,7315
420480,202005,859,644,215,677161,224675.5,901836.5
420490,202005,107,77,30,80465,31350.99,111815.99
420500,202005,455,236,219,247666.09,229900,477566.09
420510,202005,16,15,1,15675,1045,16720
420515,202005,24,17,7,17765,7315,25080
420517,202005,9,9,0,9405,0,9405
420519,202005,0,,,,,0.0
420520,202005,68,52,16,54340,16720,71060
420530,202005,162,109,53,113905.75,55385,169290.75
420535,202005,20,18,2,18810,2090,20900
420540,202005,5487,3268,2219,3421596.9,2328260.5,5749857.4
420543,202005,23,22,1,22990,1045,24035
420545,202005,207,147,60,153615,62700,216315
420550,202005,856,703,153,734635.9,159885,894520.9
420555,202005,35,26,9,27170,9405,36575
420560,202005,62,52,10,54340,10450,64790
420570,202005,158,90,68,94050,71060,165110
420580,202005,280,129,151,135850,158840.5,294690.5
420590,202005,520,353,167,370975,175560,546535
420600,202005,116,63,53,65835,55385,121220
420610,202005,39,34,5,36575,5225,41800
420620,202005,85,66,19,68970,19855,88825
420630,202005,151,105,46,109725,48070,157795
420640,202005,84,75,9,78375,9405,87780
420650,202005,247,128,119,133760,124355,258115
420660,202005,49,39,10,40755.5,10450,51205.5
420665,202005,38,29,9,30305,9405,39710
420670,202005,302,232,70,244530,73150,317680
420675,202005,13,12,1,12540,1045,13585
420680,202005,39,28,11,29260,11495,40755
420690,202005,173,135,38,141075,39710,180785
420700,202005,691,470,221,493240.46,233035,726275.46
420710,202005,146,82,64,87780,66880,154660
420720,202005,111,90,21,94050,21945,115995
420730,202005,614,382,232,399190.4,243485.5,642675.9
420740,202005,52,51,1,53295,1045,54340
420750,202005,498,335,163,351120,170335,521455
420757,202005,16,14,2,14630,2090,16720
420760,202005,37,29,8,30305,8360,38665
420765,202005,78,60,18,63745,18810,82555
420768,202005,52,46,6,48070,6270,54340
420770,202005,73,63,10,66880,10450,77330
420775,202005,40,36,4,38665,4180,42845
420780,202005,224,177,47,184965,49115,234080
420785,202005,12,10,2,10450,2090,12540
420790,202005,163,135,28,141075,29260,170335
420800,202005,67,51,16,53295,17765,71060
420810,202005,253,211,42,222585,43890,266475
420820,202005,2355,1348,1007,1414930.5,1056496.22,2471426.72
420830,202005,610,329,281,343805.5,293645,637450.5
420840,202005,148,108,40,112860,41800,154660
420845,202005,410,178,232,186010,242440.5,428450.5
420850,202005,264,199,65,207955.25,67925,275880.25
420860,202005,61,51,10,53295,10450,63745
420870,202005,124,87,37,90915,38665,129580
420880,202005,180,117,63,123310,65835,189145
420890,202005,933,466,467,489060.25,488015,977075.25
420895,202005,9,9,0,9405,0,9405
420900,202005,405,321,84,336490,87780,424270
420910,202005,5901,3274,2627,3424469.33,2757755,6182224.33
420915,202005,70,64,6,66880,6270,73150
420917,202005,22,15,7,15675,7315,22990
420920,202005,22,15,7,15675,7315,22990
420930,202005,2815,1750,1065,1833910,1116062.28,2949972.28
420940,202005,596,438,158,457711,165110.9,622821.9
420945,202005,9,7,2,7315,2090,9405
420950,202005,56,49,7,51205,7315,58520
420960,202005,110,87,23,91960,24035,115995
420970,202005,297,237,60,247666,62700,310366
420980,202005,23,22,1,22990,1045,24035
420985,202005,58,51,7,53295,7315,60610
420990,202005,79,58,21,61655,21945,83600
421000,202005,39,24,15,25080,15675,40755
421003,202005,51,35,16,36575,16720,53295
421005,202005,6,3,3,3135,3135,6270
421010,202005,772,527,245,551760,257070.75,808830.75
421020,202005,25,20,5,20900,5225,26125
421030,202005,119,100,19,105545.75,20900,126445.75
421040,202005,73,55,18,58520,18810,77330
421050,202005,345,243,102,256026,106590,362616
421055,202005,21,17,4,17765,4180,21945
421060,202005,90,52,38,54340,39710,94050
421070,202005,49,43,6,44935.5,6270,51205.5
421080,202005,36,32,4,33440,4180,37620
421085,202005,20,15,5,15675,5225,20900
421090,202005,37,28,9,29260,9405,38665
421100,202005,124,91,33,95095,34485,129580
421105,202005,204,168,36,176605,37620,214225
421110,202005,114,89,25,93005,26125,119130
421120,202005,163,120,43,125400.42,44935,170335.42
421125,202005,17,12,5,12540,5225,17765
421130,202005,815,512,303,536085,316635.5,852720.5
421140,202005,29,20,9,20900,9405,30305
421145,202005,41,33,8,34485,8360,42845
421150,202005,103,74,29,77330,30305,107635
421160,202005,68,46,22,48070,22990,71060
421165,202005,16,15,1,15675,1045,16720
421170,202005,184,155,29,162101.5,31350,193451.5
421175,202005,166,113,53,119130,55385,174515
421180,202005,51,36,15,37620.1,16720,54340.1
421185,202005,18,14,4,14630,4180,18810
421187,202005,1,0,1,0,1045,1045
421189,202005,45,31,14,32395,14630,47025
421190,202005,1685,1055,630,1103520,658350,1761870
421200,202005,95,70,25,73150,26125,99275
421205,202005,28,18,10,18810,10450,29260
421210,202005,173,119,54,124355,56430,180785
421220,202005,278,217,61,226765,63745,290510
421223,202005,50,40,10,41800,10450,52250
421225,202005,70,44,26,45980,27170,73150
421227,202005,87,67,20,70015,20900,90915
421230,202005,53,37,16,38665,16720,55385
421240,202005,18,18,0,18810,0,18810
421250,202005,375,224,151,235125.5,157795,392920.5
421260,202005,24,20,4,20900,4180,25080
421265,202005,2,2,0,2090,0,2090
421270,202005,46,41,5,42845,5225,48070
421280,202005,348,190,158,198550,165110,363660
421290,202005,333,221,112,231990,118085,350075
421300,202005,23,19,4,19855,4180,24035
421310,202005,46,33,13,34485,13585,48070
421315,202005,30,19,11,19855,11495,31350
421320,202005,129,82,47,85690,49115,134805
421330,202005,107,77,30,80465,31350,111815
421335,202005,40,28,12,29260,12540,41800
421340,202005,243,156,87,163020.25,90915,253935.25
421350,202005,187,108,79,112860.82,83600,196460.82
421360,202005,647,480,167,502645.25,174515,677160.25
421370,202005,203,153,50,159885,52250,212135
421380,202005,127,100,27,104500,28215,132715
421390,202005,19,13,6,13585,6270,19855
421400,202005,128,110,18,114950,18810,133760
421410,202005,17,15,2,15675,2090,17765
421415,202005,21,20,1,20900,1045,21945
421420,202005,134,112,22,117040,22990,140030
421430,202005,16,12,4,12540,4180,16720
421440,202005,59,50,9,52250,9405,61655
421450,202005,90,75,15,78375,15675,94050
421460,202005,61,49,12,51205,12540,63745
421470,202005,69,43,26,44935,27170,72105
421480,202005,717,548,169,572660,177650,750310
421490,202005,23,22,1,22990,1045,24035
421500,202005,488,312,176,326040.5,183920.25,509960.75
421505,202005,25,18,7,18810,7315,26125
421507,202005,32,24,8,25080,8360,33440
421510,202005,70,45,25,47025,26125,73150
421520,202005,55,46,9,48070,9405,57475
421530,202005,49,42,7,43890,7315,51205
421535,202005,27,24,3,25080,3135,28215
421540,202005,51,45,6,48070,6270,54340
421545,202005,101,74,27,77330,28215,105545
421550,202005,285,205,80,216315,83600,299915
421555,202005,21,17,4,17765,4180.5,21945.5
421560,202005,8,7,1,7315,1045,8360
421565,202005,124,83,41,86735,42845,129580
421567,202005,29,23,6,24035,6270,30305
421568,202005,29,25,4,26125,4180,30305
421569,202005,11,11,0,11495,0,11495
421570,202005,202,135,67,141075,70015,211090
421575,202005,27,22,5,22990,5225,28215
421580,202005,715,432,283,451508,295735,747243
421590,202005,19,18,1,18810,1045,19855
421600,202005,149,98,51,102410,53295.5,155705.5
421605,202005,111,76,35,79420.75,36575,115995.75
421610,202005,185,141,44,147345,45980,193325
421620,202005,1032,604,428,632225,449350,1081575
421625,202005,21,18,3,18810,3135,21945
421630,202005,303,188,115,196460.25,120176.5,316636.75
421635,202005,19,9,10,9405,10450,19855
421640,202005,97,81,16,84645,16720,101365
421650,202005,302,178,124,186010,129580,315590
421660,202005,2233,1339,894,1402391.5,935276,2337667.5
421670,202005,185,132,53,137940,55385,193325
421680,202005,178,160,18,167200,18810,186010
421690,202005,346,243,103,253935.5,107635.6,361571.1
421700,202005,54,37,17,38665,17765,56430
421710,202005,24,23,1,24035,1045,25080
421715,202005,6,5,1,5225,1045,6270
421720,202005,630,437,193,456666.21,201685,658351.21
421725,202005,16,6,10,6270,10450,16720
421730,202005,34,24,10,25080,10450,35530
421740,202005,89,34,55,35530,57475,93005
421750,202005,210,157,53,164065,55385,219450
421755,202005,23,21,2,21945,2090,24035
421760,202005,98,66,32,68970,33440,102410
421770,202005,650,414,236,432631.75,246620,679251.75
421775,202005,30,18,12,18810,12540,31350
421780,202005,193,150,43,158840.5,44935,203775.5
421790,202005,152,129,23,134805,24035,158840
421795,202005,18,15,3,15675,3135,18810
421800,202005,517,331,186,345895,195415,541310
421810,202005,68,55,13,58520,13585,72105
421820,202005,320,206,114,216315.5,119130,335445.5
421825,202005,139,118,21,123310,21945,145255
421830,202005,135,90,45,94050,47025,141075
421835,202005,6,4,2,4180,2090,6270
421840,202005,52,44,8,45980,8360,54340
421850,202005,80,68,12,71060,12540,83600
421860,202005,36,30,6,31350,6270,37620
421870,202005,1012,755,257,790021,268565,1058586
421875,202005,54,44,10,45980,10450,56430
421880,202005,168,117,51,122265,53295.5,175560.5
421885,202005,21,17,4,17765,4180,21945
421890,202005,136,96,40,100320,41800,142120
421895,202005,45,40,5,41800,5225,47025
421900,202005,152,120,32,125400,33440,158840
421910,202005,67,41,26,42845,27170,70015
421915,202005,30,25,5,26125,5225,31350
421917,202005,38,28,10,29260,10450,39710
421920,202005,42,38,4,39710,4180,43890
421930,202005,683,545,138,570570.87,144210,714780.87
421935,202005,48,42,6,43890,6270,50160
421940,202005,41,36,5,37620,5225,42845
421950,202005,867,576,291,602965.5,304095,907060.5
421960,202005,46,40,6,41800.5,6270,48070.5
421970,202005,359,230,129,241395.5,134805,376200.5
421985,202005,23,13,10,13585,10450,24035
422000,202005,0,,,,,0.0
430003,202005,186,56,130,58520,135850,194370
430005,202005,37,27,10,28215,10450,38665
430010,202005,266,193,73,201685,76285,277970
430020,202005,143,96,47,100320.5,49115,149435.5
430030,202005,122,98,24,102410,25080,127490
430040,202005,2923,1717,1206,1796357,1262360.5,3058717.5
430045,202005,68,57,11,59565,11495,71060
430047,202005,6,6,0,6270,0,6270
430050,202005,77,65,12,70015,12540,82555
430055,202005,12,11,1,11495,1045,12540
430057,202005,5,4,1,4180,1045,5225
430060,202005,3714,2159,1555,2259291.75,1630200,3889491.75
430063,202005,52,48,4,50160,4180,54340
430064,202005,153,124,29,129580,31350,160930
430066,202005,5,2,3,2090,3135,5225
430070,202005,42,29,13,30305,13585,43890
430080,202005,68,47,21,49115,24035,73150
430085,202005,31,10,21,10450,21945,32395
430087,202005,28,21,7,21945.75,7315,29260.75
430090,202005,69,63,6,65835,6270,72105
430100,202005,124,84,40,87780,41800,129580
430105,202005,153,86,67,89870,70015,159885
430107,202005,19,13,6,13585,6270,19855
430110,202005,437,251,186,262295,194370,456665
430120,202005,151,140,11,148390,11495,159885
430130,202005,799,487,312,509960.5,327085,837045.5
430140,202005,124,116,8,121220,8360,129580
430150,202005,109,71,38,74195,39710,113905
430155,202005,35,31,4,32395,4180,36575
430160,202005,3646,2139,1507,2238392.75,1577950.5,3816343.25
430163,202005,365,162,203,169290,213180,382470
430165,202005,29,20,9,20900,9405,30305
430170,202005,89,75,14,79420,14630,94050
430175,202005,77,59,18,61655,18810,80465
430180,202005,105,86,19,89870,19855,109725
430185,202005,31,21,10,21945,10450,32395
430187,202005,82,38,44,40755,45980,86735
430190,202005,221,120,101,125400,105545,230945
430192,202005,13,11,2,11495,2090,13585
430195,202005,16,11,5,11495,5225,16720
430200,202005,165,142,23,148390,24035,172425
430205,202005,21,20,1,20900,1045,21945
430210,202005,687,530,157,553850.5,165110.5,718961.0
430215,202005,13,10,3,10450,3135,13585
430220,202005,72,50,22,52250,22990,75240
430222,202005,12,6,6,6270,6270,12540
430223,202005,15,8,7,8360,7315,15675
430225,202005,2,1,1,1045,1045,2090
430230,202005,317,187,130,196460,136895,333355
430235,202005,55,43,12,44935,12540,57475
430237,202005,27,21,6,21945,6270,28215
430240,202005,129,86,43,89870,44935,134805
430245,202005,70,56,14,58520,14630,73150
430250,202005,187,111,76,115995,80465,196460
430258,202005,9,8,1,8360,1045,9405
430260,202005,32,28,4,29260,4180,33440
430265,202005,36,30,6,31350,6270,37620
430270,202005,521,385,136,402326.25,142120,544446.25
430280,202005,1041,633,408,662530,428450,1090980
430290,202005,401,216,185,225720,193325,419045
430300,202005,2077,1139,938,1194435.75,981255.5,2175691.25
430310,202005,2004,1011,993,1057540.5,1037686.21,2095226.71
430320,202005,58,47,11,49115,11495,60610
430330,202005,100,88,12,91960,12540,104500
430340,202005,72,58,14,60610,14630,75240
430350,202005,1658,1124,534,1176670.96,559075,1735745.96
430355,202005,19,17,2,17765,2090,19855
430360,202005,87,44,43,45980,45980,91960
430367,202005,35,26,9,27170,9405,36575
430370,202005,54,47,7,49115,7315,56430
430380,202005,135,104,31,108680,33440,142120
430390,202005,587,363,224,379335,234080,613415
430400,202005,135,99,36,104500.5,37620,142120.5
430410,202005,54,43,11,44935,12540,57475
430420,202005,508,334,174,349030.85,181830,530860.85
430430,202005,54,53,1,54689.03,1045,55734.03
430435,202005,154,114,40,119130,41800,160930
430440,202005,492,322,170,336490,179740,516230
430450,202005,1154,953,201,997975,212135,1210110
430460,202005,5247,2749,2498,2878976.4,2617725,5496701.4
430461,202005,16,15,1,15675,1045,16720
430462,202005,10,6,4,6270,4180,10450
430463,202005,1082,585,497,612370.77,523545,1135915.77
430465,202005,25,13,12,13585,12540,26125
430466,202005,679,483,196,507870.5,205865,713735.5
430467,202005,102,54,48,56430,50160,106590
430468,202005,121,72,49,75240,51205,126445
430469,202005,23,18,5,18810,5225,24035
430470,202005,1151,642,509,671202.62,533995,1205197.62
430471,202005,57,38,19,39710,19855,59565
430480,202005,102,66,36,68970,37620,106590
430485,202005,6,6,0,6270.5,0,6270.5
430490,202005,81,64,17,66880,17765,84645
430495,202005,34,26,8,27170,8360,35530
430500,202005,188,127,61,132715,63745,196460
430510,202005,3443,2228,1215,2335575.63,1274900,3610475.63
430511,202005,16,16,0,16720,0,16720
430512,202005,152,106,46,110770,48070,158840
430513,202005,53,43,10,44935,10450,55385
430515,202005,27,25,2,26125,2090,28215
430517,202005,166,146,20,152570,20900,173470
430520,202005,350,243,107,253935,112860,366795
430530,202005,85,50,35,52250,36575,88825
430535,202005,456,308,148,321860,156750,478610
430537,202005,9,9,0,9405,0,9405
430540,202005,84,57,27,59565,28215,87780
430543,202005,347,111,236,115995,248710,364705
430544,202005,42,39,3,40755,3135,43890
430545,202005,371,189,182,198550,190190,388740
430550,202005,41,34,7,35530,7315,42845
430558,202005,3,2,1,2090,1045,3135
430560,202005,55,29,26,31350,27170,58520
430570,202005,107,41,66,42845,68970,111815
430580,202005,129,106,23,111815,24035,135850
430583,202005,13,13,0,13585,0,13585
430585,202005,12,5,7,5225,7315,12540
430587,202005,14,7,7,7315,7315,14630
430590,202005,141,117,24,122265,25080,147345
430593,202005,2,2,0,2090,0,2090
430595,202005,16,13,3,13585,3135,16720
430597,202005,42,22,20,24035,20900,44935
430600,202005,219,160,59,167200,61655,228855
430605,202005,160,101,59,105545,61655,167200
430607,202005,24,20,4,20900,4180,25080
430610,202005,1623,762,861,797335,902880.5,1700215.5
430613,202005,2,2,0,2090,0,2090
430620,202005,107,76,31,79420,32395,111815
430630,202005,47,41,6,42845,6270,49115
430632,202005,31,26,5,27170,5225,32395
430635,202005,33,30,3,31350,3135,34485
430637,202005,60,30,30,31350,31350,62700
430640,202005,175,96,79,101365,82555,183920
430642,202005,21,17,4,17765,4180,21945
430645,202005,36,29,7,30305,7315,37620
430650,202005,245,201,44,211090.5,45980,257070.5
430655,202005,2,2,0,2090,0,2090
430660,202005,967,480,487,502645,509960.5,1012605.5
430670,202005,75,50,25,53295,26125,79420
430673,202005,67,40,27,41800,28215,70015
430675,202005,11,9,2,9405,2090,11495
430676,202005,513,304,209,318725,221540,540265
430680,202005,241,164,77,171381,80465,251846
430690,202005,529,326,203,341715,212135.29,553850.29
430692,202005,9,6,3,6270,3135,9405
430693,202005,134,88,46,91960,48070,140030
430695,202005,67,55,12,57475,12540,70015
430697,202005,55,35,20,36575,20900,57475
430700,202005,1508,1047,461,1098295.9,483835,1582130.9
430705,202005,23,20,3,20900,3135,24035
430710,202005,261,165,96,172425,100320,272745
430720,202005,106,90,16,95095,16720,111815
430730,202005,137,118,19,124355,19855,144210
430740,202005,74,49,25,51205,26125,77330
430745,202005,30,23,7,24035,7315,31350
430750,202005,322,214,108,224675,113905,338580
430755,202005,88,48,40,50160,41800,91960
430760,202005,380,218,162,228855.6,169290,398145.6
430770,202005,1503,786,717,823460.5,750310.5,1573771.0
430780,202005,290,184,106,194370,110770,305140
430781,202005,26,22,4,22990,4180,27170
430783,202005,60,48,12,50160,12540,62700
430786,202005,5,3,2,3135,2090,5225
430790,202005,513,339,174,354255,183920.5,538175.5
430800,202005,155,126,29,131670.76,30305,161975.76
430805,202005,39,35,4,36575,4180,40755
430807,202005,45,24,21,25080,21945,47025
430810,202005,74,45,29,47025,30305,77330
430820,202005,146,88,58,91960,61655,153615
430825,202005,10,8,2,8360,2090,10450
430830,202005,237,219,18,229900.5,18810,248710.5
430840,202005,127,86,41,89870,42845,132715
430843,202005,5,3,2,3135,2090,5225
430845,202005,73,41,32,42845.28,33440,76285.28
430850,202005,588,415,173,434720,181830,616550
430860,202005,161,102,59,106590,61655,168245
430865,202005,75,43,32,44935,33440,78375
430870,202005,79,64,15,66880,15675,82555
430880,202005,150,111,39,115995,40755,156750
430885,202005,8,6,2,6270,2090,8360
430890,202005,347,209,138,219450,145255,364705
430900,202005,508,356,152,373065,158840,531905
430905,202005,117,50,67,52250,70015,122265
430910,202005,285,154,131,160930,136895,297825
430912,202005,5,5,0,5225,0,5225
430915,202005,33,29,4,30305,4180,34485
430920,202005,4296,2291,2005,2399320,2102540,4501860
430925,202005,4,3,1,3135,1045,4180
430930,202005,2107,1218,889,1276992.25,932140.5,2209132.75
430940,202005,259,167,92,174515,96140,270655
430950,202005,150,124,26,129580,27170,156750
430955,202005,22,11,11,11495,11495,22990
430957,202005,17,15,2,15675,2090,17765
430960,202005,245,167,78,174515,81510,256025
430965,202005,115,72,43,75240,45980,121220
430970,202005,82,69,13,72105,13585,85690
430975,202005,42,38,4,39710,4180,43890
430980,202005,45,27,18,29260,18810,48070
430990,202005,109,84,25,87780,26125,113905
430995,202005,115,109,6,113905,6270,120175
431000,202005,298,140,158,146301.1,165110,311411.1
431010,202005,357,204,153,213180,159885,373065
431020,202005,1865,1081,784,1131735.5,820325,1952060.5
431030,202005,42,34,8,35530,8360,43890
431033,202005,406,196,210,204820,220495,425315
431036,202005,12,7,5,7315,5225,12540
431040,202005,141,87,54,90915,57475,148390
431041,202005,41,27,14,28215.5,14630,42845.5
431043,202005,43,25,18,26125,18810,44935
431046,202005,10,6,4,6270,4180,10450
431050,202005,204,129,75,134805,78375,213180
431053,202005,69,41,28,42845,29260,72105
431055,202005,63,42,21,43890,21945,65835
431057,202005,18,18,0,18810,0,18810
431060,202005,1618,1050,568,1099341.34,594605.75,1693947.09
431065,202005,17,11,6,11495,6270,17765
431070,202005,63,57,6,59565,6270,65835
431075,202005,7,7,0,7315,0,7315
431080,202005,133,81,52,84645,54340,138985
431085,202005,33,30,3,31350,3135,34485
431087,202005,15,13,2,13585,2090,15675
431090,202005,55,43,12,44935,12540,57475
431100,202005,1218,734,484,768076.55,505780,1273856.55
431110,202005,230,139,91,145255,95095.5,240350.5
431112,202005,27,15,12,15675,12540,28215
431113,202005,33,24,9,25080,9405,34485
431115,202005,152,107,45,111815,47025,158840
431120,202005,607,363,244,379335,257070,636405
431123,202005,3,2,1,2090,1045,3135
431125,202005,95,86,9,89870,9405,99275
431127,202005,10,5,5,5225,5225,10450
431130,202005,690,454,236,475475,247665,723140
431140,202005,752,518,234,541310.5,245575,786885.5
431142,202005,26,22,4,22990.67,4180,27170.67
431150,202005,197,148,49,154660,51205,205865
431160,202005,50,45,5,47025,5225,52250
431162,202005,5,4,1,4180,1045,5225
431164,202005,6,6,0,6270,0,6270
431170,202005,106,84,22,87780,22990,110770
431171,202005,69,41,28,42845,29260,72105
431173,202005,1,1,0,1045,0,1045
431175,202005,199,102,97,106590.5,101365,207955.5
431177,202005,82,58,24,60610,25080,85690
431179,202005,12,10,2,10450,2090,12540
431180,202005,435,262,173,274835,182875,457710
431190,202005,79,61,18,63745,18810,82555
431198,202005,76,55,21,57475,21945,79420
431200,202005,21,17,4,17765,4180,21945
431205,202005,20,19,1,19855,1045,20900
431210,202005,96,60,36,62700,37620,100320
431213,202005,30,26,4,27170,4180,31350
431215,202005,22,19,3,19855,3135,22990
431217,202005,4,3,1,3135,1045,4180
431220,202005,67,58,9,60610.87,9405,70015.87
431225,202005,148,96,52,100320,54340,154660
431230,202005,100,86,14,89870,14630,104500
431235,202005,7,7,0,7315,0,7315
431237,202005,22,16,6,16720,6270,22990
431238,202005,9,6,3,6270,3135,9405
431240,202005,1009,640,369,670890,385605,1056495
431242,202005,38,37,1,38665,1045,39710
431244,202005,13,9,4,9405,4180,13585
431245,202005,48,36,12,37620,12540,50160
431247,202005,10,7,3,7315,3135,10450
431250,202005,282,145,137,152570,144210,296780
431260,202005,58,45,13,47025,13585,60610
431261,202005,18,11,7,11495,7315,18810
431262,202005,17,16,1,16720,1045,17765
431265,202005,151,81,70,84645,73150,157795
431267,202005,17,15,2,15675,2090,17765
431270,202005,324,264,60,275880,62700,338580
431275,202005,37,34,3,35530,3135,38665
431280,202005,19,15,4,15675,4180,19855
431290,202005,23,21,2,21945,2090,24035
431295,202005,2,2,0,2090,0,2090
431300,202005,21,18,3,18810,3135,21945
431301,202005,6,6,0,6270,0,6270
431303,202005,57,38,19,39710,19855,59565
431306,202005,242,128,114,133573.99,119130,252703.99
431308,202005,7,5,2,5225,2090,7315
431310,202005,67,56,11,58520,11495,70015
431320,202005,145,86,59,91960,62700,154660
431330,202005,175,114,61,119130,63745,182875
431333,202005,24,20,4,20900,4180,25080
431335,202005,9,5,4,5225,4180,9405
431337,202005,351,155,196,161975,205865,367840
431339,202005,20,18,2,18810,2090,20900
431340,202005,3010,1653,1357,1728348.24,1420156.25,3148504.49
431342,202005,36,23,13,24035,13585,37620
431344,202005,18,18,0,18810,0,18810
431346,202005,5,5,0,5225,0,5225
431349,202005,34,30,4,31350,4180,35530
431350,202005,936,542,394,566390.75,413820,980210.75
431360,202005,46,39,7,41800,7315,49115
431365,202005,336,157,179,165110,187055,352165
431370,202005,1338,781,557,816145.5,584155,1400300.5
431380,202005,97,84,13,87780,13585,101365
431390,202005,498,266,232,277970,242440,520410
431395,202005,292,128,164,133760,171380,305140
431400,202005,42,29,13,30305,13585,43890
431402,202005,102,72,30,75240,32395,107635
431403,202005,25,14,11,14630,11495,26125
431405,202005,669,365,304,381425.25,318725,700150.25
431406,202005,30,26,4,27170,4180,31350
431407,202005,54,43,11,44935,11495,56430
431410,202005,3390,2069,1321,2166285.5,1385670.75,3551956.25
431413,202005,15,12,3,12540,3135,15675
431415,202005,70,51,19,53295,19855,73150
431417,202005,23,12,11,12540,11495,24035
431420,202005,320,217,103,226765,107635,334400
431430,202005,50,22,28,22990,29260,52250
431440,202005,8883,6180,2703,6470648.9,2830906.76,9301555.66
431442,202005,29,13,16,13585,16720,30305
431445,202005,23,21,2,21945,2090,24035
431446,202005,4,4,0,4180,0,4180
431447,202005,81,57,24,59565,25080,84645
431449,202005,53,46,7,48070,7315,55385
431450,202005,413,275,138,287375,144210,431585
431454,202005,0,,,,,0.0
431455,202005,53,41,12,42845,12540,55385
431460,202005,517,355,162,372020,169290,541310
431470,202005,118,89,29,93005,30305,123310
431475,202005,11,9,2,9405,2090,11495
431477,202005,36,25,11,26125,11495,37620
431478,202005,9,8,1,8360,1045,9405
431480,202005,506,305,201,318725,211090,529815
431490,202005,28597,16032,12565,16795250.59,13163869,29959119.59
431500,202005,75,61,14,63745,14630,78375
431505,202005,26,15,11,15675,11495,27170
431507,202005,10,8,2,8360,2090,10450
431510,202005,254,180,74,188100.25,77330,265430.25
431513,202005,24,21,3,21945,3135,25080
431514,202005,6,5,1,5225,1045,6270
431515,202005,82,68,14,71060,14630,85690
431517,202005,5,3,2,3135,2090,5225
431520,202005,41,36,5,37620,5225,42845
431530,202005,1457,661,796,690745,832865,1523610
431531,202005,24,23,1,24035,1045,25080
431532,202005,33,24,9,25080,9405,34485
431535,202005,28,16,12,16720,12540,29260
431540,202005,137,116,21,121220,21945,143165
431545,202005,14,12,2,12540,2090,14630
431550,202005,352,196,156,205865,163020,368885
431555,202005,12,12,0,12540,0,12540
431560,202005,4541,3110,1431,3254133.53,1498530,4752663.53
431570,202005,825,428,397,447261,418000,865261
431575,202005,40,22,18,22990,18810,41800
431580,202005,95,63,32,65835,33440,99275
431590,202005,144,123,21,128535,21945,150480
431595,202005,18,15,3,15675,3135,18810
431600,202005,247,143,104,149435,108680,258115
431610,202005,115,84,31,87780,32395,120175
431620,202005,43,36,7,37620,7315,44935
431630,202005,130,108,22,112860,22990,135850
431640,202005,1336,855,481,893475.5,502645.5,1396121.0
431642,202005,35,33,2,35530,2090,37620
431643,202005,45,21,24,21945,25080,47025
431645,202005,318,188,130,196460,135850,332310
431647,202005,9,9,0,9405,0,9405
431650,202005,34,23,11,24035,11495,35530
431660,202005,324,207,117,216315,122265,338580
431670,202005,228,103,125,107635,130625,238260
431673,202005,3,3,0,3135,0,3135
431675,202005,27,21,6,21945,6270,28215
431680,202005,1108,816,292,853765,307230,1160995
431690,202005,4733,2848,1885,2981388.6,1974006,4955394.6
431695,202005,23,16,7,16720,7315,24035
431697,202005,1,0,1,0,1045,1045
431700,202005,177,137,40,143165,41800,184965
431710,202005,3992,1746,2246,1825615.5,2352295,4177910.5
431720,202005,1321,816,505,854288,528770,1383058
431725,202005,1,1,0,1045,0,1045
431730,202005,1165,792,373,828687.9,389785,1218472.9
431740,202005,1342,661,681,691790,711645.5,1403435.5
431750,202005,1832,1197,635,1251910.55,664620,1916530.55
431755,202005,5,4,1,4180,1045,5225
431760,202005,1034,658,376,687612,396055,1083667
431770,202005,411,296,115,311410,120175,431585
431775,202005,30,22,8,22990,8360,31350
431780,202005,541,331,210,347985,220495,568480
431790,202005,166,129,37,134805,38665,173470
431795,202005,12,10,2,10450,2090,12540
431800,202005,3235,1695,1540,1774412.7,1613481,3387893.7
431805,202005,17,15,2,15675,2090,17765
431810,202005,598,394,204,412775,214225,627000
431820,202005,327,196,131,205865,137940,343805
431830,202005,2316,1389,927,1452550.5,968715,2421265.5
431840,202005,488,326,162,340670,169290,509960
431842,202005,36,29,7,30305,7315,37620
431843,202005,10,8,2,8360,2090,10450
431844,202005,17,13,4,13585,4180,17765
431845,202005,28,25,3,26125,3135,29260
431846,202005,26,22,4,22990,4180,27170
431848,202005,12,10,2,10450,2090,12540
431849,202005,8,6,2,6270,2090,8360
431850,202005,788,641,147,674025,153615,827640
431860,202005,113,76,37,79420,38665,118085
431861,202005,7,2,5,2090,5225,7315
431862,202005,54,37,17,38665,18810,57475
431870,202005,3488,2014,1474,2110900.5,1542420,3653320.5
431880,202005,922,674,248,705375,260205,965580
431890,202005,1301,786,515,822415.5,538175,1360590.5
431900,202005,182,130,52,135850,55385,191235
431910,202005,54,39,15,40755,15675,56430
431912,202005,42,25,17,26125,17765,43890
431915,202005,121,95,26,99275,28215,127490
431920,202005,154,112,42,117040,43890,160930
431930,202005,80,65,15,67925,15675,83600
431935,202005,3,3,0,3135,0,3135
431936,202005,12,11,1,11495,1045,12540
431937,202005,18,14,4,14630,4180,18810
431940,202005,462,309,153,322905,159885.25,482790.25
431950,202005,499,313,186,327085.5,194370,521455.5
431960,202005,736,403,333,421135.5,349030,770165.5
431970,202005,70,63,7,65835,7315,73150
431971,202005,3,3,0,3135,0,3135
431973,202005,21,17,4,17765,4180,21945
431975,202005,9,8,1,8360,1045,9405
431980,202005,211,132,79,138985,82555,221540
431990,202005,1147,616,531,643652.52,555940,1199592.52
432000,202005,1710,904,806,945726.75,844361,1790087.75
432010,202005,278,188,90,197505,94050,291555
432020,202005,169,140,29,147345,30305,177650
432023,202005,16,13,3,13585,3135,16720
432026,202005,67,62,5,64790,5225,70015
432030,202005,69,35,34,37620,35530,73150
432032,202005,20,16,4,16720,4180,20900
432035,202005,54,44,10,45980,10450,56430
432040,202005,98,68,30,71060,31350,102410
432045,202005,5,4,1,4180,1045,5225
432050,202005,80,47,33,49115,34485,83600
432055,202005,120,88,32,91960,33440,125400
432057,202005,6,5,1,5225.5,1045,6270.5
432060,202005,34,31,3,32395,3135,35530
432065,202005,33,29,4,30305,4180,34485
432067,202005,91,82,9,85690,9405,95095
432070,202005,393,300,93,314807.5,98230,413037.5
432080,202005,811,566,245,592515,257070,849585
432085,202005,11,8,3,8360,3135,11495
432090,202005,264,179,85,187055,88825,275880
432100,202005,174,116,58,121220,60610,181830
432110,202005,564,378,186,397100,194370,591470
432120,202005,943,552,391,576840,408595,985435
432130,202005,483,345,138,360525,145255,505780
432132,202005,23,20,3,20900,3135,24035
432135,202005,81,67,14,70015,14630,84645
432140,202005,267,206,61,215270,63745,279015
432143,202005,205,130,75,135850,78375,214225
432145,202005,277,190,87,199595,90915,290510
432146,202005,14,13,1,13585,1045,14630
432147,202005,98,55,43,57475,44935,102410
432149,202005,15,10,5,10450,5225,15675
432150,202005,882,537,345,562210.5,362615,924825.5
432160,202005,1490,768,722,803605.22,756580,1560185.22
432162,202005,4,3,1,3135,1045,4180
432163,202005,19,14,5,14630,5225,19855
432166,202005,119,87,32,91177.5,33440,124617.5
432170,202005,224,113,111,118085,115995,234080
432180,202005,549,337,212,352165,221540.5,573705.5
432183,202005,7,7,0,7315,0,7315
432185,202005,79,69,10,72105,10450,82555
432190,202005,482,282,200,294690,210045,504735
432195,202005,86,72,14,75240,14630,89870
432200,202005,409,260,149,271700,155705,427405
432210,202005,119,75,44,78375,45980,124355
432215,202005,44,40,4,41800,4180,45980
432218,202005,20,19,1,19855,1045,20900
432220,202005,669,347,322,364705,337535.29,702240.29
432225,202005,14,8,6,8360,6270,14630
432230,202005,135,92,43,97185,44935,142120
432232,202005,12,11,1,11495,1045,12540
432234,202005,3,2,1,2090,1045,3135
432235,202005,3,3,0,3135,0,3135
432237,202005,29,17,12,17765,12540,30305
432240,202005,4325,2417,1908,2530991,2000131.5,4531122.5
432250,202005,1097,717,380,750310,398145,1148455
432252,202005,45,42,3,43890,3135,47025
432253,202005,61,49,12,51205,12540,63745
432254,202005,25,11,14,11495,15675,27170
432255,202005,13,12,1,12540,1045,13585
432260,202005,817,640,177,668800.5,186010,854810.5
432270,202005,244,184,60,192280,62700,254980
432280,202005,138,105,33,109725,35530,145255
432285,202005,2,2,0,2090,0,2090
432290,202005,66,58,8,60610,8360,68970
432300,202005,4696,2560,2136,2682447.07,2238391.27,4920838.34
432310,202005,128,104,24,108680,25080,133760
432320,202005,22,17,5,17765,5225,22990
432330,202005,17,12,5,12540,5225,17765
432335,202005,8,6,2,6270,2090,8360
432340,202005,38,33,5,34485,5225,39710
432345,202005,101,69,32,72105,33440,105545
432350,202005,20,19,1,19855,1045,20900
432360,202005,6,5,1,5225,1045,6270
432370,202005,25,24,1,25080,1045,26125
432375,202005,30,27,3,28215,3135,31350
432377,202005,8,8,0,8360,0,8360
432380,202005,168,77,91,80465,95095,175560
500020,202005,239,131,108,136895,113905,250800
500025,202005,135,68,67,71060,70015,141075
500060,202005,1450,905,545,949905,571615.5,1521520.5
500070,202005,804,383,421,401280.29,440990.5,842270.79
500080,202005,129,101,28,106590,29260,135850
500085,202005,136,112,24,117040.5,25080,142120.5
500090,202005,348,157,191,164065,201685,365750
500100,202005,725,378,347,395010,362616,757626
500110,202005,2258,1043,1215,1090981,1279080.75,2370061.75
500124,202005,264,148,116,154660,121220,275880
500150,202005,340,137,203,143165,212135,355300
500190,202005,516,353,163,368885,171380.5,540265.5
500200,202005,187,160,27,167200.2,28215,195415.2
500210,202005,1555,540,1015,566390,1065900.25,1632290.25
500215,202005,245,139,106,145255,111815,257070
500220,202005,748,480,268,502645.77,280060,782705.77
500230,202005,241,152,89,158840,93005,251845
500240,202005,677,464,213,485925.4,222585.5,708510.9
500260,202005,592,227,365,237215,381425,618640
500270,202005,29842,12701,17141,13298035.1,17954150.75,31252185.85
500280,202005,202,69,133,73150,138985,212135
500290,202005,1178,711,467,745085.5,488015,1233100.5
500295,202005,439,283,156,295735.5,164065,459800.5
500310,202005,74,24,50,25080,52250,77330
500315,202005,733,425,308,444125,321860,765985
500320,202005,3645,1788,1857,1870550.54,1947880,3818430.54
500325,202005,938,507,431,530861,451440.5,982301.5
500330,202005,1489,700,789,731500.5,830775,1562275.5
500345,202005,311,235,76,245575.5,79420,324995.5
500348,202005,248,147,101,153615,105545,259160
500350,202005,117,55,62,57475,65835,123310
500370,202005,5606,2505,3101,2619816,3247861,5867677
500375,202005,346,243,103,253935,107635,361570
500380,202005,587,335,252,352165,263340,615505
500390,202005,77,37,40,38665,41800,80465
500400,202005,214,141,73,148390,76285,224675
500410,202005,543,224,319,234080,336490,570570
500430,202005,519,369,150,385605,157795,543400
500440,202005,194,102,92,106590,96140,202730
500450,202005,393,171,222,179740,231990,411730
500460,202005,276,147,129,153615.5,134805,288420.5
500470,202005,428,340,88,356345.5,91960,448305.5
500480,202005,104,63,41,65835,43890,109725
500490,202005,106,46,60,48070,63745,111815
500500,202005,1446,523,923,546535,968715,1515250
500510,202005,44,35,9,36575,9405,45980
500515,202005,103,72,31,75240,32395,107635
500520,202005,323,171,152,179740,159885.5,339625.5
500525,202005,90,48,42,50160,43890,94050
500540,202005,890,378,512,395010,536085.5,931095.5
500560,202005,932,523,409,548625,429496,978121
500568,202005,980,554,426,581020,445170.5,1026190.5
500570,202005,1204,690,514,723141,537130.5,1260271.5
500580,202005,340,173,167,181830,174515,356345
500600,202005,336,161,175,169290,182875,352165
500620,202005,904,640,264,668800.42,276925,945725.42
500625,202005,78,61,17,63745,17765,81510
500627,202005,21,10,11,10450,11495,21945
500630,202005,1572,868,704,910197.54,735680.5,1645878.04
500635,202005,516,305,211,319770,220495,540265
500640,202005,384,203,181,212135,189145,401280
500660,202005,5505,2016,3489,2112990.5,3656456.5,5769447.0
500690,202005,596,209,387,218405,405460,623865
500710,202005,398,202,196,212135,205865,418000
500720,202005,960,546,414,572660.73,433675,1006335.73
500730,202005,194,115,79,122265,82555,204820
500740,202005,895,376,519,392920,544445,937365
500750,202005,142,45,97,47025,101365,148390
500755,202005,124,89,35,93005.5,38665,131670.5
500769,202005,754,414,340,432630.5,356345,788975.5
500770,202005,401,214,187,223630,196460,420090
500780,202005,155,103,52,107635,54340.5,161975.5
500790,202005,1076,547,529,573705,555940,1129645
500793,202005,280,152,128,158840,133760.5,292600.5
500795,202005,169,117,52,122265,55385,177650
500797,202005,52,37,15,38665,15675,54340
500800,202005,432,193,239,201685,249755,451440
500830,202005,2229,1242,987,1301025,1033505,2334530
500840,202005,138,103,35,107635,36575,144210
510010,202005,174,91,83,95095,86735,181830
510020,202005,501,224,277,235125,292600,527725
510025,202005,1684,958,726,1002155.2,760760.5,1762915.7
510030,202005,665,344,321,360525,336490.5,697015.5
510035,202005,126,61,65,63745,67925,131670
510040,202005,407,190,217,198550,226765.3,425315.3
510050,202005,409,217,192,227810,200640.73,428450.73
510060,202005,120,59,61,63745,63745,127490
510080,202005,234,87,147,90915,153615,244530
510100,202005,68,28,40,29260,41800,71060
510120,202005,38,23,15,24035,15675,39710
510125,202005,384,238,146,249755,152570,402325
510130,202005,558,320,238,334400,248710.5,583110.5
510140,202005,428,125,303,130625,318725,449350
510160,202005,113,37,76,38665,81510,120175
510170,202005,810,488,322,511005.03,337535,848540.03
510180,202005,2940,1381,1559,1447326,1631246.75,3078572.75
510185,202005,20,8,12,8360,12540,20900
510190,202005,231,82,149,85690,155705,241395
510250,202005,2576,1513,1063,1581085.5,1113971,2695056.5
510260,202005,177,130,47,136895,49115,186010
510263,202005,472,266,206,279015.5,215270,494285.5
510267,202005,682,380,302,398145.5,316635,714780.5
510268,202005,62,28,34,29260,35530,64790
510269,202005,74,35,39,36575,40755,77330
510270,202005,391,197,194,205865,203775,409640
510279,202005,210,157,53,165110,55385,220495
510285,202005,186,74,112,77330,117040,194370
510300,202005,517,272,245,284240,256025,540265
510305,202005,207,98,109,102410,113905,216315
510310,202005,104,54,50,56430,52250,108680
510320,202005,848,527,321,550715,336490,887205
510325,202005,406,172,234,179740,246620,426360
510330,202005,427,235,192,245575,200640,446215
510335,202005,634,360,274,376200,291555,667755
510336,202005,54,38,16,39710,16720,56430
510337,202005,107,46,61,49115,63745,112860
510340,202005,17432,7905,9527,8271177.29,9976617.25,18247794.54
510343,202005,62,44,18,45980,18810,64790
510345,202005,162,105,57,109725,59565.5,169290.5
510350,202005,643,358,285,376200,299915.5,676115.5
510360,202005,201,121,80,126445,83600,210045
510370,202005,148,72,76,75240,79420,154660
510380,202005,86,64,22,66880,22990,89870
510385,202005,61,26,35,27170,36575,63745
510390,202005,106,47,59,49115,61655,110770
510395,202005,46,33,13,34485,13585,48070
510410,202005,714,465,249,485925,262295,748220
510420,202005,576,278,298,290510,311410,601920
510450,202005,47,24,23,25080,24035,49115
510452,202005,49,23,26,24035,27170,51205
510454,202005,51,24,27,25080,28215,53295
510455,202005,133,78,55,81510,57475,138985
510460,202005,175,84,91,87780.24,95095,182875.24
510480,202005,721,422,299,440990.2,312455,753445.2
510490,202005,349,177,172,186010,179740,365750
510500,202005,236,176,60,184965,62700,247665
510510,202005,783,459,324,480700.5,339625,820325.5
510515,202005,1210,630,580,660440,607145,1267585
510517,202005,254,109,145,113905,151525.5,265430.5
510520,202005,231,150,81,156750,84645,241395
510523,202005,98,74,24,77330,25080,102410
510525,202005,811,474,337,495330,353210,848540
510530,202005,21,15,6,15675,6270,21945
510550,202005,254,111,143,117040,149435,266475
510558,202005,291,143,148,149435,156750,306185
510560,202005,415,243,172,253935.5,179740,433675.5
510562,202005,643,462,181,485925,190190,676115
510590,202005,763,392,371,410685,388740,799425
510600,202005,244,129,115,134805,120175,254980
510610,202005,204,84,120,87780,125400,213180
510615,202005,184,82,102,85690,106590,192280
510617,202005,19,11,8,11495,8360,19855
510618,202005,117,55,62,57475,64790,122265
510619,202005,98,69,29,72105,30305,102410
510620,202005,168,94,74,98230,78375,176605
510621,202005,179,116,63,121220,65835,187055
510622,202005,501,305,196,318725,204820,523545
510623,202005,328,226,102,236170,107635,343805
510624,202005,90,44,46,45980,48070,94050
510625,202005,533,327,206,341715,216315.29,558030.29
510626,202005,112,69,43,72105,44935,117040
510627,202005,71,49,22,51205,22990,74195
510628,202005,152,90,62,97185,65835,163020
510629,202005,263,161,102,168245,106609,274854
510630,202005,442,228,214,239305,225720,465025
510631,202005,14,3,11,3135,11495,14630
510637,202005,351,201,150,210045,157795,367840
510642,202005,989,532,457,556985,478610,1035595
510645,202005,1,0,1,0,1045,1045
510650,202005,1433,936,497,978120.5,520410,1498530.5
510665,202005,78,36,42,37620,43890,81510
510670,202005,60,34,26,35530,27170,62700
510675,202005,1147,717,430,752400.5,449350,1201750.5
510677,202005,349,178,171,186010,178695,364705
510680,202005,107,62,45,64790,47025,111815
510682,202005,204,103,101,107635,105545,213180
510685,202005,56,41,15,42845,15675,58520
510700,202005,585,334,251,349030,263340,612370
510704,202005,1159,607,552,635360,578930,1214290
510706,202005,136,68,68,71060,71060,142120
510710,202005,386,271,115,284240,121220,405460
510715,202005,58,42,16,43890,16720,60610
510718,202005,210,105,105,109725,109725,219450
510719,202005,39,17,22,17765,22990,40755
510720,202005,190,130,60,135850,62700,198550
510724,202005,88,34,54,35530,56430,91960
510726,202005,49,25,24,26125,25080,51205
510729,202005,68,31,37,32395,38665,71060
510730,202005,474,262,212,273790,221540,495330
510735,202005,118,48,70,50160,73150,123310
510740,202005,22,11,11,11495,11495,22990
510757,202005,20,15,5,15675,5225,20900
510760,202005,7190,3699,3491,3868591.5,3655411.75,7524003.25
510770,202005,690,321,369,335445,387695,723140
510774,202005,19,7,12,7315,12540,19855
510775,202005,105,80,25,83600,26125,109725
510776,202005,28,10,18,10450,18810,29260
510777,202005,193,83,110,86735,114950,201685
510779,202005,51,23,28,24035,29260,53295
510780,202005,286,158,128,165110,134805,299915
510785,202005,391,212,179,221540,187055,408595
510787,202005,194,93,101,97185,105545,202730
510788,202005,3,0,3,0,3135,3135
510790,202005,2458,1287,1171,1347194.78,1229965,2577159.78
510792,202005,1150,643,507,672980,529815.66,1202795.66
510794,202005,114,59,55,61655,57475,119130
510795,202005,2349,1362,987,1426425.5,1031416,2457841.5
510800,202005,172,103,69,107635,72105,179740
510805,202005,183,120,63,125400,65835,191235
510810,202005,99,43,56,44935,58520,103455
510820,202005,236,118,118,123310.45,123310.12,246620.57
510830,202005,71,42,29,43890,30305,74195
510835,202005,15,10,5,10450,5225,15675
510840,202005,9172,4368,4804,4576058.88,5031675.5,9607734.38
510850,202005,220,87,133,90915,138985,229900
510860,202005,379,171,208,179740,218405.5,398145.5
510880,202005,66,50,16,52250,16720,68970
510885,202005,74,41,33,42845,34485,77330
510890,202005,67,39,28,40755,29260,70015
510895,202005,181,106,75,110770,79420.5,190190.5
520005,202005,106,50,56,52250,58520,110770
520010,202005,280,127,153,132715,159885.5,292600.5
520013,202005,707,453,254,474430,265430,739860
520015,202005,54,40,14,41800,14630,56430
520017,202005,86,48,38,50160.5,39710,89870.5
520020,202005,19,10,9,10450,9405,19855
520025,202005,2228,1152,1076,1204885.5,1127555,2332440.5
520030,202005,798,423,375,442035,392920,834955
520050,202005,71,49,22,51205,22990,74195
520055,202005,49,30,19,31350,19855,51205
520060,202005,175,115,60,120175,62700,182875
520080,202005,581,413,168,431585,175560,607145
520082,202005,18,12,6,12540,6270,18810
520085,202005,95,71,24,74195,25080,99275
520090,202005,93,62,31,64790,32395,97185
520110,202005,9249,3952,5297,4137156.6,5542682.5,9679839.1
520120,202005,14,8,6,8360,6270,14630
520130,202005,795,554,241,581020,251845.5,832865.5
520140,202005,11982,6647,5335,6953432.5,5590750.8,12544183.3
520145,202005,53,32,21,33440,21945,55385
520150,202005,165,130,35,135850,36575,172425
520160,202005,37,27,10,28215,10450,38665
520170,202005,252,144,108,150480,112860,263340
520180,202005,165,77,88,80465,93005,173470
520215,202005,202,134,68,140030,71060,211090
520235,202005,79,60,19,62700,19855,82555
520250,202005,130,76,54,79420,56430,135850
520260,202005,114,71,43,75240,45980,121220
520280,202005,51,34,17,35530,17765,53295
520310,202005,39,26,13,27170,13585,40755
520320,202005,172,110,62,114950,64790,179740
520330,202005,786,415,371,434720,388740,823460
520340,202005,351,206,145,215270,151525,366795
520350,202005,509,233,276,247665,288420,536085
520355,202005,88,52,36,54340,37620,91960
520357,202005,23,17,6,17765,6270,24035
520360,202005,1,1,0,1045,0,1045
520380,202005,135,73,62,76285,64790,141075
520390,202005,263,109,154,113905.5,160930,274835.5
520393,202005,15,11,4,11495,4180,15675
520396,202005,78,49,29,51205,30305,81510
520400,202005,202,119,83,124355,86735,211090
520410,202005,195,96,99,100320,103455,203775
520420,202005,20,13,7,13585,7315,20900
520425,202005,289,143,146,149435,152570,302005
520430,202005,483,244,239,255076.14,249755.25,504831.39
520440,202005,682,487,195,508915,204820,713735
520450,202005,1970,853,1117,891385,1169355,2060740
520455,202005,55,32,23,33440,24035,57475
520460,202005,34,20,14,20900,14630,35530
520465,202005,30,26,4,27170,4180,31350
520470,202005,432,277,155,289465,161975,451440
520480,202005,78,48,30,50160,31350,81510
520485,202005,120,40,80,41800,83600.5,125400.5
520490,202005,409,302,107,316635,111815,428450
520495,202005,160,96,64,102410,66880,169290
520500,202005,184,143,41,149435,42845,192280
520505,202005,185,104,81,108680,84645,193325
520510,202005,1819,865,954,906015.5,996932.75,1902948.25
520520,202005,42,31,11,32395,11495,43890
520530,202005,229,173,56,180785,58520,239305
520540,202005,567,390,177,407550,186010,593560
520545,202005,132,80,52,84645,54340,138985
520547,202005,55,32,23,33440,24035,57475
520549,202005,1217,569,648,594605.3,681340,1275945.3
520551,202005,299,159,140,166155,146300.5,312455.5
520552,202005,41,26,15,27170,15675,42845
520570,202005,16,10,6,10450,6270,16720
520580,202005,281,174,107,182875,112860,295735
520590,202005,152,93,59,97185,61655,158840
520620,202005,1146,529,617,556985.5,644765.25,1201750.75
520630,202005,37,21,16,21945,16720,38665
520640,202005,386,225,161,236170,168245,404415
520650,202005,66,36,30,37620,31350,68970
520660,202005,44,23,21,24035,21945,45980
520670,202005,37,31,6,32395,6270,38665
520680,202005,51,34,17,35530,17765,53295
520690,202005,40,11,29,11495,30305,41800
520710,202005,33,30,3,31350,3135,34485
520725,202005,196,142,54,148390,56430,204820
520735,202005,55,37,18,38665,18810,57475
520740,202005,420,199,221,209000,230945.5,439945.5
520750,202005,37,26,11,27170,11495,38665
520753,202005,61,42,19,43890,19855,63745
520760,202005,100,67,33,71060,34485,105545
520780,202005,286,212,74,222585,77330,299915
520790,202005,155,87,68,90915,71060,161975
520800,202005,3421,1841,1580,1925935.5,1656325.2,3582260.7
520810,202005,159,120,39,125400,40755,166155
520815,202005,5,4,1,4180,1045,5225
520830,202005,147,101,46,105545,48070,153615
520840,202005,349,231,118,242440,124355,366795
520850,202005,101,61,40,63745,41800,105545
520860,202005,1730,1119,611,1169355.5,639540.5,1808896.0
520870,202005,31917,15044,16873,15740843.47,17678273,33419116.47
520880,202005,1170,624,546,653125.5,571615.5,1224741.0
520890,202005,792,477,315,498465,329175,827640
520910,202005,969,517,452,542355.93,475475,1017830.93
520915,202005,98,74,24,77330,25080,102410
520920,202005,421,198,223,206910,233035,439945
520929,202005,17,16,1,16720,1045,17765
520940,202005,72,49,23,51205,24035,75240
520945,202005,19,13,6,13585,6270,19855
520960,202005,45,30,15,31350,15675,47025
520970,202005,332,204,128,214225,134805,349030
520980,202005,96,68,28,71060,29260,100320
520990,202005,451,305,146,319770,152570,472340
520993,202005,129,60,69,62700,72105,134805
520995,202005,244,140,104,147345.65,109725.5,257071.15
521000,202005,1545,902,643,943635,674025.5,1617660.5
521010,202005,676,327,349,343805,364705,708510
521015,202005,14,9,5,9405,5225,14630
521020,202005,1426,1008,418,1054405,437855.5,1492260.5
521030,202005,49,32,17,33440,17765,51205
521040,202005,947,596,351,622820.25,367840.5,990660.75
521056,202005,46,33,13,34485,13585,48070
521060,202005,128,84,44,88825,45980,134805
521080,202005,428,328,100,342760.5,104500,447260.5
521090,202005,540,343,197,358435,205865,564300
521100,202005,277,207,70,216315,73150,289465
521120,202005,1065,746,319,781660.5,334400,1116060.5
521130,202005,351,251,100,263340,104500.5,367840.5
521140,202005,177,97,80,101365,84645,186010
521150,202005,2663,1157,1506,1212200.89,1577950,2790150.89
521160,202005,31,16,15,16720,15675,32395
521170,202005,209,116,93,122265,98230,220495
521180,202005,1183,753,430,787930,452485.25,1240415.25
521190,202005,2537,1067,1470,1115015,1539285.5,2654300.5
521200,202005,56,42,14,43890,14630,58520
521205,202005,11,8,3,8360,3135,11495
521210,202005,123,72,51,75240,53295,128535
521220,202005,784,544,240,570570,252890.25,823460.25
521225,202005,34,22,12,22990,12540,35530
521230,202005,106,70,36,73150,37620,110770
521250,202005,6211,3504,2707,3668999.8,2838223,6507222.8
521260,202005,27,14,13,14630,13585,28215
521270,202005,143,111,32,115995,33440,149435
521280,202005,425,256,169,267520,177650,445170
521290,202005,26,12,14,12540,14630,27170
521295,202005,99,64,35,66880,36575,103455
521300,202005,215,116,99,121220,103455.5,224675.5
521305,202005,36,25,11,26125,11495,37620
521308,202005,1083,829,254,867350,267520,1134870
521310,202005,1333,764,569,798380,596695.39,1395075.39
521340,202005,19,15,4,15675,4180,19855
521350,202005,126,94,32,98230,33440,131670
521370,202005,174,122,52,127490,54340,181830
521375,202005,173,93,80,97185,83600,180785
521377,202005,45,34,11,35530,11495,47025
521380,202005,1056,667,389,697016.05,407550,1104566.05
521385,202005,13,8,5,8360,5225,13585
521390,202005,101,81,20,84645,20900,105545
521400,202005,340,226,114,236170,120175,356345
521405,202005,145,79,66,82555,68970,151525
521410,202005,66,45,21,47025,21945,68970
521440,202005,187,139,48,145255,50160,195415
521450,202005,727,408,319,426360,333355,759715
521460,202005,1152,737,415,772255,435765,1208020
521470,202005,13,8,5,8360,5225,13585
521480,202005,43,30,13,31350,13585.25,44935.25
521483,202005,312,182,130,190190.5,135850,326040.5
521486,202005,279,182,97,190190,102410,292600
521487,202005,23,11,12,11495,12540,24035
521490,202005,25,14,11,14630,12540,27170
521500,202005,115,74,41,77330,42845,120175
521520,202005,45,32,13,33440,13585,47025
521523,202005,713,423,290,442035,303050,745085
521525,202005,47,30,17,31350,17765,49115
521530,202005,246,133,113,138985,119130,258115
521540,202005,29,16,13,16720,13585,30305
521550,202005,87,37,50,38665,52250,90915
521560,202005,819,553,266,577885.5,280060.75,857946.25
521565,202005,59,39,20,40755,20900,61655
521570,202005,524,346,178,361570.5,186010.25,547580.75
521580,202005,59,33,26,34485,27170,61655
521590,202005,37,18,19,18810,19855,38665
521600,202005,23,12,11,12540,11495,24035
521630,202005,242,129,113,134805,118085.25,252890.25
521640,202005,299,162,137,169290,143165,312455
521645,202005,30,16,14,16720,14630,31350
521680,202005,232,143,89,149435,93005,242440
521690,202005,2,2,0,2090,0,2090
521710,202005,1155,549,606,575795,633270,1209065
521720,202005,544,377,167,393965,176605.85,570570.85
521730,202005,641,307,334,320816,349030,669846
521740,202005,906,387,519,404415,542355.5,946770.5
521760,202005,1907,991,916,1037685.95,961400.5,1999086.45
521770,202005,824,521,303,544445,317680,862125
521800,202005,2005,1281,724,1340736.5,758670,2099406.5
521805,202005,33,18,15,18810,15675,34485
521810,202005,85,54,31,56430,32395,88825
521830,202005,941,672,269,702240.09,281105,983345.09
521839,202005,86,53,33,55385,34485,89870
521850,202005,1105,577,528,604010.36,551760.5,1155770.86
521860,202005,342,214,128,223630,133760,357390
521870,202005,73,42,31,44935,32395,77330
521878,202005,33,16,17,16720,17765,34485
521880,202005,4768,2119,2649,2215401.5,2771342.5,4986744.0
521890,202005,600,427,173,446215,180785,627000
521900,202005,281,231,50,241395,52250,293645
521910,202005,160,112,48,117040,50160,167200
521920,202005,46,22,24,22990,25080,48070
521925,202005,51,27,24,28215,25080,53295
521930,202005,1159,641,518,670890.5,543400.5,1214291.0
521935,202005,35,25,10,26125,10450,36575
521940,202005,203,99,104,103455,108680,212135
521945,202005,15,13,2,13585,2090,15675
521950,202005,9,5,4,5225,4180,9405
521960,202005,68,51,17,53295,17765,71060
521970,202005,398,255,143,266475,149435,415910
521971,202005,93,48,45,50160,48070,98230
521973,202005,33,17,16,17765,16720,34485
521975,202005,1417,703,714,737770.41,752401.47,1490171.88
521980,202005,241,163,78,170335.5,81510,251845.5
521990,202005,76,54,22,56430,24035,80465
522000,202005,286,180,106,187735.29,111815,299550.29
522005,202005,20,11,9,11495,9405,20900
522010,202005,1128,629,499,659395,523545,1182940
522015,202005,62,38,24,39710,25080,64790
522020,202005,885,506,379,528770,396055.5,924825.5
522026,202005,21,13,8,13585,8360,21945
522028,202005,16,12,4,12540,4180,16720
522040,202005,785,321,464,335445.25,486970,822415.25
522045,202005,2340,1425,915,1492261.25,957221.25,2449482.50
522050,202005,156,77,79,80465,83600,164065
522060,202005,539,341,198,356345,209000,565345
522068,202005,115,80,35,83600,36575,120175
522070,202005,10,10,0,10450,0,10450
522100,202005,36,21,15,21945,17765,39710
522108,202005,44,32,12,33440,12540,45980
522119,202005,50,26,24,27170,25080,52250
522130,202005,79,33,46,34485,49115,83600
522140,202005,4056,2090,1966,2187185.88,2057605.5,4244791.38
522145,202005,48,33,15,34485,15675,50160
522150,202005,88,65,23,67925,25080,93005
522155,202005,52,34,18,35530,18810,54340
522157,202005,5,3,2,3135,3135,6270
522160,202005,1686,994,692,1039775,724185,1763960
522170,202005,396,267,129,279015,134805,413820
522180,202005,40,18,22,18810,22990,41800
522185,202005,2067,820,1247,856901,1307295,2164196
522190,202005,48,26,22,27170,22990,50160
522200,202005,302,176,126,184965,131670,316635
522205,202005,145,99,46,104500,49115,153615
522220,202005,152,109,43,114950,45980,160930
522230,202005,35,25,10,26125,10450,36575
530010,202005,54559,27517,27042,28803175.1,28338327.6,57141502.7
110001,202006,503,401,102,419045.00,106590.00,525635.00
110002,202006,2822,1740,1082,1819346.00,1134870.50,2954216.50
110003,202006,85,71,14,74195.00,14630.00,88825.00
110004,202006,2024,1316,708,1376266.50,739860.00,2116126.50
110005,202006,446,353,93,369930.50,97185.00,467115.50
110006,202006,444,341,103,357390.50,107635.00,465025.50
110007,202006,67,56,11,58520.00,11495.00,70015.00
110008,202006,237,134,103,140030.00,107635.00,247665.00
110009,202006,872,627,245,655215.00,257070.00,912285.00
110010,202006,1753,1065,688,1113970.50,728365.00,1842335.50
110011,202006,1769,1375,394,1438965.00,412775.00,1851740.00
110012,202006,4119,2392,1727,2500685.00,1807850.50,4308535.50
110013,202006,776,618,158,645810.00,165110.00,810920.00
110014,202006,376,326,50,340670.50,52250.00,392920.50
110015,202006,1381,1108,273,1159951.66,285285.00,1445236.66
110018,202006,1107,689,418,720005.00,436810.00,1156815.00
110020,202006,15601,8922,6679,9333948.06,7004637.10,16338585.16
110025,202006,620,454,166,474430.50,173470.00,647900.50
110026,202006,39,28,11,29260.00,11495.00,40755.00
110028,202006,1631,1178,453,1231010.85,475476.50,1706487.35
110029,202006,138,124,14,129580.00,14630.00,144210.00
110030,202006,2431,1611,820,1687508.22,860036.35,2547544.57
110032,202006,312,241,71,251845.17,74195.00,326040.17
110033,202006,653,480,173,502645.00,180785.00,683430.00
110034,202006,357,266,91,279015.67,95095.00,374110.67
110037,202006,99,86,13,89870.00,13585.00,103455.00
110040,202006,371,256,115,267520.00,120175.00,387695.00
110045,202006,929,640,289,668801.00,302005.60,970806.60
110050,202006,90,78,12,81510.50,12540.00,94050.50
110060,202006,68,39,29,40755.00,31350.00,72105.00
110070,202006,110,71,39,74195.00,40755.00,114950.00
110080,202006,476,267,209,280060.00,218405.00,498465.00
110090,202006,29,25,4,26125.00,4180.00,30305.00
110092,202006,96,51,45,53295.00,47025.00,100320.00
110094,202006,201,144,57,150480.00,59565.00,210045.00
110100,202006,38,30,8,31350.00,8360.00,39710.00
110110,202006,86,46,40,48070.00,41800.00,89870.00
110120,202006,69,58,11,60610.50,12540.00,73150.50
110130,202006,289,235,54,245575.00,56430.00,302005.00
110140,202006,242,168,74,175560.00,77330.00,252890.00
110143,202006,47,39,8,40755.00,8360.00,49115.00
110145,202006,25,20,5,20900.00,5225.00,26125.00
110146,202006,23,12,11,12540.00,11495.00,24035.00
110147,202006,37,26,11,27170.00,11495.00,38665.00
110148,202006,34,23,11,24035.00,11495.00,35530.00
110149,202006,308,216,92,225720.00,97185.00,322905.00
110150,202006,131,100,31,104500.00,32395.00,136895.00
110155,202006,9,8,1,8360.00,1045.00,9405.00
110160,202006,68,54,14,56430.00,14630.00,71060.00
110170,202006,214,169,45,177650.50,47025.00,224675.50
110175,202006,68,51,17,53295.00,17765.00,71060.00
110180,202006,90,75,15,79420.00,15675.00,95095.00
120001,202006,209,157,52,164065.00,54340.00,218405.00
120005,202006,198,114,84,119130.00,88825.00,207955.00
120010,202006,1102,689,413,721050.72,431585.00,1152635.72
120013,202006,146,99,47,103455.00,49115.00,152570.00
120017,202006,104,57,47,59565.00,50160.00,109725.00
120020,202006,3551,2861,690,2990791.18,721050.50,3711841.68
120025,202006,534,306,228,320815.77,241395.00,562210.77
120030,202006,1072,917,155,958266.36,161975.00,1120241.36
120032,202006,37,35,2,36575.00,2090.00,38665.00
120033,202006,214,189,25,197505.00,27170.00,224675.00
120034,202006,169,123,46,128535.00,48070.00,176605.00
120035,202006,39,32,7,33440.00,7315.00,40755.00
120038,202006,400,257,143,268565.00,149435.00,418000.00
120039,202006,30,29,1,30305.00,1045.00,31350.00
120040,202006,14081,9621,4460,10063701.52,4678465.00,14742166.52
120042,202006,43,39,4,40755.00,4180.00,44935.00
120043,202006,11,3,8,3135.00,8360.00,11495.00
120045,202006,553,354,199,370975.00,207955.00,578930.00
120050,202006,1286,984,302,1030370.69,315590.00,1345960.69
120060,202006,1467,1199,268,1252955.00,280060.00,1533015.00
120070,202006,435,310,125,324995.82,131670.00,456665.82
120080,202006,173,105,68,109725.00,71060.00,180785.00
130002,202006,148,106,42,110770.00,43890.00,154660.00
130006,202006,99,63,36,65835.00,37620.00,103455.00
130008,202006,131,71,60,74195.00,62700.00,136895.00
130010,202006,144,81,63,84645.00,65835.00,150480.00
130014,202006,277,200,77,209000.00,81510.00,290510.00
130020,202006,102,62,40,64790.00,41800.00,106590.00
130030,202006,962,571,391,596695.00,408595.00,1005290.00
130040,202006,339,166,173,173470.00,180785.40,354255.40
130050,202006,575,296,279,309320.00,291555.00,600875.00
130060,202006,858,584,274,610280.00,286330.00,896610.00
130063,202006,592,339,253,355300.00,264385.00,619685.00
130068,202006,191,120,71,125400.00,74195.00,199595.00
130070,202006,1326,903,423,943635.00,443080.00,1386715.00
130080,202006,705,461,244,481745.00,256025.00,737770.00
130083,202006,71,39,32,40755.00,33440.00,74195.00
130090,202006,335,168,167,175560.00,174515.00,350075.00
130100,202006,1106,476,630,497420.00,660440.00,1157860.00
130110,202006,739,309,430,322905.00,449350.00,772255.00
130115,202006,163,68,95,71060.00,99275.00,170335.00
130120,202006,1635,1040,595,1086800.00,621775.00,1708575.00
130130,202006,619,421,198,439945.00,206910.00,646855.00
130140,202006,1533,1190,343,1243550.00,358435.00,1601985.00
130150,202006,418,365,53,381425.00,55385.00,436810.00
130160,202006,456,264,192,275880.00,200640.00,476520.00
130165,202006,43,34,9,35530.00,9405.00,44935.00
130170,202006,972,666,306,695903.12,319770.00,1015673.12
130180,202006,227,167,60,174515.00,62700.00,237215.00
130185,202006,2343,1089,1254,1139050.00,1310431.00,2449481.00
130190,202006,3436,2160,1276,2257200.20,1338645.00,3595845.20
130195,202006,278,221,57,230945.00,59565.00,290510.00
130200,202006,184,82,102,86735.00,106590.00,193325.00
130210,202006,78,39,39,40755.00,40755.00,81510.00
130220,202006,180,123,57,128535.00,59565.00,188100.00
130230,202006,383,247,136,258115.00,144210.00,402325.00
130240,202006,1339,837,502,875710.50,524590.00,1400300.50
130250,202006,4742,3023,1719,3165305.00,1798445.00,4963750.00
130255,202006,431,205,226,215270.00,236170.00,451440.00
130260,202006,57171,26957,30214,28202384.52,31621704.00,59824088.52
130270,202006,1532,1031,501,1077489.05,523545.00,1601034.05
130280,202006,124,70,54,73150.00,56430.00,129580.00
130290,202006,2122,1481,641,1548690.00,670890.00,2219580.00
130300,202006,430,302,128,315590.00,133760.00,449350.00
130310,202006,917,481,436,503690.00,455620.00,959310.00
130320,202006,515,274,241,286330.00,252890.00,539220.00
130330,202006,749,469,280,492195.00,292600.00,784795.00
130340,202006,3517,2012,1505,2103586.00,1577950.50,3681536.50
130350,202006,480,319,161,333355.00,168245.00,501600.00
130353,202006,941,402,539,420090.00,563255.00,983345.00
130356,202006,809,365,444,381425.00,465025.00,846450.00
130360,202006,86,64,22,66880.00,22990.00,89870.00
130370,202006,711,548,163,573705.00,170335.00,744040.00
130380,202006,682,525,157,548625.00,164065.00,712690.00
130390,202006,491,396,95,413820.00,100320.00,514140.00
130395,202006,166,37,129,38665.00,134805.00,173470.00
130400,202006,66,44,22,45980.00,22990.00,68970.00
130406,202006,2081,1256,825,1312520.50,862125.00,2174645.50
130410,202006,443,201,242,211090.00,252890.00,463980.00
130420,202006,2973,2403,570,2511135.75,596695.00,3107830.75
130423,202006,154,80,74,83600.00,78375.00,161975.00
130426,202006,151,81,70,84645.00,73150.00,157795.00
130430,202006,412,256,156,267520.00,163020.00,430540.00
130440,202006,198,65,133,67925.00,138985.00,206910.00
140002,202006,33,10,23,10450.00,24035.00,34485.00
140005,202006,198,120,78,125400.00,81510.00,206910.00
140010,202006,10471,6663,3808,6972245.40,3996082.15,10968327.55
140015,202006,129,55,74,57475.00,77330.00,134805.00
140017,202006,125,81,44,84645.00,45980.00,130625.00
140020,202006,475,308,167,321860.00,174515.00,496375.00
140023,202006,49,22,27,22990.35,28215.00,51205.35
140028,202006,21,12,9,12540.00,9405.00,21945.00
140030,202006,349,243,106,254980.00,110770.00,365750.00
140040,202006,63,41,22,42845.00,22990.00,65835.00
140045,202006,255,98,157,103455.00,164065.00,267520.00
140047,202006,628,406,222,424270.50,231990.00,656260.50
140050,202006,156,94,62,98230.00,64790.00,163020.00
140060,202006,46,32,14,33440.00,14630.00,48070.00
140070,202006,32,30,2,31350.00,2090.00,33440.00
150010,202006,4686,2852,1834,2982430.50,1918620.00,4901050.50
150013,202006,161,109,52,113905.00,54340.00,168245.00
150020,202006,1086,580,506,606100.00,528770.00,1134870.00
150030,202006,675,279,396,292600.00,414865.00,707465.00
150034,202006,194,124,70,129580.00,73150.00,202730.00
150040,202006,1472,843,629,881980.00,658350.00,1540330.00
150050,202006,666,379,287,396055.00,299915.00,695970.00
150060,202006,4884,3083,1801,3224782.75,1889792.63,5114575.38
150070,202006,335,146,189,152570.00,197505.00,350075.00
150080,202006,15190,7142,8048,7465483.48,8420613.50,15886096.98
150085,202006,430,269,161,281105.00,169290.00,450395.00
150090,202006,739,621,118,648945.00,123310.00,772255.00
150095,202006,358,222,136,231990.00,142120.00,374110.00
150100,202006,60,38,22,39710.00,22990.50,62700.50
150110,202006,181,87,94,90915.00,98230.00,189145.00
150120,202006,411,299,112,312455.00,117040.00,429495.00
150125,202006,48,18,30,18810.00,31350.00,50160.00
150130,202006,2007,1056,951,1103520.00,994840.00,2098360.00
150140,202006,55040,24873,30167,26003788.75,31541243.21,57545031.96
150145,202006,201,107,94,111815.00,98230.00,210045.00
150150,202006,2947,1288,1659,1347005.00,1734701.00,3081706.00
150157,202006,392,277,115,289465.50,120175.00,409640.50
150160,202006,132,102,30,106590.00,31350.00,137940.00
150170,202006,3625,2684,941,2805825.00,984390.00,3790215.00
150172,202006,338,232,106,242440.00,110770.00,353210.00
150175,202006,79,48,31,50160.00,32395.00,82555.00
150178,202006,779,512,267,536085.00,281105.00,817190.00
150180,202006,3166,1548,1618,1618705.25,1692900.50,3311605.75
150190,202006,345,215,130,224675.00,135850.00,360525.00
150195,202006,108,57,51,59565.00,53295.00,112860.00
150200,202006,194,92,102,96140.00,106590.00,202730.00
150210,202006,3122,2495,627,2608320.00,656260.00,3264580.00
150215,202006,558,357,201,373065.00,212135.00,585200.00
150220,202006,3628,2427,1201,2536216.32,1257135.60,3793351.92
150230,202006,1186,952,234,994840.37,244530.00,1239370.37
150240,202006,6300,3601,2699,3770360.85,2828815.00,6599175.85
150250,202006,43,18,25,18810.00,26125.00,44935.00
150260,202006,88,56,32,58520.00,33440.00,91960.00
150270,202006,2245,1454,791,1519430.00,827640.50,2347070.50
150275,202006,528,330,198,344850.00,206910.00,551760.00
150276,202006,108,42,66,43890.00,68970.00,112860.00
150277,202006,775,330,445,344850.00,466070.00,810920.00
150280,202006,326,208,118,217360.00,123310.00,340670.00
150285,202006,102,51,51,53295.00,53295.00,106590.00
150290,202006,1022,607,415,635360.00,434720.50,1070080.50
150293,202006,664,311,353,324995.00,369930.00,694925.00
150295,202006,501,226,275,236170.00,287375.50,523545.50
150300,202006,82,38,44,39710.00,45980.00,85690.00
150304,202006,175,104,71,108680.00,74195.00,182875.00
150307,202006,400,331,69,345895.00,72105.00,418000.00
150309,202006,576,410,166,428450.00,173470.00,601920.00
150310,202006,238,157,81,164065.00,84645.00,248710.00
150320,202006,1917,1332,585,1392985.00,614460.00,2007445.00
150330,202006,2023,1166,857,1218470.00,895565.00,2114035.00
150340,202006,196,131,65,136895.00,67925.00,204820.00
150345,202006,636,351,285,366795.00,297825.00,664620.00
150350,202006,410,321,89,336490.00,93005.00,429495.00
150360,202006,4691,2894,1797,3028410.75,1883090.00,4911500.75
150370,202006,821,556,265,581020.00,277970.00,858990.00
150375,202006,191,89,102,93005.00,106590.00,199595.00
150380,202006,1487,985,502,1032460.00,525635.00,1558095.00
150390,202006,793,456,337,476520.00,352165.00,828685.00
150400,202006,107,89,18,93005.00,18810.00,111815.00
150405,202006,1247,791,456,826595.00,477565.00,1304160.00
150410,202006,122,80,42,83600.00,43890.00,127490.00
150420,202006,7351,3967,3384,4149867.30,3554045.50,7703912.80
150430,202006,604,387,217,404415.00,226765.00,631180.00
150440,202006,553,332,221,346940.00,230945.00,577885.00
150442,202006,2313,1221,1092,1276991.00,1143230.00,2420221.00
150445,202006,545,350,195,365750.00,204820.00,570570.00
150450,202006,228,122,106,127490.00,110770.00,238260.00
150460,202006,733,546,187,570570.00,195415.00,765985.00
150470,202006,1314,780,534,816075.33,559075.00,1375150.33
150475,202006,229,173,56,180785.00,58520.00,239305.00
150480,202006,1312,904,408,944680.00,426360.00,1371040.00
150490,202006,601,335,266,350075.00,277970.00,628045.00
150495,202006,331,244,87,254980.00,91960.00,346940.00
150497,202006,283,193,90,201685.00,96140.00,297825.00
150500,202006,218,135,83,141075.00,86735.00,227810.00
150503,202006,1033,507,526,529815.50,551760.00,1081575.50
150506,202006,922,609,313,636405.00,327085.00,963490.00
150510,202006,1247,687,560,720005.50,585200.00,1305205.50
150520,202006,274,180,94,188100.00,98230.00,286330.00
150530,202006,1718,937,781,980210.75,817190.00,1797400.75
150540,202006,227,164,63,171380.00,65835.00,237215.00
150543,202006,825,427,398,446215.00,415910.00,862125.00
150548,202006,471,333,138,347985.00,144210.00,492195.00
150549,202006,61,42,19,43890.00,19855.00,63745.00
150550,202006,2930,1474,1456,1541375.25,1523610.00,3064985.25
150553,202006,3356,1910,1446,2000131.50,1514205.00,3514336.50
150555,202006,144,78,66,81510.00,68970.00,150480.00
150560,202006,31,14,17,14630.00,17765.00,32395.00
150563,202006,93,47,46,49115.00,48070.00,97185.00
150565,202006,183,110,73,114950.00,76285.00,191235.00
150570,202006,405,266,139,277970.00,146300.00,424270.00
150580,202006,1634,769,865,803605.00,903925.00,1707530.00
150590,202006,808,527,281,550715.00,294690.00,845405.00
150600,202006,474,282,192,294690.00,200640.00,495330.00
150610,202006,142,119,23,124355.00,24035.00,148390.00
150611,202006,123,83,40,86735.00,41800.00,128535.00
150613,202006,3226,1922,1304,2009535.00,1364770.50,3374305.50
150616,202006,523,301,222,315590.00,233035.00,548625.00
150618,202006,1316,695,621,727320.00,652080.00,1379400.00
150619,202006,390,296,94,309320.00,98230.00,407550.00
150620,202006,1252,728,524,763895.00,548625.00,1312520.00
150630,202006,313,198,115,206910.00,120175.00,327085.00
150635,202006,466,190,276,198550.00,288420.00,486970.00
150640,202006,54,27,27,28215.00,28215.00,56430.00
150650,202006,2365,1363,1002,1425380.50,1048135.50,2473516.00
150655,202006,240,180,60,188100.00,62700.00,250800.00
150658,202006,88,48,40,50160.00,41800.00,91960.00
150660,202006,535,347,188,362615.00,196460.00,559075.00
150670,202006,1074,373,701,389785.00,733590.00,1123375.00
150680,202006,10089,5275,4814,5514466.19,5036900.86,10551367.05
150690,202006,19,10,9,10450.00,9405.00,19855.00
150700,202006,482,314,168,328130.00,175560.00,503690.00
150710,202006,281,151,130,158840.00,135850.00,294690.00
150715,202006,812,503,309,525635.00,323950.00,849585.00
150720,202006,410,318,92,332310.00,97185.00,429495.00
150730,202006,1022,513,509,536085.00,531905.00,1067990.00
150740,202006,230,152,78,158840.00,81510.00,240350.00
150745,202006,802,436,366,457710.00,382470.00,840180.00
150746,202006,62,36,26,37620.00,27170.00,64790.00
150747,202006,232,177,55,184965.00,57475.00,242440.00
150750,202006,138,76,62,79420.00,64790.00,144210.00
150760,202006,1819,1177,642,1229965.62,670890.00,1900855.62
150770,202006,393,216,177,225720.00,184965.00,410685.00
150775,202006,100,46,54,48070.00,56430.00,104500.00
150780,202006,192,109,83,113905.00,86735.00,200640.00
150790,202006,835,458,377,478610.00,395010.00,873620.00
150795,202006,1535,904,631,944680.00,660440.00,1605120.00
150796,202006,359,207,152,217360.00,158840.00,376200.00
150797,202006,328,160,168,167200.00,175560.00,342760.00
150800,202006,1474,845,629,884070.00,658350.00,1542420.00
150803,202006,552,446,106,467115.00,110770.00,577885.00
150805,202006,202,121,81,126445.00,84645.00,211090.00
150808,202006,995,537,458,561165.00,478610.00,1039775.00
150810,202006,3288,2236,1052,2336620.97,1099340.50,3435961.47
150812,202006,440,224,216,234080.00,225720.00,459800.00
150815,202006,1033,642,391,672980.00,408595.00,1081575.00
150820,202006,1546,914,632,956175.00,660440.00,1616615.00
150830,202006,740,545,195,569525.00,204820.00,774345.00
150835,202006,203,118,85,124355.00,88825.00,213180.00
150840,202006,1384,844,540,883025.00,565345.00,1448370.00
160005,202006,62,43,19,44935.00,19855.00,64790.00
160010,202006,200,127,73,132715.00,76285.00,209000.00
160015,202006,130,73,57,76285.00,59565.00,135850.00
160020,202006,134,75,59,78375.00,61655.00,140030.00
160021,202006,60,28,32,29260.00,33440.00,62700.00
160023,202006,68,45,23,47025.00,24035.00,71060.00
160025,202006,26,11,15,11495.00,15675.00,27170.00
160027,202006,1509,851,658,889295.25,690745.00,1580040.25
160030,202006,15948,8148,7800,8523023.10,8166675.71,16689698.81
160040,202006,294,170,124,177650.00,129580.00,307230.00
160050,202006,727,361,366,377245.00,382470.00,759715.00
160053,202006,286,166,120,173470.50,125400.00,298870.50
160055,202006,28,19,9,19855.00,9405.00,29260.00
160060,202006,6584,3457,3127,3613611.25,3276075.50,6889686.75
160070,202006,174,103,71,107635.00,74195.00,181830.00
160080,202006,109,50,59,52250.00,61655.00,113905.00
170025,202006,29,16,13,17765.00,13585.00,31350.00
170030,202006,213,172,41,179740.62,42845.00,222585.62
170035,202006,227,108,119,112860.00,124355.00,237215.00
170040,202006,184,139,45,145255.08,47025.00,192280.08
170070,202006,318,195,123,203775.00,128535.00,332310.00
170100,202006,358,259,99,270655.00,103455.00,374110.00
170105,202006,56,45,11,47025.00,11495.00,58520.00
170110,202006,115,72,43,75240.00,44935.00,120175.00
170130,202006,69,33,36,34485.00,37620.50,72105.50
170190,202006,97,59,38,61655.00,39710.00,101365.00
170200,202006,376,258,118,269610.00,123310.00,392920.00
170210,202006,6136,3223,2913,3372216.88,3045132.43,6417349.31
170215,202006,116,47,69,49115.00,72105.00,121220.00
170220,202006,1389,1018,371,1063810.00,387695.00,1451505.00
170230,202006,148,97,51,101365.00,53295.00,154660.00
170240,202006,527,354,173,369930.00,180785.00,550715.00
170255,202006,1088,880,208,920645.00,217360.00,1138005.00
170270,202006,43,30,13,31350.00,13585.00,44935.00
170290,202006,117,79,38,82555.00,39710.00,122265.00
170300,202006,94,61,33,63745.00,34485.00,98230.00
170305,202006,48,37,11,38665.00,11495.00,50160.00
170307,202006,64,49,15,51205.00,15675.00,66880.00
170310,202006,115,63,52,65835.00,54340.00,120175.00
170320,202006,26,17,9,17765.00,9405.00,27170.00
170330,202006,24,22,2,22990.00,2090.00,25080.00
170360,202006,29,18,11,18810.00,11495.00,30305.00
170370,202006,101,48,53,50160.00,55385.00,105545.00
170380,202006,74,57,17,59565.00,17765.00,77330.00
170382,202006,44,36,8,37620.00,8360.00,45980.00
170384,202006,141,109,32,113905.00,34485.00,148390.00
170386,202006,64,25,39,26125.00,40755.00,66880.00
170388,202006,47,18,29,18810.00,31350.00,50160.00
170389,202006,26,21,5,21945.00,5225.00,27170.00
170390,202006,70,40,30,41800.00,31350.00,73150.00
170410,202006,32,24,8,25080.00,8360.00,33440.00
170460,202006,18,12,6,12540.00,6270.00,18810.00
170510,202006,34,27,7,28215.00,7315.00,35530.00
170550,202006,1557,901,656,942590.00,686565.00,1629155.00
170555,202006,115,81,34,84645.00,35530.00,120175.00
170560,202006,102,71,31,74195.00,32395.00,106590.00
170600,202006,34,15,19,15675.00,19855.00,35530.00
170610,202006,197,104,93,108680.00,97185.50,205865.50
170625,202006,36,20,16,20900.00,16720.00,37620.00
170650,202006,79,58,21,60610.00,22990.00,83600.00
170700,202006,581,439,142,458755.25,148390.00,607145.25
170710,202006,159,97,62,101365.00,64790.00,166155.00
170720,202006,89,71,18,74195.00,18810.00,93005.00
170730,202006,83,49,34,51205.00,35530.00,86735.00
170740,202006,83,60,23,62700.00,24035.00,86735.00
170755,202006,65,34,31,35530.00,32395.00,67925.00
170765,202006,141,75,66,78375.00,68970.00,147345.00
170770,202006,209,131,78,136895.00,81510.00,218405.00
170820,202006,596,396,200,413820.00,209000.50,622820.50
170825,202006,33,17,16,17765.00,16720.00,34485.00
170830,202006,82,68,14,71060.00,14630.00,85690.00
170900,202006,182,142,40,148390.00,41800.00,190190.00
170930,202006,912,478,434,499510.80,453530.50,953041.30
170950,202006,3132,1419,1713,1485990.00,1791130.88,3277120.88
170980,202006,16,10,6,10450.00,6270.00,16720.00
171050,202006,144,114,30,119130.00,31350.00,150480.00
171070,202006,37,31,6,32395.00,6270.00,38665.00
171090,202006,44,33,11,34485.00,11495.00,45980.00
171110,202006,22,15,7,15675.00,7315.00,22990.00
171150,202006,40,20,20,20900.00,20900.00,41800.00
171180,202006,27,14,13,14630.00,13585.00,28215.00
171190,202006,151,85,66,88825.00,68970.00,157795.00
171195,202006,66,55,11,57475.00,11495.00,68970.00
171200,202006,49,25,24,26125.00,25080.00,51205.00
171215,202006,4,3,1,3135.00,1045.00,4180.00
171240,202006,60,42,18,43890.00,18810.00,62700.00
171245,202006,56,48,8,50160.00,8360.00,58520.00
171250,202006,73,40,33,41800.00,34485.00,76285.00
171270,202006,14,10,4,10450.00,4180.00,14630.00
171280,202006,43,37,6,38665.00,6270.00,44935.00
171320,202006,991,570,421,595650.00,439945.00,1035595.00
171330,202006,424,210,214,219450.00,223630.00,443080.00
171360,202006,86,62,24,64790.00,25080.00,89870.00
171370,202006,36,17,19,17765.00,20900.00,38665.00
171380,202006,131,111,20,115995.00,21945.00,137940.00
171395,202006,53,33,20,34485.00,20900.00,55385.00
171420,202006,284,182,102,191235.00,106590.00,297825.00
171430,202006,71,59,12,61655.00,12540.00,74195.00
171488,202006,178,98,80,102410.00,83600.00,186010.00
171500,202006,56,32,24,33440.00,26125.00,59565.00
171510,202006,73,45,28,47025.00,29260.00,76285.00
171515,202006,41,34,7,35530.00,7315.00,42845.00
171525,202006,30,28,2,29260.00,2090.00,31350.00
171550,202006,13,9,4,9405.00,4180.00,13585.00
171570,202006,53,27,26,28215.00,27170.00,55385.00
171575,202006,309,202,107,211090.00,112860.00,323950.00
171610,202006,1775,889,886,931095.00,926915.00,1858010.00
171620,202006,139,95,44,100320.00,45980.00,146300.00
171630,202006,60,31,29,32395.00,30305.00,62700.00
171650,202006,291,195,96,203775.00,100320.00,304095.00
171660,202006,268,151,117,158840.00,124355.50,283195.50
171665,202006,61,42,19,43890.00,20900.00,64790.00
171670,202006,429,254,175,265430.25,183920.00,449350.25
171700,202006,65,59,6,61655.00,6270.00,67925.00
171720,202006,29,10,19,10450.00,19855.00,30305.00
171750,202006,103,53,50,55385.00,52250.00,107635.00
171780,202006,73,58,15,60610.00,15675.00,76285.00
171790,202006,79,68,11,71060.00,11495.00,82555.00
171800,202006,32,24,8,25080.00,8360.00,33440.00
171820,202006,2104,1200,904,1257135.46,946770.50,2203905.96
171830,202006,34,26,8,27170.00,8360.00,35530.00
171840,202006,63,41,22,42845.00,22990.00,65835.00
171845,202006,31,20,11,20900.00,11495.00,32395.00
171850,202006,40,29,11,30305.00,11495.00,41800.00
171855,202006,77,60,17,62700.00,17765.00,80465.00
171865,202006,7,6,1,6270.00,1045.00,7315.00
171870,202006,32,23,9,24035.00,9405.00,33440.00
171875,202006,76,54,22,56430.00,22990.00,79420.00
171880,202006,35,23,12,24035.00,12540.00,36575.00
171884,202006,52,27,25,28215.00,26125.00,54340.00
171886,202006,136,55,81,57475.00,84645.00,142120.00
171888,202006,28,22,6,22990.00,6270.00,29260.00
171889,202006,19,13,6,13585.00,6270.00,19855.00
171890,202006,56,48,8,50160.00,8360.00,58520.00
171900,202006,35,25,10,26125.00,10450.00,36575.00
172000,202006,41,32,9,33440.00,9405.00,42845.00
172010,202006,52,41,11,42845.00,11495.00,54340.00
172015,202006,28,17,11,17765.45,11495.00,29260.45
172020,202006,145,89,56,93005.00,58520.00,151525.00
172025,202006,38,24,14,25080.00,14630.00,39710.00
172030,202006,43,24,19,25080.00,19855.00,44935.00
172049,202006,83,56,27,58520.00,29260.00,87780.00
172065,202006,141,91,50,95095.00,52250.00,147345.00
172080,202006,107,70,37,73150.00,38665.00,111815.00
172085,202006,27,14,13,14630.00,13585.00,28215.00
172090,202006,426,326,100,340670.03,105545.00,446215.03
172093,202006,17,15,2,15675.00,2090.00,17765.00
172097,202006,20,13,7,13585.00,7315.50,20900.50
172100,202006,5082,2870,2212,3002286.25,2315720.70,5318006.95
172110,202006,81,50,31,52250.00,32395.00,84645.00
172120,202006,1656,1389,267,1452553.11,279015.00,1731568.11
172125,202006,7,6,1,6270.00,1045.00,7315.00
172130,202006,21,13,8,13585.00,8360.00,21945.00
172208,202006,201,123,78,128535.00,81510.00,210045.00
172210,202006,387,186,201,194370.00,210045.00,404415.00
210005,202006,2988,1873,1115,1957285.15,1166224.50,3123509.65
210010,202006,162,91,71,95095.00,74195.00,169290.00
210015,202006,39,29,10,30305.00,10450.00,40755.00
210020,202006,350,200,150,209000.00,156750.00,365750.00
210030,202006,328,214,114,223630.00,119130.00,342760.00
210040,202006,139,111,28,115995.00,29260.00,145255.00
210043,202006,253,190,63,198550.00,65835.00,264385.00
210047,202006,523,310,213,323950.00,222585.00,546535.00
210050,202006,286,211,75,220495.00,79420.00,299915.00
210055,202006,48,37,11,38665.00,11495.00,50160.00
210060,202006,548,437,111,456665.00,115995.00,572660.00
210070,202006,413,316,97,330220.00,101365.00,431585.00
210080,202006,121,109,12,113905.00,12540.00,126445.00
210083,202006,299,146,153,152570.00,159885.00,312455.00
210087,202006,2,1,1,1045.00,1045.00,2090.00
210090,202006,445,320,125,334400.00,130625.00,465025.00
210095,202006,438,333,105,347985.00,109725.00,457710.00
210100,202006,701,546,155,570570.00,161975.00,732545.00
210110,202006,126,79,47,82555.00,49115.00,131670.00
210120,202006,5057,3931,1126,4109987.35,1177715.12,5287702.47
210125,202006,202,123,79,128535.00,82555.00,211090.00
210130,202006,478,273,205,285285.00,215270.00,500555.00
210135,202006,27,19,8,19855.00,8360.00,28215.00
210140,202006,4377,3417,960,3573900.00,1005290.00,4579190.00
210150,202006,380,242,138,252890.00,144210.00,397100.00
210160,202006,3286,2785,501,2910326.36,523545.00,3433871.36
210170,202006,1157,929,228,970805.00,238260.00,1209065.00
210173,202006,126,111,15,115995.00,15675.00,131670.00
210177,202006,363,204,159,213180.00,166155.00,379335.00
210180,202006,32,17,15,17765.00,15675.00,33440.00
210190,202006,425,282,143,294690.00,149435.00,444125.00
210193,202006,1,1,0,1045.00,0.00,1045.00
210197,202006,74,54,20,56430.00,20900.00,77330.00
210200,202006,620,510,110,532950.00,114950.00,647900.00
210203,202006,226,151,75,158840.00,78375.00,237215.00
210207,202006,365,298,67,311410.00,70015.00,381425.00
210210,202006,751,693,58,724185.00,60610.00,784795.00
210215,202006,75,65,10,67925.00,10450.00,78375.00
210220,202006,389,329,60,343805.00,62700.00,406505.00
210230,202006,312,248,64,259160.00,66880.00,326040.00
210232,202006,1383,941,442,983345.00,462935.00,1446280.00
210235,202006,166,125,41,131670.00,42845.00,174515.00
210237,202006,35,22,13,22990.00,13585.00,36575.00
210240,202006,87,75,12,78375.00,12540.00,90915.00
210250,202006,181,155,26,161975.00,27170.00,189145.00
210255,202006,354,265,89,279015.00,93005.00,372020.00
210260,202006,393,271,122,283195.00,127490.00,410685.00
210270,202006,645,431,214,451440.00,224675.00,676115.00
210275,202006,73,56,17,58520.00,17765.00,76285.00
210280,202006,1055,701,354,732545.70,370975.00,1103520.70
210290,202006,536,359,177,376200.00,184965.00,561165.00
210300,202006,5339,3359,1980,3510155.93,2071190.00,5581345.93
210310,202006,113,78,35,81510.00,36575.00,118085.00
210312,202006,116,80,36,83600.00,37620.00,121220.00
210315,202006,105,84,21,87780.00,21945.00,109725.00
210317,202006,129,98,31,102410.00,32395.00,134805.00
210320,202006,2328,1976,352,2068055.00,368885.00,2436940.00
210325,202006,139,88,51,91960.50,53295.50,145256.00
210330,202006,4546,2605,1941,2723026.91,2028345.00,4751371.91
210340,202006,1252,936,316,978120.00,330220.50,1308340.50
210350,202006,631,527,104,550715.00,108680.00,659395.00
210355,202006,150,122,28,127490.00,29260.00,156750.00
210360,202006,2234,1543,691,1614525.00,723140.00,2337665.00
210370,202006,1219,595,624,621775.00,653125.00,1274900.00
210375,202006,187,96,91,100320.00,95095.00,195415.00
210380,202006,712,542,170,566390.00,177650.00,744040.00
210390,202006,189,161,28,168245.00,29260.00,197505.00
210400,202006,395,343,52,358435.00,54340.00,412775.00
210405,202006,991,688,303,718960.00,316635.00,1035595.00
210407,202006,51,41,10,42845.00,10450.00,53295.00
210408,202006,59,52,7,54340.00,7315.00,61655.00
210409,202006,327,284,43,296780.00,44935.00,341715.00
210410,202006,440,342,98,357390.00,102410.00,459800.00
210420,202006,204,169,35,176605.00,36575.00,213180.00
210430,202006,51,34,17,35530.00,17765.00,53295.00
210440,202006,338,228,110,238260.00,114950.00,353210.00
210450,202006,141,111,30,115995.00,31350.00,147345.00
210455,202006,231,122,109,127490.50,114950.00,242440.50
210460,202006,302,204,98,213180.00,103455.00,316635.00
210462,202006,65,54,11,56430.00,11495.00,67925.00
210465,202006,143,110,33,114950.00,34485.00,149435.00
210467,202006,534,392,142,409640.00,148390.00,558030.00
210470,202006,51,44,7,45980.00,7315.00,53295.00
210480,202006,1262,906,356,948860.00,372020.00,1320880.00
210490,202006,202,136,66,142120.00,68970.00,211090.00
210500,202006,512,309,203,322905.00,212135.00,535040.00
210510,202006,559,441,118,460845.00,123310.00,584155.00
210515,202006,371,229,142,239305.00,148390.00,387695.00
210520,202006,401,361,40,377245.00,41800.00,419045.00
210530,202006,9376,4939,4437,5165440.05,4640848.74,9806288.79
210535,202006,130,97,33,101365.00,34485.00,135850.00
210540,202006,1493,990,503,1034550.00,525635.00,1560185.00
210542,202006,1193,614,579,642675.00,607146.00,1249821.00
210545,202006,18,16,2,16720.00,2090.00,18810.00
210547,202006,131,113,18,118085.00,18810.00,136895.00
210550,202006,687,498,189,520410.60,197505.00,717915.60
210560,202006,160,141,19,147345.00,19855.00,167200.00
210565,202006,21,16,5,16720.00,5225.00,21945.00
210570,202006,1302,1055,247,1102475.11,258115.00,1360590.11
210580,202006,121,103,18,107635.00,18810.00,126445.00
210590,202006,732,601,131,628045.00,136895.00,764940.00
210592,202006,37,34,3,35530.00,3135.00,38665.00
210594,202006,110,94,16,98230.00,16720.00,114950.00
210596,202006,98,82,16,85690.00,16720.00,102410.00
210598,202006,133,99,34,103455.00,35530.00,138985.00
210600,202006,320,274,46,286330.00,48070.00,334400.00
210610,202006,257,242,15,252890.00,15675.00,268565.00
210620,202006,43,28,15,29260.00,15675.00,44935.00
210630,202006,73,72,1,75240.00,1045.00,76285.00
210632,202006,1019,712,307,744040.00,320815.00,1064855.00
210635,202006,22,19,3,19855.00,3135.00,22990.00
210637,202006,110,80,30,83600.00,31350.00,114950.00
210640,202006,589,518,71,541310.00,74195.00,615505.00
210650,202006,397,331,66,345895.00,68970.00,414865.00
210660,202006,378,297,81,310365.00,85690.00,396055.00
210663,202006,35,24,11,26125.00,11495.00,37620.00
210667,202006,99,39,60,40755.00,62700.00,103455.00
210670,202006,247,219,28,228855.00,29260.00,258115.00
210675,202006,535,298,237,311410.00,247665.00,559075.00
210680,202006,235,142,93,148390.00,97185.00,245575.00
210690,202006,620,512,108,536085.00,112860.00,648945.00
210700,202006,159,121,38,126445.00,39710.00,166155.00
210710,202006,245,156,89,163020.00,93005.00,256025.00
210720,202006,131,116,15,121220.00,15675.00,136895.00
210725,202006,67,59,8,61655.00,8360.00,70015.00
210730,202006,25,18,7,18810.00,7315.00,26125.00
210735,202006,286,201,85,210045.00,88825.50,298870.50
210740,202006,527,455,72,475475.00,75240.00,550715.00
210745,202006,153,113,40,118085.00,41800.00,159885.00
210750,202006,2383,1212,1171,1269675.25,1225786.00,2495461.25
210760,202006,259,198,61,206910.00,63745.00,270655.00
210770,202006,381,299,82,313500.00,85690.00,399190.00
210780,202006,448,333,115,347985.00,120175.00,468160.00
210790,202006,183,150,33,156750.00,34485.00,191235.00
210800,202006,175,133,42,138985.00,43890.00,182875.00
210805,202006,52,47,5,49115.00,5225.00,54340.00
210810,202006,465,375,90,391875.00,94050.00,485925.00
210820,202006,2122,1760,362,1839200.90,380380.00,2219580.90
210825,202006,154,89,65,93005.00,67925.00,160930.00
210830,202006,726,484,242,505780.00,252890.00,758670.00
210840,202006,194,137,57,143165.00,59565.00,202730.00
210845,202006,234,167,67,174515.00,70015.00,244530.00
210850,202006,762,520,242,543400.00,252890.00,796290.00
210860,202006,3734,2098,1636,2194500.25,1709620.00,3904120.25
210870,202006,427,338,89,353210.00,94050.00,447260.00
210880,202006,72,55,17,57475.00,17765.00,75240.00
210890,202006,317,274,43,286330.00,44935.00,331265.00
210900,202006,626,407,219,425315.00,228855.00,654170.00
210905,202006,63,32,31,33440.00,32395.00,65835.00
210910,202006,1948,1472,476,1541376.06,498465.00,2039841.06
210920,202006,163,64,99,66880.00,104500.00,171380.00
210923,202006,80,63,17,65835.00,17765.00,83600.00
210927,202006,405,187,218,195415.00,227810.00,423225.00
210930,202006,75,60,15,62700.00,15675.00,78375.00
210940,202006,82,64,18,66880.00,18810.00,85690.00
210945,202006,193,101,92,105545.00,96140.00,201685.00
210950,202006,535,388,147,405460.00,153615.00,559075.00
210955,202006,83,53,30,55385.00,31350.00,86735.00
210960,202006,2167,1084,1083,1132780.00,1131735.00,2264515.00
210970,202006,115,101,14,105545.00,14630.00,120175.00
210975,202006,80,74,6,77330.00,6270.00,83600.00
210980,202006,1073,518,555,541310.00,579975.50,1121285.50
210990,202006,4051,2673,1378,2793285.00,1440010.00,4233295.00
211000,202006,1318,1065,253,1113970.50,264385.00,1378355.50
211003,202006,998,713,285,745085.00,297825.00,1042910.00
211010,202006,499,445,54,465025.00,56430.00,521455.00
211020,202006,1460,618,842,645810.00,880935.00,1526745.00
211023,202006,33,30,3,31350.00,3135.00,34485.00
211027,202006,72,53,19,55385.00,19855.00,75240.00
211030,202006,369,261,108,272745.00,112860.00,385605.00
211040,202006,301,249,52,260205.50,54340.00,314545.50
211050,202006,1157,770,387,804650.00,404415.50,1209065.50
211060,202006,635,550,85,574750.50,88825.46,663575.96
211065,202006,21,17,4,17765.00,4180.00,21945.00
211070,202006,898,746,152,779571.15,158840.00,938411.15
211080,202006,87,83,4,86735.00,4180.00,90915.00
211085,202006,55,28,27,29260.00,28215.00,57475.00
211090,202006,88,72,16,75240.00,16720.00,91960.00
211100,202006,491,405,86,423225.00,89870.50,513095.50
211102,202006,250,177,73,184965.00,76285.00,261250.00
211105,202006,219,154,65,160930.00,67925.00,228855.00
211107,202006,132,83,49,86735.00,51205.00,137940.00
211110,202006,818,533,285,556985.00,298870.00,855855.00
211120,202006,5347,2654,2693,2775521.05,2818365.40,5593886.45
211125,202006,35,26,9,27170.00,9405.00,36575.00
211130,202006,41630,19074,22556,19950100.75,23606553.25,43556654.00
211140,202006,397,346,51,361570.00,53295.00,414865.00
211150,202006,1217,816,401,852720.00,419045.50,1271765.50
211153,202006,172,105,67,109725.00,70015.00,179740.00
211157,202006,65,51,14,54340.00,14630.00,68970.00
211160,202006,705,601,104,628045.00,108680.00,736725.00
211163,202006,0,0,0,0.00,0.00,0.00
211167,202006,10,9,1,9405.00,1045.00,10450.00
211170,202006,422,314,108,328130.00,112860.00,440990.00
211172,202006,117,80,37,83600.00,38665.00,122265.00
211174,202006,251,155,96,161975.00,100320.00,262295.00
211176,202006,484,359,125,375155.50,130625.00,505780.50
211178,202006,95,62,33,64790.00,34485.00,99275.00
211180,202006,205,164,41,171380.00,42845.00,214225.00
211190,202006,72,67,5,70015.00,5225.00,75240.00
211195,202006,36,24,12,25080.00,12540.00,37620.00
211200,202006,150,129,21,134805.00,21945.00,156750.00
211210,202006,445,327,118,341715.00,124355.00,466070.00
211220,202006,4085,2378,1707,2486057.07,1786951.50,4273008.57
211223,202006,94,91,3,95095.00,3135.00,98230.00
211227,202006,70,55,15,57475.00,15675.00,73150.00
211230,202006,737,608,129,635360.00,134805.00,770165.00
211240,202006,405,316,89,330220.00,93005.00,423225.00
211245,202006,184,89,95,93005.00,99275.00,192280.00
211250,202006,1551,1334,217,1395075.00,227810.00,1622885.00
211260,202006,806,663,143,692835.00,149435.00,842270.00
211270,202006,1957,1604,353,1676180.50,368885.50,2045066.00
211280,202006,1746,1121,625,1171445.00,654170.00,1825615.00
211285,202006,202,125,77,130625.00,80465.00,211090.00
211290,202006,687,482,205,503690.00,214225.00,717915.00
211300,202006,764,608,156,635360.00,163020.00,798380.00
211400,202006,1526,948,578,990660.00,606100.00,1596760.00
220005,202006,15,14,1,14630.00,1045.00,15675.00
220010,202006,88,67,21,70015.00,21945.00,91960.00
220020,202006,701,555,146,579975.00,152570.00,732545.00
220025,202006,110,108,2,112860.00,2090.00,114950.00
220027,202006,44,35,9,36575.00,9405.00,45980.00
220030,202006,112,89,23,93005.00,24035.00,117040.00
220040,202006,1243,943,300,985435.00,313500.00,1298935.00
220045,202006,34,22,12,22990.00,12540.00,35530.00
220050,202006,679,571,108,596695.61,112860.00,709555.61
220060,202006,170,149,21,155705.00,21945.00,177650.00
220070,202006,112,101,11,105545.00,11495.00,117040.00
220080,202006,15,13,2,13585.00,2090.00,15675.00
220090,202006,33,27,6,28215.00,6270.00,34485.00
220095,202006,2,1,1,1045.00,1045.00,2090.00
220100,202006,21,17,4,17765.00,4180.00,21945.00
220105,202006,24,22,2,22990.50,2090.00,25080.50
220110,202006,222,202,20,211090.00,20900.00,231990.00
220115,202006,36,35,1,36575.00,1045.00,37620.00
220117,202006,21,20,1,20900.00,1045.00,21945.00
220120,202006,1484,1130,354,1181895.00,370975.00,1552870.00
220130,202006,31,30,1,31350.00,1045.00,32395.00
220140,202006,108,84,24,87780.00,25080.00,112860.00
220150,202006,496,364,132,380380.00,138985.00,519365.00
220155,202006,6,6,0,6270.00,0.00,6270.00
220157,202006,19,15,4,15675.00,4180.00,19855.00
220160,202006,89,79,10,82555.00,10450.00,93005.00
220170,202006,30,30,0,31350.00,0.00,31350.00
220173,202006,7,7,0,7315.00,0.00,7315.00
220177,202006,7,7,0,7315.00,0.00,7315.00
220180,202006,67,66,1,68970.00,1045.00,70015.00
220190,202006,1058,943,115,985435.00,120175.00,1105610.00
220191,202006,44,39,5,40755.00,5225.00,45980.00
220192,202006,79,76,3,79420.00,3135.00,82555.00
220194,202006,55,53,2,55385.00,2090.00,57475.00
220196,202006,99,83,16,86735.00,16720.00,103455.00
220198,202006,3,2,1,2090.00,1045.00,3135.00
220200,202006,412,343,69,358435.25,72105.00,430540.25
220202,202006,41,36,5,37620.00,5225.00,42845.00
220205,202006,52,46,6,48070.00,6270.00,54340.00
220207,202006,12,12,0,12540.00,0.00,12540.00
220208,202006,79,41,38,42845.00,39710.00,82555.00
220209,202006,32,29,3,30305.00,3135.00,33440.00
220210,202006,19,14,5,14630.00,5225.00,19855.00
220211,202006,29,27,2,28215.00,2090.00,30305.00
220213,202006,41,36,5,37620.00,5225.50,42845.50
220217,202006,41,32,9,33440.00,9405.00,42845.00
220220,202006,2174,1422,752,1487035.00,787930.50,2274965.50
220225,202006,10,4,6,4180.00,6270.00,10450.00
220230,202006,962,751,211,784795.00,221540.00,1006335.00
220240,202006,163,146,17,152570.00,17765.00,170335.00
220245,202006,32,29,3,30305.97,3135.00,33440.97
220250,202006,121,108,13,112860.00,13585.00,126445.00
220253,202006,44,37,7,38665.00,7315.00,45980.00
220255,202006,30,27,3,28215.00,3135.00,31350.00
220260,202006,698,520,178,543400.00,186010.00,729410.00
220265,202006,9,7,2,7315.00,2090.00,9405.00
220270,202006,753,678,75,708510.00,78375.00,786885.00
220271,202006,41,33,8,34485.00,8360.00,42845.00
220272,202006,25,25,0,26125.00,0.00,26125.00
220273,202006,17,15,2,15675.00,2090.00,17765.00
220275,202006,56,46,10,49115.00,10450.00,59565.00
220277,202006,17,14,3,14630.00,3135.00,17765.00
220280,202006,15,12,3,12540.00,3135.00,15675.00
220285,202006,44,41,3,42845.00,3135.00,45980.00
220290,202006,1480,1266,214,1325061.00,223630.25,1548691.25
220300,202006,35,34,1,35530.00,1045.00,36575.00
220310,202006,323,275,48,287375.00,50160.00,337535.00
220320,202006,441,407,34,426360.50,35530.00,461890.50
220323,202006,0,0,0,0.00,0.00,0.00
220325,202006,14,12,2,12540.00,2090.00,14630.00
220327,202006,11,11,0,11495.00,0.00,11495.00
220330,202006,231,168,63,175560.00,65835.00,241395.00
220335,202006,141,124,17,129580.00,17765.00,147345.00
220340,202006,41,28,13,29260.00,13585.00,42845.00
220342,202006,59,51,8,53295.00,8360.00,61655.00
220345,202006,80,73,7,77330.00,7315.00,84645.00
220350,202006,446,384,62,401280.00,64790.00,466070.00
220360,202006,41,30,11,31350.00,11495.00,42845.00
220370,202006,1238,1022,216,1067990.00,225720.00,1293710.00
220375,202006,20,18,2,18810.00,2090.00,20900.00
220380,202006,21,17,4,17765.00,4180.00,21945.00
220385,202006,15,13,2,13585.00,2090.00,15675.00
220390,202006,2324,1323,1001,1382535.60,1046045.75,2428581.35
220400,202006,32,28,4,29260.00,4180.00,33440.00
220410,202006,21,18,3,18810.00,3135.00,21945.00
220415,202006,13,11,2,11495.00,2090.00,13585.00
220420,202006,126,106,20,110770.00,20900.00,131670.00
220430,202006,128,115,13,120175.00,13585.00,133760.00
220435,202006,23,16,7,16720.00,7315.00,24035.00
220440,202006,292,247,45,258115.00,47025.00,305140.00
220450,202006,330,170,160,177650.00,167200.00,344850.00
220455,202006,53,52,1,54340.00,1045.00,55385.00
220460,202006,20,19,1,19855.00,1045.00,20900.00
220465,202006,96,65,31,67925.00,32395.00,100320.00
220470,202006,248,216,32,225720.00,33440.00,259160.00
220480,202006,72,64,8,66880.00,8360.00,75240.00
220490,202006,90,77,13,80465.00,13585.00,94050.00
220500,202006,106,91,15,95095.00,15675.00,110770.00
220510,202006,419,326,93,340670.00,97185.00,437855.00
220515,202006,22,20,2,20900.00,2090.00,22990.00
220520,202006,369,332,37,346940.85,38665.00,385605.85
220525,202006,10,7,3,7315.00,3135.00,10450.00
220527,202006,20,14,6,14630.00,6270.00,20900.00
220530,202006,33,13,20,13585.00,20900.00,34485.00
220535,202006,5,4,1,4180.00,1045.00,5225.00
220540,202006,67,55,12,57475.00,12540.00,70015.00
220545,202006,41,28,13,29260.00,13585.00,42845.00
220550,202006,708,557,151,582065.00,157795.00,739860.00
220551,202006,13,10,3,10450.00,3135.00,13585.00
220552,202006,15,15,0,15675.00,0.00,15675.00
220553,202006,54,49,5,51205.00,5225.00,56430.00
220554,202006,9,7,2,7315.00,2090.00,9405.00
220555,202006,36,33,3,34485.00,3135.00,37620.00
220556,202006,46,44,2,45980.00,2090.00,48070.00
220557,202006,55,52,3,54340.00,3135.00,57475.00
220558,202006,9,4,5,4180.00,5225.00,9405.00
220559,202006,2,2,0,2090.00,0.00,2090.00
220560,202006,69,45,24,47025.00,25080.00,72105.00
220570,202006,748,462,286,483835.50,299915.00,783750.50
220580,202006,560,512,48,535040.00,50160.00,585200.00
220585,202006,9,8,1,8360.00,1045.00,9405.00
220590,202006,15,15,0,15675.00,0.00,15675.00
220595,202006,64,48,16,50160.00,16720.00,66880.00
220600,202006,19,11,8,11495.00,8360.00,19855.00
220605,202006,26,24,2,25080.00,2090.00,27170.00
220610,202006,73,63,10,65835.00,10450.00,76285.00
220620,202006,563,466,97,486970.00,101365.00,588335.00
220630,202006,5,4,1,4180.00,1045.00,5225.00
220635,202006,37,32,5,33440.00,5225.00,38665.00
220640,202006,107,89,18,93005.00,18810.00,111815.00
220650,202006,113,106,7,110770.00,7315.00,118085.00
220660,202006,54,43,11,44935.00,11495.00,56430.00
220665,202006,4,4,0,4180.00,0.00,4180.00
220667,202006,22,20,2,20900.00,2090.00,22990.00
220669,202006,28,25,3,26125.00,3135.00,29260.00
220670,202006,66,53,13,55385.00,13585.00,68970.00
220672,202006,70,48,22,50160.00,22990.00,73150.00
220675,202006,35,28,7,29260.00,7315.00,36575.00
220680,202006,38,33,5,34485.00,5225.00,39710.00
220690,202006,47,43,4,44935.00,4180.00,49115.00
220695,202006,35,18,17,18810.00,17765.00,36575.00
220700,202006,1698,1311,387,1371040.50,404415.00,1775455.50
220710,202006,5,4,1,4180.00,1045.00,5225.00
220720,202006,105,89,16,93005.00,16720.00,109725.00
220730,202006,15,15,0,15675.00,0.00,15675.00
220735,202006,5,1,4,1045.00,4180.00,5225.00
220740,202006,48,44,4,45980.00,4180.00,50160.00
220750,202006,111,95,16,99275.00,17765.00,117040.00
220755,202006,15,14,1,14630.00,1045.00,15675.00
220760,202006,68,62,6,64790.00,6270.00,71060.00
220770,202006,5592,3045,2547,3185162.01,2664750.50,5849912.51
220775,202006,18,11,7,11495.00,7315.00,18810.00
220777,202006,18,17,1,17765.00,1045.00,18810.00
220779,202006,1,0,1,0.00,1045.00,1045.00
220780,202006,898,766,132,800470.00,137940.50,938410.50
220785,202006,4,1,3,1045.00,3135.00,4180.00
220790,202006,1081,858,223,896610.05,233035.00,1129645.05
220793,202006,7,6,1,6270.00,1045.00,7315.00
220795,202006,14,13,1,13585.00,1045.00,14630.00
220800,202006,4010,3086,924,3225915.81,967670.00,4193585.81
220810,202006,65,57,8,59565.50,8360.00,67925.50
220820,202006,242,221,21,230945.00,21945.00,252890.00
220830,202006,1236,1064,172,1111880.00,179740.00,1291620.00
220840,202006,2441,1696,745,1773367.59,779570.95,2552938.54
220850,202006,54,44,10,45980.00,10450.00,56430.00
220855,202006,8,5,3,5225.00,3135.00,8360.00
220860,202006,14,12,2,12540.00,2090.00,14630.00
220865,202006,31,29,2,30305.00,2090.00,32395.00
220870,202006,73,65,8,67925.00,8360.00,76285.00
220880,202006,323,258,65,269610.00,67925.00,337535.00
220885,202006,34,31,3,32395.00,3135.00,35530.00
220887,202006,13,12,1,12540.00,1045.00,13585.00
220890,202006,97,86,11,89870.00,11495.00,101365.00
220900,202006,21,14,7,14630.00,7315.00,21945.00
220910,202006,52,43,9,44935.00,9405.00,54340.00
220915,202006,10,9,1,9405.00,1045.00,10450.00
220920,202006,50,45,5,47025.00,5225.00,52250.00
220930,202006,41,40,1,41800.00,1045.00,42845.00
220935,202006,15,15,0,15675.00,0.00,15675.00
220937,202006,35,34,1,35530.00,1045.00,36575.00
220940,202006,54,50,4,53295.00,4180.00,57475.00
220945,202006,1,1,0,1045.00,0.00,1045.00
220950,202006,42,36,6,37620.00,6270.00,43890.00
220955,202006,22,21,1,21945.00,1045.00,22990.00
220960,202006,11,10,1,10450.00,1045.00,11495.00
220965,202006,37,33,4,34485.00,4180.00,38665.00
220970,202006,62,51,11,53295.00,11495.00,64790.00
220975,202006,16,14,2,14630.00,2090.00,16720.00
220980,202006,30,28,2,30305.00,2090.00,32395.00
220985,202006,64,57,7,59565.00,7315.00,66880.00
220987,202006,28,27,1,28215.00,1045.00,29260.00
220990,202006,19,18,1,18810.00,1045.00,19855.00
220995,202006,19,15,4,15675.00,4180.00,19855.00
220997,202006,66,55,11,57475.00,11495.00,68970.00
221000,202006,1173,1059,114,1107700.00,120175.00,1227875.00
221005,202006,53,46,7,48070.00,7315.00,55385.00
221010,202006,16,12,4,12540.00,4180.00,16720.00
221020,202006,40,38,2,39710.00,2090.00,41800.00
221030,202006,39,31,8,32395.00,8360.00,40755.00
221035,202006,23,23,0,24035.00,0.00,24035.00
221037,202006,12,8,4,8360.00,4180.00,12540.00
221038,202006,25,22,3,22990.00,3135.00,26125.00
221039,202006,23,23,0,24035.00,0.00,24035.00
221040,202006,248,214,34,223630.00,35530.00,259160.00
221050,202006,238,201,37,210045.00,38665.00,248710.00
221060,202006,1860,1623,237,1699170.00,247665.00,1946835.00
221062,202006,33,33,0,34485.00,0.00,34485.00
221063,202006,13,9,4,9405.00,4180.00,13585.00
221065,202006,59,48,11,50160.00,11495.00,61655.00
221070,202006,139,120,19,125400.00,19855.00,145255.00
221080,202006,372,323,49,337535.00,51205.00,388740.00
221090,202006,27,25,2,26125.00,2090.00,28215.00
221093,202006,48,33,15,34485.00,15675.00,50160.00
221095,202006,7,7,0,7315.00,0.00,7315.00
221097,202006,13,10,3,10450.00,3135.00,13585.00
221100,202006,25362,15042,10320,15728299.44,10805300.45,26533599.89
221110,202006,1087,819,268,855855.00,280060.00,1135915.00
221120,202006,540,396,144,413820.50,150480.00,564300.50
221130,202006,985,795,190,830775.00,198550.00,1029325.00
221135,202006,35,31,4,32395.00,4180.00,36575.00
221140,202006,45,39,6,40755.00,6270.00,47025.00
221150,202006,11,9,2,9405.00,2090.00,11495.00
221160,202006,13,13,0,13585.00,0.00,13585.00
221170,202006,15,15,0,15675.00,0.00,15675.00
230010,202006,168,153,15,159885.00,15675.00,175560.00
230015,202006,128,103,25,107635.00,26125.00,133760.00
230020,202006,1633,1385,248,1448370.50,260205.00,1708575.50
230030,202006,1679,1206,473,1262639.66,494285.00,1756924.66
230040,202006,222,189,33,197505.00,34485.50,231990.50
230050,202006,229,170,59,177650.00,61655.00,239305.00
230060,202006,167,133,34,138985.00,35530.00,174515.00
230070,202006,303,263,40,274835.00,41800.00,316635.00
230075,202006,854,738,116,772256.50,121220.00,893476.50
230080,202006,198,170,28,177650.00,29260.00,206910.00
230090,202006,124,88,36,91960.00,37620.00,129580.00
230100,202006,2151,1233,918,1289531.50,961400.00,2250931.50
230110,202006,2905,1883,1022,1969825.50,1072170.50,3041996.00
230120,202006,1008,793,215,831820.00,225720.00,1057540.00
230125,202006,154,128,26,133760.00,27170.00,160930.00
230130,202006,476,426,50,445170.00,52250.00,497420.00
230140,202006,223,185,38,193325.00,39710.00,233035.00
230150,202006,148,114,34,119130.00,35530.00,154660.00
230160,202006,939,796,143,831820.00,149435.00,981255.00
230170,202006,612,551,61,575795.50,63745.00,639540.50
230180,202006,72,67,5,70015.00,5225.00,75240.00
230185,202006,404,347,57,362615.00,59565.00,422180.00
230190,202006,2332,1846,486,1929070.15,507870.00,2436940.15
230195,202006,494,428,66,447260.00,68970.00,516230.00
230200,202006,402,337,65,352165.00,67925.00,420090.00
230205,202006,392,259,133,270655.00,138985.00,409640.00
230210,202006,1376,1069,307,1117105.38,320815.00,1437920.38
230220,202006,1588,1085,503,1133825.00,525635.00,1659460.00
230230,202006,908,777,131,813010.00,136895.00,949905.00
230240,202006,1741,1502,239,1570898.25,250800.00,1821698.25
230250,202006,1799,1484,315,1552870.00,330220.00,1883090.00
230260,202006,3267,2037,1230,2129710.00,1290575.00,3420285.00
230270,202006,1369,1102,267,1151591.38,280060.50,1431651.88
230280,202006,2758,2072,686,2166285.00,720005.50,2886290.50
230290,202006,409,365,44,383515.72,45980.00,429495.72
230300,202006,525,384,141,402325.00,147345.00,549670.00
230310,202006,427,322,105,336490.00,109725.00,446215.00
230320,202006,928,793,135,828686.00,141075.00,969761.00
230330,202006,314,254,60,265430.00,62700.00,328130.00
230340,202006,453,366,87,382470.00,90915.00,473385.00
230350,202006,3157,2002,1155,2097315.00,1213245.00,3310560.00
230360,202006,275,222,53,233035.00,55385.00,288420.00
230365,202006,136,115,21,120175.00,21945.00,142120.00
230370,202006,10104,4914,5190,5147673.42,5442361.00,10590034.42
230380,202006,474,406,68,424270.50,71060.00,495330.50
230390,202006,542,303,239,316635.00,249755.00,566390.00
230393,202006,249,206,43,215270.00,44935.00,260205.00
230395,202006,352,282,70,294690.70,73150.00,367840.70
230400,202006,623,494,129,516230.00,134805.00,651035.00
230410,202006,2709,1685,1024,1762915.97,1072170.50,2835086.47
230420,202006,6331,4187,2144,4377508.04,2242570.20,6620078.24
230423,202006,332,291,41,304095.00,42845.00,346940.00
230425,202006,418,344,74,360525.85,77330.00,437855.85
230426,202006,120,97,23,101365.00,24035.00,125400.00
230427,202006,76,73,3,76285.00,3135.00,79420.00
230428,202006,1512,749,763,783750.00,800470.00,1584220.00
230430,202006,454,370,84,386650.00,87780.00,474430.00
230435,202006,902,649,253,678205.00,265430.77,943635.77
230440,202006,88606,39410,49196,41232582.30,51539415.84,92771998.14
230445,202006,315,221,94,230945.00,98230.00,329175.00
230450,202006,559,442,117,461890.00,122265.00,584155.00
230460,202006,66,52,14,54340.00,14630.00,68970.00
230465,202006,310,252,58,263340.00,60610.00,323950.00
230470,202006,2023,1595,428,1668865.00,447260.25,2116125.25
230480,202006,157,148,9,154660.00,9405.00,164065.00
230490,202006,303,242,61,252890.00,63745.00,316635.00
230495,202006,448,330,118,344850.00,123310.00,468160.00
230500,202006,1029,758,271,793155.00,284240.00,1077395.00
230510,202006,59,46,13,48070.00,13585.00,61655.00
230520,202006,381,299,82,312455.00,85690.00,398145.00
230523,202006,2344,1467,877,1539285.00,924825.50,2464110.50
230526,202006,269,229,40,239305.00,41800.00,281105.00
230530,202006,696,520,176,543400.00,184965.00,728365.00
230533,202006,206,194,12,202730.00,12540.00,215270.00
230535,202006,370,274,96,286330.00,100320.00,386650.00
230540,202006,1804,1590,214,1661550.00,224675.00,1886225.00
230550,202006,3831,2457,1374,2567567.40,1436875.00,4004442.40
230560,202006,583,442,141,461890.00,147345.00,609235.00
230565,202006,227,165,62,172425.00,64790.00,237215.00
230570,202006,290,256,34,267520.00,35530.00,303050.00
230580,202006,1182,863,319,902880.00,334400.00,1237280.00
230590,202006,1008,783,225,818235.25,235125.00,1053360.25
230600,202006,242,220,22,229900.00,22990.00,252890.00
230610,202006,380,295,85,308275.00,88825.00,397100.00
230620,202006,188,158,30,165110.50,32395.00,197505.50
230625,202006,772,539,233,563255.25,244530.00,807785.25
230630,202006,1337,1046,291,1093070.00,306185.00,1399255.00
230640,202006,3792,3215,577,3362811.00,604011.25,3966822.25
230650,202006,455,390,65,407550.00,67925.00,475475.00
230655,202006,694,588,106,616550.00,110770.00,727320.00
230660,202006,367,304,63,317680.00,65835.00,383515.00
230670,202006,441,379,62,396055.00,64790.00,460845.00
230680,202006,208,189,19,197505.00,19855.00,217360.00
230690,202006,908,771,137,806740.00,143165.00,949905.00
230700,202006,845,708,137,740905.00,143165.50,884070.50
230710,202006,695,660,35,689700.00,36575.00,726275.00
230720,202006,154,134,20,140030.00,20900.00,160930.00
230725,202006,265,209,56,218405.00,58520.00,276925.00
230730,202006,12266,6667,5599,6971132.55,5867677.62,12838810.17
230740,202006,675,543,132,568480.50,137940.00,706420.50
230750,202006,830,700,130,731500.00,135850.00,867350.00
230760,202006,1465,1265,200,1321925.00,209000.00,1530925.00
230763,202006,329,272,57,284240.00,59565.00,343805.00
230765,202006,7489,3454,4035,3612565.51,4219711.25,7832276.76
230770,202006,5112,2595,2517,2717001.90,2635490.50,5352492.40
230780,202006,735,645,90,674025.50,95095.00,769120.50
230790,202006,283,237,46,247665.00,48070.00,295735.00
230800,202006,1138,822,316,860035.00,331265.00,1191300.00
230810,202006,1349,1191,158,1245640.00,165110.00,1410750.00
230820,202006,365,253,112,264385.50,119130.00,383515.50
230830,202006,962,823,139,860035.00,145255.00,1005290.00
230835,202006,276,240,36,250800.00,37620.00,288420.00
230837,202006,167,141,26,147345.00,27170.00,174515.00
230840,202006,927,731,196,763895.50,204820.50,968716.00
230850,202006,1473,1274,199,1331330.00,207955.00,1539285.00
230860,202006,301,227,74,237215.00,77330.00,314545.00
230870,202006,1835,1566,269,1636470.00,283195.00,1919665.00
230880,202006,69,53,16,55385.00,16720.00,72105.00
230890,202006,540,495,45,517275.00,47025.00,564300.00
230900,202006,279,203,76,214225.00,79420.31,293645.31
230910,202006,218,170,48,177650.00,50160.00,227810.00
230920,202006,426,340,86,355300.00,90915.00,446215.00
230930,202006,987,691,296,722095.20,310365.00,1032460.20
230940,202006,862,671,191,703285.00,199595.00,902880.00
230945,202006,519,425,94,444125.50,98230.00,542355.50
230950,202006,415,356,59,372020.00,61655.00,433675.00
230960,202006,2679,1791,888,1874730.50,931095.50,2805826.00
230970,202006,1722,960,762,1004245.00,796290.00,1800535.00
230980,202006,206,169,37,176605.00,38665.00,215270.00
230990,202006,136,111,25,115995.00,26125.00,142120.00
231000,202006,207,189,18,197505.00,18810.00,216315.00
231010,202006,151,113,38,118085.00,39710.00,157795.00
231020,202006,1355,936,419,978120.00,438900.00,1417020.00
231025,202006,1068,791,277,826595.00,291555.50,1118150.50
231030,202006,1102,916,186,957220.40,194370.00,1151590.40
231040,202006,136,93,43,97185.00,44935.00,142120.00
231050,202006,953,843,110,883025.00,114950.00,997975.00
231060,202006,157,131,26,136895.00,27170.00,164065.00
231070,202006,1500,1044,456,1090980.75,476520.00,1567500.75
231080,202006,262,241,21,251845.00,21945.00,273790.00
231085,202006,610,367,243,383515.00,254980.00,638495.00
231090,202006,245,200,45,209000.00,47025.00,256025.00
231095,202006,169,133,36,138985.00,37620.00,176605.00
231100,202006,149,123,26,129580.00,27170.00,156750.00
231110,202006,369,315,54,329175.00,56430.00,385605.00
231120,202006,271,231,40,241395.00,41800.00,283195.00
231123,202006,154,146,8,152570.00,8360.00,160930.00
231126,202006,336,263,73,274835.50,76285.00,351120.50
231130,202006,4648,3617,1031,3780810.50,1077395.50,4858206.00
231135,202006,212,184,28,192280.00,29260.00,221540.00
231140,202006,3074,2259,815,2360655.50,854810.00,3215465.50
231150,202006,368,350,18,366795.00,18810.00,385605.00
231160,202006,1209,959,250,1004245.00,261250.00,1265495.00
231170,202006,517,359,158,375155.00,166155.00,541310.00
231180,202006,1704,1461,243,1526745.00,253935.00,1780680.00
231190,202006,206,173,33,180785.00,34485.00,215270.00
231195,202006,214,183,31,191235.00,32395.00,223630.00
231200,202006,805,656,149,685520.00,155705.00,841225.00
231210,202006,582,491,91,513095.00,95095.00,608190.00
231220,202006,1052,766,286,800471.59,298870.00,1099341.59
231230,202006,1476,1170,306,1222650.00,320815.00,1543465.00
231240,202006,1459,1038,421,1087845.00,440990.50,1528835.50
231250,202006,113,104,9,108680.00,9405.00,118085.00
231260,202006,278,179,99,187055.00,103455.00,290510.00
231270,202006,1008,821,187,858991.44,195415.00,1054406.44
231280,202006,77,60,17,62700.00,17765.00,80465.00
231290,202006,7718,4321,3397,4517536.16,3556136.44,8073672.60
231300,202006,611,567,44,592515.00,45980.00,638495.00
231310,202006,751,695,56,726275.56,58520.00,784795.56
231320,202006,589,447,142,467116.50,148390.00,615506.50
231325,202006,96,85,11,88825.00,11495.00,100320.00
231330,202006,2006,1553,453,1625239.40,473385.50,2098624.90
231335,202006,255,226,29,236170.00,30305.00,266475.00
231340,202006,1719,1259,460,1317745.00,482790.00,1800535.00
231350,202006,1297,1053,244,1101430.00,254981.50,1356411.50
231355,202006,432,371,61,387695.00,63745.00,451440.00
231360,202006,511,378,133,395010.86,138985.00,533995.86
231370,202006,87,76,11,79420.00,11495.00,90915.00
231375,202006,294,213,81,222585.00,84645.00,307230.00
231380,202006,494,399,95,416955.00,100320.00,517275.00
231390,202006,207,165,42,172425.00,43890.00,216315.00
231395,202006,735,460,275,482790.00,287375.00,770165.00
231400,202006,1119,931,188,974985.25,196460.50,1171445.75
231410,202006,1327,1087,240,1135915.00,251845.00,1387760.00
240010,202006,393,173,220,180785.67,229900.00,410685.67
240020,202006,2274,1835,439,1919666.68,459800.00,2379466.68
240030,202006,120,102,18,106590.00,18810.00,125400.00
240040,202006,33,33,0,34485.00,0.00,34485.00
240050,202006,531,453,78,473385.00,81510.00,554895.00
240060,202006,67,63,4,65835.00,4180.00,70015.00
240070,202006,219,171,48,178695.00,50160.00,228855.00
240080,202006,522,356,166,372020.00,173470.01,545490.01
240090,202006,106,94,12,98230.00,12540.00,110770.00
240100,202006,1505,1424,81,1489125.25,85690.00,1574815.25
240110,202006,1061,698,363,730455.50,380380.75,1110836.25
240120,202006,133,108,25,112860.00,26125.00,138985.00
240130,202006,283,261,22,272745.00,22990.00,295735.00
240140,202006,77,57,20,59565.00,20900.00,80465.00
240145,202006,747,666,81,695970.00,84645.00,780615.00
240150,202006,20,16,4,16720.00,4180.00,20900.00
240160,202006,42,36,6,37620.00,6270.00,43890.00
240165,202006,36,28,8,29260.25,8360.00,37620.25
240170,202006,110,80,30,83600.00,31350.00,114950.00
240180,202006,88,69,19,72105.00,19855.00,91960.00
240185,202006,42,39,3,40755.00,3135.00,43890.00
240190,202006,16,14,2,14630.00,2090.00,16720.00
240200,202006,3103,1737,1366,1817257.50,1427471.00,3244728.50
240210,202006,173,134,39,140030.00,40755.00,180785.00
240220,202006,1114,808,306,844360.75,319770.00,1164130.75
240230,202006,849,781,68,817190.75,71060.00,888250.75
240240,202006,73,53,20,55385.00,20900.00,76285.00
240250,202006,89,77,12,80465.00,12540.00,93005.00
240260,202006,1814,1337,477,1398210.00,499510.00,1897720.00
240270,202006,184,162,22,169290.00,22990.00,192280.00
240280,202006,44,35,9,36575.00,9405.00,45980.00
240290,202006,51,49,2,51205.00,2090.00,53295.00
240300,202006,173,94,79,99275.00,82555.00,181830.00
240310,202006,2316,1275,1041,1334466.48,1087845.85,2422312.33
240320,202006,194,181,13,189145.00,13585.00,202730.00
240325,202006,4559,2710,1849,2836132.41,1935340.70,4771473.11
240330,202006,71,68,3,71060.00,3135.00,74195.00
240340,202006,67,43,24,44935.00,25080.00,70015.00
240350,202006,97,85,12,88825.00,12540.00,101365.00
240360,202006,562,350,212,365750.00,221540.00,587290.00
240370,202006,51,47,4,49115.00,4180.00,53295.00
240375,202006,66,40,26,41800.00,28215.00,70015.00
240380,202006,226,188,38,196460.00,39710.50,236170.50
240390,202006,13,12,1,12540.00,1045.00,13585.00
240400,202006,81,75,6,78375.00,6270.00,84645.00
240410,202006,14,8,6,8360.00,6270.00,14630.00
240420,202006,1006,740,266,774345.00,277970.00,1052315.00
240430,202006,263,246,17,257070.00,17765.00,274835.00
240440,202006,119,68,51,71060.00,53295.00,124355.00
240450,202006,224,150,74,158840.50,77330.00,236170.50
240460,202006,70,53,17,55385.00,17765.00,73150.00
240470,202006,238,212,26,221540.00,27170.00,248710.00
240480,202006,16,14,2,14630.00,2090.00,16720.00
240485,202006,80,67,13,70015.00,13585.00,83600.00
240490,202006,47,45,2,47025.00,2090.00,49115.00
240500,202006,83,63,20,65835.00,20900.00,86735.00
240510,202006,43,32,11,33440.00,11495.00,44935.00
240520,202006,116,111,5,115995.00,5225.00,121220.00
240530,202006,54,47,7,49115.00,7315.00,56430.00
240540,202006,78,66,12,68970.00,12540.00,81510.00
240550,202006,13,12,1,12540.00,1045.00,13585.00
240560,202006,378,277,101,289465.50,105545.00,395010.50
240570,202006,448,287,161,299915.00,168245.50,468160.50
240580,202006,1294,1024,270,1071125.25,282150.00,1353275.25
240590,202006,30,28,2,30305.00,2090.00,32395.00
240600,202006,107,102,5,107635.00,5225.00,112860.00
240610,202006,521,435,86,454575.50,89870.00,544445.50
240615,202006,19,18,1,18810.00,1045.00,19855.00
240620,202006,87,83,4,86735.00,4180.00,90915.00
240630,202006,38,33,5,34485.00,5225.00,39710.00
240640,202006,26,20,6,20900.00,6270.00,27170.00
240650,202006,241,200,41,209000.00,42845.00,251845.00
240660,202006,111,95,16,99275.00,16720.00,115995.00
240670,202006,305,177,128,184965.75,133760.00,318725.75
240680,202006,50,37,13,39710.00,13585.00,53295.00
240690,202006,47,44,3,45980.00,3135.00,49115.00
240700,202006,184,153,31,159885.00,32395.00,192280.00
240710,202006,2024,1249,775,1307295.75,814055.00,2121350.75
240720,202006,1069,789,280,824505.00,293645.00,1118150.00
240725,202006,64,59,5,61655.00,5225.00,66880.00
240730,202006,147,126,21,131670.00,21945.00,153615.00
240740,202006,233,199,34,207955.00,35530.85,243485.85
240750,202006,51,28,23,29260.00,24035.00,53295.00
240760,202006,46,41,5,43890.00,5225.00,49115.00
240770,202006,145,112,33,117040.00,34485.00,151525.00
240780,202006,678,559,119,585200.00,125400.00,710600.00
240790,202006,40,38,2,39710.00,2090.00,41800.00
240800,202006,9284,6323,2961,6611724.05,3099472.75,9711196.80
240810,202006,20464,11066,9398,11578959.03,9836588.90,21415547.93
240820,202006,238,140,98,146300.09,102410.00,248710.09
240830,202006,1633,1342,291,1403435.75,305140.00,1708575.75
240840,202006,77,67,10,70015.00,10450.00,80465.00
240850,202006,87,77,10,80465.00,11495.00,91960.00
240860,202006,107,103,4,107635.00,4180.00,111815.00
240870,202006,60,52,8,54340.00,8360.00,62700.00
240880,202006,31,28,3,29260.00,4180.00,33440.00
240890,202006,1127,648,479,677160.40,500555.00,1177715.40
240895,202006,63,41,22,42845.00,22990.00,65835.00
240910,202006,159,142,17,148390.00,17765.00,166155.00
240920,202006,13,10,3,10450.00,3135.00,13585.00
240930,202006,412,370,42,386650.00,43890.00,430540.00
240933,202006,46,31,15,32395.00,16720.00,49115.00
240940,202006,2394,2118,276,2213310.45,288420.00,2501730.45
240950,202006,47,43,4,44935.00,4180.00,49115.00
240960,202006,26,22,4,22990.00,4180.00,27170.00
240970,202006,115,85,30,88825.00,31350.00,120175.00
240980,202006,202,160,42,167200.00,43890.00,211090.00
240990,202006,131,87,44,90915.00,45980.00,136895.00
241000,202006,61,57,4,59565.00,4180.00,63745.00
241010,202006,69,52,17,54340.00,17765.00,72105.00
241020,202006,115,106,9,110770.00,9405.00,120175.00
241025,202006,13,7,6,7315.00,6270.00,13585.00
241030,202006,113,91,22,95095.00,22990.00,118085.00
241040,202006,45,32,13,33440.00,13585.00,47025.00
241050,202006,81,74,7,77330.50,7315.00,84645.50
241060,202006,29,24,5,25080.00,5225.00,30305.00
241070,202006,16,16,0,16720.00,0.00,16720.00
241080,202006,60,53,7,56430.00,7315.00,63745.00
241090,202006,58,46,12,48070.00,12540.00,60610.00
241100,202006,72,61,11,63745.00,11495.00,75240.00
241105,202006,8,2,6,2090.00,6270.00,8360.00
241110,202006,47,44,3,45980.00,3135.00,49115.00
241120,202006,1482,1125,357,1175625.50,373065.00,1548690.50
241140,202006,221,183,38,192280.50,39710.00,231990.50
241142,202006,41,35,6,37620.00,6270.00,43890.00
241150,202006,1181,1038,143,1084710.00,149435.00,1234145.00
241160,202006,17,16,1,16720.00,1045.00,17765.00
241170,202006,43,38,5,39710.00,5225.00,44935.00
241180,202006,42,36,6,37620.00,6270.00,43890.00
241190,202006,37,36,1,37620.00,1045.00,38665.00
241200,202006,3937,2047,1890,2140161.15,1977140.00,4117301.15
241210,202006,69,59,10,61655.00,10450.00,72105.00
241220,202006,1426,961,465,1005291.57,486970.00,1492261.57
241230,202006,240,201,39,211090.00,40755.00,251845.00
241240,202006,55,44,11,45980.00,11495.00,57475.00
241250,202006,1137,1045,92,1092025.50,96140.00,1188165.50
241255,202006,50,40,10,41800.00,10450.00,52250.00
241260,202006,684,529,155,552805.00,161975.00,714780.00
241270,202006,66,44,22,45980.00,22990.00,68970.00
241280,202006,94,82,12,85690.00,12540.00,98230.00
241290,202006,124,89,35,93005.00,36575.00,129580.00
241300,202006,77,56,21,58520.00,21945.00,80465.00
241310,202006,51,37,14,38665.75,14630.00,53295.75
241320,202006,30,18,12,18810.00,12540.00,31350.00
241330,202006,60,55,5,57475.00,5225.00,62700.00
241335,202006,74,66,8,68970.00,8360.00,77330.00
241340,202006,180,133,47,138985.00,49115.00,188100.00
241350,202006,61,52,9,54340.00,9405.00,63745.00
241355,202006,50,43,7,44935.00,7315.00,52250.00
241360,202006,51,50,1,52250.00,1045.00,53295.00
241370,202006,53,43,10,44935.00,10450.00,55385.00
241380,202006,37,33,4,34485.00,4180.00,38665.00
241390,202006,85,65,20,67925.00,20900.00,88825.00
241400,202006,224,179,45,187055.00,47025.00,234080.00
241410,202006,183,165,18,172425.00,18810.00,191235.00
241415,202006,100,80,20,83600.00,20900.00,104500.00
241420,202006,105,75,30,78375.00,31350.10,109725.10
241430,202006,28,25,3,26125.00,3135.00,29260.00
241440,202006,541,434,107,453530.00,111815.00,565345.00
241445,202006,35,33,2,34485.00,2090.00,36575.00
241450,202006,278,228,50,238260.00,52250.00,290510.00
241460,202006,140,126,14,131670.25,14630.00,146300.25
241470,202006,37,32,5,33440.00,5225.00,38665.00
241475,202006,54,51,3,53295.00,3135.00,56430.00
241480,202006,96,68,28,71060.00,29260.00,100320.00
241490,202006,11,10,1,10450.00,1045.00,11495.00
241500,202006,47,36,11,37620.00,11495.00,49115.00
250010,202006,102,87,15,90915.00,15675.00,106590.00
250020,202006,33,30,3,31350.00,3135.00,34485.00
250030,202006,871,654,217,683430.00,227810.00,911240.00
250040,202006,373,306,67,319770.00,70015.00,389785.00
250050,202006,262,214,48,223630.00,50160.00,273790.00
250053,202006,56,42,14,43890.00,14630.00,58520.00
250057,202006,1,1,0,1045.00,0.00,1045.00
250060,202006,581,414,167,432630.00,174515.00,607145.00
250070,202006,708,565,143,590425.10,149435.00,739860.10
250073,202006,8,8,0,8360.00,0.00,8360.00
250077,202006,179,136,43,142120.00,44935.00,187055.00
250080,202006,427,334,93,349030.30,98230.00,447260.30
250090,202006,217,142,75,148390.00,79420.00,227810.00
250100,202006,516,427,89,446215.00,93005.00,539220.00
250110,202006,618,470,148,491150.00,154660.00,645810.00
250115,202006,20,7,13,7315.00,13585.00,20900.00
250120,202006,124,89,35,93005.00,36575.00,129580.00
250130,202006,574,467,107,490105.00,111815.00,601920.00
250135,202006,17,10,7,10450.00,7315.00,17765.00
250140,202006,85,75,10,78375.00,10450.00,88825.00
250150,202006,595,426,169,445170.00,176605.00,621775.00
250153,202006,9,6,3,6270.00,3135.00,9405.00
250157,202006,33,26,7,27170.00,7315.00,34485.00
250160,202006,234,182,52,190190.00,54340.00,244530.00
250170,202006,62,40,22,41800.00,22990.00,64790.00
250180,202006,4287,2927,1360,3060805.30,1426425.00,4487230.30
250190,202006,844,556,288,581020.00,300960.25,881980.25
250200,202006,52,43,9,44935.00,9405.00,54340.00
250205,202006,24,20,4,20900.00,4180.00,25080.00
250210,202006,85,75,10,78375.00,10450.00,88825.00
250215,202006,65,53,12,55385.00,12540.00,67925.00
250220,202006,24,18,6,18810.00,6270.00,25080.00
250230,202006,78,71,7,74195.00,7315.00,81510.00
250240,202006,233,194,39,202730.00,40755.00,243485.00
250250,202006,390,336,54,351120.00,56430.00,407550.00
250260,202006,45,38,7,39710.00,7315.00,47025.00
250270,202006,69,50,19,52250.00,19855.00,72105.00
250280,202006,385,316,69,330220.00,72105.00,402325.00
250290,202006,94,87,7,90915.00,7315.00,98230.00
250300,202006,558,377,181,395010.00,190190.00,585200.00
250310,202006,49,44,5,45980.00,5225.00,51205.00
250320,202006,1966,1328,638,1387760.85,668800.90,2056561.75
250330,202006,105,86,19,89870.00,19855.00,109725.00
250340,202006,25,23,2,24035.00,2090.00,26125.00
250350,202006,164,107,57,112860.00,59565.00,172425.00
250355,202006,33,25,8,26125.00,8360.00,34485.00
250360,202006,198,163,35,170335.00,36575.00,206910.00
250370,202006,2406,1608,798,1681405.00,836000.00,2517405.00
250375,202006,11,7,4,7315.00,4180.00,11495.00
250380,202006,57,43,14,44935.00,14630.00,59565.00
250390,202006,44,33,11,34485.00,11495.00,45980.00
250400,202006,16411,8325,8086,8712150.06,8474951.52,17187101.58
250403,202006,329,266,63,277970.00,65835.00,343805.00
250407,202006,59,49,10,51205.00,10450.00,61655.00
250410,202006,30,26,4,27170.00,4180.00,31350.00
250415,202006,44,30,14,31350.00,14630.00,45980.00
250420,202006,43,37,6,38665.00,6270.00,44935.00
250430,202006,1457,1251,206,1308601.25,216315.00,1524916.25
250435,202006,18,14,4,14630.00,4180.00,18810.00
250440,202006,679,567,112,592515.00,117040.00,709555.00
250450,202006,86,67,19,70015.00,19855.00,89870.00
250460,202006,474,317,157,331265.00,164065.00,495330.00
250470,202006,91,64,27,66880.00,28215.00,95095.00
250480,202006,330,265,65,276925.00,67925.00,344850.00
250485,202006,3,2,1,2090.00,1045.00,3135.00
250490,202006,226,182,44,190190.00,45980.00,236170.00
250500,202006,90,66,24,68970.00,25080.00,94050.00
250510,202006,759,600,159,627000.00,166155.00,793155.00
250520,202006,181,124,57,129580.00,59565.00,189145.00
250523,202006,119,96,23,100320.00,24035.00,124355.00
250527,202006,103,80,23,83600.00,24035.00,107635.00
250530,202006,10,6,4,6270.00,4180.00,10450.00
250535,202006,35,25,10,26125.00,10450.00,36575.00
250540,202006,133,103,30,107635.00,31350.00,138985.00
250550,202006,72,69,3,72105.00,3135.00,75240.00
250560,202006,51,35,16,36575.00,16720.00,53295.00
250570,202006,165,136,29,142120.00,30305.00,172425.00
250580,202006,109,84,25,87847.00,26125.00,113972.00
250590,202006,26,16,10,16720.00,10450.00,27170.00
250600,202006,1388,911,477,951996.46,499510.00,1451506.46
250610,202006,159,131,28,136895.00,29260.00,166155.00
250620,202006,23,18,5,18810.00,5225.00,24035.00
250625,202006,73,54,19,56430.00,19855.00,76285.00
250630,202006,3043,1931,1112,2018942.43,1162040.00,3180982.43
250640,202006,218,174,44,181830.00,45980.00,227810.00
250650,202006,30,20,10,20900.00,10450.00,31350.00
250660,202006,49,38,11,39710.00,11495.00,51205.00
250670,202006,65,44,21,45980.00,21945.00,67925.00
250680,202006,406,327,79,341715.00,82555.00,424270.00
250690,202006,2018,1395,623,1457775.96,653125.00,2110900.96
250700,202006,943,813,130,851675.25,135850.00,987525.25
250710,202006,434,340,94,355300.00,98230.00,453530.00
250720,202006,115,86,29,89870.00,30305.00,120175.00
250730,202006,388,324,64,338580.00,66880.00,405460.00
250740,202006,53,49,4,51205.00,4180.00,55385.00
250750,202006,22230,13356,8874,13965274.78,9291096.50,23256371.28
250760,202006,95,76,19,79420.00,19855.00,99275.00
250770,202006,367,239,128,249755.60,133760.00,383515.60
250780,202006,64,43,21,44935.00,21945.00,66880.00
250790,202006,462,301,161,315590.00,168245.00,483835.00
250800,202006,152,137,15,143165.00,15675.00,158840.00
250810,202006,79,61,18,63745.00,18810.00,82555.00
250820,202006,153,128,25,133760.00,26125.00,159885.00
250830,202006,437,295,142,308275.50,148390.00,456665.50
250840,202006,55,49,6,51205.00,6270.00,57475.00
250850,202006,57,47,10,49115.00,10450.00,59565.00
250855,202006,13,11,2,11495.00,2090.00,13585.00
250860,202006,213,146,67,152570.00,70015.00,222585.00
250870,202006,31,27,4,28215.00,4180.00,32395.00
250880,202006,83,63,20,65835.00,20900.00,86735.00
250890,202006,2829,2118,711,2215400.00,745085.50,2960485.50
250900,202006,50,41,9,42845.00,9405.00,52250.00
250905,202006,118,91,27,96140.00,28215.00,124355.00
250910,202006,1135,822,313,860035.00,327085.00,1187120.00
250915,202006,109,77,32,80465.00,33440.00,113905.00
250920,202006,139,102,37,106590.00,38665.00,145255.00
250930,202006,169,101,68,105545.00,71060.00,176605.00
250933,202006,5,3,2,3135.00,2090.00,5225.00
250937,202006,11,10,1,10450.00,1045.00,11495.00
250939,202006,34,25,9,26125.00,9405.00,35530.00
250940,202006,103,77,26,80465.00,27170.00,107635.00
250950,202006,71,49,22,51205.00,22990.00,74195.00
250960,202006,90,50,40,52250.00,41800.00,94050.00
250970,202006,1222,859,363,897655.00,381425.00,1279080.00
250980,202006,106,72,34,75240.00,35530.00,110770.00
250990,202006,162,127,35,132715.00,36575.00,169290.00
251000,202006,75,67,8,70015.00,8360.00,78375.00
251010,202006,117,86,31,89870.00,32395.00,122265.00
251020,202006,74,61,13,63745.00,14630.00,78375.00
251030,202006,47,35,12,36575.00,12540.00,49115.00
251040,202006,57,40,17,41800.00,17765.00,59565.00
251050,202006,25,22,3,22990.00,3135.00,26125.00
251060,202006,51,40,11,41800.00,11495.00,53295.00
251065,202006,4,4,0,4180.00,0.00,4180.00
251070,202006,20,16,4,16720.00,4180.00,20900.00
251080,202006,5022,2406,2616,2516360.75,2739992.14,5256352.89
251090,202006,189,161,28,168245.00,29260.00,197505.00
251100,202006,18,18,0,18810.00,0.00,18810.00
251110,202006,46,37,9,38665.00,9405.00,48070.00
251120,202006,1864,1143,721,1194437.00,755535.20,1949972.20
251130,202006,403,328,75,342760.00,78375.00,421135.00
251140,202006,559,363,196,380380.00,205865.00,586245.00
251150,202006,340,290,50,303050.00,52250.00,355300.00
251160,202006,90,73,17,76285.00,17765.00,94050.00
251170,202006,105,83,22,86735.00,22990.00,109725.00
251180,202006,291,176,115,183920.00,121220.00,305140.00
251190,202006,198,131,67,136895.00,70015.00,206910.00
251200,202006,272,221,51,231990.00,53295.00,285285.00
251203,202006,35,33,2,34485.00,2090.00,36575.00
251207,202006,89,73,16,76285.00,16720.00,93005.00
251210,202006,1484,1082,402,1131735.00,421135.00,1552870.00
251220,202006,49,36,13,37620.00,13585.00,51205.00
251230,202006,590,497,93,520410.00,98230.00,618640.00
251240,202006,96,66,30,68970.00,31350.00,100320.00
251250,202006,1411,1008,403,1054405.75,423225.75,1477631.50
251260,202006,13,7,6,7315.00,6270.00,13585.00
251270,202006,325,246,79,257070.00,82555.00,339625.00
251272,202006,65,59,6,61655.00,6270.00,67925.00
251274,202006,30,23,7,24035.00,7315.00,31350.00
251275,202006,34,20,14,20900.00,14630.00,35530.00
251276,202006,14,11,3,11495.00,3135.00,14630.00
251278,202006,10,8,2,8360.00,2090.00,10450.00
251280,202006,103,98,5,102410.00,5225.00,107635.00
251290,202006,804,586,218,612370.00,227810.00,840180.00
251300,202006,15,12,3,12540.00,3135.00,15675.00
251310,202006,373,270,103,282150.00,107635.00,389785.00
251315,202006,30,27,3,28215.00,3135.00,31350.00
251320,202006,64,50,14,52250.00,14630.00,66880.00
251330,202006,79,70,9,73150.00,9405.00,82555.00
251335,202006,15,10,5,10450.00,5225.00,15675.00
251340,202006,739,437,302,456665.50,315590.00,772255.50
251350,202006,34,33,1,34485.00,1045.00,35530.00
251360,202006,81,71,10,74195.00,10450.00,84645.00
251365,202006,15,15,0,15675.00,0.00,15675.00
251370,202006,5562,3745,1817,3916660.65,1899810.00,5816470.65
251380,202006,45,37,8,38665.00,8360.00,47025.00
251385,202006,3,3,0,3135.00,0.00,3135.00
251390,202006,812,616,196,644765.00,204820.50,849585.50
251392,202006,17,9,8,9405.00,8360.00,17765.00
251394,202006,11,11,0,11495.00,0.00,11495.00
251396,202006,11,7,4,7315.00,4180.00,11495.00
251398,202006,18,16,2,16720.00,2090.00,18810.00
251400,202006,39,33,6,34485.00,6270.00,40755.00
251410,202006,37,31,6,32395.00,6270.00,38665.00
251420,202006,100,71,29,74195.00,30305.00,104500.00
251430,202006,44,39,5,40755.00,5225.00,45980.00
251440,202006,40,24,16,25080.00,16720.00,41800.00
251445,202006,52,47,5,49115.25,5225.00,54340.25
251450,202006,410,357,53,373065.00,55385.00,428450.00
251455,202006,3,2,1,2090.00,1045.00,3135.00
251460,202006,15,13,2,13585.00,2090.00,15675.00
251465,202006,6,3,3,3135.00,3135.00,6270.00
251470,202006,48,39,9,40755.00,9405.00,50160.00
251480,202006,26,21,5,21945.00,5225.00,27170.00
251490,202006,129,84,45,87780.00,47025.50,134805.50
251500,202006,126,103,23,107635.00,24035.00,131670.00
251510,202006,51,32,19,33440.00,19855.00,53295.00
251520,202006,30,29,1,30305.00,1045.00,31350.00
251530,202006,4514,3184,1330,3330415.50,1399255.00,4729670.50
251540,202006,75,63,12,65835.00,12540.00,78375.00
251550,202006,414,315,99,329175.00,103455.75,432630.75
251560,202006,23,15,8,15675.00,8360.00,24035.00
251570,202006,20,19,1,19855.00,1045.00,20900.00
251580,202006,130,103,27,107635.00,28215.00,135850.00
251590,202006,117,86,31,90067.50,32395.00,122462.50
251593,202006,26,16,10,16720.00,10450.00,27170.00
251597,202006,99,75,24,78375.00,25080.00,103455.00
251600,202006,1108,784,324,821370.50,339625.00,1160995.50
251610,202006,241,182,59,190190.00,61655.00,251845.00
251615,202006,8,8,0,8360.00,0.00,8360.00
251620,202006,4272,2787,1485,2913461.60,1551826.50,4465288.10
251630,202006,458,337,121,352165.00,126445.00,478610.00
251640,202006,146,103,43,107635.00,44935.00,152570.00
251650,202006,277,200,77,211090.75,80465.00,291555.75
251660,202006,191,170,21,177650.00,21945.00,199595.00
251670,202006,373,292,81,305140.00,84645.00,389785.00
251675,202006,8,6,2,6270.00,2090.00,8360.00
251680,202006,95,88,7,93005.00,7315.00,100320.00
251690,202006,326,267,59,279015.00,61655.00,340670.00
251700,202006,285,246,39,257070.90,40755.00,297825.90
251710,202006,23,15,8,15675.00,8360.00,24035.00
251720,202006,22,15,7,15675.00,7315.50,22990.50
251740,202006,11,8,3,8360.00,3135.00,11495.00
260005,202006,3279,1787,1492,1868464.21,1559140.50,3427604.71
260010,202006,1635,1183,452,1236235.55,473385.10,1709620.65
260020,202006,418,364,54,380380.00,56430.00,436810.00
260030,202006,613,427,186,448305.00,195415.00,643720.00
260040,202006,816,502,314,524590.00,329175.00,853765.00
260050,202006,1168,836,332,873620.00,346941.00,1220561.00
260060,202006,382,348,34,363660.00,35530.00,399190.00
260070,202006,1378,857,521,897655.50,544445.30,1442100.80
260080,202006,738,567,171,593560.00,178695.00,772255.00
260090,202006,499,327,172,343805.00,180785.00,524590.00
260100,202006,214,149,65,156750.00,67925.00,224675.00
260105,202006,236,127,109,132715.00,113905.00,246620.00
260110,202006,2881,2111,770,2205996.00,806740.50,3012736.50
260120,202006,2846,1453,1393,1519572.80,1457775.75,2977348.55
260130,202006,167,112,55,117040.00,57475.00,174515.00
260140,202006,2137,1389,748,1455686.80,784795.00,2240481.80
260150,202006,214,137,77,143165.00,80465.00,223630.00
260160,202006,328,271,57,284240.00,59565.00,343805.00
260170,202006,3402,2045,1357,2142251.45,1419110.50,3561361.95
260180,202006,158,127,31,132715.00,32395.00,165110.00
260190,202006,2334,1585,749,1659460.00,782705.00,2442165.00
260200,202006,973,780,193,815100.29,201685.50,1016785.79
260210,202006,1434,1022,412,1070080.00,432630.00,1502710.00
260220,202006,695,622,73,651035.50,76285.00,727320.50
260230,202006,1218,916,302,957220.00,316635.00,1273855.00
260240,202006,219,164,55,171380.00,57475.00,228855.00
260250,202006,94,70,24,73150.00,26125.00,99275.00
260260,202006,1055,740,315,773300.00,331265.00,1104565.00
260270,202006,418,327,91,343805.00,97185.00,440990.00
260280,202006,1301,919,382,960355.50,401280.50,1361636.00
260290,202006,6566,3543,3023,3707662.00,3173667.46,6881329.46
260300,202006,952,821,131,857945.50,136895.00,994840.50
260310,202006,517,409,108,427405.00,112860.00,540265.00
260320,202006,873,639,234,668800.00,245575.00,914375.00
260330,202006,62,44,18,45980.00,18810.00,64790.00
260340,202006,78,56,22,58520.00,22990.00,81510.00
260345,202006,5543,3032,2511,3170531.43,2630265.00,5800796.43
260350,202006,496,353,143,368885.50,149435.00,518320.50
260360,202006,254,140,114,146300.00,120175.00,266475.00
260370,202006,729,472,257,493240.25,268565.00,761805.25
260380,202006,591,433,158,452485.00,165110.47,617595.47
260390,202006,291,245,46,256025.00,49115.00,305140.00
260392,202006,110,95,15,100320.00,15675.00,115995.00
260400,202006,4173,2376,1797,2483966.22,1881000.50,4364966.72
260410,202006,14899,7786,7113,8144732.22,7452941.42,15597673.64
260415,202006,140,122,18,127490.00,18810.00,146300.00
260420,202006,1732,1057,675,1105611.77,708510.00,1814121.77
260430,202006,188,173,15,180785.35,15675.00,196460.35
260440,202006,202,145,57,152570.00,59565.00,212135.00
260450,202006,427,316,111,330220.96,117040.00,447260.96
260460,202006,820,433,387,452485.55,404415.00,856900.55
260470,202006,347,213,134,223630.00,140030.50,363660.50
260480,202006,238,154,84,160930.00,87780.00,248710.00
260490,202006,216,178,38,186010.00,39710.00,225720.00
260500,202006,1123,754,369,790020.00,385605.00,1175625.00
260510,202006,780,619,161,647900.00,168245.00,816145.00
260515,202006,243,218,25,227810.00,26125.00,253935.00
260520,202006,3269,2006,1263,2099405.00,1328195.95,3427600.95
260530,202006,797,659,138,688655.00,144210.00,832865.00
260540,202006,559,436,123,455620.00,128535.00,584155.00
260545,202006,14,10,4,10450.00,4180.00,14630.00
260550,202006,329,205,124,214225.00,129580.00,343805.00
260560,202006,523,394,129,412775.50,134805.00,547580.50
260570,202006,981,797,184,833910.00,192280.00,1026190.00
260580,202006,243,212,31,221540.00,32395.00,253935.00
260590,202006,647,373,274,389785.00,286330.50,676115.50
260600,202006,8078,4353,3725,4554112.84,3896806.00,8450918.84
260610,202006,486,324,162,338580.00,170335.00,508915.00
260620,202006,3695,1922,1773,2012671.65,1855920.85,3868592.50
260630,202006,87,81,6,84645.00,6270.00,90915.00
260640,202006,3559,1975,1584,2067010.80,1660505.00,3727515.80
260650,202006,330,241,89,251845.00,93005.00,344850.00
260660,202006,556,368,188,385605.00,196460.00,582065.00
260670,202006,106,78,28,81510.00,29260.00,110770.00
260680,202006,3724,2073,1651,2166285.22,1726340.50,3892625.72
260690,202006,129,93,36,97185.00,37620.00,134805.00
260700,202006,311,206,105,216315.00,109725.00,326040.00
260710,202006,44,37,7,38665.00,7315.00,45980.00
260720,202006,2430,1443,987,1511071.00,1032460.00,2543531.00
260730,202006,703,527,176,550715.00,184965.00,735680.00
260740,202006,62,57,5,59565.00,5225.00,64790.00
260750,202006,594,424,170,443080.00,177650.00,620730.00
260760,202006,667,343,324,358435.23,338580.00,697015.23
260765,202006,976,499,477,522500.00,500555.00,1023055.00
260770,202006,223,164,59,171362.00,61655.50,233017.50
260775,202006,794,444,350,463981.25,365750.00,829731.25
260780,202006,254,165,89,173470.00,93005.00,266475.00
260790,202006,13112,6772,6340,7081969.82,6638887.28,13720857.10
260795,202006,166,109,57,113905.00,59565.00,173470.00
260800,202006,288,240,48,250800.50,50160.00,300960.50
260805,202006,171,113,58,118085.00,60610.00,178695.00
260810,202006,749,649,100,679250.00,104500.00,783750.00
260820,202006,292,188,104,196460.85,108680.00,305140.85
260825,202006,209,149,60,155705.00,62700.00,218405.00
260830,202006,296,189,107,197505.00,111815.00,309320.00
260840,202006,243,177,66,184965.00,68970.00,253935.00
260845,202006,175,119,56,124355.00,58520.00,182875.00
260850,202006,449,327,122,343805.00,127490.00,471295.00
260860,202006,252,188,64,196460.00,66880.00,263340.00
260870,202006,371,278,93,290510.29,98230.00,388740.29
260875,202006,736,524,212,547580.00,222585.00,770165.00
260880,202006,1599,1015,584,1061720.50,611325.00,1673045.50
260890,202006,2383,1681,702,1757691.00,734635.00,2492326.00
260900,202006,991,705,286,736725.00,300960.00,1037685.00
260910,202006,256,204,52,213180.00,54340.00,267520.00
260915,202006,292,212,80,221540.00,83600.00,305140.00
260920,202006,179,95,84,99275.00,87780.00,187055.00
260930,202006,403,344,59,359480.00,61655.00,421135.00
260940,202006,2719,1467,1252,1534061.40,1310431.00,2844492.40
260950,202006,2027,1168,859,1223695.75,898700.00,2122395.75
260960,202006,13805,6984,6821,7307692.60,7145712.45,14453405.05
260970,202006,424,354,70,369930.00,73150.00,443080.00
260980,202006,194,174,20,181830.00,20900.00,202730.00
260990,202006,2617,2118,499,2214356.35,522500.00,2736856.35
261000,202006,4306,2583,1723,2702370.75,1803670.00,4506040.75
261010,202006,166,125,41,130625.00,42845.00,173470.00
261020,202006,610,458,152,478610.99,159885.00,638495.99
261030,202006,249,181,68,189145.00,71060.00,260205.00
261040,202006,374,326,48,340670.00,50160.00,390830.00
261050,202006,509,439,70,458755.00,73150.00,531905.00
261060,202006,1406,904,502,946770.25,525635.00,1472405.25
261070,202006,8804,4346,4458,4548888.15,4664882.87,9213771.02
261080,202006,378,291,87,305140.00,90915.00,396055.00
261090,202006,2193,1682,511,1758739.70,533995.83,2292735.53
261100,202006,1154,808,346,844360.75,361570.00,1205930.75
261110,202006,8643,5289,3354,5532230.80,3512246.00,9044476.80
261120,202006,259,222,37,231990.00,38665.00,270655.00
261130,202006,574,340,234,356345.00,245575.55,601920.55
261140,202006,200,125,75,130625.00,78375.00,209000.00
261150,202006,681,420,261,439945.03,274835.00,714780.03
261153,202006,67,62,5,64790.00,5225.00,70015.00
261160,202006,76151,37814,38337,39564793.88,40133232.11,79698025.99
261170,202006,479,360,119,376200.00,124355.00,500555.00
261180,202006,1805,1126,679,1176670.00,710600.00,1887270.00
261190,202006,634,441,193,460845.90,201685.00,662530.90
261200,202006,219,188,31,196460.00,32395.00,228855.00
261210,202006,32,26,6,27170.00,6270.00,33440.00
261220,202006,2697,1895,802,1981321.12,839135.00,2820456.12
261230,202006,346,257,89,268565.00,93005.00,361570.00
261240,202006,461,403,58,421135.00,60610.00,481745.00
261245,202006,233,193,40,201685.00,41800.00,243485.00
261247,202006,171,135,36,141075.00,37620.00,178695.00
261250,202006,3128,1534,1594,1605120.75,1668865.00,3273985.75
261255,202006,250,225,25,235125.00,26125.00,261250.00
261260,202006,855,744,111,777480.06,115995.00,893475.06
261270,202006,203,144,59,151525.00,61655.00,213180.00
261280,202006,177,145,32,151525.00,33440.00,184965.00
261290,202006,117,85,32,88825.00,33440.00,122265.00
261300,202006,1290,939,351,987525.00,370975.50,1358500.50
261310,202006,812,546,266,571615.00,279015.00,850630.00
261320,202006,554,376,178,392920.00,186010.00,578930.00
261330,202006,971,745,226,778525.00,237215.29,1015740.29
261340,202006,298,165,133,172425.00,138985.00,311410.00
261350,202006,854,605,249,632225.50,260205.00,892430.50
261360,202006,1295,844,451,883025.00,471295.00,1354320.00
261370,202006,4836,2888,1948,3023186.50,2038796.00,5061982.50
261380,202006,550,418,132,436810.69,138985.50,575796.19
261390,202006,3610,2425,1185,2539351.00,1239370.75,3778721.75
261400,202006,295,269,26,281105.00,27170.00,308275.00
261410,202006,1107,731,376,764940.00,392920.00,1157860.00
261420,202006,880,542,338,569525.55,353210.00,922735.55
261430,202006,331,298,33,311410.00,34485.00,345895.00
261440,202006,118,109,9,113905.00,9405.00,123310.00
261450,202006,2542,2053,489,2147476.25,511005.50,2658481.75
261460,202006,722,576,146,604010.85,153615.00,757625.85
261470,202006,248,198,50,206910.41,52250.00,259160.41
261480,202006,444,344,100,359480.00,104453.00,463933.00
261485,202006,350,210,140,219450.00,146300.00,365750.00
261500,202006,600,407,193,425315.00,201685.00,627000.00
261510,202006,48,32,16,33440.00,16720.00,50160.00
261520,202006,111,100,11,105545.00,11495.00,117040.00
261530,202006,4145,2630,1515,2750441.23,1587355.75,4337796.98
261540,202006,1353,796,557,832865.00,582065.00,1414930.00
261550,202006,272,138,134,145255.50,140030.00,285285.50
261560,202006,859,563,296,588336.75,309320.50,897657.25
261570,202006,398,311,87,324995.00,90915.00,415910.00
261580,202006,377,295,82,308275.00,85690.00,393965.00
261590,202006,190,153,37,159885.00,38665.00,198550.00
261600,202006,292,232,60,243485.00,62700.50,306185.50
261610,202006,90,77,13,80465.00,13585.00,94050.00
261618,202006,75,61,14,63745.00,14630.00,78375.00
261620,202006,206,128,78,133760.00,81510.00,215270.00
261630,202006,551,430,121,451440.00,127490.00,578930.00
261640,202006,6415,3389,3026,3547778.09,3167395.75,6715173.84
261650,202006,485,309,176,324995.00,183920.00,508915.00
270010,202006,524,464,60,484880.00,62700.00,547580.00
270020,202006,287,232,55,242440.00,57475.00,299915.00
270030,202006,8902,5749,3153,6015336.77,3305335.50,9320672.27
270040,202006,2007,1258,749,1314610.00,783750.00,2098360.00
270050,202006,152,116,36,121220.00,37620.00,158840.00
270060,202006,112,62,50,65835.00,52250.00,118085.00
270070,202006,874,641,233,669845.00,243485.00,913330.00
270080,202006,35,30,5,31350.00,5225.00,36575.00
270090,202006,20,15,5,15675.00,5225.00,20900.00
270100,202006,1239,825,414,862125.00,434720.00,1296845.00
270110,202006,124,96,28,100320.00,29260.00,129580.00
270120,202006,232,191,41,199595.00,42845.00,242440.00
270130,202006,252,172,80,179740.00,83600.00,263340.00
270135,202006,119,75,44,78375.00,45980.00,124355.00
270140,202006,1370,866,504,904970.50,526680.00,1431650.50
270150,202006,256,203,53,212135.00,55385.00,267520.00
270160,202006,504,398,106,415910.00,110770.00,526680.00
270170,202006,797,521,276,544445.00,288420.00,832865.00
270180,202006,71,55,16,57475.00,16720.00,74195.00
270190,202006,90,77,13,81510.00,13585.00,95095.00
270200,202006,105,92,13,96140.00,13585.00,109725.00
270210,202006,508,286,222,298870.00,231990.50,530860.50
270220,202006,177,141,36,147345.00,37620.00,184965.00
270230,202006,2100,1285,815,1346414.43,852720.00,2199134.43
270235,202006,709,554,155,578930.00,163020.00,741950.00
270240,202006,3056,2422,634,2530991.42,663575.85,3194567.27
270250,202006,157,115,42,120175.00,44935.00,165110.00
270255,202006,214,182,32,190190.00,33440.00,223630.00
270260,202006,368,298,70,312455.00,73150.00,385605.00
270270,202006,95,42,53,44935.00,55385.00,100320.00
270280,202006,239,132,107,138985.00,111815.00,250800.00
270290,202006,1169,894,275,934230.00,287375.00,1221605.00
270300,202006,318,221,97,230945.00,102410.00,333355.00
270310,202006,856,699,157,731500.00,165110.00,896610.00
270320,202006,829,708,121,741950.79,128535.00,870485.79
270330,202006,294,248,46,259160.00,48070.00,307230.00
270340,202006,60,47,13,49115.00,13585.00,62700.00
270350,202006,90,48,42,50160.00,43890.00,94050.00
270360,202006,66,37,29,38665.00,30305.00,68970.00
270370,202006,53,44,9,45980.00,9405.00,55385.00
270375,202006,71,44,27,45980.00,28215.00,74195.00
270380,202006,1007,638,369,666710.00,387695.00,1054405.00
270390,202006,192,115,77,120175.00,80465.00,200640.00
270400,202006,704,523,181,546535.79,190190.00,736725.79
270410,202006,654,481,173,503690.00,181830.00,685520.00
270420,202006,408,283,125,295735.00,130625.00,426360.00
270430,202006,32851,23591,9260,24684617.37,9701782.90,34386400.27
270440,202006,484,383,101,400687.83,105545.00,506232.83
270450,202006,789,443,346,463980.00,363660.00,827640.00
270460,202006,192,152,40,158840.00,41800.00,200640.00
270470,202006,1456,1008,448,1056320.83,468160.00,1524480.83
270480,202006,548,452,96,473385.50,100320.00,573705.50
270490,202006,24,19,5,19855.00,5225.00,25080.00
270500,202006,491,410,81,428450.00,84645.00,513095.00
270510,202006,802,494,308,518250.33,322905.00,841155.33
270520,202006,293,190,103,199595.00,107635.00,307230.00
270530,202006,67,58,9,60610.00,9405.00,70015.00
270540,202006,108,85,23,88825.00,24035.00,112860.00
270550,202006,1754,1343,411,1405525.00,430540.00,1836065.00
270560,202006,263,142,121,149435.00,127490.00,276925.00
270570,202006,516,362,154,378290.00,160930.00,539220.00
270580,202006,95,71,24,74195.00,25080.00,99275.00
270590,202006,71,56,15,58520.00,15675.00,74195.00
270600,202006,175,146,29,152570.00,30305.00,182875.00
270610,202006,227,176,51,183920.00,53295.00,237215.00
270620,202006,28,27,1,28215.00,1045.00,29260.00
270630,202006,3765,2860,905,2989502.16,946770.50,3936272.66
270640,202006,875,650,225,680295.00,235125.00,915420.00
270642,202006,223,189,34,197505.00,35530.00,233035.00
270644,202006,252,163,89,170335.00,93005.00,263340.00
270650,202006,326,192,134,201685.00,140030.00,341715.00
270660,202006,248,205,43,214225.00,45980.00,260205.00
270670,202006,3053,2329,724,2437988.55,757625.00,3195613.55
270680,202006,444,263,181,274835.00,189145.00,463980.00
270690,202006,1167,760,407,795245.70,425315.00,1220560.70
270700,202006,28,23,5,24035.00,5225.00,29260.00
270710,202006,879,680,199,710600.00,210045.00,920645.00
270720,202006,243,192,51,201267.00,53295.00,254562.00
270730,202006,1857,1116,741,1168310.50,776435.25,1944745.75
270740,202006,41,28,13,29260.00,13585.00,42845.00
270750,202006,638,480,158,501600.00,166155.00,667755.00
270760,202006,293,212,81,222585.00,84645.00,307230.00
270770,202006,2756,1823,933,1907126.55,976030.00,2883156.55
270780,202006,76,47,29,49637.50,30305.00,79942.50
270790,202006,271,178,93,186010.00,97185.00,283195.00
270800,202006,1971,1590,381,1661933.16,400235.00,2062168.16
270810,202006,279,220,59,230945.00,61655.00,292600.00
270820,202006,143,96,47,100320.00,49115.50,149435.50
270830,202006,791,590,201,616550.00,211090.00,827640.00
270840,202006,1385,1050,335,1097250.00,350075.85,1447325.85
270850,202006,1509,944,565,988570.50,591470.00,1580040.50
270860,202006,2534,1676,858,1751420.46,896610.00,2648030.46
270870,202006,122,64,58,66880.00,60610.00,127490.00
270880,202006,902,700,202,732545.00,211090.00,943635.00
270890,202006,290,216,74,225720.00,77330.00,303050.00
270895,202006,63,54,9,56430.00,9405.00,65835.00
270900,202006,92,71,21,74195.00,21945.00,96140.00
270910,202006,303,247,56,259160.00,58520.00,317680.00
270915,202006,1914,1214,700,1271487.08,733590.60,2005077.68
270920,202006,469,394,75,412775.00,78375.00,491150.00
270930,202006,5930,4444,1486,4645025.00,1553915.03,6198940.03
270940,202006,2314,1805,509,1887270.00,532950.00,2420220.00
280010,202006,40,34,6,35530.00,6270.00,41800.00
280020,202006,474,409,65,427405.45,67925.00,495330.45
280030,202006,20539,13281,7258,13898527.27,7598201.99,21496729.26
280040,202006,329,215,114,224675.00,119130.00,343805.00
280050,202006,399,306,93,319770.00,98230.00,418000.00
280060,202006,352,223,129,233035.70,134805.00,367840.70
280067,202006,1062,760,302,794200.00,315590.62,1109790.62
280070,202006,123,99,24,103455.00,25080.00,128535.00
280100,202006,628,489,139,512050.50,145255.00,657305.50
280110,202006,76,71,5,74195.00,5225.00,79420.00
280120,202006,655,534,121,559075.00,126445.00,685520.00
280130,202006,1718,1124,594,1174580.00,622820.50,1797400.50
280140,202006,479,391,88,409640.50,91960.00,501600.50
280150,202006,395,286,109,298870.00,114950.00,413820.00
280160,202006,106,88,18,91960.00,18810.00,110770.00
280170,202006,399,276,123,289465.25,129580.00,419045.25
280190,202006,31,28,3,29260.00,3135.00,32395.00
280200,202006,29,25,4,26125.00,4180.00,30305.00
280210,202006,2945,2113,832,2207962.36,870485.50,3078447.86
280220,202006,39,31,8,32395.00,8360.00,40755.00
280230,202006,329,271,58,283195.00,61655.00,344850.00
280240,202006,117,111,6,115995.00,6270.00,122265.00
280250,202006,16,10,6,10450.00,6270.00,16720.00
280260,202006,82,74,8,77330.00,8360.00,85690.00
280270,202006,147,115,32,120175.00,33440.00,153615.00
280280,202006,190,121,69,126445.37,73150.00,199595.37
280290,202006,3347,2423,924,2535104.16,966625.10,3501729.26
280300,202006,1605,1250,355,1307295.50,372020.00,1679315.50
280310,202006,102,96,6,100320.50,6270.00,106590.50
280320,202006,664,468,196,490105.00,205865.00,695970.00
280330,202006,324,234,90,244530.00,96140.00,340670.00
280340,202006,406,330,76,345895.50,80465.00,426360.50
280350,202006,3668,2857,811,2985566.76,847495.75,3833062.51
280360,202006,462,304,158,317680.00,166155.00,483835.00
280370,202006,97,85,12,88825.65,12540.00,101365.65
280380,202006,54,42,12,43890.00,12540.00,56430.00
280390,202006,171,148,23,154660.00,24035.00,178695.00
280400,202006,359,246,113,257071.40,118085.00,375156.40
280410,202006,286,234,52,244530.00,56430.00,300960.00
280420,202006,171,143,28,149435.00,29260.00,178695.00
280430,202006,38,29,9,30305.00,9405.00,39710.00
280440,202006,695,545,150,569525.65,156750.00,726275.65
280445,202006,117,108,9,112860.00,9405.00,122265.00
280450,202006,1196,1034,162,1081575.00,169290.00,1250865.00
280460,202006,618,449,169,469206.63,177650.00,646856.63
280470,202006,185,172,13,179740.00,13585.75,193325.75
280480,202006,2646,1849,797,1936388.21,836000.32,2772388.53
280490,202006,264,251,13,263340.66,13585.00,276925.66
280500,202006,42,38,4,39710.00,4180.00,43890.00
280510,202006,140,114,26,120175.00,27170.50,147345.50
280520,202006,53,39,14,40755.00,14630.00,55385.00
280530,202006,76,50,26,52250.00,27170.00,79420.00
280540,202006,534,445,89,465025.00,93005.00,558030.00
280550,202006,730,676,54,706421.71,56430.00,762851.71
280560,202006,499,440,59,459800.00,61655.00,521455.00
280570,202006,2223,1739,484,1818300.95,505780.00,2324080.95
280580,202006,598,459,139,479655.00,145255.50,624910.50
280590,202006,210,132,78,137940.00,82555.00,220495.00
280600,202006,386,323,63,337535.00,67925.00,405460.00
280610,202006,114,88,26,91960.00,27170.00,119130.00
280620,202006,557,458,99,478610.00,103455.00,582065.00
280630,202006,152,127,25,132715.00,26125.00,158840.00
280640,202006,195,154,41,160930.00,42845.00,203775.00
280650,202006,89,60,29,62700.00,30305.00,93005.00
280660,202006,143,108,35,112860.00,36575.00,149435.00
280670,202006,1841,1159,682,1213249.23,714780.88,1928030.11
280680,202006,181,157,24,164065.22,25080.00,189145.22
280690,202006,80,71,9,74195.00,9405.00,83600.00
280700,202006,22,22,0,22990.00,0.00,22990.00
280710,202006,1471,1133,338,1183985.00,354255.00,1538240.00
280720,202006,113,73,40,76285.00,41800.00,118085.00
280730,202006,25,20,5,20900.00,5225.00,26125.00
280740,202006,2528,1886,642,1971915.50,671935.00,2643850.50
280750,202006,233,204,29,213180.00,30305.00,243485.00
280760,202006,777,533,244,556985.00,254980.00,811965.00
290010,202006,205,142,63,148390.00,65835.00,214225.00
290020,202006,181,164,17,171380.00,17765.00,189145.00
290030,202006,624,401,223,420090.00,236170.00,656260.00
290035,202006,130,105,25,109725.00,26125.00,135850.00
290040,202006,305,205,100,214225.00,104500.00,318725.00
290050,202006,87,67,20,70015.00,20900.00,90915.00
290060,202006,270,119,151,124355.00,157795.00,282150.00
290070,202006,5766,2790,2976,2917641.60,3120370.75,6038012.35
290080,202006,461,210,251,219450.00,263340.00,482790.00
290090,202006,388,176,212,183920.00,221540.00,405460.00
290100,202006,1657,1074,583,1123375.00,610281.00,1733656.00
290110,202006,829,480,349,503690.75,364705.00,868395.75
290115,202006,195,180,15,188100.00,15675.00,203775.00
290120,202006,761,501,260,524590.00,271700.00,796290.00
290130,202006,431,265,166,276925.00,173470.00,450395.00
290135,202006,301,228,73,238260.00,76285.00,314545.00
290140,202006,320,265,55,276925.00,57475.00,334400.00
290150,202006,139,100,39,104500.00,41800.00,146300.00
290160,202006,243,186,57,194370.00,59565.00,253935.00
290170,202006,94,67,27,70015.00,28215.00,98230.00
290180,202006,179,130,49,135850.00,51205.00,187055.00
290190,202006,439,361,78,377245.00,81510.00,458755.00
290195,202006,319,204,115,213180.00,120175.00,333355.00
290200,202006,274,222,52,231990.00,54340.00,286330.00
290205,202006,152,92,60,96140.00,62700.00,158840.00
290210,202006,1176,863,313,901835.50,327085.00,1228920.50
290220,202006,223,123,100,128535.00,104500.00,233035.00
290225,202006,292,114,178,119130.00,186010.00,305140.00
290230,202006,75,49,26,51205.00,27170.00,78375.00
290240,202006,360,134,226,140030.00,236170.00,376200.00
290250,202006,254,234,20,244530.00,20900.00,265430.00
290260,202006,323,266,57,277970.50,59565.00,337535.50
290265,202006,187,162,25,169290.00,26125.00,195415.00
290270,202006,1422,1180,242,1234145.00,252890.50,1487035.50
290280,202006,481,340,141,355300.00,147345.00,502645.00
290290,202006,1333,798,535,833911.03,559075.50,1392986.53
290300,202006,439,373,66,389785.50,68970.00,458755.50
290310,202006,298,136,162,142120.00,169290.00,311410.00
290320,202006,4039,2499,1540,2612500.30,1614525.10,4227025.40
290323,202006,190,165,25,172425.00,26125.00,198550.00
290327,202006,168,133,35,138985.00,36575.00,175560.00
290330,202006,105,56,49,59565.00,51205.00,110770.00
290340,202006,835,343,492,358435.00,515185.00,873620.00
290350,202006,629,382,247,399190.00,258115.00,657305.00
290360,202006,353,270,83,282151.64,86735.00,368886.64
290370,202006,922,394,528,411730.75,551760.00,963490.75
290380,202006,320,199,121,207955.00,126445.00,334400.00
290390,202006,2447,1527,920,1595716.75,962445.00,2558161.75
290395,202006,249,143,106,149435.25,110770.00,260205.25
290400,202006,273,203,70,212135.50,74195.00,286330.50
290405,202006,250,217,33,226765.00,34485.00,261250.00
290410,202006,630,528,102,551760.53,107635.00,659395.53
290420,202006,253,203,50,213180.00,52250.00,265430.00
290430,202006,480,309,171,323950.00,178695.00,502645.00
290440,202006,75,67,8,70015.00,8360.00,78375.00
290450,202006,209,159,50,166155.00,52250.00,218405.00
290460,202006,1962,1188,774,1242505.00,808830.00,2051335.00
290470,202006,1401,603,798,631180.00,834955.00,1466135.00
290475,202006,561,523,38,546535.20,39710.00,586245.20
290480,202006,291,165,126,172425.00,131670.00,304095.00
290485,202006,240,222,18,231990.00,18810.00,250800.00
290490,202006,1212,873,339,914375.00,354255.00,1268630.00
290500,202006,740,381,359,398145.00,375155.00,773300.00
290510,202006,226,176,50,183920.00,52250.00,236170.00
290515,202006,152,93,59,97185.00,61655.00,158840.00
290520,202006,1429,942,487,985435.00,508916.44,1494351.44
290530,202006,300,277,23,289465.00,24035.00,313500.00
290540,202006,107,56,51,58520.00,53295.00,111815.00
290550,202006,161,136,25,142120.00,26125.00,168245.00
290560,202006,3221,1366,1855,1427470.00,1939520.00,3366990.00
290570,202006,6211,3007,3204,3146496.40,3353407.00,6499903.40
290580,202006,1294,770,524,804650.00,548625.00,1353275.00
290590,202006,571,472,99,493240.00,103455.00,596695.00
290600,202006,1780,1227,553,1282215.63,578930.00,1861145.63
290610,202006,208,187,21,195415.00,21945.00,217360.00
290620,202006,356,319,37,333355.00,38665.00,372020.00
290630,202006,2038,858,1180,896610.00,1233100.50,2129710.50
290640,202006,152,122,30,127490.00,31350.00,158840.00
290650,202006,1797,827,970,864215.84,1014695.00,1878910.84
290660,202006,280,226,54,236170.00,56430.00,292600.00
290670,202006,949,489,460,511006.71,480700.00,991706.71
290680,202006,1236,992,244,1036640.00,254980.00,1291620.00
290682,202006,307,231,76,241395.80,79420.00,320815.80
290685,202006,238,155,83,161975.00,86735.00,248710.00
290687,202006,1051,678,373,708680.10,389785.00,1098465.10
290689,202006,146,80,66,83600.00,68970.00,152570.00
290690,202006,615,255,360,266475.00,376200.00,642675.00
290700,202006,251,125,126,130625.00,131670.00,262295.00
290710,202006,749,511,238,533995.00,248710.00,782705.00
290720,202006,1030,835,195,872575.00,203775.00,1076350.00
290730,202006,1157,667,490,697015.75,513095.00,1210110.75
290740,202006,17,14,3,14630.00,3135.00,17765.00
290750,202006,1429,630,799,658350.00,836001.54,1494351.54
290755,202006,71,64,7,66880.00,7315.00,74195.00
290760,202006,297,257,40,268565.00,41800.00,310365.00
290770,202006,188,177,11,184965.00,11495.00,196460.00
290780,202006,1105,845,260,884071.00,271700.00,1155771.00
290790,202006,365,257,108,268565.00,112860.50,381425.50
290800,202006,2507,1012,1495,1057540.50,1565410.00,2622950.50
290810,202006,464,320,144,334400.00,150480.00,484880.00
290820,202006,399,233,166,243485.00,173470.00,416955.00
290830,202006,421,297,124,310365.00,129580.00,439945.00
290840,202006,1759,1092,667,1143231.70,698060.50,1841292.20
290850,202006,833,446,387,466070.00,405460.00,871530.00
290860,202006,655,295,360,308275.00,376200.50,684475.50
290870,202006,641,452,189,472340.60,197505.60,669846.20
290880,202006,122,66,56,68970.00,58520.00,127490.00
290890,202006,391,264,127,275880.00,132715.00,408595.00
290900,202006,167,127,40,132715.00,41800.00,174515.00
290910,202006,385,294,91,307230.00,96140.00,403370.00
290920,202006,215,185,30,193325.00,31350.00,224675.00
290930,202006,825,625,200,653125.50,209000.00,862125.50
290940,202006,248,206,42,215270.00,43890.00,259160.00
290950,202006,156,96,60,100320.00,62700.00,163020.00
290960,202006,475,333,142,347985.00,148390.00,496375.00
290970,202006,251,219,32,228855.00,33440.00,262295.00
290980,202006,1630,1148,482,1200705.70,504736.00,1705441.70
290990,202006,394,332,62,346940.00,64790.00,411730.00
291000,202006,869,255,614,266475.00,641630.00,908105.00
291005,202006,2327,1027,1300,1074260.00,1363725.00,2437985.00
291010,202006,162,144,18,150480.00,18810.00,169290.00
291020,202006,102,81,21,84645.00,21945.00,106590.00
291030,202006,97,71,26,74195.00,27170.00,101365.00
291040,202006,611,339,272,354255.00,284240.00,638495.00
291050,202006,1439,790,649,825550.00,679250.00,1504800.00
291060,202006,1543,851,692,889295.00,724185.00,1613480.00
291070,202006,1964,1460,504,1525701.00,526680.12,2052381.12
291072,202006,7278,2703,4575,2824636.10,4789237.50,7613873.60
291075,202006,241,194,47,202730.00,49115.00,251845.00
291077,202006,58,40,18,41800.00,18810.00,60610.00
291080,202006,20371,8926,11445,9350663.06,12032131.77,21382794.83
291085,202006,299,245,54,256025.00,56430.00,312455.00
291090,202006,305,126,179,131670.50,187055.00,318725.50
291100,202006,665,201,464,211090.00,484880.00,695970.00
291110,202006,421,320,101,334400.00,105545.00,439945.00
291120,202006,2447,1213,1234,1267585.75,1292665.00,2560250.75
291125,202006,63,30,33,31350.00,34485.00,65835.00
291130,202006,203,180,23,188100.00,24035.00,212135.00
291140,202006,136,110,26,114950.00,28215.50,143165.50
291150,202006,390,150,240,156750.00,250800.00,407550.00
291160,202006,387,316,71,330220.25,74195.00,404415.25
291165,202006,39,31,8,32395.00,8360.00,40755.00
291170,202006,3146,1577,1569,1649012.92,1642740.50,3291753.42
291180,202006,1274,505,769,528770.31,804650.00,1333420.31
291185,202006,92,87,5,90915.00,5225.00,96140.00
291190,202006,1381,622,759,649990.25,796290.00,1446280.25
291200,202006,170,126,44,131670.00,45980.00,177650.00
291210,202006,2299,923,1376,964535.20,1438965.50,2403500.70
291220,202006,273,206,67,216315.00,70015.00,286330.00
291230,202006,990,341,649,356345.50,680295.00,1036640.50
291240,202006,429,402,27,421135.50,28215.00,449350.50
291250,202006,442,356,86,372020.00,89870.00,461890.00
291260,202006,58,47,11,49115.00,11495.00,60610.00
291270,202006,1167,486,681,507870.00,711645.00,1219515.00
291280,202006,360,171,189,178695.00,199595.00,378290.00
291290,202006,1743,902,841,943635.50,879891.00,1823526.50
291300,202006,232,184,48,192280.00,51205.00,243485.00
291310,202006,219,199,20,207955.00,20900.00,228855.00
291320,202006,1370,966,404,1010515.00,424270.00,1434785.00
291330,202006,132,113,19,118085.00,19855.00,137940.00
291340,202006,204,117,87,122265.00,90915.00,213180.00
291345,202006,133,93,40,97185.00,41800.00,138985.00
291350,202006,1654,578,1076,604010.00,1124420.75,1728430.75
291360,202006,8487,4099,4388,4287636.25,4593821.25,8881457.50
291370,202006,1129,650,479,680295.50,500555.00,1180850.50
291380,202006,267,212,55,221540.00,58520.00,280060.00
291390,202006,3921,1724,2197,1802626.40,2302135.87,4104762.27
291400,202006,2101,1493,608,1561230.00,635360.84,2196590.84
291410,202006,187,165,22,172425.00,22990.00,195415.00
291420,202006,120,87,33,90915.00,34485.00,125400.00
291430,202006,165,90,75,94050.00,78375.02,172425.02
291440,202006,523,428,95,447261.00,99275.00,546536.00
291450,202006,911,585,326,611325.25,341715.00,953040.25
291460,202006,1849,1507,342,1575861.00,357390.50,1933251.50
291465,202006,2185,1034,1151,1081575.50,1203840.00,2285415.50
291470,202006,2881,1451,1430,1516295.97,1495395.50,3011691.47
291480,202006,11911,5261,6650,5509245.56,6962839.21,12472084.77
291490,202006,612,244,368,254980.00,384560.00,639540.00
291500,202006,379,221,158,230945.00,165110.00,396055.00
291510,202006,1230,478,752,499510.00,785840.00,1285350.00
291520,202006,949,429,520,448305.00,546535.00,994840.00
291530,202006,940,254,686,265430.00,717915.00,983345.00
291535,202006,125,102,23,106590.00,24035.00,130625.00
291540,202006,345,102,243,106590.50,253935.00,360525.50
291550,202006,1233,581,652,607145.00,683430.50,1290575.50
291560,202006,5302,2667,2635,2794330.00,2758801.00,5553131.00
291570,202006,199,104,95,108680.00,99275.00,207955.00
291580,202006,1220,752,468,786885.40,491150.00,1278035.40
291590,202006,88,37,51,38665.00,53295.50,91960.50
291600,202006,1163,571,592,596695.75,618640.00,1215335.75
291610,202006,1463,706,757,737770.00,792110.00,1529880.00
291620,202006,572,263,309,275880.00,324995.00,600875.00
291630,202006,488,149,339,155705.00,354255.00,509960.00
291640,202006,4025,2052,1973,2144342.20,2061786.50,4206128.70
291650,202006,423,289,134,302006.12,140030.00,442036.12
291660,202006,398,162,236,169290.29,246620.00,415910.29
291670,202006,224,135,89,141075.00,93005.00,234080.00
291680,202006,666,396,270,413820.00,282150.50,695970.50
291685,202006,589,328,261,342760.00,272745.00,615505.00
291690,202006,538,322,216,337535.00,225720.27,563255.27
291700,202006,978,760,218,795245.00,227810.00,1023055.00
291710,202006,1654,793,861,828685.25,900790.00,1729475.25
291720,202006,426,285,141,297825.00,147345.00,445170.00
291730,202006,944,557,387,582065.00,404415.00,986480.00
291733,202006,287,194,93,203775.00,97185.00,300960.00
291735,202006,76,57,19,59565.00,19855.00,79420.00
291740,202006,357,275,82,287375.00,86735.00,374110.00
291750,202006,2162,1405,757,1469270.38,791065.00,2260335.38
291760,202006,2997,1652,1345,1726340.00,1408660.00,3135000.00
291770,202006,790,534,256,558031.05,267520.00,825551.05
291780,202006,60,36,24,37620.00,25080.00,62700.00
291790,202006,164,81,83,84645.00,86735.00,171380.00
291800,202006,10124,4172,5952,4363923.09,6231336.75,10595259.84
291810,202006,1111,830,281,867350.50,294690.00,1162040.50
291820,202006,282,203,79,212135.00,82555.00,294690.00
291830,202006,1072,429,643,448306.46,672980.00,1121286.46
291835,202006,579,537,42,562210.00,43890.00,606100.00
291840,202006,4906,2482,2424,2595781.21,2539350.50,5135131.71
291845,202006,272,88,184,91960.00,192280.00,284240.00
291850,202006,329,292,37,305140.00,38665.00,343805.00
291855,202006,268,105,163,110770.00,170335.00,281105.00
291860,202006,173,109,64,113905.00,66880.00,180785.00
291870,202006,85,35,50,36575.00,52250.00,88825.00
291875,202006,183,169,14,176605.00,14630.00,191235.00
291880,202006,458,362,96,378290.00,100320.00,478610.00
291890,202006,243,77,166,80465.00,173470.50,253935.50
291900,202006,60,34,26,35530.00,27170.00,62700.00
291905,202006,129,94,35,98230.50,36575.00,134805.50
291910,202006,163,132,31,138985.00,32395.00,171380.00
291915,202006,431,383,48,400235.25,50160.00,450395.25
291920,202006,5095,2564,2531,2685650.00,2648030.50,5333680.50
291930,202006,172,102,70,106590.55,73150.00,179740.55
291940,202006,360,206,154,216315.50,160930.00,377245.50
291950,202006,1155,931,224,972896.00,234080.50,1206976.50
291955,202006,1259,745,514,779570.00,537130.00,1316700.00
291960,202006,189,137,52,143165.00,54340.00,197505.00
291970,202006,764,581,183,607145.00,191235.00,798380.00
291980,202006,1498,1328,170,1388806.23,178695.50,1567501.73
291990,202006,133,124,9,129580.00,9405.00,138985.00
291992,202006,171,88,83,91960.00,86735.00,178695.00
291995,202006,172,114,58,119130.00,60610.00,179740.00
292000,202006,400,307,93,320815.00,97185.00,418000.00
292010,202006,318,222,96,231990.00,100320.00,332310.00
292020,202006,303,223,80,233035.00,83600.00,316635.00
292030,202006,146,113,33,118085.00,34485.00,152570.00
292040,202006,634,320,314,334400.00,328130.00,662530.00
292045,202006,106,96,10,100320.00,10450.00,110770.00
292050,202006,947,690,257,722095.00,268565.50,990660.50
292060,202006,907,750,157,784795.65,165110.00,949905.65
292070,202006,56,21,35,21945.00,36575.00,58520.00
292080,202006,145,100,45,104500.00,47025.00,151525.00
292090,202006,538,187,351,195415.00,366795.00,562210.00
292100,202006,1489,635,854,665665.00,893475.00,1559140.00
292105,202006,195,171,24,179740.00,25080.00,204820.00
292110,202006,2265,824,1441,861080.00,1506890.00,2367970.00
292120,202006,702,551,151,575795.00,157795.00,733590.00
292130,202006,443,252,191,263340.00,199595.00,462935.00
292140,202006,209,169,40,176605.00,41800.00,218405.00
292145,202006,159,85,74,89870.00,77330.00,167200.00
292150,202006,1483,1209,274,1263405.00,286330.00,1549735.00
292160,202006,171,140,31,146300.00,32395.00,178695.00
292170,202006,1218,1055,163,1102475.00,170335.00,1272810.00
292180,202006,222,161,61,169290.00,63745.00,233035.00
292190,202006,161,104,57,108680.00,59565.00,168245.00
292200,202006,1342,490,852,514140.00,892430.50,1406570.50
292205,202006,124,109,15,113905.00,15675.00,129580.00
292210,202006,368,255,113,266475.00,118085.25,384560.25
292220,202006,28,22,6,22990.00,6270.00,29260.00
292225,202006,41,35,6,36575.00,6270.00,42845.00
292230,202006,966,772,194,807785.75,203775.00,1011560.75
292240,202006,617,442,175,461890.75,182875.00,644765.75
292250,202006,1748,1149,599,1201750.00,625955.00,1827705.00
292260,202006,411,247,164,258115.00,171380.00,429495.00
292265,202006,253,180,73,188100.00,76285.00,264385.00
292270,202006,741,340,401,355300.00,419045.00,774345.00
292273,202006,206,113,93,118085.00,97185.00,215270.00
292275,202006,172,85,87,88825.00,90915.00,179740.00
292280,202006,143,99,44,103455.00,45980.00,149435.00
292285,202006,75,62,13,64790.00,13585.00,78375.00
292290,202006,571,384,187,402325.00,195415.50,597740.50
292300,202006,1683,629,1054,658350.00,1103520.30,1761870.30
292303,202006,111,72,39,75240.00,40755.00,115995.00
292305,202006,114,84,30,87780.00,31350.00,119130.00
292310,202006,940,612,328,640586.25,343805.90,984392.15
292320,202006,598,454,144,475475.00,150480.00,625955.00
292330,202006,180,102,78,106590.00,81510.00,188100.00
292335,202006,282,221,61,230945.00,63745.00,294690.00
292340,202006,576,402,174,421135.00,181830.00,602965.00
292350,202006,272,147,125,153615.00,130625.00,284240.00
292360,202006,711,542,169,566390.90,176605.00,742995.90
292370,202006,737,564,173,589380.00,180785.00,770165.00
292380,202006,643,518,125,542355.35,131670.00,674025.35
292390,202006,472,189,283,197505.00,298870.00,496375.00
292400,202006,3638,2237,1401,2339757.61,1466135.00,3805892.61
292405,202006,264,174,90,181830.00,94050.00,275880.00
292410,202006,137,84,53,88825.00,56430.00,145255.00
292420,202006,295,256,39,267520.00,40755.00,308275.00
292430,202006,539,410,129,428450.00,135850.00,564300.00
292440,202006,596,516,80,539220.16,83600.00,622820.16
292450,202006,250,193,57,201685.00,59565.00,261250.00
292460,202006,555,414,141,432630.95,147345.00,579975.95
292465,202006,212,176,36,183920.00,37620.00,221540.00
292467,202006,128,75,53,78375.00,55385.00,133760.00
292470,202006,292,198,94,207955.00,98230.00,306185.00
292480,202006,370,254,116,265430.00,121220.50,386650.50
292490,202006,233,163,70,170335.00,73150.00,243485.00
292500,202006,879,389,490,406505.15,512050.00,918555.15
292510,202006,3462,1597,1865,1669910.60,1948925.00,3618835.60
292520,202006,1100,517,583,540265.00,609235.00,1149500.00
292525,202006,393,279,114,291555.00,120175.00,411730.00
292530,202006,4392,1768,2624,1849650.96,2745216.50,4594867.46
292540,202006,476,266,210,279015.00,219450.00,498465.00
292550,202006,1101,582,519,608190.50,544445.00,1152635.50
292560,202006,332,310,22,323950.00,22990.00,346940.00
292570,202006,307,240,67,250800.00,70015.00,320815.00
292575,202006,498,329,169,343805.50,176605.00,520410.50
292580,202006,1001,664,337,693880.00,352165.50,1046045.50
292590,202006,567,493,74,515185.00,77330.00,592515.00
292593,202006,143,113,30,118085.00,31350.00,149435.00
292595,202006,199,156,43,163020.00,44935.00,207955.00
292600,202006,1259,917,342,958265.29,357390.00,1315655.29
292610,202006,134,104,30,108680.00,32395.00,141075.00
292620,202006,529,443,86,462935.00,90915.00,553850.00
292630,202006,1432,804,628,843315.42,658350.25,1501665.67
292640,202006,818,565,253,590425.00,264385.00,854810.00
292650,202006,189,156,33,163020.50,34485.00,197505.50
292660,202006,2037,1463,574,1528835.00,599830.42,2128665.42
292665,202006,141,99,42,103455.00,43890.00,147345.00
292670,202006,392,317,75,331265.00,78375.00,409640.00
292680,202006,255,192,63,201685.00,65835.50,267520.50
292690,202006,194,144,50,151525.00,52250.00,203775.00
292700,202006,972,643,329,674025.00,343805.00,1017830.00
292710,202006,113,98,15,102410.00,15675.00,118085.00
292720,202006,932,530,402,553850.00,421135.00,974985.00
292730,202006,198,91,107,95095.00,111815.00,206910.00
292740,202006,69254,33733,35521,35311615.15,37210369.83,72521984.98
292750,202006,389,276,113,289465.95,119130.00,408595.95
292760,202006,335,279,56,291556.45,58520.00,350076.45
292770,202006,831,353,478,369930.00,500555.00,870485.00
292780,202006,411,164,247,171380.00,258115.00,429495.00
292790,202006,769,392,377,411730.00,396055.00,807785.00
292800,202006,1261,758,503,792110.00,525635.00,1317745.00
292805,202006,395,118,277,123310.00,289465.00,412775.00
292810,202006,1505,854,651,892431.50,680295.00,1572726.50
292820,202006,716,594,122,620731.25,127490.00,748221.25
292830,202006,110,90,20,95095.00,20900.00,115995.00
292840,202006,685,563,122,589380.00,127490.00,716870.00
292850,202006,143,95,48,99275.00,50160.00,149435.00
292860,202006,2173,1266,907,1326105.50,949905.00,2276010.50
292870,202006,3506,2338,1168,2443210.45,1222650.00,3665860.45
292880,202006,1501,985,516,1030370.05,539220.00,1569590.05
292890,202006,519,443,76,463980.00,79420.00,543400.00
292895,202006,142,94,48,98230.00,50160.00,148390.00
292900,202006,390,279,111,291555.40,115995.00,407550.40
292905,202006,476,240,236,250800.00,246620.00,497420.00
292910,202006,460,348,112,363660.75,117040.00,480700.75
292920,202006,530,229,301,239305.00,314545.00,553850.00
292925,202006,491,452,39,472340.00,40755.00,513095.00
292930,202006,613,372,241,388740.00,251845.00,640585.00
292935,202006,285,124,161,129580.00,168245.00,297825.00
292937,202006,225,159,66,166155.00,68970.00,235125.00
292940,202006,192,149,43,155705.00,44935.00,200640.00
292950,202006,1182,594,588,620730.75,614460.60,1235191.35
292960,202006,587,417,170,435765.00,177650.00,613415.00
292970,202006,250,175,75,182875.00,78375.00,261250.00
292975,202006,118,68,50,71060.00,52250.00,123310.00
292980,202006,287,195,92,203775.52,97185.00,300960.52
292990,202006,1331,989,342,1035596.55,359480.00,1395076.55
293000,202006,114,80,34,83600.00,35530.00,119130.00
293010,202006,2828,1684,1144,1759780.75,1195480.72,2955261.47
293015,202006,637,518,119,541310.00,124355.00,665665.00
293020,202006,332,273,59,285285.00,61655.00,346940.00
293030,202006,601,523,78,546535.00,81510.00,628045.00
293040,202006,357,281,76,293645.00,79420.00,373065.00
293050,202006,2881,1705,1176,1782770.50,1228920.50,3011691.00
293060,202006,261,210,51,219450.60,54340.00,273790.60
293070,202006,3488,1753,1735,1835022.22,1818301.75,3653323.97
293075,202006,91,61,30,63745.00,31350.00,95095.00
293076,202006,74,52,22,54340.00,22990.00,77330.00
293077,202006,508,296,212,309320.50,221540.00,530860.50
293080,202006,442,397,45,414865.85,47025.00,461890.85
293090,202006,130,115,15,120175.00,15675.00,135850.00
293100,202006,529,370,159,386650.00,166155.00,552805.00
293105,202006,347,251,96,262295.00,100320.00,362615.00
293110,202006,167,118,49,123310.00,51205.00,174515.00
293120,202006,313,212,101,223630.00,105545.00,329175.00
293130,202006,244,167,77,174515.00,80465.00,254980.00
293135,202006,8077,3163,4914,3311606.75,5145584.50,8457191.25
293140,202006,208,131,77,136895.00,80465.00,217360.00
293150,202006,331,286,45,298870.00,47025.00,345895.00
293160,202006,424,248,176,259160.00,183920.00,443080.00
293170,202006,178,123,55,128535.00,57475.00,186010.00
293180,202006,516,364,152,380380.50,158840.00,539220.50
293190,202006,1350,936,414,978120.61,432630.00,1410750.61
293200,202006,547,485,62,506825.00,65835.00,572660.00
293210,202006,398,302,96,315590.00,100320.00,415910.00
293220,202006,2509,1054,1455,1102475.00,1521520.00,2623995.00
293230,202006,1747,644,1103,672980.94,1153680.00,1826660.94
293240,202006,234,216,18,225720.00,18810.00,244530.00
293245,202006,126,107,19,111815.00,19855.00,131670.00
293250,202006,728,261,467,272745.90,488015.00,760760.90
293260,202006,304,253,51,264385.00,53295.00,317680.00
293270,202006,1171,542,629,566390.25,658350.00,1224740.25
293280,202006,273,151,122,158840.00,128535.00,287375.00
293290,202006,3058,1990,1068,2079550.00,1116060.00,3195610.00
293300,202006,735,523,212,546535.75,221540.00,768075.75
293305,202006,191,154,37,160930.00,38665.00,199595.00
293310,202006,150,112,38,117040.00,39710.00,156750.00
293315,202006,162,128,34,133760.00,35530.00,169290.00
293317,202006,87,63,24,65835.00,25080.00,90915.00
293320,202006,1060,587,473,613415.92,494285.00,1107700.92
293325,202006,182,68,114,71060.00,119130.00,190190.00
293330,202006,13769,6426,7343,6719353.41,7682844.25,14402197.66
293340,202006,264,188,76,196460.00,79420.00,275880.00
293345,202006,247,201,46,210045.00,48070.00,258115.00
293350,202006,621,358,263,374110.00,274835.00,648945.00
293360,202006,1532,1098,434,1149500.00,453530.00,1603030.00
310010,202006,138,76,62,79420.00,64790.50,144210.50
310020,202006,1036,576,460,602965.00,481745.00,1084710.00
310030,202006,330,264,66,276925.00,68970.00,345895.00
310040,202006,43,29,14,30305.00,14630.00,44935.00
310050,202006,182,114,68,120175.50,71060.00,191235.50
310060,202006,243,168,75,175560.50,78375.00,253935.50
310070,202006,14,9,5,9405.00,5225.00,14630.00
310080,202006,41,25,16,26125.00,16720.00,42845.00
310090,202006,1015,526,489,550717.00,511006.00,1061723.00
310100,202006,303,222,81,231990.00,84645.00,316635.00
310110,202006,703,387,316,404415.00,330220.00,734635.00
310120,202006,371,213,158,222585.00,166155.00,388740.00
310130,202006,32,19,13,19855.00,13585.00,33440.00
310140,202006,26,13,13,13585.00,13585.00,27170.00
310150,202006,1214,829,385,866305.75,404416.00,1270721.75
310160,202006,2075,1013,1062,1060677.15,1109790.50,2170467.65
310163,202006,87,50,37,52250.00,38665.00,90915.00
310170,202006,2558,1130,1428,1180850.85,1493307.00,2674157.85
310180,202006,149,55,94,57475.50,98230.00,155705.50
310190,202006,479,330,149,344850.00,155705.00,500555.00
310200,202006,486,309,177,322905.00,184965.00,507870.00
310205,202006,57,39,18,40755.00,18810.00,59565.00
310210,202006,283,228,55,239305.00,57475.00,296780.00
310220,202006,62,34,28,35530.00,29260.00,64790.00
310230,202006,275,189,86,197505.00,89870.00,287375.00
310240,202006,107,94,13,98230.00,13585.00,111815.00
310250,202006,95,79,16,82555.00,16720.00,99275.00
310260,202006,769,408,361,427406.17,377245.00,804651.17
310270,202006,268,173,95,180785.60,99275.00,280060.60
310280,202006,375,276,99,288420.00,103455.00,391875.00
310285,202006,212,153,59,159885.00,61655.00,221540.00
310290,202006,239,129,110,134805.00,114950.00,249755.00
310300,202006,156,130,26,135850.00,27170.00,163020.00
310310,202006,9,7,2,7315.00,2090.00,9405.00
310320,202006,29,11,18,11495.00,18810.00,30305.00
310330,202006,40,26,14,27170.00,14630.00,41800.00
310340,202006,1747,1149,598,1200707.00,625955.50,1826662.50
310350,202006,2812,1497,1315,1566455.00,1377310.50,2943765.50
310360,202006,41,35,6,36575.00,6270.00,42845.00
310370,202006,114,95,19,99275.00,19855.50,119130.50
310375,202006,105,39,66,40755.00,68970.00,109725.00
310380,202006,47,27,20,28215.00,20900.00,49115.00
310390,202006,93,62,31,64790.00,33440.00,98230.00
310400,202006,2359,1521,838,1590491.00,875710.00,2466201.00
310410,202006,128,70,58,74195.00,60610.00,134805.00
310420,202006,668,352,316,367840.00,331265.00,699105.00
310430,202006,308,196,112,204820.00,118085.00,322905.00
310440,202006,77,45,32,47025.00,33440.00,80465.00
310445,202006,81,67,14,70015.00,14630.00,84645.00
310450,202006,627,387,240,404415.00,254980.00,659395.00
310460,202006,263,185,78,193325.00,82555.00,275880.00
310470,202006,509,318,191,332310.00,199595.00,531905.00
310480,202006,74,52,22,54340.00,22990.00,77330.00
310490,202006,534,251,283,262295.00,297825.00,560120.00
310500,202006,135,53,82,55385.00,85690.00,141075.00
310510,202006,602,418,184,436810.00,194370.00,631180.00
310520,202006,133,93,40,98230.00,42845.00,141075.00
310530,202006,106,46,60,48070.00,62700.00,110770.00
310540,202006,467,272,195,284240.00,203775.00,488015.00
310550,202006,76,48,28,50160.00,29260.00,79420.00
310560,202006,2978,2050,928,2145386.00,972895.00,3118281.00
310570,202006,102,68,34,71060.00,35530.00,106590.00
310590,202006,372,236,136,246620.25,142120.00,388740.25
310600,202006,152,83,69,86735.50,72105.00,158840.50
310610,202006,60,24,36,25080.00,37620.00,62700.00
310620,202006,47326,22540,24786,23575136.83,25945266.40,49520403.23
310630,202006,639,392,247,409640.30,258115.50,667755.80
310640,202006,130,101,29,105545.00,30305.00,135850.00
310650,202006,161,144,17,150480.00,17765.00,168245.00
310660,202006,103,68,35,71060.00,36575.00,107635.00
310665,202006,59,45,14,47025.00,14630.00,61655.00
310670,202006,6695,2880,3815,3011692.50,3993991.00,7005683.50
310680,202006,57,36,21,37620.00,21945.00,59565.00
310690,202006,618,431,187,450395.25,195415.00,645810.25
310700,202006,58,38,20,39710.00,20900.00,60610.00
310710,202006,1328,905,423,945725.50,442035.50,1387761.00
310720,202006,135,38,97,39710.00,101365.00,141075.00
310730,202006,1449,998,451,1047091.25,472340.00,1519431.25
310740,202006,977,542,435,568481.00,457710.25,1026191.25
310750,202006,242,145,97,151525.65,101365.00,252890.65
310760,202006,64,47,17,49115.00,17765.50,66880.50
310770,202006,103,49,54,51205.00,56430.00,107635.00
310780,202006,367,295,72,308275.00,76285.00,384560.00
310790,202006,99,81,18,84645.00,18810.00,103455.00
310800,202006,450,211,239,220495.25,249755.00,470250.25
310810,202006,170,121,49,126446.22,51205.00,177651.22
310820,202006,340,268,72,280060.00,75240.00,355300.00
310825,202006,191,162,29,169290.00,30305.00,199595.00
310830,202006,472,225,247,235125.50,259160.00,494285.50
310840,202006,369,212,157,221540.00,164065.00,385605.00
310850,202006,99,79,20,83600.00,20900.00,104500.00
310855,202006,392,312,80,326040.00,83600.00,409640.00
310860,202006,1594,1177,417,1229968.00,435766.25,1665734.25
310870,202006,53,43,10,44935.00,10450.00,55385.00
310880,202006,81,63,18,65835.00,18810.00,84645.00
310890,202006,309,179,130,187055.00,135850.00,322905.00
310900,202006,652,301,351,314554.86,367852.96,682407.82
310910,202006,239,162,77,169290.50,80465.00,249755.50
310920,202006,457,271,186,284241.45,194370.50,478611.95
310925,202006,37,31,6,32395.00,6270.00,38665.00
310930,202006,1312,825,487,862125.00,508915.00,1371040.00
310940,202006,710,348,362,364705.00,378290.00,742995.00
310945,202006,118,74,44,77330.00,45980.00,123310.00
310950,202006,233,187,46,196460.00,48070.00,244530.00
310960,202006,80,24,56,25080.00,58520.00,83600.00
310970,202006,160,102,58,106590.00,60610.50,167200.50
310980,202006,50,32,18,33440.00,18810.00,52250.00
310990,202006,160,81,79,84645.00,82555.00,167200.00
311000,202006,821,406,415,425316.49,433675.50,858991.99
311010,202006,44,39,5,40755.00,5225.00,45980.00
311020,202006,45,27,18,28215.00,18810.00,47025.00
311030,202006,389,224,165,234080.50,172425.00,406505.50
311040,202006,42,32,10,33440.00,10450.00,43890.00
311050,202006,492,190,302,198550.00,316635.00,515185.00
311060,202006,788,434,354,454575.00,372020.50,826595.50
311070,202006,339,151,188,157795.00,196460.00,354255.00
311080,202006,111,60,51,62700.00,53295.00,115995.00
311090,202006,335,158,177,165110.00,187055.00,352165.00
311100,202006,587,353,234,369930.00,244530.00,614460.00
311110,202006,696,485,211,508915.00,220495.00,729410.00
311115,202006,75,54,21,56430.00,21945.00,78375.00
311120,202006,1083,576,507,604010.50,531905.00,1135915.50
311130,202006,354,215,139,224675.00,146300.00,370975.00
311140,202006,172,91,81,95095.00,84645.00,179740.00
311150,202006,348,227,121,237215.00,126445.00,363660.00
311160,202006,705,501,204,523545.50,213180.00,736725.50
311170,202006,86,68,18,71060.00,18810.00,89870.00
311180,202006,329,221,108,230945.00,112860.50,343805.50
311190,202006,43,22,21,22990.00,21945.00,44935.00
311200,202006,324,228,96,238260.00,100320.00,338580.00
311205,202006,35,24,11,25080.00,12540.00,37620.00
311210,202006,48,42,6,43890.50,6270.00,50160.50
311220,202006,24,21,3,21945.00,3135.00,25080.00
311230,202006,1634,1069,565,1119195.50,590425.00,1709620.50
311240,202006,185,120,65,125400.00,67925.00,193325.00
311250,202006,95,27,68,28215.00,71060.00,99275.00
311260,202006,556,348,208,363660.00,217360.00,581020.00
311265,202006,123,83,40,86735.00,41800.00,128535.00
311270,202006,287,195,92,203775.00,96140.00,299915.00
311280,202006,216,98,118,102410.00,123310.00,225720.00
311290,202006,104,86,18,89870.00,18810.00,108680.00
311300,202006,588,368,220,384560.00,229900.00,614460.00
311310,202006,21,16,5,16720.00,5225.00,21945.00
311320,202006,666,494,172,516230.00,179740.00,695970.00
311330,202006,1096,802,294,839135.00,307230.50,1146365.50
311340,202006,2632,1858,774,1942656.00,811965.00,2754621.00
311350,202006,275,214,61,223630.00,63745.00,287375.00
311360,202006,174,106,68,110770.00,71060.00,181830.00
311370,202006,1216,499,717,521455.25,752400.00,1273855.25
311380,202006,7,6,1,6270.00,1045.00,7315.00
311390,202006,259,140,119,146300.00,124355.00,270655.00
311400,202006,140,89,51,93005.00,53295.00,146300.00
311410,202006,112,60,52,62700.00,54340.00,117040.00
311420,202006,306,165,141,172425.00,148390.00,320815.00
311430,202006,852,565,287,592515.00,300960.50,893475.50
311440,202006,462,325,137,340670.00,143165.00,483835.00
311450,202006,316,191,125,199595.00,130625.00,330220.00
311455,202006,281,194,87,202730.00,90915.00,293645.00
311460,202006,141,61,80,63745.00,83600.00,147345.00
311470,202006,23,12,11,12540.00,11495.00,24035.00
311480,202006,47,21,26,21945.00,27170.00,49115.00
311490,202006,13,9,4,9405.00,4180.00,13585.00
311500,202006,25,12,13,12540.00,13585.00,26125.00
311510,202006,637,439,198,459800.00,206910.00,666710.00
311520,202006,41,33,8,34485.00,8360.00,42845.00
311530,202006,1817,1336,481,1397166.70,502645.00,1899811.70
311535,202006,67,47,20,49115.00,20900.00,70015.00
311540,202006,34,30,4,31350.00,4180.00,35530.00
311545,202006,179,134,45,140030.00,47025.00,187055.00
311547,202006,40,33,7,34485.00,7315.00,41800.00
311550,202006,698,322,376,337535.00,392920.00,730455.00
311560,202006,42,28,14,30305.00,14630.00,44935.00
311570,202006,285,190,95,198550.00,99275.00,297825.00
311580,202006,334,197,137,205865.00,144210.00,350075.00
311590,202006,32,29,3,30305.00,3135.00,33440.00
311600,202006,107,83,24,86735.00,25080.00,111815.00
311610,202006,255,221,34,230945.25,35530.00,266475.25
311615,202006,82,66,16,68970.00,16720.00,85690.00
311620,202006,25,14,11,14630.00,11495.00,26125.00
311630,202006,86,72,14,75240.00,14630.00,89870.00
311640,202006,138,67,71,70015.00,74195.00,144210.00
311650,202006,125,87,38,90915.00,39710.00,130625.00
311660,202006,400,197,203,205865.00,213180.00,419045.00
311670,202006,148,99,49,103455.66,51205.00,154660.66
311680,202006,210,155,55,161975.00,57475.00,219450.00
311690,202006,15,11,4,11495.00,4180.00,15675.00
311700,202006,197,138,59,144210.00,61655.00,205865.00
311710,202006,201,133,68,138985.00,72105.00,211090.00
311720,202006,41,30,11,31350.50,11495.00,42845.50
311730,202006,580,392,188,409640.00,196460.00,606100.00
311740,202006,37,26,11,27170.00,11495.00,38665.00
311750,202006,727,491,236,513095.76,246620.00,759715.76
311760,202006,67,29,38,30305.00,39710.00,70015.00
311770,202006,396,196,200,204821.35,209000.00,413821.35
311780,202006,178,91,87,95095.50,91960.00,187055.50
311783,202006,87,78,9,81510.00,9405.00,90915.00
311787,202006,37,13,24,13585.00,25080.00,38665.00
311790,202006,263,117,146,123310.00,152570.00,275880.00
311800,202006,684,450,234,471295.95,245575.00,716870.95
311810,202006,49,40,9,41800.00,9405.00,51205.00
311820,202006,120,99,21,103455.00,21945.00,125400.00
311830,202006,1904,1172,732,1225785.75,765985.00,1991770.75
311840,202006,1011,563,448,589381.00,469205.25,1058586.25
311850,202006,12,8,4,8360.00,4180.00,12540.00
311860,202006,9632,4186,5446,4380642.25,5703611.00,10084253.25
311870,202006,125,66,59,68970.00,61655.00,130625.00
311880,202006,929,674,255,707465.00,266475.00,973940.00
311890,202006,208,100,108,104414.00,112860.00,217274.00
311900,202006,73,29,44,30305.00,45980.00,76285.00
311910,202006,1406,885,521,924825.75,544445.50,1469271.25
311920,202006,234,152,82,158840.00,85690.00,244530.00
311930,202006,908,515,393,538175.50,410685.00,948860.50
311940,202006,2506,1320,1186,1383580.00,1241460.15,2625040.15
311950,202006,56,42,14,43890.00,14630.00,58520.00
311960,202006,58,43,15,44935.00,15675.00,60610.00
311970,202006,23,14,9,14630.00,9405.00,24035.00
311980,202006,44,35,9,36575.00,9405.00,45980.00
311990,202006,38,29,9,30305.00,9405.00,39710.00
311995,202006,58,37,21,38665.00,22990.00,61655.00
312000,202006,30,22,8,22990.00,8360.00,31350.00
312010,202006,77,60,17,62700.00,17765.00,80465.00
312015,202006,75,57,18,59565.00,18810.00,78375.00
312020,202006,129,85,44,88825.00,45980.00,134805.00
312030,202006,59,44,15,45980.00,15675.00,61655.00
312040,202006,86,52,34,54340.50,35530.00,89870.50
312050,202006,211,116,95,121220.00,99275.00,220495.00
312060,202006,22,12,10,12540.00,10450.00,22990.00
312070,202006,76,50,26,52250.00,27170.00,79420.00
312080,202006,534,242,292,252890.00,306185.00,559075.00
312083,202006,61,39,22,40755.00,22990.00,63745.00
312087,202006,106,83,23,86735.00,24035.00,110770.00
312090,202006,3196,1908,1288,1994907.00,1345960.50,3340867.50
312100,202006,149,104,45,108440.15,47025.00,155465.15
312110,202006,119,71,48,74195.00,50160.00,124355.00
312120,202006,143,104,39,108681.14,40755.00,149436.14
312125,202006,91,51,40,53295.00,41800.00,95095.00
312130,202006,127,83,44,86735.00,45980.00,132715.00
312140,202006,136,106,30,110770.50,31350.00,142120.50
312150,202006,43,33,10,34485.00,10450.00,44935.00
312160,202006,1569,1028,541,1074356.50,565345.50,1639702.00
312170,202006,10,8,2,8360.00,2090.00,10450.00
312180,202006,114,69,45,72105.00,48070.50,120175.50
312190,202006,35,31,4,32395.00,4180.00,36575.00
312200,202006,753,641,112,669845.50,118085.00,787930.50
312210,202006,110,59,51,61655.00,53295.00,114950.00
312220,202006,138,103,35,107635.25,36575.00,144210.25
312230,202006,3643,1689,1954,1767095.40,2049246.00,3816341.40
312235,202006,170,113,57,118085.00,59565.00,177650.00
312240,202006,99,70,29,73150.00,30305.00,103455.00
312245,202006,188,129,59,134805.00,61655.00,196460.00
312247,202006,70,49,21,51205.00,21945.00,73150.00
312250,202006,178,85,93,88825.00,97185.00,186010.00
312260,202006,109,73,36,76285.00,37620.00,113905.00
312270,202006,132,77,55,80465.00,57475.00,137940.00
312280,202006,27,13,14,13585.00,14630.00,28215.00
312290,202006,147,105,42,109725.00,43890.00,153615.00
312300,202006,212,134,78,140030.00,82555.00,222585.00
312310,202006,61,54,7,57475.00,7315.00,64790.00
312320,202006,424,271,153,283195.00,160930.75,444125.75
312330,202006,90,79,11,82555.00,11495.00,94050.00
312340,202006,36,17,19,17765.00,19855.00,37620.00
312350,202006,18,11,7,11495.00,7315.00,18810.00
312352,202006,93,69,24,72105.00,25080.00,97185.00
312360,202006,586,251,335,262295.00,350075.00,612370.00
312370,202006,309,171,138,178695.00,144210.00,322905.00
312380,202006,144,95,49,99275.00,52250.00,151525.00
312385,202006,162,129,33,136895.00,35530.00,172425.00
312390,202006,301,187,114,195415.00,119130.50,314545.50
312400,202006,382,285,97,297825.00,101365.50,399190.50
312410,202006,994,316,678,330220.00,710600.00,1040820.00
312420,202006,628,480,148,501600.50,155705.00,657305.50
312430,202006,868,635,233,663576.11,247665.00,911241.11
312440,202006,42,31,11,32395.00,11495.00,43890.00
312450,202006,209,131,78,136895.00,81510.00,218405.00
312460,202006,32,16,16,16720.00,16720.00,33440.00
312470,202006,46,31,15,33440.00,15675.00,49115.00
312480,202006,190,117,73,122265.00,76285.00,198550.00
312490,202006,270,188,82,196460.00,85690.00,282150.00
312500,202006,36,21,15,21945.00,15675.00,37620.00
312510,202006,529,204,325,213180.00,340670.00,553850.00
312520,202006,31,9,22,9405.00,24035.00,33440.00
312530,202006,48,33,15,34485.00,15675.00,50160.00
312540,202006,97,85,12,88825.00,12540.00,101365.00
312550,202006,34,28,6,29260.00,6270.00,35530.00
312560,202006,216,163,53,170335.50,55385.00,225720.50
312570,202006,442,262,180,273790.00,188100.00,461890.00
312580,202006,87,47,40,50160.00,41800.00,91960.00
312590,202006,247,198,49,206910.00,51205.00,258115.00
312595,202006,136,122,14,127490.00,14630.00,142120.00
312600,202006,70,38,32,39710.25,33440.00,73150.25
312610,202006,1596,818,778,855857.00,814055.50,1669912.50
312620,202006,213,151,62,157795.00,64790.00,222585.00
312630,202006,65,55,10,57475.00,10450.00,67925.00
312640,202006,47,15,32,15675.00,33440.00,49115.00
312650,202006,147,121,26,126445.50,27170.00,153615.50
312660,202006,93,64,29,66880.76,30305.00,97185.76
312670,202006,918,591,327,618640.00,341715.00,960355.00
312675,202006,29,23,6,24035.00,6270.00,30305.00
312680,202006,78,48,30,50160.00,31350.00,81510.00
312690,202006,248,129,119,134805.00,124355.00,259160.00
312695,202006,35,29,6,30305.00,6270.00,36575.00
312700,202006,228,133,95,138985.00,100320.00,239305.00
312705,202006,85,67,18,70015.00,18810.00,88825.00
312707,202006,129,89,40,93005.00,41800.00,134805.00
312710,202006,1894,1003,891,1051271.41,933185.00,1984456.41
312720,202006,59,31,28,32395.00,29260.00,61655.00
312730,202006,287,166,121,173470.00,126445.00,299915.00
312733,202006,55,45,10,47025.00,10450.00,57475.00
312735,202006,22,14,8,14630.00,8360.00,22990.00
312737,202006,72,39,33,40755.00,34485.00,75240.00
312738,202006,61,41,20,42845.00,20900.00,63745.00
312740,202006,83,53,30,55385.00,31350.00,86735.00
312750,202006,81,58,23,60610.00,24035.00,84645.00
312760,202006,290,206,84,215270.00,87780.00,303050.00
312770,202006,7975,3645,4330,3819479.25,4536345.00,8355824.25
312780,202006,427,325,102,339625.00,106590.00,446215.00
312790,202006,23,17,6,17765.00,6270.00,24035.00
312800,202006,1601,1111,490,1160995.75,512050.00,1673045.75
312810,202006,372,237,135,247665.00,141075.00,388740.00
312820,202006,188,144,44,150480.00,45980.00,196460.00
312825,202006,24,15,9,15675.00,9405.00,25080.00
312830,202006,234,133,101,140030.00,105545.00,245575.00
312840,202006,158,106,52,111815.00,54340.00,166155.00
312850,202006,43,38,5,39710.00,5225.00,44935.00
312860,202006,153,96,57,100320.00,59565.00,159885.00
312870,202006,1061,553,508,577885.75,531905.00,1109790.75
312880,202006,127,89,38,93005.00,40755.00,133760.00
312890,202006,157,113,44,118085.00,45980.00,164065.00
312900,202006,194,145,49,151525.00,51205.00,202730.00
312910,202006,177,92,85,96140.00,88825.00,184965.00
312920,202006,158,85,73,88825.00,76285.00,165110.00
312930,202006,330,228,102,238260.00,106590.00,344850.00
312940,202006,115,81,34,84645.00,35530.00,120175.00
312950,202006,703,478,225,499510.00,235125.00,734635.00
312960,202006,174,130,44,135850.93,45980.00,181830.93
312965,202006,74,63,11,65835.00,11495.00,77330.00
312970,202006,277,226,51,236170.25,53295.00,289465.25
312980,202006,2463,1234,1229,1291621.00,1285350.00,2576971.00
312990,202006,43,22,21,22990.00,21945.00,44935.00
313000,202006,51,28,23,29260.00,24035.00,53295.00
313005,202006,174,135,39,141075.00,40755.50,181830.50
313010,202006,919,360,559,376200.50,585200.12,961400.62
313020,202006,191,101,90,105545.00,94050.00,199595.00
313030,202006,196,131,65,136895.35,67925.00,204820.35
313040,202006,75,23,52,24035.00,54340.00,78375.00
313050,202006,183,133,50,138985.00,52250.00,191235.00
313055,202006,38,28,10,29260.00,10450.00,39710.00
313060,202006,130,89,41,93005.00,42845.00,135850.00
313065,202006,63,45,18,47025.00,18810.50,65835.50
313070,202006,135,69,66,72105.00,68970.00,141075.00
313080,202006,39,17,22,17765.00,24035.00,41800.00
313090,202006,654,433,221,453530.00,231990.00,685520.00
313100,202006,182,65,117,67925.00,122265.00,190190.00
313110,202006,139,75,64,78375.00,66880.00,145255.00
313115,202006,210,116,94,121220.00,98230.00,219450.00
313120,202006,822,470,352,492195.00,369930.50,862125.50
313130,202006,5692,3091,2601,3233232.25,2726406.75,5959639.00
313140,202006,141,75,66,79420.00,68970.00,148390.00
313150,202006,311,246,65,257070.00,67925.00,324995.00
313160,202006,187,138,49,144210.50,51205.00,195415.50
313170,202006,1394,946,448,988570.50,469205.00,1457775.50
313180,202006,303,179,124,187055.50,129580.00,316635.50
313190,202006,755,449,306,469205.50,319770.00,788975.50
313200,202006,28,22,6,22990.00,6270.00,29260.00
313210,202006,1000,845,155,883027.55,161975.00,1045002.55
313220,202006,268,169,99,177650.00,103455.50,281105.50
313230,202006,263,199,64,209000.87,66880.00,275880.87
313240,202006,2140,1101,1039,1151593.00,1087845.00,2239438.00
313250,202006,1260,961,299,1004245.76,313500.80,1317746.56
313260,202006,90,47,43,49115.00,44935.00,94050.00
313270,202006,972,562,410,587290.75,430541.50,1017832.25
313280,202006,52,44,8,45980.00,8360.00,54340.00
313290,202006,220,176,44,183920.00,45980.00,229900.00
313300,202006,350,180,170,188100.00,177650.00,365750.00
313310,202006,260,124,136,129580.00,142120.00,271700.00
313320,202006,381,282,99,294690.00,103455.00,398145.00
313330,202006,1400,858,542,896610.00,566390.00,1463000.00
313340,202006,325,231,94,243485.00,98230.00,341715.00
313350,202006,502,332,170,346940.00,178695.00,525635.00
313360,202006,134,69,65,72105.00,67925.00,140030.00
313370,202006,210,69,141,72105.00,147345.00,219450.00
313375,202006,289,174,115,182875.00,121220.00,304095.00
313380,202006,1357,708,649,741950.50,678205.00,1420155.50
313390,202006,53,47,6,49115.00,6270.00,55385.00
313400,202006,402,273,129,285285.00,134806.00,420091.00
313410,202006,24,14,10,14630.00,10450.00,25080.00
313420,202006,4619,2459,2160,2573836.00,2262425.50,4836261.50
313430,202006,144,68,76,71060.00,79420.00,150480.00
313440,202006,1437,982,455,1029326.81,476522.00,1505848.81
313450,202006,68,27,41,28215.00,42845.00,71060.00
313460,202006,393,173,220,180785.50,229900.00,410685.50
313470,202006,529,247,282,258115.50,294690.50,552806.00
313480,202006,148,108,40,112860.50,41800.00,154660.50
313490,202006,521,238,283,248710.50,295735.25,544445.75
313500,202006,25,14,11,14630.00,11495.00,26125.00
313505,202006,1025,805,220,841225.00,229900.00,1071125.00
313507,202006,106,63,43,65835.00,44935.00,110770.00
313510,202006,2819,1780,1039,1863236.54,1088890.00,2952126.54
313520,202006,3481,2709,772,2832997.91,807785.00,3640782.91
313530,202006,34,23,11,24035.00,11495.00,35530.00
313535,202006,63,49,14,51205.00,14630.00,65835.00
313540,202006,69,51,18,53295.00,18810.50,72105.50
313545,202006,113,95,18,99275.00,18810.00,118085.00
313550,202006,232,196,36,204820.00,37620.50,242440.50
313560,202006,341,166,175,174515.00,183920.00,358435.00
313570,202006,67,26,41,27170.00,42845.00,70015.00
313580,202006,1314,742,572,775390.50,599831.50,1375222.00
313590,202006,68,38,30,39710.00,31350.00,71060.00
313600,202006,682,412,270,430540.00,283195.50,713735.50
313610,202006,60,46,14,48070.00,14630.00,62700.00
313620,202006,1393,703,690,737771.00,723140.00,1460911.00
313630,202006,1616,1229,387,1285351.00,406505.00,1691856.00
313640,202006,119,73,46,76285.00,48070.00,124355.00
313650,202006,236,109,127,113905.00,133760.18,247665.18
313652,202006,18,18,0,18810.00,0.00,18810.00
313655,202006,66,44,22,45980.00,22990.00,68970.00
313657,202006,49,45,4,47025.00,4180.00,51205.00
313660,202006,133,93,40,97185.00,41818.81,139003.81
313665,202006,647,301,346,314545.75,361570.00,676115.75
313670,202006,10357,7080,3277,7405919.87,3428646.00,10834565.87
313680,202006,43,32,11,33440.00,11495.95,44935.95
313690,202006,145,108,37,113905.00,38665.00,152570.00
313695,202006,78,58,20,60610.00,20900.00,81510.00
313700,202006,311,251,60,262295.50,63745.00,326040.50
313710,202006,144,99,45,103455.00,47025.00,150480.00
313720,202006,1122,521,601,545490.50,629091.50,1174582.00
313730,202006,77,45,32,47025.00,33440.00,80465.00
313740,202006,149,121,28,126445.00,29260.00,155705.00
313750,202006,430,312,118,327085.00,124355.00,451440.00
313753,202006,233,173,60,180785.00,62700.00,243485.00
313760,202006,1292,471,821,492195.00,860036.25,1352231.25
313770,202006,380,276,104,288420.25,108680.00,397100.25
313780,202006,773,405,368,424270.00,384560.00,808830.00
313790,202006,28,27,1,28215.00,1045.00,29260.00
313800,202006,139,85,54,88825.00,56430.00,145255.00
313810,202006,80,44,36,45980.00,37620.00,83600.00
313820,202006,1318,626,692,655216.00,723140.50,1378356.50
313830,202006,58,41,17,42845.00,17765.00,60610.00
313835,202006,60,50,10,53295.00,10450.00,63745.00
313840,202006,1669,1000,669,1045001.50,701195.50,1746197.00
313850,202006,206,75,131,78375.00,136895.00,215270.00
313860,202006,477,359,118,376200.50,123310.00,499510.50
313862,202006,164,109,55,113905.00,57475.00,171380.00
313865,202006,119,89,30,93005.00,31350.00,124355.00
313867,202006,47,37,10,38665.00,10450.00,49115.00
313868,202006,33,20,13,20900.00,13585.00,34485.00
313870,202006,118,63,55,65835.00,58520.00,124355.00
313880,202006,379,231,148,241395.00,154660.00,396055.00
313890,202006,337,177,160,184965.00,168245.00,353210.00
313900,202006,886,479,407,500555.25,425315.25,925870.50
313910,202006,147,105,42,109725.00,43890.00,153615.00
313920,202006,646,453,193,473385.00,202730.94,676115.94
313925,202006,31,28,3,29260.00,3135.00,32395.00
313930,202006,864,671,193,701195.00,201685.00,902880.00
313940,202006,1866,1168,698,1220560.00,732545.00,1953105.00
313950,202006,881,552,329,576840.00,343805.00,920645.00
313960,202006,1410,806,604,842270.90,632227.00,1474497.90
313970,202006,153,100,53,104500.00,55385.00,159885.00
313980,202006,206,130,76,135850.25,79420.00,215270.25
313990,202006,242,163,79,170335.00,82555.00,252890.00
314000,202006,907,602,305,629090.85,318725.00,947815.85
314010,202006,85,51,34,53295.00,35530.00,88825.00
314015,202006,63,17,46,17765.00,48070.00,65835.00
314020,202006,54,34,20,35530.00,20900.00,56430.00
314030,202006,77,37,40,38665.00,41800.00,80465.00
314040,202006,43,24,19,25080.00,19855.00,44935.00
314050,202006,285,170,115,177650.00,120175.00,297825.00
314053,202006,98,64,34,66880.00,35530.00,102410.00
314055,202006,299,184,115,192280.00,120175.00,312455.00
314060,202006,135,116,19,121220.04,19855.00,141075.04
314070,202006,1063,543,520,571615.00,543400.00,1115015.00
314080,202006,207,132,75,137940.00,78375.40,216315.40
314085,202006,143,97,46,101365.00,48070.00,149435.00
314090,202006,383,272,111,284240.25,115995.00,400235.25
314100,202006,488,392,96,409640.75,100320.00,509960.75
314110,202006,756,390,366,408595.50,383515.00,792110.50
314120,202006,91,55,36,57475.00,37620.00,95095.00
314130,202006,19,10,9,10450.00,9405.00,19855.00
314140,202006,1107,676,431,707256.00,450395.00,1157651.00
314150,202006,177,113,64,118085.00,67925.00,186010.00
314160,202006,331,251,80,262295.00,83600.00,345895.00
314170,202006,85,65,20,67925.00,20900.00,88825.00
314180,202006,732,647,85,676115.50,88825.75,764941.25
314190,202006,101,60,41,62700.00,42845.00,105545.00
314200,202006,485,332,153,346940.00,159885.00,506825.00
314210,202006,245,190,55,198550.00,57475.50,256025.50
314220,202006,303,223,80,234080.50,83600.00,317680.50
314225,202006,63,46,17,48070.00,17765.00,65835.00
314230,202006,116,52,64,54340.00,66880.00,121220.00
314240,202006,145,109,36,113905.00,37620.00,151525.00
314250,202006,53,30,23,31350.00,24035.00,55385.00
314260,202006,212,105,107,109725.00,111815.00,221540.00
314270,202006,364,282,82,294690.00,85690.00,380380.00
314280,202006,703,383,320,400235.00,334400.00,734635.00
314290,202006,543,438,105,457710.00,109725.00,567435.00
314300,202006,361,260,101,272745.25,105545.25,378290.50
314310,202006,1373,931,442,973157.57,461890.00,1435047.57
314315,202006,33,26,7,27170.00,7315.00,34485.00
314320,202006,592,390,202,407550.50,213180.00,620730.50
314330,202006,11121,5417,5704,5665992.00,5977401.00,11643393.00
314340,202006,604,274,330,286330.00,344851.00,631181.00
314345,202006,46,30,16,31350.00,16720.00,48070.00
314350,202006,181,114,67,119130.00,70015.00,189145.00
314360,202006,61,38,23,39710.00,25080.00,64790.00
314370,202006,66,47,19,49115.00,19855.00,68970.00
314380,202006,95,61,34,63745.00,35530.00,99275.00
314390,202006,3338,2138,1200,2237347.11,1256090.00,3493437.11
314400,202006,696,496,200,519366.30,209000.00,728366.30
314410,202006,480,313,167,328130.00,175560.00,503690.00
314420,202006,14,7,7,7315.00,7315.00,14630.00
314430,202006,2441,891,1550,931095.36,1621840.50,2552935.86
314435,202006,203,123,80,128535.00,83600.00,212135.00
314437,202006,28,22,6,22990.00,6270.00,29260.00
314440,202006,97,69,28,72105.00,29260.00,101365.00
314450,202006,157,108,49,112860.00,51205.00,164065.00
314460,202006,645,305,340,318725.00,355300.00,674025.00
314465,202006,97,61,36,63745.00,37620.00,101365.00
314467,202006,69,57,12,59565.00,12540.00,72105.00
314470,202006,412,205,207,214225.95,217360.00,431585.95
314480,202006,1064,502,562,524590.00,587290.00,1111880.00
314490,202006,47,32,15,33440.00,15675.00,49115.00
314500,202006,283,194,89,202730.00,93005.00,295735.00
314505,202006,119,78,41,81510.00,42845.00,124355.00
314510,202006,239,196,43,204820.00,44935.00,249755.00
314520,202006,1306,684,622,714786.50,649991.50,1364778.00
314530,202006,746,598,148,625955.95,154660.00,780615.95
314535,202006,189,111,78,115995.00,81510.00,197505.00
314537,202006,60,36,24,37620.00,25080.00,62700.00
314540,202006,16,10,6,10450.00,6270.00,16720.00
314545,202006,54,35,19,36575.00,19855.00,56430.00
314550,202006,81,42,39,43890.00,40755.00,84645.00
314560,202006,863,468,395,489060.50,412775.00,901835.50
314570,202006,21,16,5,16720.00,5225.00,21945.00
314580,202006,12,5,7,5225.00,7315.00,12540.00
314585,202006,24,17,7,17765.00,7315.00,25080.00
314587,202006,84,71,13,74195.00,13585.00,87780.00
314590,202006,566,405,161,423225.64,168245.00,591470.64
314600,202006,946,602,344,629091.00,359480.29,988571.29
314610,202006,960,496,464,518320.50,485925.00,1004245.50
314620,202006,140,104,36,108680.00,37620.00,146300.00
314625,202006,95,68,27,71060.00,28215.00,99275.00
314630,202006,1184,628,556,656260.00,582065.00,1238325.00
314640,202006,81,52,29,54340.00,30305.50,84645.50
314650,202006,181,102,79,107635.00,82555.00,190190.00
314655,202006,62,45,17,47025.00,17765.00,64790.00
314660,202006,17,14,3,14630.00,3135.00,17765.00
314670,202006,200,152,48,159885.50,50160.00,210045.50
314675,202006,209,121,88,127490.00,91960.00,219450.00
314690,202006,584,311,273,324995.00,287375.00,612370.00
314700,202006,2286,1228,1058,1286397.00,1105610.00,2392007.00
314710,202006,1684,973,711,1017831.75,744040.50,1761872.25
314720,202006,393,234,159,244530.00,166155.00,410685.00
314730,202006,519,267,252,279016.00,263340.00,542356.00
314740,202006,716,344,372,359480.00,388740.00,748220.00
314750,202006,22,19,3,19855.00,3135.00,22990.00
314760,202006,340,157,183,164065.00,191235.00,355300.00
314770,202006,105,73,32,76285.00,33440.00,109725.00
314780,202006,19,7,12,7315.00,12540.00,19855.00
314790,202006,2385,1490,895,1558095.50,937365.00,2495460.50
314795,202006,52,42,10,43890.00,10450.00,54340.00
314800,202006,2939,1711,1228,1787997.22,1284305.00,3072302.22
314810,202006,1528,861,667,899745.00,698060.00,1597805.00
314820,202006,107,58,49,60610.00,51205.00,111815.00
314830,202006,213,172,41,179740.00,42845.00,222585.00
314840,202006,85,52,33,54340.00,34485.00,88825.00
314850,202006,385,193,192,201685.50,201685.00,403370.50
314860,202006,671,513,158,537130.00,165110.00,702240.00
314870,202006,1535,803,732,841225.50,765985.00,1607210.50
314875,202006,58,50,8,52250.00,8360.00,60610.00
314880,202006,44,30,14,31350.00,14630.00,45980.00
314890,202006,56,33,23,34485.00,24035.00,58520.00
314900,202006,31,24,7,25080.00,7315.00,32395.00
314910,202006,241,158,83,165110.00,86735.00,251845.00
314915,202006,141,127,14,132715.00,15675.00,148390.00
314920,202006,103,63,40,65835.00,41800.00,107635.00
314930,202006,1056,516,540,539220.50,564300.00,1103520.50
314940,202006,47,37,10,38665.00,10450.00,49115.00
314950,202006,29,20,9,20900.00,9405.00,30305.00
314960,202006,37,29,8,30305.00,8360.00,38665.00
314970,202006,148,73,75,76285.00,78375.00,154660.00
314980,202006,312,197,115,205865.00,120175.00,326040.00
314990,202006,446,240,206,250800.00,215270.00,466070.00
314995,202006,208,67,141,70015.00,147345.00,217360.00
315000,202006,93,72,21,75240.00,21945.00,97185.00
315010,202006,43,27,16,28215.00,16720.00,44935.00
315015,202006,173,137,36,143165.00,37620.00,180785.00
315020,202006,73,57,16,59565.00,16720.00,76285.00
315030,202006,114,88,26,91960.50,27170.00,119130.50
315040,202006,70,50,20,52250.00,20900.00,73150.00
315050,202006,183,107,76,111815.00,79420.00,191235.00
315053,202006,45,37,8,38665.00,8360.00,47025.00
315057,202006,104,81,23,84645.00,24035.00,108680.00
315060,202006,75,64,11,66880.80,11495.00,78375.80
315070,202006,104,58,46,60610.00,48070.00,108680.00
315080,202006,378,304,74,317680.00,77330.00,395010.00
315090,202006,95,57,38,59565.00,39710.00,99275.00
315100,202006,84,41,43,42845.00,44935.00,87780.00
315110,202006,274,144,130,150480.00,135850.00,286330.00
315120,202006,1724,839,885,877800.00,931095.20,1808895.20
315130,202006,349,252,97,264385.00,101365.00,365750.00
315140,202006,522,299,223,313500.50,233035.50,546536.00
315150,202006,977,465,512,486970.00,540265.00,1027235.00
315160,202006,217,108,109,112860.00,114950.00,227810.00
315170,202006,320,212,108,221540.50,113905.00,335445.50
315180,202006,3285,1359,1926,1421201.50,2017896.57,3439098.07
315190,202006,325,190,135,199595.00,142120.00,341715.00
315200,202006,1249,738,511,771210.00,536085.00,1307295.00
315210,202006,1660,942,718,984390.00,751355.00,1735745.00
315213,202006,42,23,19,24035.00,19855.00,43890.00
315217,202006,215,168,47,175560.00,49115.00,224675.00
315220,202006,1587,1192,395,1245640.95,413820.00,1659460.95
315230,202006,175,123,52,128535.50,54340.00,182875.50
315240,202006,427,271,156,283195.00,163021.00,446216.00
315250,202006,2579,1262,1317,1320880.00,1378355.50,2699235.50
315260,202006,146,82,64,85690.00,66880.00,152570.00
315270,202006,129,89,40,93005.00,41800.00,134805.00
315280,202006,658,423,235,445170.00,246620.00,691790.00
315290,202006,190,118,72,124355.00,75240.00,199595.00
315300,202006,79,58,21,60610.00,21945.00,82555.00
315310,202006,75,67,8,70015.00,8360.00,78375.00
315320,202006,168,100,68,104500.00,71060.00,175560.00
315330,202006,57,47,10,49115.00,10450.00,59565.00
315340,202006,393,282,111,294690.00,115995.00,410685.00
315350,202006,154,91,63,95095.00,65835.00,160930.00
315360,202006,92,45,47,47025.00,49115.00,96140.00
315370,202006,54,34,20,35530.00,20900.00,56430.00
315380,202006,9,8,1,8360.00,1045.00,9405.00
315390,202006,68,17,51,17765.00,53295.50,71060.50
315400,202006,841,624,217,654170.50,227810.00,881980.50
315410,202006,324,190,134,198550.50,140031.50,338582.00
315415,202006,56,42,14,43890.00,14630.00,58520.00
315420,202006,199,142,57,149435.50,59565.00,209000.50
315430,202006,656,372,284,388740.50,296780.00,685520.50
315440,202006,94,63,31,65835.00,32395.00,98230.00
315445,202006,232,191,41,200640.00,42845.00,243485.00
315450,202006,183,138,45,145255.00,47025.00,192280.00
315460,202006,4055,1956,2099,2047155.00,2198680.00,4245835.00
315470,202006,43,17,26,17765.00,27170.00,44935.00
315480,202006,70,21,49,21945.00,51205.00,73150.00
315490,202006,668,412,256,430540.00,267520.00,698060.00
315500,202006,18,12,6,12540.00,6270.00,18810.00
315510,202006,149,101,48,105545.00,50160.00,155705.00
315520,202006,70,61,9,63745.00,9405.00,73150.00
315530,202006,50,28,22,29260.00,22990.00,52250.00
315540,202006,248,168,80,175560.00,83600.00,259160.00
315550,202006,180,145,35,151525.00,36575.00,188100.00
315560,202006,744,596,148,622820.50,155705.00,778525.50
315570,202006,312,158,154,165112.19,160930.00,326042.19
315580,202006,708,476,232,497420.00,242440.50,739860.50
315590,202006,196,105,91,109725.00,95095.00,204820.00
315600,202006,302,227,75,237215.00,78375.00,315590.00
315610,202006,101,52,49,54340.00,51205.00,105545.00
315620,202006,36,28,8,29260.00,8360.00,37620.00
315630,202006,128,85,43,88825.00,44935.00,133760.00
315640,202006,74,45,29,47025.00,30305.00,77330.00
315645,202006,46,32,14,33440.00,14630.50,48070.50
315650,202006,174,124,50,129580.50,52250.00,181830.50
315660,202006,459,201,258,211090.50,269610.00,480700.50
315670,202006,2390,1144,1246,1197572.00,1304160.00,2501732.00
315680,202006,845,595,250,622820.00,262295.00,885115.00
315690,202006,679,465,214,486971.97,224675.00,711646.97
315700,202006,1899,995,904,1039776.21,946770.00,1986546.21
315710,202006,345,102,243,106590.00,253935.00,360525.00
315720,202006,456,280,176,292600.50,183920.00,476520.50
315725,202006,191,154,37,160930.50,38665.00,199595.50
315727,202006,52,22,30,22990.00,31350.00,54340.00
315730,202006,46,43,3,44935.00,3135.00,48070.00
315733,202006,88,57,31,59565.00,32395.00,91960.00
315737,202006,50,37,13,38665.00,13585.00,52250.00
315740,202006,33,26,7,27170.00,7315.00,34485.00
315750,202006,162,120,42,125400.00,43890.50,169290.50
315760,202006,40,30,10,31350.00,10450.00,41800.00
315765,202006,124,73,51,76285.00,53295.00,129580.00
315770,202006,223,141,82,147345.00,85690.50,233035.50
315780,202006,3516,1754,1762,1835020.75,1843381.49,3678402.24
315790,202006,231,180,51,188100.00,53295.00,241395.00
315800,202006,293,206,87,215270.00,90915.00,306185.00
315810,202006,96,57,39,59565.00,40755.50,100320.50
315820,202006,749,542,207,566390.50,217360.00,783750.50
315830,202006,130,80,50,83600.00,52250.00,135850.00
315840,202006,85,56,29,58520.00,30305.00,88825.00
315850,202006,258,182,76,190190.25,79420.00,269610.25
315860,202006,15,6,9,6270.00,9405.00,15675.00
315870,202006,38,29,9,30305.00,9405.00,39710.00
315880,202006,107,68,39,71060.00,40755.00,111815.00
315890,202006,91,69,22,72105.00,22990.00,95095.00
315895,202006,443,293,150,306185.00,156751.00,462936.00
315900,202006,72,34,38,35530.00,39710.00,75240.00
315910,202006,42,25,17,26125.00,17765.00,43890.00
315920,202006,161,106,55,110770.00,57475.75,168245.75
315930,202006,49,18,31,18810.00,32395.00,51205.00
315935,202006,132,102,30,106590.50,31350.00,137940.50
315940,202006,101,74,27,77330.00,28215.00,105545.00
315950,202006,42,32,10,33440.00,10450.00,43890.00
315960,202006,536,255,281,266475.00,294690.50,561165.50
315970,202006,34,27,7,28215.00,7315.00,35530.00
315980,202006,686,338,348,353210.00,364705.00,717915.00
315990,202006,255,148,107,154660.00,111815.50,266475.50
316000,202006,51,33,18,34485.00,18810.00,53295.00
316010,202006,79,68,11,71060.00,11495.00,82555.00
316020,202006,117,100,17,104500.00,17765.00,122265.00
316030,202006,388,214,174,223630.50,181830.75,405461.25
316040,202006,523,219,304,228855.50,317680.50,546536.00
316045,202006,62,55,7,57475.00,7315.00,64790.00
316050,202006,14,11,3,11495.00,3135.00,14630.00
316060,202006,94,62,32,64790.00,34485.00,99275.00
316070,202006,1089,696,393,727320.75,410685.00,1138005.75
316080,202006,100,67,33,70015.00,34485.00,104500.00
316090,202006,43,21,22,21945.00,22990.00,44935.00
316095,202006,100,82,18,85690.00,18810.00,104500.00
316100,202006,314,180,134,188100.25,141075.00,329175.25
316105,202006,41,28,13,29260.00,13585.00,42845.00
316110,202006,1880,1487,393,1557050.62,411730.00,1968780.62
316120,202006,82,59,23,61655.00,24035.00,85690.00
316130,202006,124,93,31,97185.50,32395.00,129580.50
316140,202006,32,21,11,21945.00,11495.00,33440.00
316150,202006,204,143,61,149435.00,64790.00,214225.00
316160,202006,84,48,36,50160.00,37620.00,87780.00
316165,202006,66,49,17,51205.00,17765.00,68970.00
316170,202006,184,122,62,127490.00,64790.00,192280.00
316180,202006,202,85,117,88825.00,122265.50,211090.50
316190,202006,135,97,38,102410.00,39710.00,142120.00
316200,202006,663,362,301,379335.00,316635.00,695970.00
316210,202006,771,511,260,534174.74,272745.00,806919.74
316220,202006,117,77,40,80465.00,41800.00,122265.00
316225,202006,27,15,12,15675.00,12540.00,28215.00
316230,202006,33,19,14,19855.00,14630.00,34485.00
316240,202006,649,518,131,541310.00,136895.00,678205.00
316245,202006,128,111,17,115995.00,17765.00,133760.00
316250,202006,1533,1038,495,1084711.50,517275.00,1601986.50
316255,202006,128,101,27,105545.00,29260.00,134805.00
316257,202006,180,94,86,98230.00,89870.00,188100.00
316260,202006,195,138,57,145255.25,60610.50,205865.75
316265,202006,27,18,9,18810.00,9405.00,28215.00
316270,202006,684,482,202,504735.50,211090.60,715826.10
316280,202006,554,342,212,358435.29,222586.00,581021.29
316290,202006,750,497,253,519365.65,265430.00,784795.65
316292,202006,514,198,316,206910.00,332310.00,539220.00
316294,202006,99,60,39,62700.00,40755.00,103455.00
316295,202006,312,133,179,138985.50,187055.00,326040.50
316300,202006,105,71,34,74195.00,35530.00,109725.00
316310,202006,30,16,14,16720.00,14630.00,31350.00
316320,202006,50,27,23,28215.00,24035.00,52250.00
316330,202006,160,109,51,113905.25,53295.00,167200.25
316340,202006,134,92,42,96140.00,43890.00,140030.00
316350,202006,192,136,56,142120.74,58520.00,200640.74
316360,202006,19,13,6,13585.00,6270.00,19855.00
316370,202006,1110,570,540,596696.25,564300.00,1160996.25
316380,202006,119,89,30,93005.00,31350.00,124355.00
316390,202006,117,84,33,88825.00,34485.00,123310.00
316400,202006,131,100,31,104500.00,32395.00,136895.00
316410,202006,293,211,82,220495.00,85690.00,306185.00
316420,202006,204,138,66,144210.00,68970.00,213180.00
316430,202006,154,81,73,84645.00,76285.00,160930.00
316440,202006,90,42,48,43890.00,50160.00,94050.00
316443,202006,42,40,2,41800.00,2090.00,43890.00
316447,202006,60,44,16,45980.00,16720.00,62700.00
316450,202006,224,170,54,177650.00,56430.00,234080.00
316460,202006,78,26,52,27170.00,54340.00,81510.00
316470,202006,1687,1233,454,1291613.26,474430.00,1766043.26
316480,202006,12,8,4,8360.00,4180.00,12540.00
316490,202006,18,6,12,6270.00,12540.00,18810.00
316500,202006,150,101,49,106590.00,51205.00,157795.00
316510,202006,155,117,38,122265.00,39710.00,161975.00
316520,202006,198,121,77,126445.00,80465.00,206910.00
316530,202006,163,108,55,112860.00,57475.00,170335.00
316540,202006,140,75,65,78375.00,67925.00,146300.00
316550,202006,129,88,41,91960.00,42845.00,134805.00
316553,202006,296,134,162,140030.00,170335.72,310365.72
316555,202006,41,35,6,36575.00,6270.00,42845.00
316556,202006,12,9,3,9405.00,3135.00,12540.00
316557,202006,22,18,4,18810.00,4180.00,22990.00
316560,202006,68,48,20,50160.00,20900.00,71060.00
316570,202006,217,197,20,205865.00,20900.00,226765.00
316580,202006,18,13,5,13585.00,5225.00,18810.00
316590,202006,104,88,16,91960.00,16720.00,108680.00
316600,202006,179,146,33,152570.50,34485.00,187055.50
316610,202006,65,49,16,51205.00,16720.00,67925.00
316620,202006,140,103,37,107635.00,38665.00,146300.00
316630,202006,44,35,9,36575.00,9405.00,45980.00
316640,202006,22,14,8,14630.00,8360.00,22990.00
316650,202006,74,61,13,63745.00,13585.00,77330.00
316660,202006,8,3,5,3135.00,5225.00,8360.00
316670,202006,442,154,288,160930.00,302005.00,462935.00
316680,202006,159,110,49,114950.00,51205.00,166155.00
316690,202006,188,116,72,121220.00,75240.00,196460.00
316695,202006,63,54,9,56430.00,9405.00,65835.00
316700,202006,17,11,6,11495.00,6270.00,17765.00
316710,202006,782,587,195,613415.25,204820.00,818235.25
316720,202006,5046,2464,2582,2575927.74,2703416.00,5279343.74
316730,202006,17,16,1,16720.00,1045.00,17765.00
316740,202006,139,90,49,94050.00,51205.00,145255.00
316750,202006,18,10,8,10450.00,8360.00,18810.00
316760,202006,327,260,67,272745.00,70015.00,342760.00
316770,202006,159,83,76,86735.00,79420.00,166155.00
316780,202006,70,43,27,44935.00,28215.00,73150.00
316790,202006,52,39,13,40755.00,13585.00,54340.00
316800,202006,1761,1092,669,1141140.00,701195.50,1842335.50
316805,202006,24,16,8,16720.00,8360.00,25080.00
316810,202006,68,44,24,45980.00,25080.00,71060.00
316820,202006,43,21,22,21945.00,22990.00,44935.00
316830,202006,97,43,54,44935.00,56430.00,101365.00
316840,202006,534,306,228,319770.50,239305.00,559075.50
316850,202006,331,221,110,230945.00,114950.00,345895.00
316860,202006,5952,2618,3334,2739993.40,3494480.75,6234474.15
316870,202006,1547,989,558,1035597.25,583110.50,1618707.75
316880,202006,124,61,63,63745.00,65835.00,129580.00
316890,202006,240,165,75,173470.00,78375.00,251845.00
316900,202006,419,295,124,308275.65,130625.00,438900.65
316905,202006,23,11,12,11495.00,12540.00,24035.00
316910,202006,70,27,43,28215.00,44935.00,73150.00
316920,202006,135,108,27,112860.00,28215.00,141075.00
316930,202006,1897,970,927,1014696.50,970805.75,1985502.25
316935,202006,918,556,362,581020.10,379335.50,960355.60
316940,202006,1099,621,478,651035.50,500555.50,1151591.00
316950,202006,177,87,90,90915.00,94050.00,184965.00
316960,202006,1116,624,492,655216.00,517275.00,1172491.00
316970,202006,656,519,137,542355.50,144210.00,686565.50
316980,202006,78,43,35,44935.00,36575.00,81510.00
316990,202006,2176,1451,725,1517340.85,759715.74,2277056.59
317000,202006,335,256,79,267520.00,82555.00,350075.00
317005,202006,239,167,72,174515.00,75240.00,249755.00
317010,202006,6410,3541,2869,3705575.73,3009600.50,6715176.23
317020,202006,16155,7061,9094,7392537.60,9522045.10,16914582.70
317030,202006,80,30,50,31350.00,52250.00,83600.00
317040,202006,3068,1906,1162,1994906.00,1216380.00,3211286.00
317043,202006,75,55,20,57475.00,20900.00,78375.00
317047,202006,31,16,15,16720.00,15675.00,32395.00
317050,202006,163,126,37,131670.00,38665.00,170335.00
317052,202006,135,103,32,107635.00,33440.00,141075.00
317057,202006,170,131,39,136895.00,40755.00,177650.00
317060,202006,63,39,24,40755.00,26125.00,66880.00
317065,202006,56,45,11,47025.00,11495.00,58520.00
317070,202006,1967,902,1065,943635.75,1115015.50,2058651.25
317075,202006,108,58,50,60610.00,52250.00,112860.00
317080,202006,925,470,455,492195.75,475475.00,967670.75
317090,202006,659,524,135,547580.00,141075.00,688655.00
317100,202006,430,323,107,337535.00,111815.00,449350.00
317103,202006,103,83,20,86735.00,20900.00,107635.00
317107,202006,44,39,5,40755.00,5225.00,45980.00
317110,202006,115,50,65,52250.00,67925.00,120175.00
317115,202006,42,36,6,37620.00,6270.00,43890.00
317120,202006,1931,934,997,977076.50,1042910.50,2019987.00
317130,202006,1976,1311,665,1372086.00,697015.00,2069101.00
317140,202006,8,6,2,7315.00,2090.00,9405.00
317150,202006,262,154,108,160930.50,112860.00,273790.50
317160,202006,317,237,80,247665.79,83600.00,331265.79
317170,202006,220,149,71,155705.00,74195.00,229900.00
317180,202006,442,304,138,318725.00,144210.00,462935.00
317190,202006,265,185,80,193325.00,83600.00,276925.00
317200,202006,823,577,246,602967.90,257070.00,860037.90
317210,202006,186,101,85,105545.00,88825.00,194370.00
317220,202006,24,13,11,13585.00,11495.00,25080.00
320010,202006,605,440,165,459800.25,172425.00,632225.25
320013,202006,126,90,36,94050.00,37620.00,131670.00
320016,202006,272,171,101,178695.00,106590.00,285285.00
320020,202006,712,416,296,434722.37,310365.00,745087.37
320030,202006,151,105,46,109725.00,48070.27,157795.27
320035,202006,141,103,38,107635.00,39710.00,147345.00
320040,202006,490,249,241,261250.00,252890.00,514140.00
320050,202006,108,76,32,79420.00,33440.00,112860.00
320060,202006,1670,789,881,826595.25,920646.75,1747242.00
320070,202006,102,64,38,66880.00,39710.00,106590.00
320080,202006,799,458,341,478610.75,357390.00,836000.75
320090,202006,1242,835,407,872575.00,426360.00,1298935.00
320100,202006,333,189,144,197505.00,150480.00,347985.00
320110,202006,124,80,44,83601.25,45980.00,129581.25
320115,202006,111,91,20,95095.00,20900.00,115995.00
320120,202006,3452,1844,1608,1930117.65,1686630.50,3616748.15
320130,202006,7526,3397,4129,3554047.52,4325256.50,7879304.02
320140,202006,438,289,149,302005.00,156751.16,458756.16
320150,202006,2066,1158,908,1210110.75,950950.00,2161060.75
320160,202006,657,300,357,313500.00,373065.50,686565.50
320170,202006,110,89,21,93005.00,21945.00,114950.00
320180,202006,53,31,22,32395.00,22990.00,55385.00
320190,202006,243,154,89,160930.00,93005.00,253935.00
320200,202006,59,44,15,45980.00,15675.00,61655.00
320210,202006,899,493,406,515186.00,425315.50,940501.50
320220,202006,301,105,196,109725.00,204820.00,314545.00
320225,202006,86,67,19,70015.00,19855.00,89870.00
320230,202006,617,388,229,405460.00,240350.00,645810.00
320240,202006,3275,1581,1694,1653192.50,1773365.50,3426558.00
320245,202006,472,319,153,333355.50,160930.00,494285.50
320250,202006,230,116,114,121220.00,119130.00,240350.00
320255,202006,147,114,33,119130.00,35530.00,154660.00
320260,202006,208,143,65,149435.12,67925.08,217360.20
320265,202006,167,131,36,136895.00,37620.00,174515.00
320270,202006,156,123,33,128535.00,34485.00,163020.00
320280,202006,1043,591,452,617596.07,473385.00,1090981.07
320290,202006,58,50,8,52250.00,8360.00,60610.00
320300,202006,577,396,181,413821.35,189146.60,602967.95
320305,202006,683,369,314,386650.00,329175.50,715825.50
320310,202006,199,112,87,119130.90,90915.00,210045.90
320313,202006,331,163,168,170335.25,175561.00,345896.25
320316,202006,111,86,25,90915.00,26125.00,117040.00
320320,202006,3462,1555,1907,1626021.15,1992881.88,3618903.03
320330,202006,256,193,63,201685.00,65835.00,267520.00
320332,202006,835,514,321,537131.50,338580.25,875711.75
320334,202006,243,146,97,152570.52,101365.00,253935.52
320335,202006,146,100,46,104500.00,48070.00,152570.00
320340,202006,554,385,169,402325.75,176605.34,578931.09
320350,202006,983,422,561,442035.97,588335.50,1030371.47
320360,202006,166,91,75,95095.00,78375.00,173470.00
320370,202006,241,181,60,189145.90,62700.50,251846.40
320380,202006,283,197,86,206910.50,89870.00,296780.50
320390,202006,1159,693,466,724185.00,486970.50,1211155.50
320400,202006,311,229,82,239305.28,85690.00,324995.28
320405,202006,959,401,558,422180.25,583110.50,1005290.75
320410,202006,995,505,490,527725.00,514140.25,1041865.25
320420,202006,507,242,265,252890.75,276925.00,529815.75
320425,202006,187,101,86,105545.00,89870.00,195415.00
320430,202006,387,212,175,221540.25,182875.00,404415.25
320435,202006,155,104,51,108680.00,53295.00,161975.00
320440,202006,195,113,82,118085.16,85690.14,203775.30
320450,202006,128,67,61,70015.00,63745.00,133760.00
320455,202006,252,205,47,214225.50,49115.00,263340.50
320460,202006,271,166,105,173470.00,109725.00,283195.00
320465,202006,116,78,38,81510.00,39710.00,121220.00
320470,202006,699,424,275,443080.50,287375.00,730455.50
320480,202006,198,129,69,134805.00,72105.25,206910.25
320490,202006,3088,1520,1568,1588401.26,1642743.73,3231144.99
320495,202006,112,70,42,73150.00,43891.00,117041.00
320500,202006,9695,4752,4943,4971580.30,5184250.95,10155831.25
320501,202006,554,283,271,295735.00,283195.00,578930.00
320503,202006,290,203,87,212135.08,91960.02,304095.10
320506,202006,261,185,76,193325.00,79420.00,272745.00
320510,202006,1035,461,574,481745.00,602965.00,1084710.00
320515,202006,85,67,18,70015.00,18810.00,88825.00
320517,202006,210,149,61,155705.00,63745.00,219450.00
320520,202006,6983,2999,3984,3145452.08,4175823.00,7321275.08
320530,202006,6139,3030,3109,3173667.22,3264580.50,6438247.72
330010,202006,3135,1584,1551,1659462.50,1620795.00,3280257.50
330015,202006,166,67,99,71060.90,103455.00,174515.90
330020,202006,3696,1569,2127,1644831.10,2225850.00,3870681.10
330022,202006,247,125,122,130625.00,127490.00,258115.00
330023,202006,609,192,417,200640.00,435765.00,636405.00
330025,202006,570,110,460,114950.00,480700.00,595650.00
330030,202006,1926,1223,703,1279080.62,735680.50,2014761.12
330040,202006,2445,1248,1197,1307295.50,1254000.50,2561296.00
330045,202006,8907,2703,6204,2828816.00,6494675.00,9323491.00
330050,202006,890,568,322,594605.00,336490.00,931095.00
330060,202006,1008,599,409,625956.25,428450.00,1054406.25
330070,202006,3682,1319,2363,1379400.40,2476650.50,3856050.90
330080,202006,1594,703,891,735680.75,931095.00,1666775.75
330090,202006,375,220,155,231990.00,161975.00,393965.00
330093,202006,263,116,147,122265.00,153615.00,275880.00
330095,202006,80,46,34,48070.00,36575.00,84645.00
330100,202006,9897,4947,4950,5175887.67,5184246.25,10360133.92
330110,202006,479,205,274,215270.75,287375.00,502645.75
330115,202006,532,277,255,289465.00,266475.00,555940.00
330120,202006,378,195,183,204820.00,191236.00,396056.00
330130,202006,1537,382,1155,399190.00,1208020.00,1607210.00
330140,202006,612,323,289,337535.00,305140.00,642675.00
330150,202006,508,294,214,309320.00,224675.00,533995.00
330160,202006,212,125,87,130625.00,90915.00,221540.00
330170,202006,27388,9187,18201,9611913.10,19054535.30,28666448.40
330180,202006,243,145,98,152570.00,104500.00,257070.00
330185,202006,961,337,624,352165.00,653125.00,1005290.00
330187,202006,364,111,253,115995.00,266475.00,382470.00
330190,202006,5772,2201,3571,2300046.90,3742145.50,6042192.40
330200,202006,4735,1403,3332,1467181.81,3487165.50,4954347.31
330205,202006,440,257,183,268565.00,191235.50,459800.50
330210,202006,984,601,383,628045.00,402326.00,1030371.00
330220,202006,2670,1585,1085,1658415.20,1134870.50,2793285.70
330225,202006,570,292,278,306185.00,290510.00,596695.00
330227,202006,2436,729,1707,762850.00,1787995.25,2550845.25
330230,202006,250,145,105,151525.00,110770.00,262295.00
330240,202006,3879,1909,1970,2000130.75,2060742.00,4060872.75
330245,202006,147,66,81,68970.10,84645.00,153615.10
330250,202006,6703,3375,3328,3531056.25,3484032.02,7015088.27
330260,202006,595,156,439,163020.00,459800.00,622820.00
330270,202006,3587,1208,2379,1262360.00,2495461.00,3757821.00
330280,202006,455,287,168,299915.50,176605.45,476520.95
330285,202006,7082,2200,4882,2301090.75,5107962.25,7409053.00
330290,202006,651,235,416,246620.25,434720.00,681340.25
330300,202006,766,493,273,515185.75,286330.00,801515.75
330310,202006,447,247,200,259160.75,209000.00,468160.75
330320,202006,7917,2930,4987,3066031.49,5219777.00,8285808.49
330330,202006,9023,3408,5615,3566586.75,5882306.29,9448893.04
330340,202006,2695,1581,1114,1653190.00,1166220.50,2819410.50
330350,202006,18580,7086,11494,7410101.15,12040496.88,19450598.03
330360,202006,2268,1093,1175,1143231.55,1229965.00,2373196.55
330370,202006,1031,514,517,537132.00,540265.00,1077397.00
330380,202006,894,379,515,397100.00,539220.01,936320.01
330385,202006,636,321,315,337535.25,331265.00,668800.25
330390,202006,5619,2964,2655,3104696.00,2778655.50,5883351.50
330395,202006,319,194,125,203775.00,130625.75,334400.75
330400,202006,715,374,341,390830.00,356345.00,747175.00
330410,202006,508,367,141,383515.25,147345.50,530860.75
330411,202006,258,139,119,145255.55,125400.00,270655.55
330412,202006,243,97,146,102410.50,153615.00,256025.50
330414,202006,5440,2187,3253,2287507.70,3408790.50,5696298.20
330415,202006,603,263,340,274836.50,356345.00,631181.50
330420,202006,2227,1140,1087,1193391.55,1135915.50,2329307.05
330430,202006,1795,810,985,848541.00,1032462.50,1881003.50
330440,202006,287,138,149,145255.00,155705.00,300960.00
330450,202006,124,54,70,56430.00,73150.00,129580.00
330452,202006,2036,884,1152,924825.00,1205930.50,2130755.50
330455,202006,112863,39279,73584,41101067.01,77061457.62,118162524.63
330460,202006,263,111,152,115995.00,158840.00,274835.00
330470,202006,1231,668,563,703287.00,589381.75,1292668.75
330475,202006,1518,398,1120,415910.00,1175625.00,1591535.00
330480,202006,811,431,380,450395.00,398145.00,848540.00
330490,202006,14618,4688,9930,4910456.25,10397751.50,15308207.75
330500,202006,1423,608,815,636405.00,854810.14,1491215.14
330510,202006,10936,3732,7204,3904122.15,7549081.75,11453203.90
330513,202006,102,52,50,54340.00,52250.00,106590.00
330515,202006,824,337,487,352166.25,508915.50,861081.75
330520,202006,2503,881,1622,922735.35,1701260.00,2623995.35
330530,202006,206,116,90,121220.25,94050.00,215270.25
330540,202006,377,181,196,190190.50,205865.50,396056.00
330550,202006,2909,1007,1902,1052315.70,1989681.00,3041996.70
330555,202006,807,313,494,328130.00,518320.00,846450.00
330560,202006,697,223,474,233035.00,495330.00,728365.00
330570,202006,269,194,75,202730.00,78375.00,281105.00
330575,202006,789,290,499,304095.00,524592.25,828687.25
330580,202006,3409,1891,1518,1980277.62,1589446.00,3569723.62
330590,202006,290,147,143,154660.09,149435.00,304095.09
330600,202006,1191,745,446,780616.00,468160.00,1248776.00
330610,202006,1595,846,749,885117.75,783750.75,1668868.50
330615,202006,211,164,47,171380.00,49115.00,220495.00
330620,202006,1077,420,657,438900.00,686565.00,1125465.00
330630,202006,4125,2560,1565,2676245.94,1638561.25,4314807.19
350010,202006,594,394,200,412776.81,209000.00,621776.81
350020,202006,52,22,30,22990.00,31350.00,54340.00
350030,202006,513,317,196,333355.50,205865.50,539221.00
350040,202006,124,50,74,52250.00,77330.00,129580.00
350050,202006,303,158,145,166155.00,151525.00,317680.00
350055,202006,94,49,45,51205.00,47025.00,98230.00
350060,202006,90,32,58,33440.00,60610.00,94050.00
350070,202006,801,469,332,491150.49,347985.50,839135.99
350075,202006,73,49,24,51205.00,25080.00,76285.00
350080,202006,61,29,32,30305.00,33440.00,63745.00
350090,202006,82,49,33,51205.00,34485.00,85690.00
350100,202006,284,173,111,181830.00,115995.00,297825.00
350110,202006,62,43,19,44935.00,19855.00,64790.00
350115,202006,145,88,57,93005.00,59565.00,152570.00
350120,202006,111,69,42,72105.00,43890.00,115995.00
350130,202006,370,164,206,171380.03,216315.00,387695.03
350140,202006,42,27,15,28215.00,15675.00,43890.00
350150,202006,72,55,17,57475.00,17765.00,75240.00
350160,202006,2466,954,1512,1001111.00,1585265.00,2586376.00
350170,202006,386,226,160,236171.85,168245.50,404417.35
350180,202006,168,97,71,101365.00,75240.50,176605.50
350190,202006,1009,526,483,550715.29,504736.00,1055451.29
350200,202006,69,25,44,26125.00,45980.00,72105.00
350210,202006,1300,726,574,761806.50,601920.29,1363726.79
350220,202006,673,553,120,579975.29,125400.00,705375.29
350230,202006,74,51,23,53295.00,24035.00,77330.00
350240,202006,60,42,18,43890.00,18810.00,62700.00
350250,202006,1144,542,602,566391.00,630136.25,1196527.25
350260,202006,94,69,25,72105.50,26125.00,98230.50
350270,202006,875,578,297,604011.00,311410.50,915421.50
350275,202006,302,126,176,131670.00,186010.00,317680.00
350280,202006,4615,2339,2276,2448439.40,2380510.00,4828949.40
350290,202006,449,202,247,211090.00,258115.50,469205.50
350300,202006,54,28,26,29260.00,27170.00,56430.00
350310,202006,86,55,31,57475.00,32395.00,89870.00
350315,202006,50,26,24,27170.00,25080.00,52250.00
350320,202006,3325,1615,1710,1689765.50,1793220.00,3482985.50
350330,202006,1685,897,788,938412.12,824506.00,1762918.12
350335,202006,16,11,5,12540.00,5225.00,17765.00
350340,202006,121,54,67,56430.00,70015.75,126445.75
350350,202006,88,43,45,45980.00,47025.00,93005.00
350360,202006,117,77,40,80465.00,41800.00,122265.00
350370,202006,85,50,35,53295.29,36575.00,89870.29
350380,202006,778,332,446,346940.00,467116.00,814056.00
350390,202006,1583,604,979,631180.37,1025145.50,1656325.87
350395,202006,24,19,5,19855.00,5225.00,25080.00
350400,202006,1703,860,843,899747.12,884070.29,1783817.41
350410,202006,2676,1150,1526,1202795.00,1596779.29,2799574.29
350420,202006,251,152,99,158840.79,103455.00,262295.79
350430,202006,74,43,31,45980.00,32395.00,78375.00
350440,202006,154,113,41,118085.50,42845.50,160931.00
350450,202006,1633,961,672,1007380.56,705376.00,1712756.56
350460,202006,397,127,270,132715.00,282150.00,414865.00
350470,202006,21,10,11,10450.00,11495.00,21945.00
350480,202006,177,100,77,104500.00,80465.00,184965.00
350490,202006,231,113,118,118085.00,124355.00,242440.00
350500,202006,48,19,29,19855.00,30305.00,50160.00
350510,202006,167,110,57,115995.00,59565.00,175560.00
350520,202006,457,230,227,240350.00,237215.00,477565.00
350530,202006,442,203,239,213180.00,249755.00,462935.00
350535,202006,82,65,17,67925.00,17765.00,85690.00
350540,202006,378,191,187,199595.00,198550.00,398145.00
350550,202006,2730,1611,1119,1688720.00,1172491.08,2861211.08
350560,202006,627,428,199,447260.00,207955.00,655215.00
350570,202006,4204,1718,2486,1798446.79,2606231.35,4404678.14
350580,202006,368,180,188,188100.00,197505.00,385605.00
350590,202006,909,496,413,518320.50,433675.00,951995.50
350600,202006,6116,2924,3192,3063942.75,3342955.50,6406898.25
350610,202006,1518,785,733,821370.29,768075.00,1589445.29
350620,202006,31,21,10,21945.00,11495.00,33440.00
350630,202006,244,138,106,144210.29,111815.29,256025.58
350635,202006,977,381,596,399191.35,625955.50,1025146.85
350640,202006,122,92,30,96140.00,31350.00,127490.00
350650,202006,1888,1254,634,1312520.95,665665.00,1978185.95
350660,202006,752,313,439,327085.00,462935.00,790020.00
350670,202006,310,153,157,159885.00,164065.00,323950.00
350680,202006,178,93,85,97185.00,89871.00,187056.00
350690,202006,195,97,98,103455.00,102410.00,205865.00
350700,202006,792,377,415,393966.00,434720.00,828686.00
350710,202006,383,141,242,148390.00,254980.00,403370.00
350715,202006,55,44,11,45980.00,11495.00,57475.00
350720,202006,19,13,6,13585.00,6270.00,19855.00
350730,202006,46,30,16,31350.00,16720.00,48070.00
350740,202006,219,125,94,130625.00,98230.00,228855.00
350745,202006,25,11,14,11495.00,14630.00,26125.00
350750,202006,2217,1367,850,1431650.75,890340.00,2321990.75
350760,202006,3757,1614,2143,1687675.59,2241525.00,3929200.59
350770,202006,61,44,17,45980.00,17765.00,63745.00
350775,202006,44,33,11,34485.00,11495.00,45980.00
350780,202006,432,222,210,231990.00,219450.00,451440.00
350790,202006,374,155,219,163020.00,228855.00,391875.00
350800,202006,476,278,198,290510.00,206910.00,497420.00
350810,202006,521,418,103,437855.75,107635.00,545490.75
350820,202006,88,51,37,53295.00,38665.00,91960.00
350830,202006,78,39,39,40755.00,40755.00,81510.00
350840,202006,775,308,467,321860.50,489060.85,810921.35
350850,202006,1743,964,779,1008425.50,817190.50,1825616.00
350860,202006,598,334,264,349030.75,275880.00,624910.75
350870,202006,427,285,142,297825.00,148390.00,446215.00
350880,202006,289,162,127,171380.25,132715.00,304095.25
350890,202006,38,25,13,26125.00,13585.00,39710.00
350900,202006,1469,458,1011,479655.75,1060675.29,1540331.04
350910,202006,30,17,13,17765.00,13585.00,31350.00
350920,202006,697,365,332,381425.00,350075.00,731500.00
350925,202006,1217,644,573,674026.45,598787.39,1272813.84
350930,202006,101,60,41,62700.00,42845.00,105545.00
350940,202006,715,395,320,412775.00,336490.00,749265.00
350945,202006,109,78,31,81510.00,32395.00,113905.00
350950,202006,16486,7669,8817,8024560.88,9244072.25,17268633.13
350960,202006,1396,627,769,655215.00,806740.00,1461955.00
350970,202006,1105,576,529,601809.19,552805.50,1154614.69
350980,202006,98,66,32,68970.00,33440.00,102410.00
350990,202006,375,133,242,138985.00,252890.00,391875.00
350995,202006,36,17,19,17765.00,19855.00,37620.00
351000,202006,639,433,206,452485.58,215270.00,667755.58
351010,202006,52,31,21,32395.00,21945.00,54340.00
351015,202006,49,34,15,35530.00,15675.00,51205.00
351020,202006,1584,952,632,996930.50,662530.00,1659460.50
351030,202006,340,221,119,231990.00,124355.00,356345.00
351040,202006,901,464,437,484880.95,458755.89,943636.84
351050,202006,3346,1505,1841,1575863.30,1928025.00,3503888.30
351060,202006,5342,2062,3280,2154791.70,3435960.00,5590751.70
351070,202006,406,256,150,267521.64,156750.00,424271.64
351080,202006,728,531,197,554895.50,207955.00,762850.50
351090,202006,55,24,31,25080.00,32395.00,57475.00
351100,202006,438,249,189,260205.70,197505.00,457710.70
351110,202006,2058,970,1088,1015741.31,1141140.50,2156881.81
351120,202006,67,35,32,36575.00,33440.00,70015.00
351130,202006,197,59,138,61655.00,144210.00,205865.00
351140,202006,319,215,104,224675.00,108680.00,333355.00
351150,202006,439,229,210,239305.75,220495.50,459801.25
351160,202006,270,180,90,188100.50,96140.00,284240.50
351170,202006,189,98,91,102410.00,96140.00,198550.00
351190,202006,89,62,27,64790.00,28215.00,93005.00
351200,202006,366,243,123,253935.50,128535.00,382470.50
351210,202006,115,58,57,60610.00,59565.00,120175.00
351220,202006,539,322,217,336491.91,226765.00,563256.91
351230,202006,273,188,85,196460.00,88825.00,285285.00
351240,202006,241,115,126,120175.00,131670.00,251845.00
351250,202006,81,58,23,60610.57,24035.00,84645.57
351260,202006,149,111,38,115995.00,39710.00,155705.00
351270,202006,46,19,27,19855.00,28215.00,48070.00
351280,202006,1004,449,555,469205.29,582065.79,1051271.08
351290,202006,253,108,145,112860.00,152570.50,265430.50
351300,202006,3788,1655,2133,1735664.61,2235255.29,3970919.90
351310,202006,766,380,386,398145.00,407550.00,805695.00
351320,202006,114,67,47,70015.29,49115.00,119130.29
351330,202006,41,26,15,27170.00,15675.00,42845.00
351340,202006,1257,735,522,768076.00,546535.00,1314611.00
351350,202006,2413,1391,1022,1455686.25,1070080.00,2525766.25
351360,202006,782,374,408,390830.00,426360.00,817190.00
351370,202006,393,197,196,205865.50,205865.00,411730.50
351380,202006,9062,4057,5005,4245841.35,5244856.79,9490698.14
351385,202006,27,17,10,17765.00,10450.00,28215.00
351390,202006,274,205,69,214225.35,72105.00,286330.35
351400,202006,67,43,24,44935.00,25080.00,70015.00
351410,202006,434,274,160,286330.77,168245.00,454575.77
351420,202006,69,52,17,54340.00,17765.00,72105.00
351430,202006,70,39,31,40755.00,32395.00,73150.00
351440,202006,793,552,241,577887.33,251845.00,829732.33
351450,202006,265,130,135,135850.00,141075.00,276925.00
351460,202006,127,56,71,58520.00,74195.00,132715.00
351470,202006,142,78,64,81510.00,66880.00,148390.00
351480,202006,499,284,215,296780.79,225720.00,522500.79
351490,202006,290,107,183,111815.00,191235.00,303050.00
351492,202006,28,20,8,20900.00,8360.00,29260.00
351495,202006,25,18,7,18810.00,7315.00,26125.00
351500,202006,3555,1481,2074,1548691.35,2173601.90,3722293.25
351510,202006,1938,739,1199,774346.00,1254000.50,2028346.50
351512,202006,19,14,5,14630.00,5225.00,19855.00
351515,202006,186,106,80,111815.00,85690.00,197505.00
351518,202006,750,470,280,492195.00,293645.00,785840.00
351519,202006,80,48,32,50160.00,33440.00,83600.00
351520,202006,153,92,61,96140.00,63745.00,159885.00
351530,202006,24,14,10,14630.00,10450.00,25080.00
351535,202006,130,75,55,79420.00,57475.00,136895.00
351540,202006,446,320,126,334400.05,132715.00,467115.05
351550,202006,1414,843,571,881982.08,597740.00,1479722.08
351560,202006,72,41,31,42845.00,32395.00,75240.00
351565,202006,9,7,2,7315.00,2090.00,9405.00
351570,202006,2728,1326,1402,1389850.50,1467180.00,2857030.50
351580,202006,39,34,5,35530.00,5225.00,40755.00
351590,202006,64,41,23,42845.00,24035.00,66880.00
351600,202006,184,133,51,138985.00,53295.00,192280.00
351610,202006,45,21,24,21945.00,25080.00,47025.00
351620,202006,5894,3291,2603,3446413.50,2729540.75,6175954.25
351630,202006,2835,1396,1439,1460911.00,1511070.00,2971981.00
351640,202006,2013,936,1077,979165.02,1134871.29,2114036.31
351650,202006,27,23,4,24035.00,4180.00,28215.00
351660,202006,141,92,49,96140.00,51205.00,147345.00
351670,202006,716,445,271,465026.50,284240.00,749266.50
351680,202006,72,61,11,63745.00,11495.00,75240.00
351685,202006,28,16,12,16720.00,12540.00,29260.00
351690,202006,300,204,96,213180.37,100320.00,313500.37
351700,202006,159,108,51,112860.50,53295.00,166155.50
351710,202006,69,46,23,48070.00,24035.00,72105.00
351720,202006,135,76,59,79420.00,61655.00,141075.00
351730,202006,109,72,37,75240.00,38665.29,113905.29
351740,202006,728,470,258,493240.89,269610.00,762850.89
351750,202006,353,144,209,151525.00,219450.00,370975.00
351760,202006,768,581,187,608190.00,198550.00,806740.00
351770,202006,307,259,48,270655.29,50160.00,320815.29
351780,202006,157,93,64,97185.00,66880.00,164065.00
351790,202006,256,136,120,142120.00,125400.75,267520.75
351800,202006,39,24,15,25080.00,15675.00,40755.00
351810,202006,123,83,40,86735.00,41800.00,128535.00
351820,202006,820,593,227,619685.50,238260.00,857945.50
351830,202006,551,193,358,203775.00,375155.00,578930.00
351840,202006,1923,935,988,978121.60,1033505.50,2011627.10
351850,202006,239,170,69,177650.00,72105.00,249755.00
351860,202006,661,459,202,480700.45,211090.00,691790.45
351870,202006,5603,2604,2999,2724317.60,3148585.62,5872903.22
351880,202006,19533,7946,11587,8316113.00,12144992.10,20461105.10
351885,202006,84,53,31,55385.00,32395.00,87780.00
351890,202006,72,59,13,61655.00,13585.00,75240.00
351900,202006,229,131,98,136895.00,102410.00,239305.00
351905,202006,81,32,49,33440.00,51205.00,84645.00
351907,202006,3460,1427,2033,1493306.35,2128665.50,3621971.85
351910,202006,182,76,106,79420.00,110770.00,190190.00
351920,202006,122,68,54,71060.00,56430.00,127490.00
351925,202006,91,59,32,61655.00,33440.00,95095.00
351930,202006,397,254,143,265430.00,149435.00,414865.00
351940,202006,239,105,134,109725.00,141075.00,250800.00
351950,202006,133,72,61,75240.00,63745.00,138985.00
351960,202006,922,450,472,471622.37,493240.50,964862.87
351970,202006,1911,995,916,1040820.50,959310.50,2000131.00
351980,202006,157,75,82,78375.00,85690.00,164065.00
351990,202006,260,170,90,177651.00,94050.00,271701.00
352000,202006,346,222,124,231990.50,130625.00,362615.50
352010,202006,395,251,144,263340.00,150480.00,413820.00
352020,202006,188,69,119,74195.00,124355.00,198550.00
352030,202006,1100,554,546,578930.00,571615.00,1150545.00
352040,202006,580,239,341,249755.00,358435.00,608190.00
352042,202006,288,86,202,90915.00,211091.00,302006.00
352044,202006,358,221,137,230945.00,143165.00,374110.00
352050,202006,3222,1249,1973,1307297.14,2068055.50,3375352.64
352060,202006,107,65,42,67925.00,43890.00,111815.00
352070,202006,93,69,24,72105.58,25080.00,97185.58
352080,202006,67,43,24,44935.00,25080.00,70015.00
352090,202006,160,107,53,111815.00,55385.00,167200.00
352100,202006,287,136,151,142120.50,157795.50,299916.00
352110,202006,113,34,79,36575.00,82555.00,119130.00
352115,202006,62,20,42,20900.00,43890.00,64790.00
352120,202006,87,60,27,62700.29,28215.00,90915.29
352130,202006,219,184,35,193325.00,38665.00,231990.00
352140,202006,186,87,99,90915.00,104500.00,195415.00
352150,202006,120,62,58,64790.00,60610.00,125400.00
352160,202006,141,89,52,93005.00,54340.00,147345.00
352170,202006,390,266,124,277970.00,129580.00,407550.00
352180,202006,620,395,225,413820.29,237215.00,651035.29
352190,202006,243,99,144,103455.00,150480.00,253935.00
352200,202006,30,15,15,15675.00,15675.00,31350.00
352210,202006,4124,1680,2444,1758737.00,2560250.50,4318987.50
352215,202006,59,33,26,34485.00,27170.00,61655.00
352220,202006,6747,2533,4214,2648031.55,4417217.19,7065248.74
352230,202006,3335,2151,1184,2249886.70,1243551.62,3493438.32
352240,202006,2470,1405,1065,1470315.50,1113970.50,2584286.00
352250,202006,2779,1325,1454,1385671.58,1521520.00,2907191.58
352260,202006,985,507,478,531905.50,499510.50,1031416.00
352265,202006,57,28,29,29260.00,30305.00,59565.00
352270,202006,401,231,170,242440.00,177650.25,420090.25
352280,202006,449,282,167,294690.58,175560.00,470250.58
352290,202006,172,103,69,107635.00,72105.00,179740.00
352300,202006,93,66,27,68970.00,28215.00,97185.00
352310,202006,6406,2837,3569,2968846.19,3739010.30,6707856.49
352320,202006,1033,542,491,566391.00,513095.00,1079486.00
352330,202006,546,264,282,275880.00,299915.50,575795.50
352340,202006,1356,618,738,649992.00,774347.00,1424339.00
352350,202006,346,206,140,216315.00,146300.50,362615.50
352360,202006,220,99,121,104500.00,126445.00,230945.00
352370,202006,104,68,36,72105.00,37620.00,109725.00
352380,202006,117,75,42,78375.00,43890.00,122265.00
352390,202006,2458,1041,1417,1088890.50,1482856.30,2571746.80
352400,202006,497,217,280,226765.00,293645.50,520410.50
352410,202006,862,603,259,630135.29,270655.00,900790.29
352420,202006,97,67,30,70015.00,31350.00,101365.00
352430,202006,1754,801,953,838091.87,996930.58,1835022.45
352440,202006,3229,1594,1635,1667821.60,1711710.00,3379531.60
352450,202006,198,162,36,169290.00,37620.00,206910.00
352460,202006,624,317,307,332310.00,321860.00,654170.00
352470,202006,653,221,432,230945.00,452485.00,683430.00
352480,202006,1424,786,638,823460.00,669845.50,1493305.50
352490,202006,63,24,39,25080.00,40755.00,65835.00
352500,202006,1237,523,714,547580.85,747175.50,1294756.35
352510,202006,732,391,341,408595.58,356345.00,764940.58
352520,202006,669,322,347,336490.00,364705.00,701195.00
352530,202006,1757,917,840,958265.00,879890.50,1838155.50
352540,202006,74,47,27,49115.00,28215.00,77330.00
352550,202006,192,114,78,119130.00,81510.00,200640.00
352560,202006,49,39,10,40755.00,10450.00,51205.00
352570,202006,679,345,334,362615.29,349030.00,711645.29
352580,202006,57,43,14,44935.00,14630.00,59565.00
352585,202006,20,6,14,6270.00,14630.00,20900.00
352590,202006,4434,2202,2232,2302135.79,2343936.00,4646071.79
352600,202006,348,250,98,261250.00,102410.00,363660.00
352610,202006,947,433,514,452485.67,538175.00,990660.67
352620,202006,1039,403,636,423225.00,667755.00,1090980.00
352630,202006,175,62,113,64790.00,118085.00,182875.00
352640,202006,521,351,170,367840.00,177650.00,545490.00
352650,202006,86,62,24,64790.00,25080.00,89870.00
352660,202006,65,39,26,40755.00,27170.00,67925.00
352670,202006,1663,890,773,931096.32,808830.00,1739926.32
352680,202006,931,583,348,610280.00,364705.00,974985.00
352690,202006,4563,2049,2514,2145387.38,2641760.29,4787147.67
352700,202006,102,61,41,64790.72,42845.00,107635.72
352710,202006,1381,728,653,762850.00,682385.00,1445235.00
352720,202006,1376,629,747,658350.00,783750.50,1442100.50
352725,202006,23,18,5,18810.00,5225.00,24035.00
352730,202006,395,197,198,209000.00,206910.00,415910.00
352740,202006,420,267,153,279016.90,160930.11,439947.01
352750,202006,19,12,7,12540.00,7315.00,19855.00
352760,202006,178,116,62,121220.00,64790.00,186010.00
352770,202006,88,65,23,67925.00,24035.00,91960.00
352780,202006,80,43,37,44935.00,38665.00,83600.00
352790,202006,25,20,5,20900.00,5225.00,26125.00
352800,202006,236,173,63,180785.00,65835.00,246620.00
352810,202006,155,95,60,99275.50,62700.00,161975.50
352820,202006,60,47,13,49115.00,13585.00,62700.00
352830,202006,78,53,25,55385.00,26125.00,81510.00
352840,202006,664,329,335,343805.25,350075.00,693880.25
352850,202006,1543,500,1043,523545.00,1089935.50,1613480.50
352860,202006,117,75,42,78375.00,43890.00,122265.00
352870,202006,47,31,16,32395.00,17765.00,50160.00
352880,202006,181,121,60,126445.00,63745.00,190190.00
352885,202006,32,22,10,22990.00,10450.00,33440.00
352890,202006,53,35,18,36575.00,18810.50,55385.50
352900,202006,4805,2325,2480,2433806.90,2598916.09,5032722.99
352910,202006,36,29,7,30305.00,7315.00,37620.00
352920,202006,662,399,263,416955.50,274835.00,691790.50
352930,202006,1231,590,641,616550.50,671935.75,1288486.25
352940,202006,6178,2529,3649,2648080.07,3820520.50,6468600.57
352950,202006,113,43,70,44935.00,73150.00,118085.00
352960,202006,58,40,18,41800.00,18810.00,60610.00
352965,202006,18,9,9,9405.00,9405.00,18810.00
352970,202006,515,392,123,409640.23,128535.00,538175.23
352980,202006,158,88,70,91960.00,74195.00,166155.00
352990,202006,999,454,545,474430.00,571615.00,1046045.00
353000,202006,66,29,37,30305.00,38665.00,68970.00
353010,202006,545,338,207,353210.00,216315.00,569525.00
353020,202006,299,216,83,226765.00,86735.00,313500.00
353030,202006,1263,574,689,600875.85,720005.00,1320880.85
353040,202006,84,53,31,55385.00,32395.00,87780.00
353050,202006,1332,863,469,902881.19,491150.00,1394031.19
353060,202006,8464,3649,4815,3818435.61,5046305.00,8864740.61
353070,202006,1763,1083,680,1138006.33,710413.99,1848420.32
353080,202006,1287,692,595,724185.47,627000.00,1351185.47
353090,202006,58,31,27,32395.00,28215.00,60610.00
353100,202006,53,43,10,44935.00,10450.00,55385.00
353110,202006,2101,632,1469,660440.50,1538240.00,2198680.50
353120,202006,96,50,46,52250.00,48070.00,100320.00
353130,202006,860,420,440,439945.41,459800.00,899745.41
353140,202006,555,229,326,239305.29,340670.00,579975.29
353150,202006,337,191,146,200640.29,152570.00,353210.29
353160,202006,94,75,19,79420.00,19855.00,99275.00
353170,202006,218,69,149,72105.00,156750.00,228855.00
353180,202006,1075,483,592,505780.75,618641.25,1124422.00
353190,202006,501,366,135,382470.00,142120.00,524590.00
353200,202006,221,106,115,110770.00,120175.00,230945.00
353205,202006,19,12,7,13585.00,7315.00,20900.00
353210,202006,72,41,31,42845.00,32395.00,75240.00
353215,202006,46,27,19,28215.00,19855.00,48070.00
353220,202006,77,44,33,45980.00,34485.00,80465.00
353230,202006,163,61,102,63745.00,106590.00,170335.00
353240,202006,319,161,158,168245.00,165110.00,333355.00
353250,202006,209,104,105,108680.00,110770.00,219450.00
353260,202006,458,315,143,330220.80,149435.00,479655.80
353270,202006,72,54,18,56430.00,18810.00,75240.00
353280,202006,101,50,51,52250.00,53295.00,105545.00
353282,202006,133,94,39,98230.00,40755.00,138985.00
353284,202006,24,16,8,16720.00,8360.00,25080.00
353286,202006,2,0,2,0.00,2090.00,2090.00
353290,202006,73,43,30,44935.00,31350.00,76285.00
353300,202006,451,242,209,252891.33,219450.00,472341.33
353310,202006,48,41,7,42845.00,7315.00,50160.00
353320,202006,55,32,23,33440.00,24035.00,57475.00
353325,202006,53,31,22,32395.00,22990.50,55385.50
353330,202006,60,40,20,41800.75,21945.00,63745.75
353340,202006,644,228,416,238260.00,434720.50,672980.50
353350,202006,906,439,467,458755.00,489060.50,947815.50
353360,202006,104,84,20,87780.00,20900.00,108680.00
353370,202006,115,66,49,68970.00,51205.00,120175.00
353380,202006,32,18,14,18810.00,14630.00,33440.00
353390,202006,1130,543,587,568480.00,614460.50,1182940.50
353400,202006,44,25,19,26125.00,19855.00,45980.00
353410,202006,110,66,44,68970.00,45980.25,114950.25
353420,202006,59,24,35,25080.00,36575.00,61655.00
353430,202006,585,393,192,410685.91,200640.00,611325.91
353440,202006,11065,4781,6284,5006597.44,6587681.00,11594278.44
353450,202006,56,31,25,32395.00,26125.00,58520.00
353460,202006,601,324,277,338580.75,289465.00,628045.75
353470,202006,2152,1126,1026,1177715.37,1075305.00,2253020.37
353475,202006,244,162,82,169290.50,85690.00,254980.50
353480,202006,188,155,33,161975.00,34485.00,196460.00
353490,202006,242,146,96,152570.00,100320.50,252890.50
353500,202006,203,116,87,121220.29,90915.00,212135.29
353510,202006,104,72,32,75240.00,33440.00,108680.00
353520,202006,206,145,61,151525.00,64790.00,216315.00
353530,202006,468,253,215,264385.00,224675.00,489060.00
353540,202006,381,252,129,263340.00,135850.00,399190.00
353550,202006,717,467,250,488016.47,261250.00,749266.47
353560,202006,592,235,357,245575.00,373065.00,618640.00
353570,202006,67,36,31,37620.50,32395.00,70015.50
353580,202006,353,260,93,271701.35,97185.00,368886.35
353590,202006,89,65,24,67925.00,25080.00,93005.00
353600,202006,278,160,118,167200.29,123310.00,290510.29
353610,202006,125,68,57,72105.00,59565.00,131670.00
353620,202006,618,322,296,336490.50,310365.00,646855.50
353625,202006,53,27,26,28215.00,27170.00,55385.00
353630,202006,234,173,61,180785.45,63745.00,244530.45
353640,202006,130,84,46,87780.00,48070.00,135850.00
353650,202006,938,350,588,365750.00,615505.00,981255.00
353657,202006,22,16,6,16720.00,6270.00,22990.00
353660,202006,274,147,127,153615.00,133760.00,287375.00
353670,202006,765,451,314,471295.79,328130.50,799426.29
353680,202006,104,74,30,77330.25,31350.00,108680.25
353690,202006,44,30,14,31350.00,14630.00,45980.00
353700,202006,269,192,77,200640.00,80465.00,281105.00
353710,202006,468,218,250,228855.00,262295.50,491150.50
353715,202006,46,33,13,34485.00,13585.00,48070.00
353720,202006,351,161,190,168245.50,198550.00,366795.50
353730,202006,1101,675,426,706420.00,446215.50,1152635.50
353740,202006,616,336,280,351120.50,292600.00,643720.50
353750,202006,79,47,32,49115.00,33440.00,82555.00
353760,202006,2987,1119,1868,1170337.65,1956241.65,3126579.30
353770,202006,91,74,17,77330.00,17765.00,95095.00
353780,202006,1229,585,644,611325.29,672980.00,1284305.29
353790,202006,507,307,200,320815.90,209000.50,529816.40
353800,202006,3423,1653,1770,1728450.50,1851811.50,3580262.00
353810,202006,232,133,99,138985.00,103455.00,242440.00
353820,202006,209,94,115,98230.00,120175.00,218405.00
353830,202006,51,44,7,45980.00,7315.00,53295.00
353850,202006,178,82,96,85690.00,100320.00,186010.00
353860,202006,501,222,279,233035.00,291555.00,524590.00
353870,202006,5375,2711,2664,2835088.50,2790151.75,5625240.25
353880,202006,684,473,211,496375.89,223630.00,720005.89
353890,202006,561,322,239,336490.50,250800.61,587291.11
353900,202006,136,70,66,73150.00,68970.00,142120.00
353910,202006,177,75,102,78375.00,107635.00,186010.00
353920,202006,441,244,197,254980.75,207955.00,462935.75
353930,202006,1009,592,417,618640.00,435766.35,1054406.35
353940,202006,193,97,96,101365.00,100320.00,201685.00
353950,202006,507,309,198,322905.00,207955.00,530860.00
353960,202006,75,61,14,63745.00,14630.00,78375.00
353970,202006,57,31,26,32395.00,27170.00,59565.00
353980,202006,1695,784,911,820325.00,954085.50,1774410.50
353990,202006,71,43,28,44935.00,29260.00,74195.00
354000,202006,383,182,201,190190.00,210045.00,400235.00
354010,202006,90,50,40,52250.00,41800.50,94050.50
354020,202006,512,327,185,343805.00,193325.00,537130.00
354025,202006,50,41,9,42845.00,9405.00,52250.00
354030,202006,51,31,20,32395.00,20900.00,53295.00
354040,202006,99,75,24,78375.00,25080.00,103455.00
354050,202006,178,100,78,104500.79,81510.00,186010.79
354060,202006,760,366,394,382470.00,412775.00,795245.00
354070,202006,922,529,393,553851.00,410685.00,964536.00
354075,202006,220,105,115,109725.00,120175.00,229900.00
354080,202006,313,135,178,142120.00,186010.00,328130.00
354085,202006,20,13,7,13585.00,7315.00,20900.00
354090,202006,294,167,127,174427.00,133760.00,308187.00
354100,202006,5617,2270,3347,2376331.53,3510157.35,5886488.88
354105,202006,93,45,48,47025.00,50160.00,97185.00
354110,202006,47,22,25,22990.00,26125.00,49115.00
354120,202006,139,97,42,101365.00,43890.00,145255.00
354130,202006,721,456,265,478610.00,279015.50,757625.50
354140,202006,3181,1466,1715,1533016.02,1797400.50,3330416.52
354150,202006,635,378,257,395010.87,268565.00,663575.87
354160,202006,659,420,239,439945.50,249755.89,689701.39
354165,202006,17,14,3,14630.00,3135.00,17765.00
354170,202006,177,121,56,126445.00,58520.00,184965.00
354180,202006,62,36,26,37620.59,27170.00,64790.59
354190,202006,195,82,113,85690.00,118085.00,203775.00
354200,202006,116,60,56,62700.00,58520.00,121220.00
354210,202006,59,23,36,24035.00,37620.00,61655.00
354220,202006,656,410,246,428450.29,257070.00,685520.29
354230,202006,168,71,97,74195.00,101365.00,175560.00
354240,202006,336,214,122,223630.62,127490.00,351120.62
354250,202006,85,52,33,54340.00,34485.00,88825.00
354260,202006,2069,961,1108,1007904.82,1158906.60,2166811.42
354270,202006,92,66,26,70015.00,27170.00,97185.00
354280,202006,45,22,23,22990.00,24035.00,47025.00
354290,202006,146,101,45,105545.00,47025.00,152570.00
354300,202006,376,265,111,277970.29,115995.00,393965.29
354310,202006,93,68,25,71060.50,26125.00,97185.50
354320,202006,207,101,106,105545.00,110770.00,216315.00
354323,202006,10,9,1,9405.00,1045.00,10450.00
354325,202006,116,67,49,70015.83,53295.00,123310.83
354330,202006,2463,826,1637,863021.50,1712755.50,2575777.00
354340,202006,10430,4980,5450,5219777.13,5710928.21,10930705.34
354350,202006,130,87,43,90915.00,44935.00,135850.00
354360,202006,75,42,33,43890.00,34485.00,78375.00
354370,202006,248,131,117,136895.00,122265.00,259160.00
354380,202006,187,112,75,117040.00,78375.00,195415.00
354390,202006,2708,970,1738,1013650.00,1820390.45,2834040.45
354400,202006,310,168,142,177650.00,148390.00,326040.00
354410,202006,618,297,321,312455.85,336490.50,648946.35
354420,202006,272,172,100,179740.00,104500.00,284240.00
354425,202006,307,183,124,191284.00,129580.00,320864.00
354430,202006,184,107,77,111815.00,80465.00,192280.00
354440,202006,38,27,11,28215.00,11495.00,39710.00
354450,202006,52,36,16,37620.00,16720.00,54340.00
354460,202006,99,56,43,58520.00,44935.00,103455.00
354470,202006,35,19,16,19855.00,16720.00,36575.00
354480,202006,113,61,52,63745.00,54340.00,118085.00
354490,202006,149,92,57,96140.00,59565.00,155705.00
354500,202006,379,179,200,187055.00,211090.00,398145.00
354510,202006,95,66,29,68970.00,30305.00,99275.00
354515,202006,37,12,25,12540.00,26125.00,38665.00
354520,202006,1596,681,915,711496.75,957220.50,1668717.25
354530,202006,756,377,379,393965.50,396055.00,790020.50
354540,202006,271,146,125,152570.00,130625.00,283195.00
354550,202006,37,23,14,24035.00,14630.00,38665.00
354560,202006,148,78,70,81510.00,74195.00,155705.00
354570,202006,135,88,47,93005.25,49115.00,142120.25
354580,202006,1884,885,999,924826.50,1045000.50,1969827.00
354600,202006,254,140,114,146300.00,120175.00,266475.00
354610,202006,72,61,11,63745.15,11495.00,75240.15
354620,202006,65,20,45,20900.00,47025.00,67925.00
354625,202006,16,10,6,10450.00,6270.00,16720.00
354630,202006,309,198,111,207955.00,115995.00,323950.00
354640,202006,798,505,293,530860.75,306185.00,837045.75
354650,202006,72,42,30,43890.00,31350.00,75240.00
354660,202006,796,591,205,620730.25,215270.00,836000.25
354670,202006,238,88,150,91960.00,157795.00,249755.00
354680,202006,1269,472,797,493240.00,838090.00,1331330.00
354690,202006,82,56,26,58520.50,27170.00,85690.50
354700,202006,66,47,19,49115.00,19855.00,68970.00
354710,202006,45,33,12,35530.00,13585.00,49115.00
354720,202006,20,20,0,20900.00,0.00,20900.00
354730,202006,1744,726,1018,759715.55,1066945.50,1826661.05
354740,202006,73,52,21,54340.00,21945.00,76285.00
354750,202006,424,243,181,253935.00,190190.00,444125.00
354760,202006,466,283,183,296781.25,192280.50,489061.75
354765,202006,10,5,5,5225.00,5225.00,10450.00
354770,202006,344,226,118,236170.13,123310.00,359480.13
354780,202006,8242,3233,5009,3384759.21,5251126.70,8635885.91
354790,202006,101,57,44,59565.00,47025.00,106590.00
354800,202006,456,245,211,256025.00,220495.00,476520.00
354805,202006,102,46,56,48070.50,58520.00,106590.50
354810,202006,101,61,40,63745.00,41800.00,105545.00
354820,202006,205,83,122,86735.90,128535.00,215270.90
354830,202006,40,22,18,22990.00,18810.00,41800.00
354840,202006,57,40,17,41800.00,17765.00,59565.00
354850,202006,4512,1985,2527,2077461.00,2648031.30,4725492.30
354860,202006,330,160,170,167200.00,178695.04,345895.04
354870,202006,12200,5432,6768,5691076.28,7092417.75,12783494.03
354880,202006,2804,1049,1755,1099340.88,1838156.65,2937497.53
354890,202006,2924,1559,1365,1630201.75,1432695.00,3062896.75
354900,202006,63,43,20,44935.00,20900.00,65835.00
354910,202006,1245,652,593,683431.00,622820.00,1306251.00
354920,202006,44,36,8,37620.00,8360.00,45980.00
354925,202006,12,6,6,6270.00,6270.00,12540.00
354930,202006,35,32,3,33440.78,3135.00,36575.78
354940,202006,808,587,221,613678.04,233035.00,846713.04
354950,202006,200,130,70,135850.25,73150.00,209000.25
354960,202006,150,57,93,59565.00,97185.00,156750.00
354970,202006,967,637,330,666711.64,344850.50,1011562.14
354980,202006,8810,3163,5647,3313698.45,5911566.02,9225264.47
354990,202006,9362,4297,5065,4498728.50,5302330.00,9801058.50
354995,202006,545,177,368,184965.00,384560.00,569525.00
355000,202006,469,160,309,167200.00,323950.00,491150.00
355010,202006,605,373,232,389785.50,242440.79,632226.29
355020,202006,775,492,283,514140.00,296780.50,810920.50
355030,202006,208980,80326,128654,84055373.98,134811947.48,218867321.46
355040,202006,769,358,411,377245.50,429495.00,806740.50
355050,202006,149,94,55,98230.00,57475.00,155705.00
355060,202006,1634,818,816,854811.50,853765.00,1708576.50
355070,202006,1447,685,762,716870.77,800470.29,1517341.06
355080,202006,199,122,77,127490.00,80465.00,207955.00
355090,202006,282,168,114,176605.00,119130.19,295735.19
355100,202006,5039,2375,2664,2486999.60,2792241.00,5279240.60
355110,202006,253,171,82,178695.50,85690.00,264385.50
355120,202006,77,55,22,57475.00,22990.00,80465.00
355130,202006,52,29,23,30305.00,24035.00,54340.00
355140,202006,185,113,72,118085.00,75240.00,193325.00
355150,202006,676,399,277,418001.00,291556.05,709557.05
355160,202006,472,226,246,236170.29,257070.50,493240.79
355170,202006,2051,1075,976,1123375.00,1022010.00,2145385.00
355180,202006,681,291,390,305140.00,408595.00,713735.00
355190,202006,212,144,68,150480.00,71060.00,221540.00
355200,202006,112,64,48,66880.00,50160.00,117040.00
355210,202006,699,395,304,412775.00,319770.00,732545.00
355220,202006,7193,3687,3506,3860234.00,3672132.50,7532366.50
355230,202006,100,58,42,60610.00,44935.00,105545.00
355240,202006,4491,1863,2628,1952062.66,2754620.00,4706682.66
355250,202006,5842,2622,3220,2745234.60,3374305.25,6119539.85
355255,202006,47,28,19,30305.00,19855.00,50160.00
355260,202006,184,112,72,117040.50,76285.00,193325.50
355270,202006,163,103,60,108680.00,62700.00,171380.00
355280,202006,6399,2516,3883,2635492.00,4065051.00,6700543.00
355290,202006,78,62,16,64790.00,16720.00,81510.00
355300,202006,196,119,77,125400.00,80465.50,205865.50
355310,202006,108,59,49,61655.00,52250.00,113905.00
355320,202006,89,46,43,48070.00,44935.00,93005.00
355330,202006,283,161,122,168245.00,128535.00,296780.00
355340,202006,1482,514,968,537130.77,1012605.00,1549735.77
355350,202006,133,65,68,70015.00,71060.00,141075.00
355360,202006,168,112,56,117040.50,58520.00,175560.50
355365,202006,22,18,4,18810.00,4180.00,22990.00
355370,202006,1041,609,432,636406.08,453530.00,1089936.08
355380,202006,821,520,301,543400.00,314545.00,857945.00
355385,202006,72,51,21,53295.00,21945.00,75240.00
355390,202006,108,61,47,63745.00,49115.00,112860.00
355395,202006,192,110,82,114950.92,85690.00,200640.92
355400,202006,1673,993,680,1039692.25,712690.29,1752382.54
355410,202006,4892,2297,2595,2407683.00,2720135.75,5127818.75
355420,202006,49,34,15,35530.00,15675.00,51205.00
355430,202006,373,231,142,241395.50,151525.00,392920.50
355440,202006,80,45,35,47025.00,36575.00,83600.00
355450,202006,466,228,238,239306.20,249755.75,489061.95
355460,202006,65,48,17,50160.35,17765.00,67925.35
355465,202006,46,29,17,30305.00,17765.00,48070.00
355470,202006,175,72,103,75240.75,107635.00,182875.75
355475,202006,11,7,4,7315.00,4180.00,11495.00
355480,202006,525,221,304,230945.00,317680.00,548625.00
355490,202006,119,85,34,88825.00,35530.00,124355.00
355495,202006,63,25,38,26125.00,39710.00,65835.00
355500,202006,1575,878,697,920647.05,729410.50,1650057.55
355510,202006,268,199,69,207955.29,72105.00,280060.29
355520,202006,34,24,10,25080.00,10450.00,35530.00
355530,202006,20,12,8,12540.00,8360.00,20900.00
355535,202006,75,34,41,35530.00,42845.00,78375.00
355540,202006,2469,971,1498,1017977.84,1567500.79,2585478.63
355550,202006,57,35,22,36575.00,22990.00,59565.00
355560,202006,250,114,136,119130.00,142120.00,261250.00
355570,202006,23,15,8,16720.00,8360.00,25080.00
355580,202006,243,171,72,178695.00,75240.50,253935.50
355590,202006,16,10,6,10450.00,6270.00,16720.00
355600,202006,277,141,136,147345.00,142120.00,289465.00
355610,202006,229,152,77,158840.00,80465.00,239305.00
355620,202006,1329,601,728,628045.50,765985.00,1394030.50
355630,202006,443,325,118,341715.00,123310.29,465025.29
355635,202006,114,53,61,55385.00,63745.00,119130.00
355640,202006,568,321,247,335445.00,258115.50,593560.50
355645,202006,850,335,515,350075.00,540266.13,890341.13
355650,202006,1998,841,1157,879891.35,1210110.00,2090001.35
355660,202006,247,132,115,137940.00,121220.00,259160.00
355670,202006,566,231,335,241395.00,351120.00,592515.00
355680,202006,206,116,90,123310.00,94050.00,217360.00
355690,202006,93,43,50,45980.00,52250.66,98230.66
355695,202006,17,11,6,11495.00,6270.00,17765.00
355700,202006,1152,596,556,622820.65,582066.00,1204886.65
355710,202006,2229,1211,1018,1267585.99,1065900.50,2333486.49
355715,202006,19,15,4,15675.00,4180.00,19855.00
355720,202006,227,133,94,138985.60,98230.00,237215.60
355730,202006,103,58,45,60610.00,47025.00,107635.00
410010,202006,130,107,23,112860.00,24035.00,136895.00
410020,202006,113,87,26,90915.00,27170.00,118085.00
410030,202006,164,97,67,101365.50,70015.00,171380.50
410040,202006,1178,583,595,609235.00,623865.00,1233100.00
410045,202006,40,30,10,31350.00,10450.00,41800.00
410050,202006,478,266,212,277970.00,221540.00,499510.00
410060,202006,285,214,71,223630.00,74195.00,297825.00
410070,202006,297,247,50,258115.00,52250.00,310365.00
410080,202006,169,105,64,109725.00,66880.00,176605.00
410090,202006,80,69,11,72105.90,11495.00,83600.90
410100,202006,286,199,87,207955.00,90915.00,298870.00
410105,202006,48,30,18,31350.00,18810.00,50160.00
410110,202006,328,196,132,204820.00,137940.00,342760.00
410115,202006,33,25,8,26125.00,8360.00,34485.00
410120,202006,415,210,205,219450.00,215270.00,434720.00
410130,202006,47,29,18,30305.00,18810.00,49115.00
410140,202006,3128,1510,1618,1582132.67,1696039.33,3278172.00
410150,202006,2693,1053,1640,1100386.35,1715891.80,2816278.15
410160,202006,513,316,197,330220.00,205865.50,536085.50
410165,202006,67,42,25,43890.00,26125.00,70015.00
410170,202006,175,116,59,121220.54,61655.00,182875.54
410180,202006,2268,1263,1005,1320880.00,1053360.00,2374240.00
410185,202006,38,33,5,34485.00,5225.00,39710.00
410190,202006,490,321,169,336490.89,177650.00,514140.89
410200,202006,950,691,259,723140.00,270655.00,993795.00
410210,202006,601,314,287,328130.00,300960.00,629090.00
410220,202006,46,22,24,22990.00,25080.00,48070.00
410230,202006,148,69,79,72105.00,82555.00,154660.00
410240,202006,752,491,261,513095.25,273790.00,786885.25
410250,202006,381,277,104,290126.83,108680.00,398806.83
410260,202006,301,167,134,175560.00,140030.50,315590.50
410270,202006,28,20,8,20900.00,8360.00,29260.00
410275,202006,57,44,13,45980.00,13585.00,59565.00
410280,202006,323,186,137,195415.00,143165.00,338580.00
410290,202006,248,153,95,159885.00,99275.00,259160.00
410300,202006,80,57,23,59565.00,24035.00,83600.00
410302,202006,19,12,7,12540.00,7315.00,19855.00
410304,202006,41,29,12,30305.00,12540.00,42845.00
410305,202006,218,115,103,120175.00,107635.00,227810.00
410310,202006,221,129,92,135850.00,96140.00,231990.00
410315,202006,48,34,14,35530.00,14630.00,50160.00
410320,202006,134,93,41,97185.00,42845.00,140030.00
410322,202006,34,22,12,22990.00,12540.00,35530.00
410330,202006,178,123,55,128535.00,57475.00,186010.00
410335,202006,100,57,43,59565.00,44935.00,104500.00
410337,202006,43,33,10,34485.00,10450.00,44935.00
410340,202006,37,31,6,32395.00,6270.00,38665.00
410345,202006,210,121,89,127490.00,93005.00,220495.00
410347,202006,48,37,11,38665.00,11495.00,50160.00
410350,202006,235,143,92,149435.00,96140.00,245575.00
410360,202006,473,299,174,312455.50,181831.00,494286.50
410370,202006,2350,996,1354,1042910.45,1414931.35,2457841.80
410380,202006,207,131,76,137940.00,79420.00,217360.00
410390,202006,390,270,120,282150.00,125400.00,407550.00
410395,202006,37,24,13,25080.00,13585.00,38665.00
410400,202006,842,387,455,405460.27,475930.00,881390.27
410405,202006,90,67,23,71060.00,24035.00,95095.00
410410,202006,30,22,8,22990.00,8360.00,31350.00
410420,202006,1671,787,884,826502.49,923780.85,1750283.34
410425,202006,172,71,101,74195.00,105545.00,179740.00
410430,202006,2290,1277,1013,1338645.00,1059631.40,2398276.40
410440,202006,378,276,102,288420.00,107635.00,396055.00
410442,202006,365,240,125,250800.00,130625.00,381425.00
410445,202006,423,300,123,313500.00,129580.00,443080.00
410450,202006,397,198,199,206910.00,209000.00,415910.00
410460,202006,510,262,248,273790.00,259160.00,532950.00
410465,202006,222,133,89,138985.00,93005.00,231990.00
410470,202006,238,144,94,151525.00,98230.00,249755.00
410480,202006,6216,2984,3232,3124554.20,3379531.75,6504085.95
410490,202006,1422,868,554,908105.51,579975.50,1488081.01
410500,202006,264,147,117,154660.00,123310.00,277970.00
410510,202006,169,125,44,133760.00,45980.00,179740.00
410520,202006,254,188,66,196460.00,68970.00,265430.00
410530,202006,276,99,177,105545.00,184965.00,290510.00
410540,202006,325,236,89,247665.00,93005.00,340670.00
410550,202006,1678,722,956,756580.00,999020.50,1755600.50
410560,202006,145,103,42,107635.00,43890.00,151525.00
410570,202006,434,291,143,304096.30,150480.00,454576.30
410580,202006,3490,1510,1980,1577951.70,2071190.50,3649142.20
410590,202006,401,270,131,282132.00,136895.00,419027.00
410600,202006,193,165,28,173470.00,29260.00,202730.00
410610,202006,53,43,10,44935.00,10450.00,55385.00
410620,202006,245,166,79,173470.03,82555.00,256025.03
410630,202006,440,250,190,262295.00,198550.00,460845.00
410640,202006,1020,637,383,665665.75,404415.00,1070080.75
410645,202006,109,79,30,82555.00,31350.00,113905.00
410650,202006,354,229,125,239305.00,130625.00,369930.00
410655,202006,87,63,24,65835.00,25080.00,90915.00
410657,202006,25,9,16,9405.00,16720.00,26125.00
410660,202006,599,417,182,435765.52,190190.00,625955.52
410670,202006,73,61,12,63745.00,12540.00,76285.00
410680,202006,215,172,43,179740.00,44935.00,224675.00
410685,202006,18,11,7,11495.00,7315.00,18810.00
410690,202006,28540,12075,16465,12631871.50,17246685.75,29878557.25
410700,202006,330,243,87,253935.00,91960.00,345895.00
410710,202006,127,103,24,107635.00,25080.00,132715.00
410712,202006,34,25,9,26125.00,9405.00,35530.00
410715,202006,89,64,25,66880.00,26125.00,93005.00
410720,202006,702,398,304,415910.00,318725.00,734635.00
410725,202006,182,132,50,137940.00,52250.00,190190.00
410730,202006,95,48,47,50160.00,49115.00,99275.00
410740,202006,107,76,31,79420.00,32395.00,111815.00
410750,202006,263,176,87,183920.00,90915.00,274835.00
410752,202006,25,15,10,15675.00,10450.00,26125.00
410753,202006,57,25,32,26125.00,33440.00,59565.00
410754,202006,49,25,24,26125.50,25080.00,51205.50
410755,202006,83,50,33,52250.00,34485.00,86735.00
410760,202006,773,425,348,444125.50,366795.00,810920.50
410765,202006,1764,816,948,855855.00,993796.00,1849651.00
410770,202006,108,84,24,87780.00,25080.00,112860.00
410773,202006,58,42,16,43890.00,16720.00,60610.00
410775,202006,183,136,47,142120.00,49115.00,191235.00
410780,202006,88,48,40,50160.00,41800.00,91960.00
410785,202006,59,46,13,48070.00,13585.00,61655.00
410790,202006,78,36,42,37620.00,43890.00,81510.00
410800,202006,288,175,113,183920.00,119130.50,303050.50
410810,202006,22,16,6,16720.00,6270.50,22990.50
410820,202006,172,126,46,131670.00,48070.00,179740.00
410830,202006,8632,3724,4908,3894717.53,5138265.50,9032983.03
410832,202006,105,73,32,76285.00,33440.00,109725.00
410840,202006,1459,788,671,824506.44,703285.25,1527791.69
410845,202006,68,44,24,45980.00,25080.00,71060.00
410850,202006,194,135,59,141075.00,61655.00,202730.00
410855,202006,58,46,12,48070.00,12540.00,60610.00
410860,202006,725,400,325,418000.50,339625.00,757625.50
410865,202006,101,75,26,78375.00,27170.00,105545.00
410870,202006,153,129,24,134805.00,25080.00,159885.00
410880,202006,1110,566,544,591470.50,569525.00,1160995.50
410890,202006,90,64,26,66880.00,27170.00,94050.00
410895,202006,71,54,17,56430.00,17765.00,74195.00
410900,202006,24,18,6,18810.00,7315.00,26125.00
410910,202006,16,13,3,13585.00,3135.00,16720.00
410920,202006,37,25,12,27170.00,13585.00,40755.00
410930,202006,522,324,198,338580.00,206910.00,545490.00
410940,202006,4384,2459,1925,2572338.73,2014760.50,4587099.23
410950,202006,106,77,29,80465.00,30305.00,110770.00
410960,202006,824,342,482,357390.00,503690.00,861080.00
410965,202006,62,47,15,49115.00,15675.00,64790.00
410970,202006,633,447,186,467115.00,200640.00,667755.00
410975,202006,123,75,48,78375.91,50160.00,128535.91
410980,202006,1629,730,899,763895.00,941545.00,1705440.00
410990,202006,269,186,83,194370.00,86735.00,281105.00
411000,202006,69,42,27,43890.00,28215.50,72105.50
411005,202006,27,22,5,22990.00,5225.00,28215.00
411007,202006,260,153,107,159885.00,111815.00,271700.00
411010,202006,607,409,198,427405.00,206910.00,634315.00
411020,202006,289,200,89,210045.85,93005.00,303050.85
411030,202006,18,10,8,10450.00,8360.00,18810.00
411040,202006,57,39,18,40755.00,18810.00,59565.00
411050,202006,206,159,47,166155.00,49115.00,215270.00
411060,202006,517,348,169,363660.00,178695.00,542355.00
411065,202006,56,48,8,50160.00,8360.00,58520.00
411070,202006,1243,759,484,794200.00,507870.00,1302070.00
411080,202006,244,172,72,179740.00,75240.00,254980.00
411090,202006,99,76,23,79420.00,25080.00,104500.00
411095,202006,282,107,175,112860.00,182875.00,295735.00
411100,202006,118,96,22,100320.00,22990.00,123310.00
411110,202006,128,84,44,87780.00,45980.00,133760.00
411120,202006,205,142,63,149435.00,66880.00,216315.00
411125,202006,242,104,138,108680.00,144210.00,252890.00
411130,202006,134,115,19,120175.00,19855.00,140030.00
411140,202006,211,140,71,146300.00,74195.00,220495.00
411150,202006,1219,800,419,838090.00,438900.54,1276990.54
411155,202006,122,82,40,85690.00,41800.00,127490.00
411160,202006,25,11,14,11495.00,14630.00,26125.00
411170,202006,52,47,5,49115.50,5225.00,54340.50
411180,202006,973,642,331,670890.00,345895.00,1016785.00
411190,202006,329,192,137,201685.00,143165.00,344850.00
411200,202006,672,412,260,430540.29,271700.00,702240.29
411210,202006,692,366,326,382470.00,340670.50,723140.50
411220,202006,155,112,43,117040.00,44935.00,161975.00
411230,202006,39,33,6,34485.00,6270.00,40755.00
411240,202006,121,78,43,81510.00,44935.00,126445.00
411250,202006,431,314,117,328130.00,122265.00,450395.00
411260,202006,18,12,6,12540.00,6270.00,18810.00
411270,202006,276,150,126,156750.00,131670.00,288420.00
411275,202006,186,163,23,170335.00,24035.00,194370.00
411280,202006,212,149,63,155705.29,65835.00,221540.29
411290,202006,61,47,14,49115.00,14630.00,63745.00
411295,202006,140,109,31,113905.00,32395.00,146300.00
411300,202006,78,36,42,37620.00,43890.00,81510.00
411310,202006,91,71,20,74195.00,21945.00,96140.00
411320,202006,787,528,259,551760.00,270655.00,822415.00
411325,202006,61,41,20,42845.00,20900.00,63745.00
411330,202006,906,580,326,606100.50,341715.99,947816.49
411340,202006,29,19,10,19855.00,10450.00,30305.00
411342,202006,66,51,15,53295.00,15675.00,68970.00
411345,202006,120,58,62,60610.00,64790.00,125400.00
411350,202006,483,370,113,387695.45,118085.50,505780.95
411360,202006,53,35,18,36575.00,18810.00,55385.00
411370,202006,14245,5803,8442,6071455.24,8839657.13,14911112.37
411373,202006,175,127,48,132715.00,50160.00,182875.00
411375,202006,77,61,16,63745.00,16720.00,80465.00
411380,202006,85,63,22,65835.00,22990.00,88825.00
411390,202006,125,79,46,83600.00,48070.00,131670.00
411400,202006,377,277,100,289465.00,104500.00,393965.00
411410,202006,440,223,217,233035.00,226765.50,459800.50
411420,202006,987,427,560,446215.00,585200.00,1031415.00
411430,202006,469,270,199,282150.00,207955.00,490105.00
411435,202006,33,21,12,21945.00,12540.00,34485.00
411440,202006,451,356,95,372020.00,101365.00,473385.00
411450,202006,420,357,63,373065.00,65835.00,438900.00
411460,202006,763,294,469,307230.00,491150.57,798380.57
411470,202006,85,62,23,64790.00,24035.50,88825.50
411480,202006,674,376,298,392920.50,311410.00,704330.50
411490,202006,294,189,105,197505.00,110770.00,308275.00
411500,202006,99,81,18,84645.00,18810.00,103455.00
411510,202006,224,179,45,187055.00,47025.00,234080.00
411520,202006,6062,2285,3777,2390961.00,3955326.76,6346287.76
411530,202006,124,84,40,87780.00,41800.00,129580.00
411535,202006,50,19,31,19855.00,32395.00,52250.00
411540,202006,351,242,109,252890.00,113905.00,366795.00
411545,202006,56,42,14,43890.00,14630.00,58520.00
411550,202006,80,62,18,64790.00,18810.00,83600.00
411560,202006,401,172,229,179740.00,240350.00,420090.00
411570,202006,835,303,532,316635.20,555940.00,872575.20
411573,202006,24,15,9,15675.00,9405.00,25080.00
411575,202006,295,189,106,197505.00,110770.00,308275.00
411580,202006,1281,464,817,486970.00,855855.00,1342825.00
411585,202006,75,36,39,37620.00,40755.00,78375.00
411590,202006,23,16,7,16720.00,7315.00,24035.00
411600,202006,26,12,14,12540.00,14630.00,27170.00
411605,202006,239,95,144,99275.00,150480.00,249755.00
411610,202006,204,135,69,141075.00,72105.00,213180.00
411620,202006,374,199,175,209000.00,182875.00,391875.00
411630,202006,58,39,19,40755.00,19855.00,60610.00
411640,202006,33,24,9,26125.00,9405.00,35530.00
411650,202006,12,7,5,7315.00,5225.00,12540.00
411660,202006,36,24,12,25080.00,12540.00,37620.00
411670,202006,239,174,65,181830.00,67925.00,249755.00
411680,202006,165,136,29,142120.00,30305.00,172425.00
411690,202006,591,315,276,329175.00,288420.00,617595.00
411695,202006,61,45,16,47025.00,16720.00,63745.00
411700,202006,140,116,24,121220.00,25080.00,146300.00
411705,202006,105,70,35,73150.00,36575.00,109725.00
411710,202006,304,205,99,214225.00,103455.00,317680.00
411720,202006,132,89,43,93005.00,44935.00,137940.00
411721,202006,65,54,11,56430.00,11495.00,67925.00
411722,202006,101,43,58,44935.00,60610.00,105545.00
411725,202006,154,115,39,121220.50,40755.00,161975.50
411727,202006,88,67,21,70015.00,21945.00,91960.00
411729,202006,38,30,8,31350.00,8360.00,39710.00
411730,202006,547,347,200,364705.00,209000.00,573705.00
411740,202006,39,24,15,25080.00,15675.00,40755.00
411745,202006,68,49,19,51205.00,20900.00,72105.00
411750,202006,861,384,477,402325.50,499510.00,901835.50
411760,202006,1183,878,305,917510.60,318725.00,1236235.60
411770,202006,460,305,155,318725.00,161975.00,480700.00
411780,202006,345,226,119,236170.00,124355.00,360525.00
411790,202006,518,290,228,305140.22,238260.00,543400.22
411800,202006,154,119,35,124355.64,36575.00,160930.64
411810,202006,180,136,44,142120.00,45980.00,188100.00
411820,202006,2213,970,1243,1014696.70,1301025.00,2315721.70
411830,202006,11,10,1,10450.00,1045.00,11495.00
411840,202006,2028,1235,793,1291620.00,831821.00,2123441.00
411845,202006,54,20,34,20900.00,35530.00,56430.00
411850,202006,1220,676,544,706420.50,569525.75,1275946.25
411860,202006,48,32,16,33440.50,16720.00,50160.50
411870,202006,72,48,24,50160.00,25080.00,75240.00
411880,202006,424,270,154,282150.00,160930.00,443080.00
411885,202006,105,69,36,72105.00,37620.00,109725.00
411890,202006,309,200,109,209001.49,113905.00,322906.49
411900,202006,79,60,19,62700.50,19855.00,82555.50
411910,202006,181,144,37,150480.00,38665.00,189145.00
411915,202006,2168,885,1283,924825.00,1347005.05,2271830.05
411920,202006,118,95,23,99275.00,24035.00,123310.00
411925,202006,12,8,4,8360.00,4180.00,12540.00
411930,202006,809,586,223,612370.85,233035.00,845405.85
411940,202006,583,399,184,416955.85,193325.00,610280.85
411950,202006,998,485,513,506825.76,537130.00,1043955.76
411960,202006,1042,702,340,733590.75,356345.00,1089935.75
411965,202006,20,14,6,14630.00,6270.00,20900.00
411970,202006,82,73,9,77330.00,9405.00,86735.00
411980,202006,168,106,62,111815.00,64790.00,176605.00
411990,202006,5164,2937,2227,3070217.99,2329307.25,5399525.24
411995,202006,489,169,320,178695.00,336490.00,515185.00
412000,202006,319,203,116,212135.00,121220.00,333355.00
412010,202006,45,28,17,29260.00,17765.00,47025.00
412015,202006,41,29,12,30305.00,12540.00,42845.00
412020,202006,31,25,6,26125.00,6270.00,32395.00
412030,202006,49,46,3,48070.00,3135.00,51205.00
412033,202006,47,29,18,30305.00,18810.00,49115.00
412035,202006,72,46,26,48070.00,27170.00,75240.00
412040,202006,42,25,17,26125.50,18810.00,44935.50
412050,202006,199,153,46,159885.00,48070.00,207955.00
412060,202006,787,585,202,612370.00,211090.00,823460.00
412065,202006,48,31,17,32395.00,17765.00,50160.00
412070,202006,163,110,53,114950.00,55385.00,170335.00
412080,202006,288,146,142,152570.00,150480.00,303050.00
412085,202006,36,16,20,16720.00,20900.00,37620.00
412090,202006,811,509,302,531905.25,315590.00,847495.25
412100,202006,242,204,38,213180.00,39710.50,252890.50
412110,202006,69,54,15,56430.50,15675.00,72105.50
412120,202006,326,195,131,203775.00,136895.00,340670.00
412125,202006,82,49,33,51205.00,34485.00,85690.00
412130,202006,36,23,13,24035.40,13585.00,37620.40
412135,202006,29,17,12,17765.00,12540.00,30305.00
412140,202006,346,229,117,239305.00,122265.00,361570.00
412150,202006,253,168,85,175560.00,89870.00,265430.00
412160,202006,91,51,40,53295.00,41800.00,95095.00
412170,202006,687,474,213,495330.50,222585.00,717915.50
412175,202006,39,29,10,30305.00,10450.00,40755.00
412180,202006,196,150,46,156750.00,48070.00,204820.00
412190,202006,334,266,68,279015.00,71060.00,350075.00
412200,202006,184,119,65,124355.00,68970.00,193325.00
412210,202006,72,57,15,59565.00,15675.00,75240.00
412215,202006,231,162,69,169290.00,72105.00,241395.00
412217,202006,67,53,14,55385.00,14630.00,70015.00
412220,202006,837,593,244,619685.00,254980.00,874665.00
412230,202006,328,199,129,207955.00,135850.00,343805.00
412240,202006,1354,670,684,701195.00,715825.00,1417020.00
412250,202006,407,253,154,264385.00,160930.00,425315.00
412260,202006,109,77,32,80465.00,33440.00,113905.00
412265,202006,178,139,39,145255.00,40755.00,186010.00
412270,202006,85,58,27,60610.00,28215.00,88825.00
412280,202006,91,73,18,76285.00,18810.00,95095.00
412290,202006,94,65,29,67925.00,30305.00,98230.00
412300,202006,203,135,68,141075.00,71060.00,212135.00
412310,202006,47,41,6,42845.00,6270.00,49115.00
412320,202006,98,80,18,83600.00,18810.00,102410.00
412330,202006,184,157,27,164065.00,28215.00,192280.00
412340,202006,154,108,46,112860.00,48070.50,160930.50
412350,202006,625,303,322,317680.00,338580.00,656260.00
412360,202006,26,22,4,22990.00,4180.00,27170.00
412370,202006,162,141,21,147345.30,21945.00,169290.30
412380,202006,263,199,64,207955.00,66880.00,274835.00
412382,202006,63,33,30,34485.00,31350.00,65835.00
412385,202006,152,109,43,113905.00,44935.00,158840.00
412390,202006,283,216,67,226765.00,70015.00,296780.00
412395,202006,71,58,13,60610.00,13585.00,74195.00
412400,202006,91,62,29,64790.00,32395.00,97185.00
412402,202006,231,115,116,120175.50,121220.00,241395.50
412405,202006,861,316,545,334400.00,571615.00,906015.00
412410,202006,973,600,373,627000.50,391875.00,1018875.50
412420,202006,13,12,1,12540.00,1045.00,13585.00
412430,202006,19,14,5,14630.00,5225.00,19855.00
412440,202006,617,335,282,350075.00,295735.00,645810.00
412450,202006,76,66,10,68970.00,10450.00,79420.00
412460,202006,92,70,22,73150.00,22990.00,96140.00
412470,202006,216,174,42,181830.00,43890.00,225720.00
412480,202006,144,106,38,110770.75,39710.00,150480.75
412490,202006,159,142,17,148390.00,17765.00,166155.00
412500,202006,437,356,81,372020.56,85690.00,457710.56
412510,202006,177,146,31,152570.00,32395.00,184965.00
412520,202006,93,61,32,63745.00,33440.00,97185.00
412530,202006,106,55,51,57475.00,54340.00,111815.00
412535,202006,91,68,23,71060.00,24035.00,95095.00
412540,202006,83,40,43,41800.00,44935.00,86735.00
412545,202006,91,62,29,64790.00,30305.00,95095.00
412550,202006,3814,1638,2176,1714845.50,2279145.50,3993991.00
412555,202006,13,9,4,9405.00,4180.00,13585.00
412560,202006,613,432,181,451441.50,189145.75,640587.25
412570,202006,766,394,372,411730.00,389785.00,801515.00
412575,202006,89,62,27,64790.00,28215.00,93005.00
412580,202006,178,116,62,121220.00,64790.00,186010.00
412590,202006,38,33,5,34485.00,5225.00,39710.00
412600,202006,166,124,42,129580.85,43890.00,173470.85
412610,202006,35,17,18,17765.00,18810.00,36575.00
412620,202006,149,125,24,130625.00,25080.00,155705.00
412625,202006,2144,1117,1027,1169356.04,1073216.85,2242572.89
412627,202006,68,51,17,53295.00,17765.00,71060.00
412630,202006,406,268,138,281105.00,144210.00,425315.00
412635,202006,64,18,46,18810.00,48070.00,66880.00
412640,202006,107,74,33,77330.00,34485.00,111815.00
412650,202006,338,219,119,228855.00,124355.00,353210.00
412660,202006,476,285,191,297825.00,199595.00,497420.00
412665,202006,46,41,5,42845.00,5225.00,48070.00
412667,202006,294,202,92,211090.00,96140.00,307230.00
412670,202006,64,52,12,54340.00,12540.00,66880.00
412680,202006,297,230,67,241395.00,70015.70,311410.70
412690,202006,102,67,35,70015.00,36575.50,106590.50
412700,202006,162,109,53,113905.00,55385.00,169290.00
412710,202006,1390,834,556,873621.25,581020.00,1454641.25
412720,202006,228,144,84,150480.00,87780.00,238260.00
412730,202006,187,157,30,164065.00,31350.00,195415.00
412740,202006,431,226,205,236170.00,215270.00,451440.00
412750,202006,439,246,193,258115.00,201685.00,459800.00
412760,202006,282,144,138,150480.00,144210.00,294690.00
412770,202006,2157,1193,964,1248775.29,1008426.00,2257201.29
412780,202006,142,109,33,114950.00,34485.00,149435.00
412785,202006,283,139,144,145255.00,150480.00,295735.00
412788,202006,36,21,15,21945.00,15675.00,37620.00
412790,202006,124,105,19,110770.00,19855.00,130625.00
412795,202006,148,107,41,112860.00,43890.00,156750.00
412796,202006,321,211,110,221540.00,114950.00,336490.00
412800,202006,617,375,242,391875.25,252890.00,644765.25
412810,202006,2945,1600,1345,1675137.75,1407615.00,3082752.75
412820,202006,943,592,351,620731.75,367840.00,988571.75
412830,202006,14,11,3,11495.00,3135.00,14630.00
412840,202006,227,164,63,171380.00,65835.00,237215.00
412850,202006,762,493,269,516230.00,282150.00,798380.00
412853,202006,171,87,84,90915.00,87780.00,178695.00
412855,202006,193,103,90,107635.09,94050.00,201685.09
412860,202006,94,64,30,66880.00,31350.00,98230.00
412862,202006,56,39,17,40755.00,17765.00,58520.00
412863,202006,6,5,1,5225.00,1045.00,6270.00
412865,202006,45,32,13,33440.00,13585.00,47025.00
412870,202006,112,67,45,70015.00,47025.00,117040.00
412880,202006,95,70,25,73150.50,26125.00,99275.50
420005,202006,42,38,4,39710.00,4180.00,43890.00
420010,202006,361,234,127,244530.75,132715.00,377245.75
420020,202006,83,70,13,73150.00,14630.00,87780.00
420030,202006,23,21,2,21945.00,2090.00,24035.00
420040,202006,105,82,23,85690.00,24035.00,109725.00
420050,202006,57,35,22,36575.00,22990.00,59565.00
420055,202006,18,18,0,18810.00,0.00,18810.00
420060,202006,28,22,6,22990.00,6270.00,29260.00
420070,202006,102,86,16,89870.00,16720.00,106590.00
420075,202006,11,11,0,11495.00,0.00,11495.00
420080,202006,44,38,6,39710.00,6270.00,45980.00
420090,202006,34,31,3,32395.00,3135.00,35530.00
420100,202006,149,126,23,132715.50,24035.00,156750.50
420110,202006,19,19,0,19855.00,0.00,19855.00
420120,202006,63,46,17,48070.00,17765.00,65835.00
420125,202006,80,62,18,64790.00,18810.00,83600.00
420127,202006,31,26,5,27170.00,5225.00,32395.00
420130,202006,428,256,172,267520.00,179740.00,447260.00
420140,202006,1300,721,579,754490.75,606100.00,1360590.75
420150,202006,43,36,7,37620.00,7315.00,44935.00
420160,202006,33,31,2,32395.00,2090.00,34485.00
420165,202006,19,13,6,13585.00,6270.00,19855.00
420170,202006,76,50,26,52250.00,27170.00,79420.00
420180,202006,21,18,3,18810.00,3135.00,21945.00
420190,202006,25,22,3,22990.00,3135.00,26125.00
420195,202006,131,63,68,65835.00,71060.00,136895.00
420200,202006,1271,559,712,586245.50,746130.00,1332375.50
420205,202006,83,46,37,48070.00,38665.00,86735.00
420207,202006,122,66,56,68970.00,58520.00,127490.00
420208,202006,19,15,4,15675.00,4180.00,19855.00
420209,202006,18,15,3,15675.00,3135.00,18810.00
420210,202006,514,235,279,245575.00,292600.00,538175.00
420213,202006,45,36,9,37620.00,9405.00,47025.00
420215,202006,26,23,3,24035.00,3135.00,27170.00
420220,202006,64,42,22,43890.00,22990.00,66880.00
420230,202006,829,469,360,490105.00,376200.50,866305.50
420240,202006,2258,1476,782,1545555.90,818235.00,2363790.90
420243,202006,42,32,10,33440.00,10450.00,43890.00
420245,202006,153,81,72,84645.00,75240.00,159885.00
420250,202006,62,41,21,42845.00,21945.00,64790.00
420253,202006,34,28,6,29260.00,6270.00,35530.00
420257,202006,14,11,3,11495.00,3135.00,14630.00
420260,202006,101,85,16,88825.00,16720.00,105545.00
420270,202006,31,26,5,27170.00,5225.00,32395.00
420280,202006,296,225,71,235125.75,74195.75,309321.50
420285,202006,22,12,10,12540.00,10450.00,22990.00
420287,202006,49,33,16,34485.00,16720.00,51205.00
420290,202006,970,670,300,701195.50,314545.00,1015740.50
420300,202006,1432,1132,300,1183987.95,314545.65,1498533.60
420310,202006,52,35,17,36575.00,17765.00,54340.00
420315,202006,35,28,7,29260.00,7315.00,36575.00
420320,202006,915,450,465,471295.10,485925.00,957220.10
420325,202006,0,0,0,0.00,0.00,0.00
420330,202006,117,77,40,80465.00,41800.00,122265.00
420340,202006,157,104,53,108680.00,55385.00,164065.00
420350,202006,254,181,73,189145.00,76285.00,265430.00
420360,202006,736,558,178,586245.19,186010.00,772255.19
420370,202006,120,71,49,74195.00,51205.50,125400.50
420380,202006,1180,817,363,854810.75,380380.50,1235191.25
420390,202006,249,175,74,182875.00,77330.00,260205.00
420395,202006,199,143,56,149435.00,58520.00,207955.00
420400,202006,241,184,57,192281.15,59565.00,251846.15
420410,202006,61,46,15,48070.00,15675.00,63745.00
420415,202006,34,29,5,30305.00,5225.00,35530.00
420417,202006,50,39,11,40755.00,11495.00,52250.00
420419,202006,11,11,0,11495.00,0.00,11495.00
420420,202006,2858,1761,1097,1843383.24,1150545.50,2993928.74
420425,202006,67,55,12,57475.00,12540.00,70015.00
420430,202006,1172,841,331,880935.45,345895.00,1226830.45
420435,202006,15,13,2,13585.00,2090.00,15675.00
420440,202006,102,72,30,75240.50,31350.00,106590.50
420445,202006,22,21,1,21945.00,1045.00,22990.00
420450,202006,75,38,37,39710.00,39710.00,79420.00
420455,202006,214,162,52,169290.00,54340.00,223630.00
420460,202006,2336,1509,827,1582132.79,866305.00,2448437.79
420470,202006,106,76,30,79420.00,31350.00,110770.00
420475,202006,7,7,0,7315.00,0.00,7315.00
420480,202006,860,645,215,674026.00,224675.50,898701.50
420490,202006,108,78,30,81510.00,31350.65,112860.65
420500,202006,456,238,218,248711.09,227810.00,476521.09
420510,202006,16,15,1,15675.00,1045.00,16720.00
420515,202006,24,17,7,17765.00,7315.00,25080.00
420517,202006,9,9,0,9405.00,0.00,9405.00
420519,202006,0,0,0,0.00,0.00,0.00
420520,202006,67,51,16,53295.00,16720.00,70015.00
420530,202006,161,108,53,112860.75,55385.00,168245.75
420535,202006,20,18,2,18810.00,2090.00,20900.00
420540,202006,5505,3284,2221,3442497.40,2326170.50,5768667.90
420543,202006,23,22,1,22990.00,1045.00,24035.00
420545,202006,208,147,61,153615.00,63745.00,217360.00
420550,202006,857,703,154,735681.42,160930.00,896611.42
420555,202006,35,26,9,27170.00,9405.00,36575.00
420560,202006,62,52,10,54340.00,10450.00,64790.00
420570,202006,159,91,68,95095.00,71060.00,166155.00
420580,202006,281,129,152,134805.00,158840.50,293645.50
420590,202006,515,349,166,365750.00,173470.00,539220.00
420600,202006,116,62,54,64790.00,56430.00,121220.00
420610,202006,39,34,5,35530.00,5225.00,40755.00
420620,202006,86,68,18,71060.00,18810.00,89870.00
420630,202006,153,105,48,110770.00,51205.00,161975.00
420640,202006,84,75,9,78375.00,9405.00,87780.00
420650,202006,247,127,120,132715.00,125400.00,258115.00
420660,202006,49,39,10,40755.50,10450.00,51205.50
420665,202006,38,29,9,30305.00,9405.00,39710.00
420670,202006,301,232,69,242440.00,72105.00,314545.00
420675,202006,13,12,1,12540.00,1045.00,13585.00
420680,202006,39,28,11,29260.00,11495.00,40755.00
420690,202006,172,135,37,141075.00,38665.00,179740.00
420700,202006,685,465,220,486970.46,229900.00,716870.46
420710,202006,145,82,63,85690.00,66880.00,152570.00
420720,202006,111,90,21,94050.00,21945.00,115995.00
420730,202006,612,379,233,396055.40,243485.50,639540.90
420740,202006,52,51,1,53295.00,1045.00,54340.00
420750,202006,501,338,163,353210.00,171380.00,524590.00
420757,202006,16,14,2,14630.00,2090.00,16720.00
420760,202006,37,29,8,30305.00,8360.00,38665.00
420765,202006,78,60,18,62700.00,18810.00,81510.00
420768,202006,52,46,6,48070.00,6270.00,54340.00
420770,202006,73,63,10,65835.00,10450.00,76285.00
420775,202006,40,36,4,37620.00,4180.00,41800.00
420780,202006,223,176,47,183920.00,49115.00,233035.00
420785,202006,11,9,2,9405.00,2090.00,11495.00
420790,202006,162,135,27,141075.00,29260.00,170335.00
420800,202006,68,51,17,53295.00,17765.00,71060.00
420810,202006,251,209,42,218405.00,43890.00,262295.00
420820,202006,2362,1348,1014,1410750.50,1062766.22,2473516.72
420830,202006,615,330,285,344850.50,297825.00,642675.50
420840,202006,147,107,40,111815.00,41800.00,153615.00
420845,202006,414,178,236,186010.00,246620.50,432630.50
420850,202006,263,199,64,207955.25,67925.00,275880.25
420860,202006,60,50,10,53295.00,10450.00,63745.00
420870,202006,127,88,39,91960.00,40755.00,132715.00
420880,202006,180,116,64,122265.00,66880.00,189145.00
420890,202006,937,470,467,491150.25,489060.00,980210.25
420895,202006,9,9,0,9405.00,0.00,9405.00
420900,202006,406,323,83,337535.00,86735.00,424270.00
420910,202006,5895,3270,2625,3425514.83,2747305.00,6172819.83
420915,202006,69,63,6,65835.00,6270.00,72105.00
420917,202006,22,15,7,15675.00,7315.00,22990.00
420920,202006,22,15,7,15675.00,7315.00,22990.00
420930,202006,2808,1747,1061,1827640.00,1111882.28,2939522.28
420940,202006,597,440,157,459801.00,164065.90,623866.90
420945,202006,9,7,2,7315.00,2090.00,9405.00
420950,202006,56,49,7,51205.00,7315.00,58520.00
420960,202006,112,88,24,91960.00,25080.00,117040.00
420970,202006,297,237,60,247666.00,62700.00,310366.00
420980,202006,24,23,1,24035.00,1045.00,25080.00
420985,202006,57,51,6,53295.00,6270.00,59565.00
420990,202006,80,58,22,60610.00,22990.00,83600.00
421000,202006,40,25,15,26125.00,15675.00,41800.00
421003,202006,51,35,16,36575.00,16720.00,53295.00
421005,202006,6,3,3,3135.00,3135.00,6270.00
421010,202006,773,523,250,546535.00,261250.75,807785.75
421020,202006,25,20,5,20900.00,5225.00,26125.00
421030,202006,117,98,19,103455.75,19855.00,123310.75
421040,202006,73,55,18,57475.00,18810.00,76285.00
421050,202006,346,243,103,253936.00,107635.00,361571.00
421055,202006,21,17,4,17765.00,4180.00,21945.00
421060,202006,89,51,38,53295.00,39710.00,93005.00
421070,202006,50,44,6,45980.50,6270.00,52250.50
421080,202006,35,31,4,33440.00,4180.00,37620.00
421085,202006,20,15,5,15675.00,5225.00,20900.00
421090,202006,37,28,9,29260.00,9405.00,38665.00
421100,202006,125,91,34,95095.00,35530.00,130625.00
421105,202006,203,167,36,174515.00,37620.00,212135.00
421110,202006,114,88,26,91960.00,27170.00,119130.00
421120,202006,161,119,42,125400.42,43890.00,169290.42
421125,202006,16,11,5,12540.00,5225.00,17765.00
421130,202006,814,513,301,536085.00,314545.50,850630.50
421140,202006,29,20,9,20900.00,9405.00,30305.00
421145,202006,41,33,8,34485.00,8360.00,42845.00
421150,202006,103,73,30,76285.00,31350.00,107635.00
421160,202006,68,46,22,48070.00,22990.00,71060.00
421165,202006,16,15,1,15675.00,1045.00,16720.00
421170,202006,183,155,28,162101.50,30305.00,192406.50
421175,202006,165,113,52,118085.00,56430.00,174515.00
421180,202006,51,36,15,37620.10,15675.00,53295.10
421185,202006,18,14,4,14630.00,4180.00,18810.00
421187,202006,1,0,1,0.00,1045.00,1045.00
421189,202006,47,31,16,32395.00,16720.00,49115.00
421190,202006,1693,1056,637,1104565.00,665665.00,1770230.00
421200,202006,94,70,24,73150.00,25080.00,98230.00
421205,202006,27,18,9,18810.00,9405.00,28215.00
421210,202006,172,118,54,123310.00,56430.00,179740.00
421220,202006,277,217,60,226765.00,62700.00,289465.00
421223,202006,49,39,10,40755.00,10450.00,51205.00
421225,202006,70,45,25,47025.00,27170.00,74195.00
421227,202006,87,67,20,70015.00,20900.00,90915.00
421230,202006,56,39,17,40755.00,17765.00,58520.00
421240,202006,18,18,0,18810.00,0.00,18810.00
421250,202006,374,222,152,231990.50,158840.00,390830.50
421260,202006,24,20,4,20900.00,4180.00,25080.00
421265,202006,2,2,0,2090.00,0.00,2090.00
421270,202006,46,41,5,42845.00,5225.00,48070.00
421280,202006,349,190,159,198550.00,166155.00,364705.00
421290,202006,332,221,111,231990.00,115995.00,347985.00
421300,202006,23,19,4,19855.00,4180.00,24035.00
421310,202006,46,33,13,34485.00,13585.00,48070.00
421315,202006,30,18,12,19855.00,12540.00,32395.00
421320,202006,127,81,46,84645.00,49115.00,133760.00
421330,202006,106,77,29,80465.00,30305.00,110770.00
421335,202006,40,28,12,29260.00,12540.00,41800.00
421340,202006,241,155,86,161975.25,89870.00,251845.25
421350,202006,188,107,81,112860.82,84645.00,197505.82
421360,202006,645,477,168,499510.25,176605.00,676115.25
421370,202006,203,152,51,158840.00,53295.00,212135.00
421380,202006,128,100,28,104500.00,29260.00,133760.00
421390,202006,19,13,6,13585.00,6270.00,19855.00
421400,202006,128,110,18,114950.00,18810.00,133760.00
421410,202006,17,15,2,15675.00,2090.00,17765.00
421415,202006,21,20,1,20900.00,1045.00,21945.00
421420,202006,136,114,22,119130.00,22990.00,142120.00
421430,202006,16,12,4,12540.00,4180.00,16720.00
421440,202006,59,50,9,52250.00,9405.00,61655.00
421450,202006,92,77,15,80465.00,15675.00,96140.00
421460,202006,61,49,12,51205.00,12540.00,63745.00
421470,202006,69,43,26,44935.00,27170.00,72105.00
421480,202006,719,548,171,573705.00,179740.00,753445.00
421490,202006,23,22,1,22990.00,1045.00,24035.00
421500,202006,490,312,178,327085.50,187055.25,514140.75
421505,202006,26,19,7,19855.00,7315.00,27170.00
421507,202006,33,25,8,26125.00,8360.00,34485.00
421510,202006,70,45,25,47025.00,26125.00,73150.00
421520,202006,55,46,9,48070.00,9405.00,57475.00
421530,202006,50,42,8,43890.00,8360.00,52250.00
421535,202006,27,24,3,25080.00,3135.00,28215.00
421540,202006,49,43,6,44935.00,6270.00,51205.00
421545,202006,102,74,28,77330.00,29260.00,106590.00
421550,202006,285,205,80,214225.00,83600.00,297825.00
421555,202006,21,17,4,17765.00,4180.50,21945.50
421560,202006,8,7,1,7315.00,1045.00,8360.00
421565,202006,122,81,41,85690.00,42845.00,128535.00
421567,202006,29,23,6,24035.00,6270.00,30305.00
421568,202006,29,25,4,26125.00,4180.00,30305.00
421569,202006,11,11,0,11495.00,0.00,11495.00
421570,202006,202,135,67,141075.00,71060.00,212135.00
421575,202006,27,22,5,22990.00,5225.00,28215.00
421580,202006,714,428,286,449418.00,298870.00,748288.00
421590,202006,19,18,1,18810.00,1045.00,19855.00
421600,202006,149,98,51,102410.50,53295.50,155706.00
421605,202006,112,78,34,81510.75,36575.00,118085.75
421610,202006,183,141,42,147345.00,43890.00,191235.00
421620,202006,1030,601,429,628045.00,448305.00,1076350.00
421625,202006,21,18,3,18810.00,3135.00,21945.00
421630,202006,302,189,113,197505.25,119131.50,316636.75
421635,202006,19,9,10,9405.00,10450.00,19855.00
421640,202006,97,81,16,84645.00,16720.00,101365.00
421650,202006,302,178,124,186010.00,129580.00,315590.00
421660,202006,2241,1344,897,1405526.50,938411.00,2343937.50
421670,202006,185,132,53,137940.00,55385.00,193325.00
421680,202006,179,161,18,168245.00,18810.00,187055.00
421690,202006,344,241,103,251845.50,108680.60,360526.10
421700,202006,54,37,17,38665.00,17765.00,56430.00
421710,202006,24,23,1,24035.00,1045.00,25080.00
421715,202006,6,5,1,5225.00,1045.00,6270.00
421720,202006,634,440,194,459801.21,203775.00,663576.21
421725,202006,16,6,10,6270.00,10450.00,16720.00
421730,202006,34,24,10,25080.00,10450.00,35530.00
421740,202006,91,34,57,35530.00,59565.00,95095.00
421750,202006,211,157,54,164065.00,56430.00,220495.00
421755,202006,23,21,2,21945.00,2090.00,24035.00
421760,202006,98,66,32,68970.00,33440.00,102410.00
421770,202006,646,411,235,429496.75,247665.00,677161.75
421775,202006,29,17,12,17765.00,12540.00,30305.00
421780,202006,191,148,43,154660.50,44935.00,199595.50
421790,202006,150,127,23,133760.00,24035.00,157795.00
421795,202006,18,15,3,15675.00,3135.00,18810.00
421800,202006,516,329,187,343805.00,195415.00,539220.00
421810,202006,68,55,13,58520.00,13585.00,72105.00
421820,202006,318,204,114,213180.50,119130.00,332310.50
421825,202006,141,119,22,124355.00,22990.00,147345.00
421830,202006,136,90,46,94050.00,48070.00,142120.00
421835,202006,6,4,2,4180.00,2090.00,6270.00
421840,202006,52,44,8,45980.00,8360.00,54340.00
421850,202006,80,68,12,71060.00,12540.00,83600.00
421860,202006,37,30,7,31350.00,7315.00,38665.00
421870,202006,1019,761,258,796290.77,269610.00,1065900.77
421875,202006,54,44,10,45980.00,10450.00,56430.00
421880,202006,170,119,51,124355.00,53295.50,177650.50
421885,202006,22,17,5,17765.00,5225.00,22990.00
421890,202006,135,95,40,99275.00,41800.00,141075.00
421895,202006,45,40,5,41800.00,5225.00,47025.00
421900,202006,154,122,32,127490.00,33440.00,160930.00
421910,202006,68,41,27,42845.00,28215.00,71060.00
421915,202006,30,25,5,26125.00,5225.00,31350.00
421917,202006,37,27,10,28215.00,10450.00,38665.00
421920,202006,41,37,4,38665.00,4180.00,42845.00
421930,202006,676,541,135,568480.00,143165.00,711645.00
421935,202006,48,42,6,43890.00,6270.00,50160.00
421940,202006,41,36,5,37620.00,5225.00,42845.00
421950,202006,872,581,291,607145.50,305140.00,912285.50
421960,202006,45,40,5,41800.50,6270.00,48070.50
421970,202006,356,228,128,238260.50,133760.00,372020.50
421985,202006,23,13,10,13585.00,10450.00,24035.00
422000,202006,0,0,0,0.00,0.00,0.00
430003,202006,187,56,131,58520.00,136895.00,195415.00
430005,202006,38,27,11,28215.00,11495.00,39710.00
430010,202006,268,194,74,203775.00,77330.00,281105.00
430020,202006,143,96,47,100320.50,49115.00,149435.50
430030,202006,123,99,24,103455.00,25080.00,128535.00
430040,202006,2930,1723,1207,1802627.00,1265495.50,3068122.50
430045,202006,67,56,11,58520.00,11495.00,70015.00
430047,202006,6,6,0,6270.00,0.00,6270.00
430050,202006,77,65,12,67925.00,12540.00,80465.00
430055,202006,12,11,1,11495.00,1045.00,12540.00
430057,202006,5,4,1,4180.00,1045.00,5225.00
430060,202006,3726,2160,1566,2260336.75,1638560.00,3898896.75
430063,202006,52,48,4,50160.00,4180.00,54340.00
430064,202006,154,124,30,129580.00,31350.00,160930.00
430066,202006,5,2,3,2090.00,3135.00,5225.00
430070,202006,42,29,13,30305.00,13585.00,43890.00
430080,202006,68,47,21,49115.00,21945.00,71060.00
430085,202006,31,10,21,10450.00,21945.00,32395.00
430087,202006,27,20,7,20900.75,7315.00,28215.75
430090,202006,71,64,7,66880.00,7315.00,74195.00
430100,202006,124,84,40,87780.00,41800.00,129580.00
430105,202006,153,85,68,88825.00,71060.00,159885.00
430107,202006,19,13,6,13585.00,6270.00,19855.00
430110,202006,439,255,184,266475.00,192280.00,458755.00
430120,202006,153,142,11,148390.00,11495.00,159885.00
430130,202006,798,487,311,508915.50,324995.00,833910.50
430140,202006,124,115,9,120175.00,9405.00,129580.00
430150,202006,111,73,38,76285.00,39710.00,115995.00
430155,202006,36,31,5,32395.00,5225.00,37620.00
430160,202006,3649,2143,1506,2240482.75,1575860.50,3816343.25
430163,202006,367,161,206,168245.00,215270.00,383515.00
430165,202006,29,20,9,20900.00,9405.00,30305.00
430170,202006,90,75,15,78375.00,15675.00,94050.00
430175,202006,77,59,18,61655.00,18810.00,80465.00
430180,202006,105,87,18,90915.00,18810.00,109725.00
430185,202006,30,21,9,21945.00,9405.00,31350.00
430187,202006,82,38,44,39710.00,45980.00,85690.00
430190,202006,220,119,101,124355.00,105545.00,229900.00
430192,202006,13,11,2,11495.00,2090.00,13585.00
430195,202006,16,11,5,11495.00,5225.00,16720.00
430200,202006,164,141,23,147345.00,24035.00,171380.00
430205,202006,21,20,1,20900.00,1045.00,21945.00
430210,202006,681,523,158,546535.50,165110.50,711646.00
430215,202006,14,11,3,11495.00,3135.00,14630.00
430220,202006,73,50,23,52250.00,24035.00,76285.00
430222,202006,12,6,6,6270.00,6270.00,12540.00
430223,202006,15,8,7,8360.00,7315.00,15675.00
430225,202006,2,1,1,1045.00,1045.00,2090.00
430230,202006,316,187,129,195415.00,135850.00,331265.00
430235,202006,55,43,12,44935.00,12540.00,57475.00
430237,202006,27,21,6,21945.00,6270.00,28215.00
430240,202006,128,85,43,89870.00,44935.00,134805.00
430245,202006,71,57,14,59565.00,14630.00,74195.00
430250,202006,188,111,77,117040.00,80465.00,197505.00
430258,202006,9,8,1,8360.00,1045.00,9405.00
430260,202006,33,28,5,29260.00,5225.00,34485.00
430265,202006,36,30,6,31350.00,6270.00,37620.00
430270,202006,523,388,135,405461.25,143165.00,548626.25
430280,202006,1040,631,409,661485.00,427405.00,1088890.00
430290,202006,401,214,187,223630.00,195415.00,419045.00
430300,202006,2075,1144,931,1195480.75,978120.50,2173601.25
430310,202006,2014,1014,1000,1062765.50,1049181.21,2111946.71
430320,202006,57,47,10,50160.00,10450.00,60610.00
430330,202006,100,88,12,91960.00,12540.00,104500.00
430340,202006,72,58,14,60610.00,14630.00,75240.00
430350,202006,1659,1126,533,1176671.00,558030.00,1734701.00
430355,202006,19,17,2,17765.00,2090.00,19855.00
430360,202006,88,44,44,45980.00,45980.00,91960.00
430367,202006,35,26,9,27170.00,9405.00,36575.00
430370,202006,53,47,6,49115.00,6270.00,55385.00
430380,202006,135,104,31,108680.00,33440.00,142120.00
430390,202006,585,363,222,380380.00,234080.00,614460.00
430400,202006,248,178,70,186010.50,73150.00,259160.50
430410,202006,54,43,11,44935.00,11495.00,56430.00
430420,202006,511,336,175,351120.85,182875.00,533995.85
430430,202006,55,54,1,55734.03,1045.00,56779.03
430435,202006,156,114,42,119130.00,43890.00,163020.00
430440,202006,490,321,169,335445.00,178695.00,514140.00
430450,202006,1151,950,201,993795.00,210045.00,1203840.00
430460,202006,5273,2758,2515,2885246.40,2630265.00,5515511.40
430461,202006,16,15,1,15675.00,1045.00,16720.00
430462,202006,10,6,4,6270.00,4180.00,10450.00
430463,202006,1092,592,500,618640.00,523545.00,1142185.00
430465,202006,25,13,12,13585.00,12540.00,26125.00
430466,202006,680,482,198,503690.50,206910.00,710600.50
430467,202006,104,56,48,58520.00,50160.00,108680.00
430468,202006,122,72,50,75240.00,52250.00,127490.00
430469,202006,23,18,5,18810.00,5225.00,24035.00
430470,202006,1157,642,515,673292.62,539220.00,1212512.62
430471,202006,55,36,19,37620.00,19855.00,57475.00
430480,202006,102,66,36,68970.00,37620.00,106590.00
430485,202006,6,6,0,6270.50,0.00,6270.50
430490,202006,80,64,16,66880.00,17765.00,84645.00
430495,202006,34,26,8,27170.00,8360.00,35530.00
430500,202006,189,128,61,133760.00,63745.00,197505.00
430510,202006,3442,2221,1221,2321990.63,1278035.00,3600025.63
430511,202006,16,16,0,16720.00,0.00,16720.00
430512,202006,153,106,47,111815.00,49115.00,160930.00
430513,202006,54,44,10,45980.00,10450.00,56430.00
430515,202006,28,26,2,27170.00,2090.00,29260.00
430517,202006,166,146,20,152570.00,20900.00,173470.00
430520,202006,348,242,106,253935.00,110770.00,364705.00
430530,202006,85,50,35,52250.00,36575.00,88825.00
430535,202006,456,309,147,322905.00,154660.00,477565.00
430537,202006,9,9,0,9405.00,0.00,9405.00
430540,202006,84,58,26,60610.00,27170.00,87780.00
430543,202006,348,112,236,117040.00,246620.00,363660.00
430544,202006,42,39,3,40755.00,3135.00,43890.00
430545,202006,373,189,184,198550.00,192280.00,390830.00
430550,202006,41,33,8,35530.00,8360.00,43890.00
430558,202006,3,2,1,2090.00,1045.00,3135.00
430560,202006,55,29,26,30305.00,27170.00,57475.00
430570,202006,106,41,65,42845.00,68970.00,111815.00
430580,202006,130,106,24,110770.00,25080.00,135850.00
430583,202006,13,13,0,13585.00,0.00,13585.00
430585,202006,12,5,7,5225.00,7315.00,12540.00
430587,202006,14,7,7,7315.00,7315.00,14630.00
430590,202006,143,117,26,122265.00,27170.00,149435.00
430593,202006,2,2,0,2090.00,0.00,2090.00
430595,202006,16,13,3,13585.00,3135.00,16720.00
430597,202006,43,22,21,22990.00,21945.00,44935.00
430600,202006,218,160,58,167200.00,60610.00,227810.00
430605,202006,160,101,59,105545.00,61655.00,167200.00
430607,202006,25,20,5,20900.00,5225.00,26125.00
430610,202006,1627,761,866,796290.00,904970.50,1701260.50
430613,202006,2,2,0,2090.00,0.00,2090.00
430620,202006,109,77,32,80465.00,33440.00,113905.00
430630,202006,47,41,6,42845.00,6270.00,49115.00
430632,202006,31,26,5,27170.00,5225.00,32395.00
430635,202006,32,30,2,31350.00,2090.00,33440.00
430637,202006,60,30,30,31350.00,31350.00,62700.00
430640,202006,177,96,81,100320.00,84645.00,184965.00
430642,202006,21,17,4,17765.00,4180.00,21945.00
430645,202006,36,29,7,30305.00,7315.00,37620.00
430650,202006,245,201,44,210045.50,45980.00,256025.50
430655,202006,2,2,0,2090.00,0.00,2090.00
430660,202006,963,479,484,500555.00,506825.50,1007380.50
430670,202006,75,50,25,52250.00,26125.00,78375.00
430673,202006,68,41,27,42845.00,28215.00,71060.00
430675,202006,11,9,2,9405.00,2090.00,11495.00
430676,202006,512,303,209,316635.00,218405.00,535040.00
430680,202006,241,164,77,171381.00,80465.00,251846.00
430690,202006,531,326,205,340670.00,214225.29,554895.29
430692,202006,8,6,2,6270.00,2090.00,8360.00
430693,202006,136,88,48,91960.00,50160.00,142120.00
430695,202006,67,55,12,57475.00,12540.00,70015.00
430697,202006,55,35,20,36575.00,20900.00,57475.00
430700,202006,1507,1049,458,1096205.90,479655.00,1575860.90
430705,202006,22,20,2,20900.00,2090.00,22990.00
430710,202006,259,164,95,171380.00,99275.00,270655.00
430720,202006,107,92,15,96140.00,15675.00,111815.00
430730,202006,137,118,19,123310.00,19855.00,143165.00
430740,202006,73,49,24,51205.00,26125.00,77330.00
430745,202006,30,23,7,24035.00,7315.00,31350.00
430750,202006,323,215,108,224675.00,112860.00,337535.00
430755,202006,84,44,40,47025.00,41800.00,88825.00
430760,202006,381,219,162,228855.60,170335.00,399190.60
430770,202006,1499,783,716,819280.50,748220.50,1567501.00
430780,202006,293,186,107,194370.00,111815.00,306185.00
430781,202006,26,22,4,22990.00,4180.00,27170.00
430783,202006,60,48,12,50160.00,12540.00,62700.00
430786,202006,5,3,2,3135.00,2090.00,5225.00
430790,202006,516,340,176,356345.00,183920.50,540265.50
430800,202006,151,123,28,130625.76,30305.00,160930.76
430805,202006,39,35,4,36575.00,4180.00,40755.00
430807,202006,46,24,22,25080.00,22990.00,48070.00
430810,202006,74,44,30,45980.00,31350.00,77330.00
430820,202006,147,88,59,91960.00,61655.00,153615.00
430825,202006,10,8,2,8360.00,2090.00,10450.00
430830,202006,238,220,18,229900.50,18810.00,248710.50
430840,202006,126,85,41,88825.00,42845.00,131670.00
430843,202006,5,3,2,3135.00,2090.00,5225.00
430845,202006,73,41,32,42845.00,33440.00,76285.00
430850,202006,587,415,172,434720.00,179740.00,614460.00
430860,202006,160,102,58,106590.00,60610.00,167200.00
430865,202006,76,43,33,44935.00,34485.00,79420.00
430870,202006,80,65,15,67925.00,15675.00,83600.00
430880,202006,152,111,41,115995.00,42845.00,158840.00
430885,202006,8,6,2,6270.00,2090.00,8360.00
430890,202006,350,211,139,220495.00,145255.00,365750.00
430900,202006,506,354,152,370975.00,159885.00,530860.00
430905,202006,118,51,67,53295.00,70015.00,123310.00
430910,202006,283,154,129,160930.00,135850.00,296780.00
430912,202006,5,5,0,5225.00,0.00,5225.00
430915,202006,33,29,4,30305.00,4180.00,34485.00
430920,202006,4298,2289,2009,2396185.00,2101495.00,4497680.00
430925,202006,4,3,1,3135.00,1045.00,4180.00
430930,202006,2107,1222,885,1278036.75,929005.50,2207042.25
430940,202006,255,165,90,173470.00,95095.00,268565.00
430950,202006,152,124,28,130625.00,29260.00,159885.00
430955,202006,22,11,11,11495.00,11495.00,22990.00
430957,202006,18,16,2,16720.00,2090.00,18810.00
430960,202006,245,167,78,174515.00,81510.00,256025.00
430965,202006,113,72,41,75240.00,43890.00,119130.00
430970,202006,81,68,13,71060.00,13585.00,84645.00
430975,202006,42,38,4,39710.00,4180.00,43890.00
430980,202006,44,27,17,28215.00,17765.00,45980.00
430990,202006,110,85,25,88825.00,26125.00,114950.00
430995,202006,114,108,6,112860.00,6270.00,119130.00
431000,202006,293,139,154,145256.10,163020.00,308276.10
431010,202006,354,203,151,213180.00,157795.00,370975.00
431020,202006,1858,1078,780,1128600.50,816145.00,1944745.50
431030,202006,42,34,8,35530.00,8360.00,43890.00
431033,202006,404,195,209,203775.00,219450.00,423225.00
431036,202006,12,7,5,7315.00,5225.00,12540.00
431040,202006,140,87,53,90915.00,56430.00,147345.00
431041,202006,40,27,13,28215.50,13585.00,41800.50
431043,202006,42,25,17,26125.00,18810.00,44935.00
431046,202006,10,6,4,6270.00,4180.00,10450.00
431050,202006,202,128,74,134805.00,78375.00,213180.00
431053,202006,69,41,28,42845.00,29260.00,72105.00
431055,202006,62,42,20,43890.00,20900.00,64790.00
431057,202006,18,18,0,18810.00,0.00,18810.00
431060,202006,1617,1053,564,1100386.34,593560.75,1693947.09
431065,202006,17,11,6,11495.00,6270.00,17765.00
431070,202006,63,57,6,59565.00,6270.00,65835.00
431075,202006,7,7,0,7315.00,0.00,7315.00
431080,202006,134,81,53,84645.00,55385.00,140030.00
431085,202006,34,31,3,32395.00,3135.00,35530.00
431087,202006,15,13,2,13585.00,2090.00,15675.00
431090,202006,56,44,12,45980.00,12540.00,58520.00
431100,202006,1217,733,484,768076.55,505780.00,1273856.55
431110,202006,229,139,90,146300.00,94050.50,240350.50
431112,202006,28,16,12,16720.00,12540.00,29260.00
431113,202006,33,24,9,25080.00,9405.00,34485.00
431115,202006,152,106,46,110770.00,48070.00,158840.00
431120,202006,611,363,248,379335.00,259160.00,638495.00
431123,202006,3,2,1,2090.00,1045.00,3135.00
431125,202006,95,86,9,89870.00,9405.00,99275.00
431127,202006,10,5,5,5225.00,5225.00,10450.00
431130,202006,686,452,234,474430.00,247665.00,722095.00
431140,202006,753,518,235,542355.50,245575.00,787930.50
431142,202006,26,22,4,22990.67,4180.00,27170.67
431150,202006,195,147,48,154660.00,50160.00,204820.00
431160,202006,50,45,5,47025.00,5225.00,52250.00
431162,202006,5,4,1,4180.00,1045.00,5225.00
431164,202006,6,6,0,6270.00,0.00,6270.00
431170,202006,105,83,22,86735.00,22990.00,109725.00
431171,202006,69,41,28,42845.00,29260.00,72105.00
431173,202006,1,1,0,1045.00,0.00,1045.00
431175,202006,197,101,96,106590.50,101365.00,207955.50
431177,202006,83,58,25,60610.00,26125.00,86735.00
431179,202006,12,10,2,10450.00,2090.00,12540.00
431180,202006,434,261,173,274835.00,180785.00,455620.00
431190,202006,79,61,18,63745.00,18810.00,82555.00
431198,202006,75,54,21,56430.00,21945.00,78375.00
431200,202006,21,17,4,17765.00,4180.00,21945.00
431205,202006,20,19,1,19855.00,1045.00,20900.00
431210,202006,96,60,36,62700.00,37620.00,100320.00
431213,202006,30,26,4,27170.00,4180.00,31350.00
431215,202006,23,20,3,20900.00,3135.00,24035.00
431217,202006,4,3,1,3135.00,1045.00,4180.00
431220,202006,67,58,9,60610.87,9405.00,70015.87
431225,202006,150,96,54,100320.00,56430.00,156750.00
431230,202006,100,86,14,89870.00,14630.00,104500.00
431235,202006,7,7,0,7315.00,0.00,7315.00
431237,202006,21,15,6,15675.00,6270.00,21945.00
431238,202006,9,6,3,6270.00,3135.00,9405.00
431240,202006,1004,633,371,661485.00,387695.00,1049180.00
431242,202006,38,37,1,38665.00,1045.00,39710.00
431244,202006,13,9,4,9405.00,4180.00,13585.00
431245,202006,48,36,12,37620.00,12540.00,50160.00
431247,202006,9,6,3,6270.00,3135.00,9405.00
431250,202006,281,144,137,151525.00,143165.00,294690.00
431260,202006,58,45,13,47025.00,13585.00,60610.00
431261,202006,18,11,7,11495.00,7315.00,18810.00
431262,202006,17,16,1,16720.00,1045.00,17765.00
431265,202006,149,79,70,82555.00,73150.00,155705.00
431267,202006,16,14,2,14630.00,2090.00,16720.00
431270,202006,325,264,61,275880.00,63745.00,339625.00
431275,202006,37,34,3,35530.00,3135.00,38665.00
431280,202006,19,15,4,15675.00,4180.00,19855.00
431290,202006,23,21,2,21945.00,2090.00,24035.00
431295,202006,2,2,0,2090.00,0.00,2090.00
431300,202006,21,18,3,18810.00,3135.00,21945.00
431301,202006,5,5,0,5225.00,0.00,5225.00
431303,202006,58,38,20,39710.00,20900.00,60610.00
431306,202006,247,131,116,136708.99,122265.00,258973.99
431308,202006,7,5,2,5225.00,2090.00,7315.00
431310,202006,66,55,11,57475.00,11495.00,68970.00
431320,202006,145,87,58,90915.00,61655.00,152570.00
431330,202006,174,114,60,119130.00,62700.00,181830.00
431333,202006,25,19,6,19855.00,6270.00,26125.00
431335,202006,9,5,4,5225.00,4180.00,9405.00
431337,202006,349,156,193,163020.00,201685.00,364705.00
431339,202006,20,18,2,18810.00,2090.00,20900.00
431340,202006,3022,1659,1363,1734618.24,1428516.25,3163134.49
431342,202006,36,23,13,24035.00,13585.00,37620.00
431344,202006,19,19,0,19855.00,0.00,19855.00
431346,202006,5,5,0,5225.00,0.00,5225.00
431349,202006,35,31,4,32395.00,4180.00,36575.00
431350,202006,935,541,394,565345.75,411730.00,977075.75
431360,202006,46,39,7,40755.00,7315.00,48070.00
431365,202006,337,157,180,164065.00,188100.00,352165.00
431370,202006,1218,698,520,729410.50,543400.00,1272810.50
431380,202006,97,84,13,87780.00,13585.00,101365.00
431390,202006,499,265,234,276925.00,244530.00,521455.00
431395,202006,291,128,163,133760.00,171380.00,305140.00
431400,202006,42,29,13,30305.00,13585.00,43890.00
431402,202006,103,73,30,76285.00,31350.00,107635.00
431403,202006,24,14,10,14630.00,10450.00,25080.00
431405,202006,668,365,303,381425.25,317680.00,699105.25
431406,202006,29,25,4,26125.00,4180.00,30305.00
431407,202006,54,43,11,44935.00,11495.00,56430.00
431410,202006,3387,2068,1319,2163151.00,1380445.75,3543596.75
431413,202006,15,12,3,12540.00,3135.00,15675.00
431415,202006,69,51,18,53295.00,18810.00,72105.00
431417,202006,22,11,11,11495.00,11495.00,22990.00
431420,202006,323,219,104,228855.00,108680.00,337535.00
431430,202006,50,22,28,22990.00,29260.00,52250.00
431440,202006,8889,6181,2708,6463333.97,2835086.76,9298420.73
431442,202006,29,13,16,13585.00,16720.00,30305.00
431445,202006,23,21,2,21945.00,2090.00,24035.00
431446,202006,4,4,0,4180.00,0.00,4180.00
431447,202006,81,57,24,59565.00,25080.00,84645.00
431449,202006,53,46,7,48070.00,7315.00,55385.00
431450,202006,413,275,138,287375.00,144210.00,431585.00
431454,202006,0,0,0,0.00,0.00,0.00
431455,202006,53,40,13,42845.00,13585.00,56430.00
431460,202006,512,352,160,368885.00,167200.00,536085.00
431470,202006,119,90,29,94050.00,30305.00,124355.00
431475,202006,11,9,2,9405.00,2090.00,11495.00
431477,202006,36,25,11,26125.00,11495.00,37620.00
431478,202006,9,8,1,8360.00,1045.00,9405.00
431480,202006,506,305,201,319770.00,210045.00,529815.00
431490,202006,28613,16023,12590,16755923.25,13174319.00,29930242.25
431500,202006,76,62,14,64790.00,14630.00,79420.00
431505,202006,26,16,10,16720.00,10450.00,27170.00
431507,202006,10,8,2,8360.00,2090.00,10450.00
431510,202006,255,181,74,189145.25,77330.00,266475.25
431513,202006,24,21,3,21945.00,3135.00,25080.00
431514,202006,6,5,1,5225.00,1045.00,6270.00
431515,202006,81,67,14,70015.00,14630.00,84645.00
431517,202006,5,3,2,3135.00,2090.00,5225.00
431520,202006,42,37,5,38665.00,5225.00,43890.00
431530,202006,1458,661,797,690745.00,832865.00,1523610.00
431531,202006,24,23,1,24035.00,1045.00,25080.00
431532,202006,34,25,9,26125.00,9405.00,35530.00
431535,202006,28,16,12,16720.00,12540.00,29260.00
431540,202006,138,117,21,122265.00,21945.00,144210.00
431545,202006,14,12,2,12540.00,2090.00,14630.00
431550,202006,350,194,156,203775.00,163020.00,366795.00
431555,202006,12,12,0,12540.00,0.00,12540.00
431560,202006,4547,3109,1438,3249953.35,1503755.00,4753708.35
431570,202006,823,429,394,449351.00,411730.00,861081.00
431575,202006,39,22,17,22990.00,17765.00,40755.00
431580,202006,94,61,33,63745.00,34485.00,98230.00
431590,202006,143,122,21,127490.00,21945.00,149435.00
431595,202006,18,15,3,15675.00,3135.00,18810.00
431600,202006,245,141,104,147345.00,108680.00,256025.00
431610,202006,116,85,31,88825.00,32395.00,121220.00
431620,202006,43,36,7,37620.00,7315.00,44935.00
431630,202006,131,109,22,113905.00,22990.00,136895.00
431640,202006,1340,853,487,892430.50,508915.50,1401346.00
431642,202006,35,33,2,34485.00,2090.00,36575.00
431643,202006,45,21,24,21945.00,25080.00,47025.00
431645,202006,315,187,128,195415.00,133760.00,329175.00
431647,202006,8,8,0,8360.00,0.00,8360.00
431650,202006,34,23,11,24035.00,11495.00,35530.00
431660,202006,322,205,117,214225.00,122265.00,336490.00
431670,202006,228,103,125,107635.00,131670.00,239305.00
431673,202006,3,3,0,3135.00,0.00,3135.00
431675,202006,27,21,6,21945.00,6270.00,28215.00
431680,202006,1111,813,298,851675.00,311410.00,1163085.00
431690,202006,4739,2848,1891,2979298.60,1982366.00,4961664.60
431695,202006,23,16,7,16720.00,7315.00,24035.00
431697,202006,1,0,1,0.00,1045.00,1045.00
431700,202006,178,137,41,143165.00,42845.00,186010.00
431710,202006,3988,1744,2244,1823525.50,2349160.00,4172685.50
431720,202006,1325,817,508,853243.00,530860.00,1384103.00
431725,202006,1,1,0,1045.00,0.00,1045.00
431730,202006,1164,788,376,826597.90,392920.00,1219517.90
431740,202006,1341,659,682,688655.00,715825.50,1404480.50
431750,202006,1831,1195,636,1252955.55,667755.00,1920710.55
431755,202006,5,4,1,4180.00,1045.00,5225.00
431760,202006,1033,654,379,685522.00,396055.00,1081577.00
431770,202006,411,296,115,309320.00,121220.00,430540.00
431775,202006,29,21,8,21945.00,8360.00,30305.00
431780,202006,544,332,212,346940.00,221540.00,568480.00
431790,202006,168,130,38,135850.00,39710.00,175560.00
431795,202006,12,10,2,10450.00,2090.00,12540.00
431800,202006,3226,1691,1535,1769187.70,1608256.00,3377443.70
431805,202006,17,15,2,15675.00,2090.00,17765.00
431810,202006,601,396,205,413820.00,214225.00,628045.00
431820,202006,327,196,131,204820.00,136895.00,341715.00
431830,202006,2313,1388,925,1452550.50,967670.00,2420220.50
431840,202006,480,321,159,337535.00,167200.00,504735.00
431842,202006,34,27,7,28215.00,7315.00,35530.00
431843,202006,10,8,2,8360.00,2090.00,10450.00
431844,202006,17,13,4,13585.00,4180.00,17765.00
431845,202006,28,25,3,26125.00,3135.00,29260.00
431846,202006,26,22,4,22990.00,4180.00,27170.00
431848,202006,12,10,2,10450.00,2090.00,12540.00
431849,202006,7,6,1,6270.00,1045.00,7315.00
431850,202006,789,641,148,669845.00,155705.00,825550.00
431860,202006,114,77,37,80465.00,38665.00,119130.00
431861,202006,7,2,5,2090.00,5225.00,7315.00
431862,202006,54,37,17,38665.00,17765.00,56430.00
431870,202006,3490,2011,1479,2103585.50,1551825.00,3655410.50
431880,202006,923,676,247,706420.00,259160.00,965580.00
431890,202006,1310,786,524,822415.50,548625.00,1371040.50
431900,202006,181,129,52,134805.00,54340.00,189145.00
431910,202006,54,39,15,40755.00,15675.00,56430.00
431912,202006,42,24,18,26125.00,18810.00,44935.00
431915,202006,122,95,27,99275.00,28215.00,127490.00
431920,202006,155,113,42,118085.00,43890.00,161975.00
431930,202006,81,66,15,68970.00,15675.00,84645.00
431935,202006,3,3,0,3135.00,0.00,3135.00
431936,202006,12,11,1,11495.00,1045.00,12540.00
431937,202006,18,14,4,14630.00,4180.00,18810.00
431940,202006,459,306,153,320815.00,159885.25,480700.25
431950,202006,498,313,185,327085.50,194370.00,521455.50
431960,202006,736,402,334,421135.50,349030.00,770165.50
431970,202006,70,63,7,65835.00,7315.00,73150.00
431971,202006,3,3,0,3135.00,0.00,3135.00
431973,202006,21,17,4,17765.00,4180.00,21945.00
431975,202006,9,8,1,8360.00,1045.00,9405.00
431980,202006,213,132,81,137940.00,84645.00,222585.00
431990,202006,1151,618,533,645742.52,560120.00,1205862.52
432000,202006,1715,904,811,946771.75,850631.00,1797402.75
432010,202006,278,188,90,196460.00,94050.00,290510.00
432020,202006,168,139,29,146300.00,30305.00,176605.00
432023,202006,16,13,3,13585.00,3135.00,16720.00
432026,202006,66,61,5,63745.00,5225.00,68970.00
432030,202006,68,35,33,36575.00,34485.00,71060.00
432032,202006,20,16,4,16720.00,4180.00,20900.00
432035,202006,54,44,10,45980.00,10450.00,56430.00
432040,202006,98,68,30,71060.00,31350.00,102410.00
432045,202006,5,4,1,4180.00,1045.00,5225.00
432050,202006,80,47,33,49115.00,34485.00,83600.00
432055,202006,122,89,33,93005.00,34485.00,127490.00
432057,202006,7,6,1,6270.50,1045.00,7315.50
432060,202006,34,31,3,32395.00,3135.00,35530.00
432065,202006,33,29,4,30305.00,4180.00,34485.00
432067,202006,91,82,9,85690.00,9405.00,95095.00
432070,202006,393,299,94,312717.50,98230.00,410947.50
432080,202006,819,569,250,594605.00,262295.00,856900.00
432085,202006,11,8,3,8360.00,3135.00,11495.00
432090,202006,265,178,87,186010.00,90915.00,276925.00
432100,202006,173,116,57,121220.00,60610.00,181830.00
432110,202006,563,379,184,396055.00,193325.00,589380.00
432120,202006,952,554,398,578930.00,418000.50,996930.50
432130,202006,479,345,134,361570.00,141075.00,502645.00
432132,202006,23,20,3,20900.00,3135.00,24035.00
432135,202006,82,67,15,70015.00,15675.00,85690.00
432140,202006,268,207,61,216315.00,63745.00,280060.00
432143,202006,207,131,76,136895.00,79420.00,216315.00
432145,202006,276,188,88,196460.00,91960.00,288420.00
432146,202006,14,13,1,13585.00,1045.00,14630.00
432147,202006,99,56,43,58520.00,44935.00,103455.00
432149,202006,15,10,5,10450.00,5225.00,15675.00
432150,202006,881,536,345,560120.50,361570.00,921690.50
432160,202006,1500,771,729,806740.22,761805.00,1568545.22
432162,202006,4,3,1,3135.00,1045.00,4180.00
432163,202006,19,14,5,14630.00,5225.00,19855.00
432166,202006,121,89,32,93267.50,33440.00,126707.50
432170,202006,222,112,110,117040.00,114950.00,231990.00
432180,202006,545,335,210,352165.00,221540.50,573705.50
432183,202006,7,7,0,7315.00,0.00,7315.00
432185,202006,77,67,10,71060.00,10450.00,81510.00
432190,202006,482,283,199,295735.00,207955.00,503690.00
432195,202006,86,72,14,75240.00,14630.00,89870.00
432200,202006,411,262,149,274835.00,155705.00,430540.00
432210,202006,118,75,43,78375.00,44935.00,123310.00
432215,202006,43,39,4,40755.00,4180.00,44935.00
432218,202006,20,19,1,19855.00,1045.00,20900.00
432220,202006,664,345,319,361570.00,334400.29,695970.29
432225,202006,14,8,6,8360.00,6270.00,14630.00
432230,202006,136,92,44,96140.00,45980.00,142120.00
432232,202006,12,11,1,11495.00,1045.00,12540.00
432234,202006,3,2,1,2090.00,1045.00,3135.00
432235,202006,3,3,0,3135.00,0.00,3135.00
432237,202006,29,17,12,17765.00,12540.00,30305.00
432240,202006,4327,2415,1912,2527856.00,2000131.50,4527987.50
432250,202006,1102,719,383,751355.00,400235.00,1151590.00
432252,202006,45,42,3,43890.00,3135.00,47025.00
432253,202006,61,49,12,51205.00,12540.00,63745.00
432254,202006,25,11,14,11495.00,14630.00,26125.00
432255,202006,14,12,2,12540.00,2090.00,14630.00
432260,202006,813,637,176,666710.50,184965.00,851675.50
432270,202006,244,184,60,192280.00,62700.00,254980.00
432280,202006,138,105,33,110770.00,34485.00,145255.00
432285,202006,2,2,0,2090.00,0.00,2090.00
432290,202006,65,57,8,59565.00,8360.00,67925.00
432300,202006,4712,2568,2144,2686627.07,2243616.00,4930243.07
432310,202006,129,104,25,108680.00,26125.00,134805.00
432320,202006,22,17,5,17765.00,5225.00,22990.00
432330,202006,17,12,5,12540.00,5225.00,17765.00
432335,202006,8,6,2,6270.00,2090.00,8360.00
432340,202006,39,33,6,34485.00,6270.00,40755.00
432345,202006,101,69,32,72105.00,33440.00,105545.00
432350,202006,20,19,1,19855.00,1045.00,20900.00
432360,202006,6,5,1,5225.00,1045.00,6270.00
432370,202006,25,24,1,25080.00,1045.00,26125.00
432375,202006,30,27,3,28215.00,3135.00,31350.00
432377,202006,8,8,0,8360.00,0.00,8360.00
432380,202006,171,77,94,80465.00,99275.00,179740.00
500020,202006,238,131,107,137940.00,113905.00,251845.00
500025,202006,137,68,69,71060.00,72105.00,143165.00
500060,202006,1449,904,545,945725.00,569525.50,1515250.50
500070,202006,800,379,421,397100.29,440990.50,838090.79
500080,202006,128,101,27,105545.00,28215.00,133760.00
500085,202006,135,111,24,115995.50,25080.00,141075.50
500090,202006,350,159,191,166155.00,199595.00,365750.00
500100,202006,723,378,345,395010.00,361571.00,756581.00
500110,202006,2263,1050,1213,1098296.00,1270720.75,2369016.75
500124,202006,263,144,119,150480.00,124355.00,274835.00
500150,202006,343,136,207,142120.00,216315.00,358435.00
500190,202006,516,352,164,368885.00,171380.50,540265.50
500200,202006,188,161,27,168245.20,28215.00,196460.20
500210,202006,1564,543,1021,567435.00,1066945.25,1634380.25
500215,202006,246,140,106,146300.00,111815.00,258115.00
500220,202006,749,483,266,505780.77,279015.00,784795.77
500230,202006,242,152,90,158840.00,94050.00,252890.00
500240,202006,675,462,213,483835.40,222585.50,706420.90
500260,202006,594,228,366,238260.00,383515.00,621775.00
500270,202006,29963,12762,17201,13356589.62,18018940.75,31375530.37
500280,202006,202,70,132,73150.00,137940.00,211090.00
500290,202006,1171,706,465,739860.50,486970.00,1226830.50
500295,202006,440,283,157,295735.50,164065.00,459800.50
500310,202006,74,24,50,25080.00,52250.00,77330.00
500315,202006,738,428,310,448305.00,323950.00,772255.00
500320,202006,3642,1788,1854,1869505.54,1938475.00,3807980.54
500325,202006,940,508,432,530861.00,451440.50,982301.50
500330,202006,1495,704,791,735680.50,827640.00,1563320.50
500345,202006,311,236,75,246620.50,79420.00,326040.50
500348,202006,255,148,107,154660.00,111815.00,266475.00
500350,202006,116,55,61,57475.00,63745.00,121220.00
500370,202006,5607,2504,3103,2617726.00,3250996.00,5868722.00
500375,202006,347,245,102,257070.00,107635.00,364705.00
500380,202006,591,337,254,352165.00,265430.00,617595.00
500390,202006,77,37,40,38665.00,41800.00,80465.00
500400,202006,215,140,75,146300.00,78375.00,224675.00
500410,202006,545,224,321,234080.00,337535.00,571615.00
500430,202006,517,369,148,385605.00,155705.00,541310.00
500440,202006,196,103,93,107635.00,97185.00,204820.00
500450,202006,396,171,225,179740.00,235125.00,414865.00
500460,202006,273,145,128,152570.00,133760.00,286330.00
500470,202006,431,342,89,357390.50,93005.00,450395.50
500480,202006,104,64,40,66880.00,41800.00,108680.00
500490,202006,105,45,60,48070.00,62700.00,110770.00
500500,202006,1441,523,918,546535.00,960355.00,1506890.00
500510,202006,44,35,9,36575.00,9405.00,45980.00
500515,202006,102,70,32,74195.00,33440.00,107635.00
500520,202006,320,169,151,176605.00,157795.50,334400.50
500525,202006,90,49,41,51205.00,42845.00,94050.00
500540,202006,888,381,507,400235.00,529815.50,930050.50
500560,202006,936,522,414,545490.00,432631.00,978121.00
500568,202006,985,556,429,582065.00,448305.50,1030370.50
500570,202006,1208,696,512,728366.50,535040.50,1263407.00
500580,202006,340,173,167,180785.00,174515.00,355300.00
500600,202006,340,163,177,170335.00,184965.00,355300.00
500620,202006,900,635,265,664620.42,276925.00,941545.42
500625,202006,79,61,18,64790.00,18810.00,83600.00
500627,202006,21,10,11,10450.00,11495.00,21945.00
500630,202006,1574,872,702,911242.54,734635.50,1645878.04
500635,202006,516,306,210,319770.00,219450.00,539220.00
500640,202006,386,203,183,212135.00,191235.00,403370.00
500660,202006,5499,2014,3485,2108810.50,3652276.50,5761087.00
500690,202006,602,210,392,219450.00,409640.00,629090.00
500710,202006,403,206,197,215270.00,205865.00,421135.00
500720,202006,955,548,407,572660.73,429495.00,1002155.73
500730,202006,195,116,79,121220.00,82555.00,203775.00
500740,202006,891,373,518,390830.00,543400.00,934230.00
500750,202006,143,46,97,48070.00,101365.00,149435.00
500755,202006,123,89,34,93005.50,35530.00,128535.50
500769,202006,752,412,340,431585.50,355300.00,786885.50
500770,202006,402,213,189,223630.00,197505.00,421135.00
500780,202006,155,102,53,106590.00,55385.50,161975.50
500790,202006,1074,542,532,567435.00,559075.00,1126510.00
500793,202006,280,150,130,158840.00,135850.50,294690.50
500795,202006,171,117,54,122265.00,56430.00,178695.00
500797,202006,51,37,14,38665.00,15675.00,54340.00
500800,202006,434,193,241,201685.00,252890.00,454575.00
500830,202006,2217,1236,981,1298935.75,1027235.00,2326170.75
500840,202006,138,103,35,107635.00,36575.00,144210.00
510010,202006,174,91,83,95095.00,86735.00,181830.00
510020,202006,499,221,278,230945.00,292600.00,523545.00
510025,202006,1693,964,729,1007380.20,763895.50,1771275.70
510030,202006,666,345,321,360525.00,335445.50,695970.50
510035,202006,127,62,65,64790.00,67925.00,132715.00
510040,202006,407,188,219,196460.00,229900.30,426360.30
510050,202006,406,216,190,225720.00,198550.73,424270.73
510060,202006,120,59,61,61655.00,63745.00,125400.00
510080,202006,235,88,147,91960.00,153615.50,245575.50
510100,202006,67,28,39,29260.00,41800.00,71060.00
510120,202006,38,23,15,24035.00,15675.00,39710.00
510125,202006,387,240,147,250800.00,154660.00,405460.00
510130,202006,561,320,241,334400.00,251845.50,586245.50
510140,202006,426,125,301,130625.00,315590.00,446215.00
510160,202006,112,37,75,38665.00,78375.00,117040.00
510170,202006,805,485,320,507870.03,334400.00,842270.03
510180,202006,2939,1382,1557,1445237.00,1632291.26,3077528.26
510185,202006,20,8,12,8360.00,12540.00,20900.00
510190,202006,230,82,148,86735.00,154660.00,241395.00
510250,202006,2592,1525,1067,1594670.50,1118151.50,2712822.00
510260,202006,177,129,48,135850.00,50160.00,186010.00
510263,202006,468,265,203,277970.50,213180.00,491150.50
510267,202006,680,378,302,395010.50,315590.00,710600.50
510268,202006,62,28,34,29260.00,35530.00,64790.00
510269,202006,75,35,40,36575.00,41800.00,78375.00
510270,202006,392,196,196,204820.00,204820.00,409640.00
510279,202006,214,160,54,168245.00,56430.00,224675.00
510285,202006,183,73,110,76285.00,114950.00,191235.00
510300,202006,516,270,246,282150.00,258115.00,540265.00
510305,202006,206,98,108,102410.00,113905.00,216315.00
510310,202006,103,54,49,56430.00,52250.00,108680.00
510320,202006,855,537,318,561165.00,332310.00,893475.00
510325,202006,409,172,237,179740.00,247665.00,427405.00
510330,202006,430,239,191,249755.00,200640.00,450395.00
510335,202006,637,362,275,378290.00,287375.00,665665.00
510336,202006,55,39,16,40755.00,16720.00,57475.00
510337,202006,107,46,61,48070.00,63745.00,111815.00
510340,202006,17435,7889,9546,8252367.34,9989156.75,18241524.09
510343,202006,64,45,19,47025.00,19855.00,66880.00
510345,202006,162,105,57,109725.00,59565.50,169290.50
510350,202006,644,356,288,372020.00,300960.50,672980.50
510360,202006,204,123,81,128535.00,84645.00,213180.00
510370,202006,149,72,77,75240.00,80465.00,155705.00
510380,202006,86,64,22,66880.00,22990.00,89870.00
510385,202006,62,27,35,28215.00,36575.00,64790.00
510390,202006,107,47,60,49115.00,62700.00,111815.00
510395,202006,48,34,14,35530.00,14630.00,50160.00
510410,202006,710,466,244,486970.00,256025.00,742995.00
510420,202006,577,278,299,290510.00,312455.00,602965.00
510450,202006,49,24,25,25080.00,26125.00,51205.00
510452,202006,50,23,27,24035.00,28215.00,52250.00
510454,202006,52,24,28,25080.00,29260.00,54340.00
510455,202006,133,79,54,82555.00,57475.00,140030.00
510460,202006,179,84,95,87780.00,99275.00,187055.00
510480,202006,721,423,298,442035.20,313500.00,755535.20
510490,202006,351,177,174,184965.00,181830.00,366795.00
510500,202006,239,179,60,187055.00,62700.00,249755.00
510510,202006,789,463,326,483835.50,340670.00,824505.50
510515,202006,1221,634,587,662530.00,614460.00,1276990.00
510517,202006,253,108,145,113905.00,152570.12,266475.12
510520,202006,233,150,83,156750.00,86735.00,243485.00
510523,202006,99,76,23,79420.00,24035.00,103455.00
510525,202006,818,483,335,505780.00,352165.00,857945.00
510530,202006,21,15,6,15675.00,6270.00,21945.00
510550,202006,255,112,143,117040.00,149435.00,266475.00
510558,202006,291,143,148,149435.00,155705.00,305140.00
510560,202006,416,243,173,253935.50,180785.00,434720.50
510562,202006,645,465,180,485925.00,188100.00,674025.00
510590,202006,763,392,371,409640.00,387695.00,797335.00
510600,202006,241,125,116,132715.00,121220.00,253935.00
510610,202006,205,84,121,87780.00,126445.00,214225.00
510615,202006,183,83,100,86735.00,105545.00,192280.00
510617,202006,19,11,8,11495.00,8360.00,19855.00
510618,202006,118,55,63,57475.00,65835.00,123310.00
510619,202006,99,68,31,71060.00,32395.00,103455.00
510620,202006,168,94,74,98230.00,77330.00,175560.00
510621,202006,181,117,64,122265.00,66880.00,189145.00
510622,202006,503,307,196,320815.00,204820.00,525635.00
510623,202006,327,226,101,236170.00,105545.00,341715.00
510624,202006,92,45,47,47025.00,49115.00,96140.00
510625,202006,535,329,206,343805.00,216315.29,560120.29
510626,202006,113,69,44,72105.00,45980.00,118085.00
510627,202006,70,49,21,51205.00,21945.00,73150.00
510628,202006,153,91,62,95095.00,66880.00,161975.00
510629,202006,259,160,99,167200.00,103474.00,270674.00
510630,202006,441,227,214,238260.00,223630.00,461890.00
510631,202006,14,3,11,3135.00,11495.00,14630.00
510637,202006,351,200,151,209000.00,157795.00,366795.00
510642,202006,996,531,465,555940.00,485925.00,1041865.00
510645,202006,2,0,2,0.00,2090.00,2090.00
510650,202006,1431,933,498,974985.50,520410.00,1495395.50
510665,202006,78,35,43,37620.00,44935.00,82555.00
510670,202006,59,33,26,34485.00,27170.00,61655.00
510675,202006,1150,725,425,757625.50,445170.00,1202795.50
510677,202006,348,177,171,184965.00,178695.00,363660.00
510680,202006,106,60,46,62700.00,48070.00,110770.00
510682,202006,204,104,100,108680.00,104500.00,213180.00
510685,202006,55,41,14,42845.00,15675.00,58520.00
510700,202006,586,335,251,350075.00,262295.00,612370.00
510704,202006,1168,610,558,637450.00,583110.00,1220560.00
510706,202006,137,68,69,71060.00,72105.00,143165.00
510710,202006,385,271,114,283195.00,119130.00,402325.00
510715,202006,58,41,17,42845.00,17765.00,60610.00
510718,202006,210,105,105,109725.00,109725.00,219450.00
510719,202006,39,17,22,17765.00,22990.00,40755.00
510720,202006,191,130,61,135850.00,63745.00,199595.00
510724,202006,87,33,54,34485.00,56430.00,90915.00
510726,202006,48,24,24,25080.00,25080.00,50160.00
510729,202006,68,31,37,32395.00,38665.00,71060.00
510730,202006,476,264,212,275880.00,222585.00,498465.00
510735,202006,117,48,69,50160.00,72105.00,122265.00
510740,202006,22,11,11,11495.00,11495.00,22990.00
510757,202006,24,19,5,19855.00,5225.00,25080.00
510760,202006,7203,3697,3506,3866501.50,3670042.25,7536543.75
510770,202006,689,322,367,336490.00,385605.00,722095.00
510774,202006,18,7,11,7315.00,11495.00,18810.00
510775,202006,105,80,25,83600.00,26125.00,109725.00
510776,202006,28,10,18,10450.00,18810.00,29260.00
510777,202006,193,82,111,85690.00,115995.00,201685.00
510779,202006,52,23,29,24035.00,30305.00,54340.00
510780,202006,286,158,128,165110.00,133760.00,298870.00
510785,202006,390,212,178,221540.00,186010.00,407550.00
510787,202006,198,96,102,100320.00,106590.00,206910.00
510788,202006,3,0,3,0.00,3135.00,3135.00
510790,202006,2477,1291,1186,1350189.75,1241460.00,2591649.75
510792,202006,1158,646,512,675070.00,537130.66,1212200.66
510794,202006,116,61,55,63745.00,57475.00,121220.00
510795,202006,2347,1363,984,1424335.50,1029326.00,2453661.50
510800,202006,174,103,71,107635.00,74195.00,181830.00
510805,202006,184,121,63,126445.00,65835.00,192280.00
510810,202006,98,43,55,44935.00,58520.00,103455.00
510820,202006,237,119,118,124355.45,124355.12,248710.57
510830,202006,72,42,30,43890.00,32395.00,76285.00
510835,202006,14,9,5,9405.00,5225.00,14630.00
510840,202006,9196,4365,4831,4568743.13,5052575.50,9621318.63
510850,202006,220,87,133,91960.00,140030.00,231990.00
510860,202006,382,171,211,178695.00,220495.50,399190.50
510880,202006,66,50,16,52250.00,16720.00,68970.00
510885,202006,74,41,33,42845.00,34485.00,77330.00
510890,202006,68,39,29,40755.00,30305.00,71060.00
510895,202006,179,106,73,110770.00,77330.50,188100.50
520005,202006,112,50,62,52250.00,64790.00,117040.00
520010,202006,282,127,155,132715.00,161975.50,294690.50
520013,202006,720,464,256,485925.00,268565.00,754490.00
520015,202006,53,40,13,41800.00,14630.00,56430.00
520017,202006,86,48,38,50160.50,39710.00,89870.50
520020,202006,19,10,9,10450.00,9405.00,19855.00
520025,202006,2239,1162,1077,1214290.50,1131735.00,2346025.50
520030,202006,802,425,377,444125.00,395010.00,839135.00
520050,202006,70,49,21,51205.00,21945.00,73150.00
520055,202006,50,31,19,32395.00,19855.00,52250.00
520060,202006,177,117,60,122265.00,62700.00,184965.00
520080,202006,584,415,169,434720.00,176605.00,611325.00
520082,202006,18,12,6,12540.00,6270.00,18810.00
520085,202006,94,70,24,73150.00,25080.00,98230.00
520090,202006,93,62,31,64790.00,32395.00,97185.00
520110,202006,9275,3969,5306,4150741.60,5549997.50,9700739.10
520120,202006,13,8,5,8360.00,5225.00,13585.00
520130,202006,796,555,241,579975.00,251845.50,831820.50
520140,202006,12049,6684,5365,6990008.00,5616875.80,12606883.80
520145,202006,53,32,21,34485.00,21945.00,56430.00
520150,202006,165,130,35,135850.00,36575.00,172425.00
520160,202006,37,27,10,28215.00,10450.00,38665.00
520170,202006,254,146,108,152570.00,112860.00,265430.00
520180,202006,167,78,89,81510.00,94050.00,175560.00
520215,202006,204,136,68,142120.00,71060.00,213180.00
520235,202006,81,62,19,65835.00,19855.00,85690.00
520250,202006,130,76,54,79420.00,56430.00,135850.00
520260,202006,116,73,43,76285.00,44935.00,121220.00
520280,202006,50,34,16,35530.00,16720.00,52250.00
520310,202006,40,27,13,28215.00,13585.00,41800.00
520320,202006,173,110,63,114950.00,65835.00,180785.00
520330,202006,789,418,371,436810.00,388740.00,825550.00
520340,202006,363,216,147,226765.00,154660.50,381425.50
520350,202006,509,237,272,247665.00,286330.00,533995.00
520355,202006,88,52,36,54340.00,37620.00,91960.00
520357,202006,24,18,6,18810.00,6270.00,25080.00
520360,202006,1,1,0,1045.00,0.00,1045.00
520380,202006,135,73,62,76285.00,64790.00,141075.00
520390,202006,261,109,152,113905.50,158840.00,272745.50
520393,202006,15,11,4,11495.00,4180.00,15675.00
520396,202006,76,49,27,51205.00,28215.00,79420.00
520400,202006,201,118,83,124355.00,86735.00,211090.00
520410,202006,198,99,99,103455.00,103455.00,206910.00
520420,202006,20,13,7,13585.00,7315.00,20900.00
520425,202006,293,145,148,151525.00,154660.00,306185.00
520430,202006,482,244,238,256121.14,248710.25,504831.39
520440,202006,691,497,194,519365.00,202730.00,722095.00
520450,202006,1974,854,1120,893475.00,1170400.00,2063875.00
520455,202006,54,31,23,32395.00,24035.00,56430.00
520460,202006,36,22,14,22990.00,14630.00,37620.00
520465,202006,31,27,4,28215.00,4180.00,32395.00
520470,202006,434,278,156,291555.00,163020.00,454575.00
520480,202006,78,48,30,50160.00,31350.00,81510.00
520485,202006,118,40,78,41800.00,82555.50,124355.50
520490,202006,410,303,107,316635.00,111815.00,428450.00
520495,202006,161,96,65,100320.00,67925.00,168245.00
520500,202006,189,146,43,152570.00,44935.00,197505.00
520505,202006,187,107,80,111815.00,83600.00,195415.00
520510,202006,1817,864,953,904970.50,997977.25,1902947.75
520520,202006,43,32,11,33440.00,11495.00,44935.00
520530,202006,226,171,55,179740.00,57475.00,237215.00
520540,202006,576,398,178,415910.00,186010.00,601920.00
520545,202006,133,81,52,84645.00,54340.00,138985.00
520547,202006,56,32,24,33440.00,25080.00,58520.00
520549,202006,1223,569,654,595650.30,684475.00,1280125.30
520551,202006,302,159,143,166155.00,149435.50,315590.50
520552,202006,41,26,15,27170.00,15675.00,42845.00
520570,202006,16,10,6,10450.00,6270.00,16720.00
520580,202006,280,173,107,180785.00,111815.00,292600.00
520590,202006,152,93,59,97185.00,61655.00,158840.00
520620,202006,1148,530,618,553850.50,647900.25,1201750.75
520630,202006,37,21,16,21945.00,17765.00,39710.00
520640,202006,388,225,163,235125.00,170335.00,405460.00
520650,202006,65,36,29,37620.00,30305.00,67925.00
520660,202006,44,23,21,24035.00,21945.00,45980.00
520670,202006,37,31,6,32395.00,6270.00,38665.00
520680,202006,52,35,17,36575.00,17765.00,54340.00
520690,202006,41,11,30,11495.00,31350.00,42845.00
520710,202006,33,30,3,31350.00,3135.00,34485.00
520725,202006,202,148,54,154660.00,56430.00,211090.00
520735,202006,55,37,18,38665.00,18810.00,57475.00
520740,202006,419,199,220,207955.00,230945.50,438900.50
520750,202006,37,26,11,27170.00,11495.00,38665.00
520753,202006,64,45,19,47025.00,19855.00,66880.00
520760,202006,102,68,34,71060.00,35530.00,106590.00
520780,202006,288,213,75,222585.00,78375.00,300960.00
520790,202006,156,88,68,91960.00,71060.00,163020.00
520800,202006,3420,1843,1577,1926980.50,1653190.20,3580170.70
520810,202006,158,120,38,125400.00,40755.00,166155.00
520815,202006,5,4,1,4180.00,1045.00,5225.00
520830,202006,148,102,46,106590.00,48070.00,154660.00
520840,202006,350,234,116,244530.00,122265.00,366795.00
520850,202006,103,62,41,64790.00,42845.00,107635.00
520860,202006,1744,1127,617,1180850.50,644765.50,1825616.00
520870,202006,32019,15077,16942,15770103.97,17731568.00,33501671.97
520880,202006,1173,622,551,654170.50,575795.50,1229966.00
520890,202006,791,480,311,501600.00,324995.00,826595.00
520910,202006,971,519,452,542355.93,475475.00,1017830.93
520915,202006,100,76,24,79420.00,25080.00,104500.00
520920,202006,423,199,224,207955.00,234080.00,442035.00
520929,202006,17,16,1,16720.00,1045.00,17765.00
520940,202006,72,49,23,51205.00,24035.00,75240.00
520945,202006,19,13,6,13585.00,6270.00,19855.00
520960,202006,44,30,14,31350.00,14630.00,45980.00
520970,202006,336,206,130,215270.00,135850.00,351120.00
520980,202006,96,68,28,71060.00,29260.00,100320.00
520990,202006,449,305,144,318725.00,151525.00,470250.00
520993,202006,127,60,67,62700.00,70015.00,132715.00
520995,202006,246,141,105,147345.65,109725.50,257071.15
521000,202006,1558,908,650,948860.00,679250.50,1628110.50
521010,202006,678,329,349,343805.00,364705.00,708510.00
521015,202006,14,9,5,9405.00,5225.00,14630.00
521020,202006,1432,1011,421,1057540.00,440990.50,1498530.50
521030,202006,53,37,16,38665.00,17765.00,56430.00
521040,202006,951,598,353,625955.25,369930.50,995885.75
521056,202006,48,33,15,34485.00,15675.00,50160.00
521060,202006,130,85,45,88825.00,47025.00,135850.00
521080,202006,424,326,98,341715.50,103455.00,445170.50
521090,202006,547,349,198,365750.00,206910.00,572660.00
521100,202006,276,208,68,217360.00,72105.00,289465.00
521120,202006,1069,749,320,782705.50,334400.00,1117105.50
521130,202006,352,251,101,262295.00,105545.50,367840.50
521140,202006,178,97,81,101365.00,85690.00,187055.00
521150,202006,2659,1156,1503,1209065.00,1575860.00,2784925.00
521160,202006,31,16,15,16720.00,15675.00,32395.00
521170,202006,209,115,94,121220.00,98230.00,219450.00
521180,202006,1181,752,429,787930.00,449350.25,1237280.25
521190,202006,2546,1071,1475,1120240.00,1541375.50,2661615.50
521200,202006,56,42,14,43890.00,14630.00,58520.00
521205,202006,11,8,3,8360.00,3135.00,11495.00
521210,202006,124,72,52,75240.00,54340.00,129580.00
521220,202006,786,546,240,570570.00,251845.25,822415.25
521225,202006,34,22,12,22990.00,12540.00,35530.00
521230,202006,106,70,36,73150.00,37620.00,110770.00
521250,202006,6209,3509,2700,3671089.80,2827773.00,6498862.80
521260,202006,27,14,13,14630.00,13585.00,28215.00
521270,202006,144,112,32,117040.00,33440.00,150480.00
521280,202006,426,259,167,270655.00,175560.00,446215.00
521290,202006,26,12,14,12540.00,14630.00,27170.00
521295,202006,98,64,34,66880.00,36575.00,103455.00
521300,202006,221,122,99,127490.00,103455.50,230945.50
521305,202006,37,26,11,27170.00,11495.00,38665.00
521308,202006,1076,824,252,863170.00,264385.00,1127555.00
521310,202006,1342,771,571,805695.00,596695.00,1402390.00
521340,202006,19,15,4,15675.00,4180.00,19855.00
521350,202006,126,94,32,98230.00,33440.00,131670.00
521370,202006,176,125,51,130625.00,53295.00,183920.00
521375,202006,174,93,81,97185.00,84645.00,181830.00
521377,202006,46,35,11,36575.00,11495.00,48070.00
521380,202006,1068,677,391,707466.05,410685.00,1118151.05
521385,202006,13,8,5,8360.00,5225.00,13585.00
521390,202006,102,83,19,86735.00,19855.00,106590.00
521400,202006,349,232,117,242440.00,122265.00,364705.00
521405,202006,145,78,67,82555.00,70015.00,152570.00
521410,202006,66,45,21,47025.00,21945.00,68970.00
521440,202006,196,144,52,150480.00,54340.00,204820.00
521450,202006,728,408,320,428450.00,334400.00,762850.00
521460,202006,1163,746,417,781660.00,436810.00,1218470.00
521470,202006,12,8,4,8360.00,4180.00,12540.00
521480,202006,42,29,13,31350.00,13585.25,44935.25
521483,202006,309,180,129,189145.50,134805.00,323950.50
521486,202006,279,181,98,189145.00,102410.00,291555.00
521487,202006,24,12,12,12540.00,12540.00,25080.00
521490,202006,24,13,11,13585.00,11495.00,25080.00
521500,202006,120,76,44,79420.00,45980.00,125400.00
521520,202006,46,33,13,34485.00,13585.00,48070.00
521523,202006,715,425,290,444125.00,305140.00,749265.00
521525,202006,46,30,16,32395.00,17765.00,50160.00
521530,202006,247,135,112,141075.00,118085.00,259160.00
521540,202006,30,16,14,16720.00,14630.00,31350.00
521550,202006,87,37,50,38665.00,52250.00,90915.00
521560,202006,823,557,266,582065.50,277971.25,860036.75
521565,202006,61,40,21,41800.00,21945.00,63745.00
521570,202006,526,346,180,362615.50,189145.25,551760.75
521580,202006,59,33,26,34485.00,27170.00,61655.00
521590,202006,36,18,18,18810.00,19855.00,38665.00
521600,202006,22,12,10,12540.00,10450.00,22990.00
521630,202006,243,130,113,135850.00,118085.25,253935.25
521640,202006,304,162,142,169290.00,148390.00,317680.00
521645,202006,31,16,15,16720.00,15675.00,32395.00
521680,202006,238,148,90,154660.00,94050.00,248710.00
521690,202006,2,2,0,2090.00,0.00,2090.00
521710,202006,1153,551,602,575795.00,632225.00,1208020.00
521720,202006,571,400,171,420090.00,178695.85,598785.85
521730,202006,647,312,335,326041.00,350075.00,676116.00
521740,202006,909,387,522,405460.00,545490.50,950950.50
521760,202006,1914,994,920,1039775.95,961400.50,2001176.45
521770,202006,826,521,305,545490.00,320815.00,866305.00
521800,202006,2013,1294,719,1352231.50,752400.00,2104631.50
521805,202006,33,18,15,18810.00,15675.00,34485.00
521810,202006,84,54,30,56430.00,32395.00,88825.00
521830,202006,946,676,270,707465.09,283195.00,990660.09
521839,202006,88,54,34,56430.00,35530.00,91960.00
521850,202006,1108,581,527,608190.36,554895.50,1163085.86
521860,202006,341,212,129,222585.00,134805.00,357390.00
521870,202006,75,44,31,45980.00,32395.00,78375.00
521878,202006,33,16,17,16720.00,17765.00,34485.00
521880,202006,4774,2124,2650,2225851.50,2779702.50,5005554.00
521890,202006,605,430,175,449350.00,182875.00,632225.00
521900,202006,285,235,50,245575.00,52250.00,297825.00
521910,202006,161,114,47,119130.00,49115.00,168245.00
521920,202006,46,22,24,22990.00,25080.00,48070.00
521925,202006,54,31,23,32395.00,24035.00,56430.00
521930,202006,1168,643,525,671935.50,549670.03,1221605.53
521935,202006,35,25,10,26125.00,10450.00,36575.00
521940,202006,204,99,105,103455.00,109725.00,213180.00
521945,202006,15,13,2,13585.00,2090.00,15675.00
521950,202006,9,5,4,5225.00,4180.00,9405.00
521960,202006,69,52,17,54340.00,17765.00,72105.00
521970,202006,400,257,143,268565.00,149435.00,418000.00
521971,202006,99,53,46,55385.00,48070.00,103455.00
521973,202006,33,17,16,17765.00,16720.00,34485.00
521975,202006,1437,719,718,753445.41,752401.47,1505846.88
521980,202006,244,165,79,172425.50,82555.00,254980.50
521990,202006,78,56,22,58520.00,22990.00,81510.00
522000,202006,288,182,106,190870.29,110770.00,301640.29
522005,202006,19,10,9,11495.00,9405.00,20900.00
522010,202006,1133,633,500,662530.00,522500.00,1185030.00
522015,202006,62,38,24,39710.00,25080.00,64790.00
522020,202006,895,514,381,537130.00,398145.50,935275.50
522026,202006,23,14,9,14630.00,9405.00,24035.00
522028,202006,16,12,4,12540.00,4180.00,16720.00
522040,202006,782,319,463,334400.25,484880.00,819280.25
522045,202006,2351,1433,918,1499576.25,959311.25,2458887.50
522050,202006,155,75,80,79420.00,83600.00,163020.00
522060,202006,539,340,199,356345.00,209000.00,565345.00
522068,202006,114,80,34,83600.00,35530.00,119130.00
522070,202006,10,10,0,10450.00,0.00,10450.00
522100,202006,37,22,15,22990.00,15675.00,38665.00
522108,202006,42,31,11,32395.00,11495.00,43890.00
522119,202006,55,30,25,31350.00,26125.00,57475.00
522130,202006,79,33,46,34485.00,48070.00,82555.00
522140,202006,4092,2116,1976,2215400.60,2071190.50,4286591.10
522145,202006,47,32,15,34485.00,15675.00,50160.00
522150,202006,88,65,23,67925.00,24035.00,91960.00
522155,202006,53,35,18,36575.00,18810.00,55385.00
522157,202006,5,3,2,3135.00,2090.00,5225.00
522160,202006,1702,1008,694,1054405.00,726275.00,1780680.00
522170,202006,398,267,131,279015.00,136895.00,415910.00
522180,202006,39,18,21,18810.00,21945.00,40755.00
522185,202006,2070,820,1250,856900.50,1309385.00,2166285.50
522190,202006,51,27,24,28215.00,25080.00,53295.00
522200,202006,302,176,126,183920.00,131670.00,315590.00
522205,202006,145,99,46,103455.00,48070.00,151525.00
522220,202006,149,109,40,113905.00,42845.00,156750.00
522230,202006,34,25,9,27170.00,9405.00,36575.00
530010,202006,54565,27539,27026,28827662.76,28298617.10,57126279.86
110001,202007,498,398,100,415910,104500,520410
110002,202007,2827,1750,1077,1828750.5,1126510.5,2955261.0
110003,202007,86,71,15,74195,15675,89870
110004,202007,2019,1318,701,1378356.5,737770,2116126.5
110005,202007,440,349,91,366795.5,96140,462935.5
110006,202007,445,343,102,358435.5,106590,465025.5
110007,202007,69,57,12,59565,12540,72105
110008,202007,238,135,103,141075,107635,248710
110009,202007,877,632,245,660440,256025,916465
110010,202007,1720,1059,661,1108745.5,692835,1801580.5
110011,202007,1766,1370,396,1433740,413820,1847560
110012,202007,4113,2388,1725,2497132.5,1806039.16,4303171.66
110013,202007,771,614,157,641630,165110,806740
110014,202007,375,326,49,340670.5,51205,391875.5
110015,202007,1376,1108,268,1158906.55,280060,1438966.55
110018,202007,1104,688,416,718960,434720,1153680
110020,202007,15556,8914,6642,9325588.06,6959702.1,16285290.16
110025,202007,624,458,166,478610.5,174515,653125.5
110026,202007,40,29,11,30305,11495,41800
110028,202007,1631,1179,452,1237280.85,472341.5,1709622.35
110029,202007,137,123,14,128535,14630,143165
110030,202007,2428,1609,819,1682283.22,855856.35,2538139.57
110032,202007,315,242,73,253935.17,76285,330220.17
110033,202007,656,482,174,503690,181830,685520
110034,202007,357,265,92,276925.67,96140,373065.67
110037,202007,99,86,13,89870,13585,103455
110040,202007,373,256,117,267520,122265,389785
110045,202007,931,644,287,672981,299915.6,972896.6
110050,202007,91,79,12,82555.5,12540,95095.5
110060,202007,68,39,29,40755,30305,71060
110070,202007,110,71,39,74195,40755,114950
110080,202007,479,270,209,282150,218405,500555
110090,202007,28,24,4,25080,4180,29260
110092,202007,98,53,45,55385,47025,102410
110094,202007,201,144,57,150480,59565,210045
110100,202007,35,27,8,28215,8360,36575
110110,202007,90,48,42,50160,43890,94050
110120,202007,70,59,11,61655.35,11495,73150.35
110130,202007,290,237,53,247943.66,56430,304373.66
110140,202007,238,164,74,171380,77330,248710
110143,202007,45,37,8,38665,8360,47025
110145,202007,24,20,4,20900,5225,26125
110146,202007,22,12,10,12540,11495,24035
110147,202007,38,27,11,28215,11495,39710
110148,202007,34,23,11,24035,11495,35530
110149,202007,308,216,92,225720,96140,321860
110150,202007,131,100,31,104500,32395,136895
110155,202007,8,7,1,8360,1045,9405
110160,202007,67,53,14,55385,14630,70015
110170,202007,218,170,48,177859,50160,228019
110175,202007,67,50,17,53295,17765,71060
110180,202007,90,75,15,78375,15675,94050
120001,202007,211,157,54,164065,56430,220495
120005,202007,195,113,82,118085,85690,203775
120010,202007,1098,689,409,721050.72,427405,1148455.72
120013,202007,145,99,46,103455,48070,151525
120017,202007,106,60,46,62700.5,48070,110770.5
120020,202007,3543,2858,685,2988701.18,720005.5,3708706.68
120025,202007,526,303,223,316635.77,233035,549670.77
120030,202007,1076,920,156,961401.36,163020,1124421.36
120032,202007,35,33,2,34485,2090,36575
120033,202007,212,187,25,196460,26125,222585
120034,202007,170,124,46,129580.5,48070,177650.5
120035,202007,39,31,8,32395,8360,40755
120038,202007,399,256,143,267520,149435,416955
120039,202007,30,29,1,30305,1045,31350
120040,202007,14066,9621,4445,10060601.1,4654430,14715031.1
120042,202007,42,38,4,39710,4180,43890
120043,202007,11,3,8,3135,8360,11495
120045,202007,547,348,199,363660,209000,572660
120050,202007,1282,979,303,1025145.69,316635,1341780.69
120060,202007,1466,1201,265,1255045,277970,1533015
120070,202007,433,309,124,322905.82,129580,452485.82
120080,202007,174,108,66,112860,68970,181830
130002,202007,148,106,42,110770,43890,154660
130006,202007,100,63,37,65835,38665,104500
130008,202007,133,72,61,75240,63745,138985
130010,202007,146,82,64,85690,66880,152570
130014,202007,275,202,73,211090,77330,288420
130020,202007,101,61,40,63745,42845,106590
130030,202007,956,570,386,595650,404415,1000065
130040,202007,335,165,170,172425,178695.4,351120.4
130050,202007,570,293,277,306185,289465,595650
130060,202007,853,583,270,610280,283195,893475
130063,202007,593,339,254,354255,265430,619685
130068,202007,190,121,69,126445,72105,198550
130070,202007,1322,901,421,941545,440990,1382535
130080,202007,699,460,239,480700,250800,731500
130083,202007,69,38,31,39710,32395,72105
130090,202007,334,167,167,174515,174515,349030
130100,202007,1104,473,631,494285,659395,1153680
130110,202007,740,308,432,322905,451440,774345
130115,202007,163,68,95,71060,99275,170335
130120,202007,1626,1037,589,1083665,616550,1700215
130130,202007,618,422,196,440990,205865,646855
130140,202007,1528,1192,336,1245640,351120,1596760
130150,202007,417,365,52,381425,54340,435765
130160,202007,458,263,195,274835,204820,479655
130165,202007,41,32,9,33440,9405,42845
130170,202007,962,660,302,690678.12,315590,1006268.12
130180,202007,232,172,60,179740,62700,242440
130185,202007,2333,1084,1249,1134870,1306251,2441121
130190,202007,3426,2158,1268,2255110.7,1329240,3584350.7
130195,202007,277,222,55,231990,57475,289465
130200,202007,180,81,99,85690,104500,190190
130210,202007,77,38,39,39710,40755,80465
130220,202007,179,123,56,128535,59565,188100
130230,202007,380,247,133,258115,140030,398145
130240,202007,1337,837,500,874665.5,522500,1397165.5
130250,202007,4700,3008,1692,3144405,1769185,4913590
130255,202007,426,200,226,209000,236170,445170
130260,202007,57061,26909,30152,28145955.52,31552737.12,59698692.64
130270,202007,1525,1028,497,1075399.05,519365,1594764.05
130280,202007,123,70,53,73150,55385,128535
130290,202007,2122,1481,641,1547645,669845,2217490
130300,202007,427,300,127,313500,132715,446215
130310,202007,917,484,433,505780,452485,958265
130320,202007,516,275,241,287375,251845,539220
130330,202007,749,469,280,490105,293645,783750
130340,202007,3513,2012,1501,2104631,1571680.5,3676311.5
130350,202007,481,320,161,334400,168245,502645
130353,202007,932,402,530,420090,553850,973940
130356,202007,803,362,441,378290,461890,840180
130360,202007,88,66,22,68970,22990,91960
130370,202007,707,546,161,572660,168245,740905
130380,202007,673,520,153,543400,160930,704330
130390,202007,487,392,95,410685,99275,509960
130395,202007,164,38,126,39710,132715,172425
130400,202007,67,44,23,45980,24035,70015
130406,202007,2066,1254,812,1311475.5,850630,2162105.5
130410,202007,443,202,241,211090,251845,462935
130420,202007,2953,2393,560,2502775.75,585200,3087975.75
130423,202007,154,80,74,83600,77330,160930
130426,202007,151,81,70,84645,73150,157795
130430,202007,413,257,156,268565,163020,431585
130440,202007,197,64,133,66880,138985,205865
140002,202007,33,10,23,10450,24035,34485
140005,202007,201,122,79,127490,82555,210045
140010,202007,10403,6634,3769,6940895.9,3952192.15,10893088.05
140015,202007,128,56,72,58520,75240,133760
140017,202007,126,80,46,83600,48070,131670
140020,202007,472,308,164,321860,171380,493240
140023,202007,48,22,26,22990.35,27170,50160.35
140028,202007,22,13,9,13585,9405,22990
140030,202007,350,244,106,254980,110770,365750
140040,202007,64,41,23,42845,24035,66880
140045,202007,251,98,153,103455,160930,264385
140047,202007,628,406,222,424270.5,231990,656260.5
140050,202007,155,94,61,98230,63745,161975
140060,202007,48,34,14,35530,14630,50160
140070,202007,32,30,2,31350,2090,33440
150010,202007,4671,2847,1824,2977205.5,1908170.5,4885376.0
150013,202007,160,109,51,113905,53295,167200
150020,202007,1084,579,505,605055,529815,1134870
150030,202007,668,279,389,291555,406505,698060
150034,202007,194,124,70,129580,73150,202730
150040,202007,1474,843,631,880935,659395,1540330
150050,202007,659,373,286,390830,298870,689700
150060,202007,4851,3069,1782,3209107.75,1869937.63,5079045.38
150070,202007,335,147,188,153615,196460,350075
150080,202007,15117,7113,8004,7437268.2,8367318.5,15804586.7
150085,202007,425,269,156,281105,164065,445170
150090,202007,733,618,115,647900,120175,768075
150095,202007,356,221,135,230945,141075,372020
150100,202007,60,38,22,39710,24035.5,63745.5
150110,202007,183,89,94,93005,98230,191235
150120,202007,411,298,113,311410,118085,429495
150125,202007,46,17,29,17765,30305,48070
150130,202007,2002,1059,943,1107700,986480,2094180
150140,202007,54767,24772,29995,25898243.75,31370908.61,57269152.36
150145,202007,202,107,95,111815,99275,211090
150150,202007,2928,1278,1650,1335510,1725296,3060806
150157,202007,391,275,116,287375.5,121220,408595.5
150160,202007,131,101,30,105545,31350,136895
150170,202007,3611,2679,932,2801645,973940,3775585
150172,202007,338,232,106,242440,110770,353210
150175,202007,79,48,31,50160,32395,82555
150178,202007,769,506,263,528770,274835,803605
150180,202007,3158,1550,1608,1619750.25,1680360.5,3300110.75
150190,202007,340,214,126,223630,131670,355300
150195,202007,109,58,51,60610,53295,113905
150200,202007,193,93,100,97185,104500,201685
150210,202007,3112,2494,618,2606230,646855,3253085
150215,202007,555,356,199,373065,209000,582065
150220,202007,3618,2423,1195,2532036.32,1249820.6,3781856.92
150230,202007,1182,952,230,995885.37,240350,1236235.37
150240,202007,6269,3576,2693,3739010.6,2819410,6558420.6
150250,202007,43,18,25,18810,26125,44935
150260,202007,88,56,32,58520,33440,91960
150270,202007,2238,1452,786,1517340,822415.5,2339755.5
150275,202007,525,329,196,343805,204820,548625
150276,202007,108,42,66,43890,68970,112860
150277,202007,774,331,443,346940,463980,810920
150280,202007,330,210,120,219450,125400,344850
150285,202007,101,51,50,53295,52250,105545
150290,202007,1013,606,407,634315,426360.5,1060675.5
150293,202007,666,309,357,322905,373065,695970
150295,202007,502,226,276,236170,288420.5,524590.5
150300,202007,81,37,44,38665,45980,84645
150304,202007,175,104,71,108680,74195,182875
150307,202007,398,330,68,344850,71060,415910
150309,202007,573,409,164,428450,171380,599830
150310,202007,237,156,81,163020,84645,247665
150320,202007,1906,1326,580,1386715,607145,1993860
150330,202007,2013,1167,846,1219515,884070,2103585
150340,202007,194,130,64,135850,66880,202730
150345,202007,629,349,280,365750,292600,658350
150350,202007,406,319,87,333355,91960,425315
150360,202007,4671,2888,1783,3020050.75,1871595,4891645.75
150370,202007,817,554,263,578930,275880,854810
150375,202007,193,89,104,93005,108680,201685
150380,202007,1481,984,497,1028280,519365,1547645
150390,202007,793,457,336,477565,351120,828685
150400,202007,108,90,18,94050,18810,112860
150405,202007,1241,788,453,823460,473385,1296845
150410,202007,122,80,42,83600,43890,127490
150420,202007,7321,3952,3369,4131056.5,3522695.5,7653752.0
150430,202007,599,385,214,402325,223630,625955
150440,202007,551,334,217,349030,227810,576840
150442,202007,2300,1216,1084,1270721,1132780,2403501
150445,202007,544,349,195,365750,203775,569525
150450,202007,226,120,106,125400,110770,236170
150460,202007,733,547,186,572660,194370,767030
150470,202007,1307,778,529,813010,552805,1365815
150475,202007,228,174,54,181830,56430,238260
150480,202007,1307,904,403,944680,421135,1365815
150490,202007,658,388,270,405460,282150,687610
150495,202007,333,246,87,257070,90915,347985
150497,202007,283,193,90,201685,94050,295735
150500,202007,220,135,85,142120,88825,230945
150503,202007,1024,504,520,528770.5,544445,1073215.5
150506,202007,921,610,311,638495,324995,963490
150510,202007,1240,686,554,716870.5,578930,1295800.5
150520,202007,275,180,95,188100,99275,287375
150530,202007,1710,935,775,977075.75,809875,1786950.75
150540,202007,227,164,63,171380,65835,237215
150543,202007,820,425,395,445170,412775,857945
150548,202007,469,332,137,346940,143165,490105
150549,202007,60,42,18,43890,18810,62700
150550,202007,2917,1471,1446,1539285.25,1512115,3051400.25
150553,202007,3345,1901,1444,1987591.5,1512115,3499706.5
150555,202007,145,78,67,81510,70015,151525
150560,202007,30,14,16,14630,16720,31350
150563,202007,93,47,46,49115,48070,97185
150565,202007,185,110,75,114950,78375,193325
150570,202007,429,284,145,296780,151525,448305
150580,202007,1663,797,866,832865,906015,1738880
150590,202007,809,529,280,553850,292600,846450
150600,202007,471,281,190,293645,198550,492195
150610,202007,143,119,24,124355,25080,149435
150611,202007,122,83,39,86735,40755,127490
150613,202007,3230,1918,1312,2004310,1372085.5,3376395.5
150616,202007,522,300,222,313500,231990,545490
150618,202007,1316,698,618,729410,645810,1375220
150619,202007,389,295,94,309320,98230,407550
150620,202007,1251,731,520,763895,545490,1309385
150630,202007,310,198,112,206910,117040,323950
150635,202007,457,189,268,197505,281105,478610
150640,202007,53,27,26,28215,27170,55385
150650,202007,2375,1365,1010,1426425.5,1056495.5,2482921.0
150655,202007,239,179,60,188100,62700,250800
150658,202007,86,48,38,50160,39710,89870
150660,202007,535,349,186,364705,194370,559075
150670,202007,1069,372,697,388740,729410,1118150
150680,202007,10063,5251,4812,5493566.19,5033765,10527331.19
150690,202007,19,10,9,10450,9405,19855
150700,202007,480,312,168,326040,175560,501600
150710,202007,280,152,128,158840,133760,292600
150715,202007,811,505,306,527725,320815,848540
150720,202007,408,316,92,330220,97185,427405
150730,202007,1018,513,505,536085,527725,1063810
150740,202007,230,152,78,158840,81510,240350
150745,202007,794,429,365,448305,381425,829730
150746,202007,63,36,27,37620,28215,65835
150747,202007,230,175,55,182875,57475,240350
150750,202007,138,76,62,79420,64790,144210
150760,202007,1813,1179,634,1232055.62,662530,1894585.62
150770,202007,394,216,178,225720,186010,411730
150775,202007,99,46,53,48070,55385,103455
150780,202007,191,108,83,112860,86735,199595
150790,202007,828,455,373,477565,392920,870485
150795,202007,1527,900,627,940500,655215,1595715
150796,202007,355,204,151,213180,157795,370975
150797,202007,328,160,168,167200,175560,342760
150800,202007,1478,845,633,885115,661485,1546600
150803,202007,552,447,105,467115,109725,576840
150805,202007,200,119,81,126445,84645,211090
150808,202007,989,532,457,555940,478610,1034550
150810,202007,3275,2224,1051,2324080.97,1098295.5,3422376.47
150812,202007,438,223,215,233035,224675,457710
150815,202007,1030,641,389,670890,406505,1077395
150820,202007,1539,912,627,953040,655215,1608255
150830,202007,737,544,193,568480,201685,770165
150835,202007,204,118,86,123310,89870,213180
150840,202007,1383,844,539,881980,563255,1445235
160005,202007,60,41,19,42845,19855,62700
160010,202007,198,126,72,132715,75240,207955
160015,202007,128,74,54,78375,57475,135850
160020,202007,134,75,59,78375,61655,140030
160021,202007,59,27,32,28215,33440,61655
160023,202007,66,45,21,47025,22990,70015
160025,202007,25,11,14,11495,14630,26125
160027,202007,1497,846,651,885115.25,682385,1567500.25
160030,202007,15854,8114,7740,8484358.1,8110245.5,16594603.6
160040,202007,290,166,124,173470,129580,303050
160050,202007,713,363,350,379335,366795,746130
160053,202007,281,165,116,172425.5,121220,293645.5
160055,202007,28,19,9,19855,9405,29260
160060,202007,6545,3444,3101,3603161.25,3244725.5,6847886.75
160070,202007,175,103,72,107635,75240,182875
160080,202007,108,50,58,52250,60610,112860
170025,202007,29,16,13,16720,13585,30305
170030,202007,213,172,41,179740.62,42845,222585.62
170035,202007,225,107,118,111815,123310,235125
170040,202007,181,137,44,144210.08,45980,190190.08
170070,202007,319,196,123,204820,129580,334400
170100,202007,355,259,96,270655,101365,372020
170105,202007,55,44,11,45980,11495,57475
170110,202007,116,72,44,75240,45980,121220
170130,202007,69,33,36,34485,37620.5,72105.5
170190,202007,98,59,39,61655,40755,102410
170200,202007,376,257,119,268565,124355,392920
170210,202007,6131,3227,2904,3374306.63,3037817.43,6412124.06
170215,202007,115,48,67,50160,70015,120175
170220,202007,1379,1014,365,1060675,382470,1443145
170230,202007,148,97,51,101365,53295,154660
170240,202007,524,351,173,366795,180785,547580
170255,202007,1081,877,204,916465,215270,1131735
170270,202007,44,31,13,32395,13585,45980
170290,202007,118,80,38,83600,39710,123310
170300,202007,94,61,33,63745,34485,98230
170305,202007,49,38,11,39710,11495,51205
170307,202007,64,49,15,51205,15675,66880
170310,202007,116,64,52,66880,54340,121220
170320,202007,26,17,9,17765,9405,27170
170330,202007,25,22,3,22990,3135,26125
170360,202007,30,18,12,18810,12540,31350
170370,202007,103,50,53,52250,55385,107635
170380,202007,74,57,17,59565,17765,77330
170382,202007,44,36,8,37620,8360,45980
170384,202007,140,108,32,112860,33440,146300
170386,202007,65,25,40,26125,41800,67925
170388,202007,47,18,29,18810,30305,49115
170389,202007,26,21,5,21945,5225,27170
170390,202007,70,40,30,41800,31350,73150
170410,202007,33,25,8,26125,8360,34485
170460,202007,17,11,6,11495,6270,17765
170510,202007,35,28,7,29260,7315,36575
170550,202007,1558,901,657,942590,686565,1629155
170555,202007,112,80,32,83600,34485,118085
170560,202007,106,74,32,77330,33440,110770
170600,202007,36,16,20,16720,20900,37620
170610,202007,195,102,93,106590,98230.5,204820.5
170625,202007,36,20,16,20900,16720,37620
170650,202007,80,58,22,60610,22990,83600
170700,202007,579,438,141,457710.25,147345,605055.25
170710,202007,158,97,61,101365,63745,165110
170720,202007,90,72,18,75240,18810,94050
170730,202007,83,49,34,51205,35530,86735
170740,202007,84,60,24,62700,25080,87780
170755,202007,65,34,31,35530,32395,67925
170765,202007,141,75,66,78375,68970,147345
170770,202007,207,130,77,137940,80465,218405
170820,202007,599,398,201,415910,210045.5,625955.5
170825,202007,36,19,17,19855,17765,37620
170830,202007,82,68,14,71060,14630,85690
170900,202007,181,141,40,147345,41800,189145
170930,202007,911,483,428,504735.8,450395.5,955131.3
170950,202007,3130,1419,1711,1482855,1796355.88,3279210.88
170980,202007,15,10,5,10450,5225,15675
171050,202007,142,111,31,115995,32395,148390
171070,202007,37,31,6,32395,6270,38665
171090,202007,46,33,13,34485,13585,48070
171110,202007,22,15,7,15675,7315,22990
171150,202007,41,21,20,21945,20900,42845
171180,202007,27,14,13,14630,13585,28215
171190,202007,152,86,66,89870,68970,158840
171195,202007,66,55,11,57475,11495,68970
171200,202007,49,25,24,26125,25080,51205
171215,202007,4,3,1,3135,1045,4180
171240,202007,60,42,18,43890,18810,62700
171245,202007,56,48,8,50160,8360,58520
171250,202007,74,41,33,42845,34485,77330
171270,202007,14,10,4,10450,4180,14630
171280,202007,42,37,5,38665,5225,43890
171320,202007,994,572,422,597740,440990,1038730
171330,202007,425,211,214,220495,223630,444125
171360,202007,87,62,25,64790,26125,90915
171370,202007,37,18,19,18810,19855,38665
171380,202007,131,111,20,115995,20900,136895
171395,202007,53,33,20,34485,20900,55385
171420,202007,285,183,102,191235,106590,297825
171430,202007,72,59,13,61655,13585,75240
171488,202007,175,97,78,101365,81510,182875
171500,202007,56,33,23,34485,24035,58520
171510,202007,71,44,27,45980,28215,74195
171515,202007,44,35,9,36575,9405,45980
171525,202007,30,28,2,29260,2090,31350
171550,202007,13,9,4,9405,4180,13585
171570,202007,52,27,25,28215,26125,54340
171575,202007,307,200,107,209000,111815,320815
171610,202007,1765,884,881,923780,921690,1845470
171620,202007,140,96,44,100320,45980,146300
171630,202007,57,28,29,31350,30305,61655
171650,202007,295,199,96,207955,100320,308275
171660,202007,267,151,116,157795,121220.5,279015.5
171665,202007,61,42,19,43890,19855,63745
171670,202007,430,256,174,268565.25,182875,451440.25
171700,202007,64,58,6,60610,6270,66880
171720,202007,28,10,18,10450,18810,29260
171750,202007,102,53,49,55385,51205,106590
171780,202007,73,58,15,60610,15675,76285
171790,202007,79,68,11,71060,11495,82555
171800,202007,33,24,9,25080,9405,34485
171820,202007,2104,1198,906,1251910.46,947815.5,2199725.96
171830,202007,33,26,7,27170,7315,34485
171840,202007,63,41,22,42845,22990,65835
171845,202007,31,20,11,20900,11495,32395
171850,202007,41,30,11,31350,11495,42845
171855,202007,78,60,18,62700,18810,81510
171865,202007,7,6,1,6270,1045,7315
171870,202007,34,24,10,25080,10450,35530
171875,202007,77,54,23,56430,24035,80465
171880,202007,35,22,13,22990,13585,36575
171884,202007,50,27,23,28215,24035,52250
171886,202007,134,54,80,57475,84645,142120
171888,202007,28,22,6,22990,6270,29260
171889,202007,18,12,6,13097.33,6270,19367.33
171890,202007,56,48,8,50160,8360,58520
171900,202007,34,25,9,26125,9405,35530
172000,202007,41,32,9,33440,9405,42845
172010,202007,52,41,11,42845,11495,54340
172015,202007,27,17,10,17765.45,10450,28215.45
172020,202007,142,89,53,93005,55385,148390
172025,202007,40,26,14,27170,14630,41800
172030,202007,43,24,19,25080,19855,44935
172049,202007,85,57,28,59565,29260,88825
172065,202007,140,91,49,95095,52250,147345
172080,202007,107,70,37,73150,38665,111815
172085,202007,27,14,13,14630,13585,28215
172090,202007,427,326,101,340670.03,105545,446215.03
172093,202007,17,15,2,15675,2090,17765
172097,202007,20,13,7,13585,7315.5,20900.5
172100,202007,5091,2882,2209,3015871.49,2314675.7,5330547.19
172110,202007,80,49,31,51205,32395,83600
172120,202007,1655,1389,266,1452552.45,277970,1730522.45
172125,202007,11,10,1,10450,1045,11495
172130,202007,23,14,9,14630,9405,24035
172208,202007,201,123,78,128535,81510,210045
172210,202007,386,184,202,192280,211090,403370
210005,202007,2978,1863,1115,1947880.15,1167269,3115149.15
210010,202007,161,91,70,95095,73150,168245
210015,202007,39,29,10,30305,10450,40755
210020,202007,353,199,154,207955,160930,368885
210030,202007,326,213,113,222585,118085,340670
210040,202007,142,111,31,115995,32395,148390
210043,202007,253,191,62,199595,64790,264385
210047,202007,520,310,210,323950,219450,543400
210050,202007,285,210,75,219450,78375,297825
210055,202007,48,38,10,39710,10450,50160
210060,202007,546,437,109,456665,113905,570570
210070,202007,410,316,94,330220,98230,428450
210080,202007,121,109,12,113905,12540,126445
210083,202007,297,146,151,152570,157795,310365
210087,202007,2,1,1,1045,1045,2090
210090,202007,446,320,126,334400,131670,466070
210095,202007,436,333,103,347985,107635,455620
210100,202007,700,545,155,570570,163020,733590
210110,202007,125,79,46,82555,48070,130625
210120,202007,5043,3928,1115,4108942.35,1169355.12,5278297.47
210125,202007,198,120,78,125400,81510,206910
210130,202007,476,271,205,284240,214225,498465
210135,202007,27,19,8,19855,8360,28215
210140,202007,4379,3414,965,3568675,1009470,4578145
210150,202007,376,238,138,248710,144210,392920
210160,202007,3275,2778,497,2903011.36,521455,3424466.36
210170,202007,1150,926,224,968715,234080,1202795
210173,202007,126,111,15,115995,15675,131670
210177,202007,360,203,157,212135,164065,376200
210180,202007,32,17,15,17765,15675,33440
210190,202007,430,284,146,296780,152570,449350
210193,202007,1,1,0,1045,0,1045
210197,202007,73,53,20,55385,20900,76285
210200,202007,619,512,107,535040,111815,646855
210203,202007,226,152,74,158840,77330,236170
210207,202007,363,297,66,310365,68970,379335
210210,202007,750,692,58,723140,60610,783750
210215,202007,74,65,9,67925,9405,77330
210220,202007,386,328,58,342760,60610,403370
210230,202007,310,247,63,258115,65835,323950
210232,202007,1384,941,443,983345,463980,1447325
210235,202007,167,127,40,132715,41800,174515
210237,202007,37,23,14,24035,14630,38665
210240,202007,87,75,12,78375,12540,90915
210250,202007,181,155,26,161975,27170,189145
210255,202007,354,265,89,276925,93005,369930
210260,202007,394,272,122,284240,127490,411730
210270,202007,648,435,213,454575,222585,677160
210275,202007,77,60,17,62700,17765,80465
210280,202007,1047,698,349,729410.7,366795,1096205.7
210290,202007,535,359,176,375155,183920,559075
210300,202007,5308,3347,1961,3501795.93,2053425,5555220.93
210310,202007,112,78,34,81510,35530,117040
210312,202007,115,79,36,82555,37620,120175
210315,202007,104,85,19,88825,19855,108680
210317,202007,132,99,33,103455,34485,137940
210320,202007,2325,1976,349,2065965,364705,2430670
210325,202007,139,88,51,91960.5,53295.5,145256.0
210330,202007,4540,2602,1938,2721180.75,2027300,4748480.75
210340,202007,1253,938,315,980210,329175.5,1309385.5
210350,202007,628,524,104,547580,108680,656260
210355,202007,149,122,27,127490,28215,155705
210360,202007,2232,1537,695,1607210,726275,2333485
210370,202007,1218,597,621,623865,649990,1273855
210375,202007,187,95,92,99275,96140,195415
210380,202007,711,541,170,565345,177650,742995
210390,202007,190,162,28,169290,29260,198550
210400,202007,394,342,52,357390,54340,411730
210405,202007,989,689,300,720005,314545,1034550
210407,202007,51,41,10,42845,10450,53295
210408,202007,59,52,7,54340,7315,61655
210409,202007,325,283,42,295735,43890,339625
210410,202007,439,342,97,357390,102410,459800
210420,202007,202,168,34,175560,35530,211090
210430,202007,52,35,17,36575,17765,54340
210440,202007,335,227,108,237215,112860,350075
210450,202007,140,112,28,117040,29260,146300
210455,202007,229,122,107,127490.5,111815,239305.5
210460,202007,301,203,98,212135,102410,314545
210462,202007,65,54,11,56430,11495,67925
210465,202007,142,110,32,114950,33440,148390
210467,202007,531,390,141,407550,147345,554895
210470,202007,50,43,7,44935,7315,52250
210480,202007,1262,905,357,946770,374110,1320880
210490,202007,201,134,67,140030,70015,210045
210500,202007,509,307,202,320815,211090,531905
210510,202007,556,440,116,459800,121220,581020
210515,202007,370,230,140,240350,146300,386650
210520,202007,399,360,39,376200,40755,416955
210530,202007,9308,4914,4394,5139315.05,4596958.74,9736273.79
210535,202007,130,97,33,101365,34485,135850
210540,202007,1500,1000,500,1045000,524590,1569590
210542,202007,1187,614,573,641630,598786,1240416
210545,202007,18,16,2,16720,2090,18810
210547,202007,128,111,17,115995,17765,133760
210550,202007,683,496,187,518320.6,195415,713735.6
210560,202007,158,139,19,145255,19855,165110
210565,202007,21,16,5,16720,5225,21945
210570,202007,1296,1055,241,1102475.11,251845,1354320.11
210580,202007,121,103,18,107635,18810,126445
210590,202007,729,601,128,628045,133760,761805
210592,202007,36,33,3,34485,3135,37620
210594,202007,110,94,16,98230,16720,114950
210596,202007,97,82,15,85690,15675,101365
210598,202007,132,99,33,103455,34485,137940
210600,202007,315,271,44,283195,45980,329175
210610,202007,258,242,16,252890,16720,269610
210620,202007,43,28,15,29260,15675,44935
210630,202007,73,72,1,75240,1045,76285
210632,202007,1021,717,304,749265,317680,1066945
210635,202007,22,19,3,19855,3135,22990
210637,202007,111,81,30,84645,31350,115995
210640,202007,594,520,74,543400,77330,620730
210650,202007,397,329,68,343805,71060,414865
210660,202007,376,296,80,309320,84645,393965
210663,202007,36,25,11,26125,11495,37620
210667,202007,102,40,62,41800,64790,106590
210670,202007,247,219,28,228855,29260,258115
210675,202007,538,296,242,309320,252890,562210
210680,202007,223,144,79,150480,82555,233035
210690,202007,616,510,106,532950,110770,643720
210700,202007,156,119,37,124355,38665,163020
210710,202007,246,156,90,163020,94050,257070
210720,202007,129,115,14,120175,14630,134805
210725,202007,66,58,8,60610,8360,68970
210730,202007,25,18,7,18810,7315,26125
210735,202007,284,201,83,210045,86735.5,296780.5
210740,202007,524,453,71,473385,74195,547580
210745,202007,152,113,39,118085,40755,158840
210750,202007,2370,1203,1167,1258180.25,1222651,2480831.25
210760,202007,261,200,61,209000,63745,272745
210770,202007,380,298,82,311410,85690,397100
210780,202007,447,332,115,346940,120175,467115
210790,202007,183,150,33,156750,34485,191235
210800,202007,175,133,42,138985,43890,182875
210805,202007,52,47,5,49115,5225,54340
210810,202007,463,376,87,392920,90915,483835
210820,202007,2131,1767,364,1846515.9,380380,2226895.9
210825,202007,155,89,66,93005,68970,161975
210830,202007,732,485,247,506825,258115,764940
210840,202007,195,137,58,143165,60610,203775
210845,202007,231,164,67,171380,70015,241395
210850,202007,756,518,238,542355,250800,793155
210860,202007,3735,2097,1638,2191365.25,1714845,3906210.25
210870,202007,427,338,89,353210,93005,446215
210880,202007,74,56,18,58520,18810,77330
210890,202007,318,275,43,287375,44935,332310
210900,202007,625,406,219,424270,228855,653125
210905,202007,61,32,29,33440,30305,63745
210910,202007,1944,1470,474,1537196.06,495330,2032526.06
210920,202007,161,63,98,65835,102410,168245
210923,202007,81,64,17,66880,17765,84645
210927,202007,411,192,219,200640,228855,429495
210930,202007,75,60,15,62700,15675,78375
210940,202007,82,64,18,66880,18810,85690
210945,202007,194,103,91,107635,95095,202730
210950,202007,537,389,148,406505,154660,561165
210955,202007,83,53,30,55385,31350,86735
210960,202007,2155,1085,1070,1134870,1119195,2254065
210970,202007,116,102,14,106590,14630,121220
210975,202007,81,75,6,78375,6270,84645
210980,202007,1081,525,556,548625,581020.5,1129645.5
210990,202007,4021,2659,1362,2778665.45,1427470,4206135.45
211000,202007,1326,1070,256,1118150.5,267520,1385670.5
211003,202007,992,708,284,739860,297825,1037685
211010,202007,499,445,54,465025,56430,521455
211020,202007,1446,616,830,643720,869440,1513160
211023,202007,33,30,3,31350,3135,34485
211027,202007,72,53,19,55385,19855,75240
211030,202007,369,263,106,274835,110770,385605
211040,202007,298,247,51,258115.5,53295,311410.5
211050,202007,1156,771,385,805695,402325.5,1208020.5
211060,202007,631,549,82,573705.5,85690.46,659395.96
211065,202007,21,17,4,17765,4180,21945
211070,202007,895,744,151,778526.15,157795,936321.15
211080,202007,87,83,4,86735,4180,90915
211085,202007,55,28,27,29260,28215,57475
211090,202007,88,72,16,75240,16720,91960
211100,202007,493,406,87,425315,90915.5,516230.5
211102,202007,251,178,73,186010,76285,262295
211105,202007,219,154,65,160930,67925,228855
211107,202007,131,83,48,86735,50160,136895
211110,202007,815,531,284,554895,296780,851675
211120,202007,5308,2645,2663,2767161.05,2783880.4,5551041.45
211125,202007,34,25,9,26125,9405,35530
211130,202007,41523,19053,22470,19919795.85,23504143.79,43423939.64
211140,202007,393,343,50,358435,52250,410685
211150,202007,1217,816,401,852720,419045.5,1271765.5
211153,202007,170,105,65,109725,67925,177650
211157,202007,66,51,15,53295,15675,68970
211160,202007,703,601,102,628045,107635,735680
211163,202007,1,1,0,1045,0,1045
211167,202007,10,9,1,9405,1045,10450
211170,202007,419,312,107,326040,111815,437855
211172,202007,119,82,37,85690,38665,124355
211174,202007,252,156,96,163020,100320,263340
211176,202007,485,361,124,377245.5,129580,506825.5
211178,202007,95,62,33,64790,34485,99275
211180,202007,204,163,41,170335,42845,213180
211190,202007,72,66,6,68970,6270,75240
211195,202007,35,24,11,25080,11495,36575
211200,202007,149,129,20,134805,20900,155705
211210,202007,439,323,116,337535,121220,458755
211220,202007,4084,2386,1698,2497552.07,1775456.5,4273008.57
211223,202007,94,91,3,95095,3135,98230
211227,202007,70,55,15,57475,15675,73150
211230,202007,735,606,129,633270,134805,768075
211240,202007,405,317,88,331265,91960,423225
211245,202007,182,89,93,93005,97185,190190
211250,202007,1552,1334,218,1394030,227810,1621840
211260,202007,812,665,147,695970,153615,849585
211270,202007,1951,1601,350,1674090.5,365750.5,2039841.0
211280,202007,1741,1120,621,1170400,649990,1820390
211285,202007,202,125,77,130625,80465,211090
211290,202007,689,485,204,507870,213180,721050
211300,202007,763,607,156,634315,163020,797335
211400,202007,1521,944,577,986480,604010,1590490
220005,202007,15,14,1,14630,1045,15675
220010,202007,88,68,20,71060,20900,91960
220020,202007,700,556,144,582065,150480,732545
220025,202007,110,108,2,112860,2090,114950
220027,202007,44,35,9,36575,9405,45980
220030,202007,112,89,23,93005,24035,117040
220040,202007,1241,942,299,985435,312455,1297890
220045,202007,34,22,12,22990,12540,35530
220050,202007,683,573,110,599830.61,114950,714780.61
220060,202007,167,147,20,153615,20900,174515
220070,202007,112,101,11,105545,11495,117040
220080,202007,15,13,2,13585,2090,15675
220090,202007,33,27,6,28215,6270,34485
220095,202007,2,1,1,1045,1045,2090
220100,202007,20,16,4,16720,4180,20900
220105,202007,25,23,2,24035.5,2090,26125.5
220110,202007,224,204,20,213180,20900,234080
220115,202007,36,35,1,36575,1045,37620
220117,202007,21,20,1,20900,1045,21945
220120,202007,1481,1129,352,1181895,368885,1550780
220130,202007,31,30,1,31350,1045,32395
220140,202007,107,84,23,87780,24035,111815
220150,202007,494,364,130,380380,135850,516230
220155,202007,6,6,0,6270,0,6270
220157,202007,19,15,4,15675,4180,19855
220160,202007,90,80,10,83600,10450,94050
220170,202007,32,31,1,32395,1045,33440
220173,202007,7,7,0,7315,0,7315
220177,202007,8,8,0,8360,0,8360
220180,202007,67,66,1,68970,1045,70015
220190,202007,1060,942,118,984390,123310,1107700
220191,202007,47,39,8,40755,8360,49115
220192,202007,79,76,3,79420,3135,82555
220194,202007,54,51,3,55385,3135,58520
220196,202007,100,84,16,87780,16720,104500
220198,202007,3,2,1,2090,1045,3135
220200,202007,413,345,68,360525.25,71060,431585.25
220202,202007,40,35,5,36575,5225,41800
220205,202007,53,47,6,49115,6270,55385
220207,202007,12,12,0,12540,0,12540
220208,202007,80,42,38,43890,39710,83600
220209,202007,32,29,3,30305,3135,33440
220210,202007,19,14,5,14630,5225,19855
220211,202007,28,26,2,27170,2090,29260
220213,202007,41,36,5,37620,5225.5,42845.5
220217,202007,41,32,9,33440,9405,42845
220220,202007,2175,1430,745,1495395,782705.5,2278100.5
220225,202007,10,4,6,4180,6270,10450
220230,202007,962,751,211,784795,220495,1005290
220240,202007,162,146,16,152570,16720,169290
220245,202007,32,29,3,30305.97,3135,33440.97
220250,202007,120,108,12,112860,12540,125400
220253,202007,44,37,7,38665,7315,45980
220255,202007,31,28,3,29260,3135,32395
220260,202007,699,521,178,544445,186010,730455
220265,202007,9,7,2,7315,2090,9405
220270,202007,751,676,75,707465,78375,785840
220271,202007,42,34,8,35530,8360,43890
220272,202007,24,24,0,25080,0,25080
220273,202007,17,15,2,15675,2090,17765
220275,202007,56,46,10,48070,10450,58520
220277,202007,17,14,3,14630,3135,17765
220280,202007,16,12,4,12540,4180,16720
220285,202007,44,41,3,42845,3135,45980
220290,202007,1475,1265,210,1324016,219450.25,1543466.25
220300,202007,35,34,1,35530,1045,36575
220310,202007,327,277,50,289465,52250,341715
220320,202007,442,408,34,427405.5,35530,462935.5
220323,202007,0,,,,,0.0
220325,202007,14,12,2,12540,2090,14630
220327,202007,11,11,0,11495,0,11495
220330,202007,231,167,64,174515,66880,241395
220335,202007,143,125,18,130625,18810,149435
220340,202007,40,27,13,28215,13585,41800
220342,202007,58,50,8,52250,8360,60610
220345,202007,79,72,7,75240,7315,82555
220350,202007,444,381,63,399190,65835,465025
220360,202007,41,30,11,31350,11495,42845
220370,202007,1243,1029,214,1075305,225720,1301025
220375,202007,20,18,2,18810,2090,20900
220380,202007,21,17,4,17765,4180,21945
220385,202007,15,13,2,13585,2090,15675
220390,202007,2322,1321,1001,1381490.6,1047090.75,2428581.35
220400,202007,33,29,4,30305,4180,34485
220410,202007,21,18,3,18810,3135,21945
220415,202007,13,11,2,11495,2090,13585
220420,202007,126,106,20,111815,20900,132715
220430,202007,128,114,14,119130,14630,133760
220435,202007,23,16,7,16720,7315,24035
220440,202007,292,248,44,259160,45980,305140
220450,202007,330,170,160,177650,169290,346940
220455,202007,53,52,1,54340,1045,55385
220460,202007,19,18,1,18810,1045,19855
220465,202007,97,65,32,67925,33440,101365
220470,202007,246,214,32,223630,33440,257070
220480,202007,72,64,8,66880,8360,75240
220490,202007,90,77,13,80465,13585,94050
220500,202007,106,91,15,95095,15675,110770
220510,202007,417,325,92,340670,96140,436810
220515,202007,22,20,2,20900,2090,22990
220520,202007,370,332,38,346940.85,39710,386650.85
220525,202007,10,7,3,7315,3135,10450
220527,202007,19,14,5,14630,5225,19855
220530,202007,33,13,20,13585,20900,34485
220535,202007,4,4,0,4180,0,4180
220540,202007,66,54,12,56430,12540,68970
220545,202007,40,27,13,28215,13585,41800
220550,202007,711,560,151,585200,157795,742995
220551,202007,14,11,3,11495,3135,14630
220552,202007,14,14,0,14630,0,14630
220553,202007,54,49,5,51205,5225,56430
220554,202007,9,7,2,7315,2090,9405
220555,202007,33,30,3,31350,3135,34485
220556,202007,47,45,2,47025,2090,49115
220557,202007,56,53,3,55385,3135,58520
220558,202007,9,4,5,4180,5225,9405
220559,202007,2,2,0,2090,0,2090
220560,202007,71,47,24,49115,25080,74195
220570,202007,746,461,285,482790,298870,781660
220580,202007,559,512,47,535040,50160,585200
220585,202007,10,9,1,9405,1045,10450
220590,202007,15,15,0,15675,0,15675
220595,202007,64,48,16,50160,16720,66880
220600,202007,19,11,8,11495,8360,19855
220605,202007,26,24,2,25080,2090,27170
220610,202007,75,65,10,67925,10450,78375
220620,202007,563,465,98,485925,102410,588335
220630,202007,5,4,1,4180,1045,5225
220635,202007,37,32,5,33440,5225,38665
220640,202007,106,88,18,91960,18810,110770
220650,202007,113,106,7,110770,7315,118085
220660,202007,53,42,11,43890,11495,55385
220665,202007,4,4,0,4180,0,4180
220667,202007,22,20,2,20900,2090,22990
220669,202007,27,24,3,25080,3135,28215
220670,202007,66,53,13,55385,13585,68970
220672,202007,74,52,22,54340,22990,77330
220675,202007,35,28,7,29260,7315,36575
220680,202007,41,36,5,37620,5225,42845
220690,202007,47,44,3,45980,3135,49115
220695,202007,36,19,17,19855,17765,37620
220700,202007,1692,1309,383,1368950.5,401280,1770230.5
220710,202007,5,4,1,4180,1045,5225
220720,202007,105,89,16,93005,16720,109725
220730,202007,15,15,0,15675,0,15675
220735,202007,5,1,4,1045,4180,5225
220740,202007,48,45,3,48070,3135,51205
220750,202007,110,95,15,99275,15675,114950
220755,202007,15,14,1,14630,1045,15675
220760,202007,68,62,6,64790,6270,71060
220770,202007,5599,3051,2548,3188297.01,2662660.5,5850957.51
220775,202007,18,11,7,11495,7315,18810
220777,202007,18,17,1,17765,1045,18810
220779,202007,1,0,1,0,1045,1045
220780,202007,900,767,133,801515,138985.5,940500.5
220785,202007,4,1,3,1045,3135,4180
220790,202007,1083,856,227,895565.05,237215,1132780.05
220793,202007,6,6,0,6270,0,6270
220795,202007,14,13,1,13585,1045,14630
220800,202007,4000,3082,918,3225915.81,960355,4186270.81
220810,202007,65,57,8,59565.5,8360,67925.5
220820,202007,241,220,21,229900,21945,251845
220830,202007,1237,1066,171,1115015,178695,1293710
220840,202007,2440,1696,744,1774412.59,777480.95,2551893.54
220850,202007,55,45,10,47025,10450,57475
220855,202007,8,5,3,5225,3135,8360
220860,202007,14,12,2,12540,2090,14630
220865,202007,30,29,1,30305,1045,31350
220870,202007,73,65,8,67925,8360,76285
220880,202007,324,258,66,269610,68970,338580
220885,202007,34,31,3,32395,3135,35530
220887,202007,13,12,1,12540,1045,13585
220890,202007,95,84,11,88825,11495,100320
220900,202007,22,14,8,14630,8360,22990
220910,202007,52,43,9,44935,9405,54340
220915,202007,10,9,1,9405,1045,10450
220920,202007,52,47,5,49115,5225,54340
220930,202007,42,41,1,42845,1045,43890
220935,202007,15,15,0,15675,0,15675
220937,202007,35,34,1,35530,1045,36575
220940,202007,54,50,4,52250,4180,56430
220945,202007,1,1,0,1045,0,1045
220950,202007,43,36,7,37620,7315,44935
220955,202007,24,21,3,21945,3135,25080
220960,202007,11,10,1,10450,1045,11495
220965,202007,37,33,4,34485,4180,38665
220970,202007,62,51,11,53295,11495,64790
220975,202007,16,14,2,14630,2090,16720
220980,202007,32,29,3,30305,3135,33440
220985,202007,64,57,7,59565,7315,66880
220987,202007,29,28,1,29260,1045,30305
220990,202007,21,20,1,20900,1045,21945
220995,202007,19,15,4,15675,4180,19855
220997,202007,66,54,12,56430,12540,68970
221000,202007,1175,1061,114,1108745,119130,1227875
221005,202007,55,48,7,50160,7315,57475
221010,202007,16,12,4,12540,4180,16720
221020,202007,39,38,1,39710,1045,40755
221030,202007,40,32,8,33440,8360,41800
221035,202007,23,23,0,24035,0,24035
221037,202007,12,8,4,8360,4180,12540
221038,202007,26,23,3,24035,3135,27170
221039,202007,23,23,0,24035,0,24035
221040,202007,249,215,34,226765,35530,262295
221050,202007,237,201,36,210045,37620,247665
221060,202007,1859,1621,238,1693945,249755,1943700
221062,202007,33,33,0,34485,0,34485
221063,202007,13,9,4,9405,4180,13585
221065,202007,58,47,11,49115,11495,60610
221070,202007,139,120,19,125400,19855,145255
221080,202007,371,322,49,336490,51205,387695
221090,202007,27,25,2,26125,2090,28215
221093,202007,48,33,15,34485,15675,50160
221095,202007,7,7,0,7315,0,7315
221097,202007,13,10,3,10450,3135,13585
221100,202007,25363,15078,10285,15764874.44,10768725.03,26533599.47
221110,202007,1095,829,266,866305,279015,1145320
221120,202007,538,394,144,412775.5,150480,563255.5
221130,202007,980,791,189,827640,198550,1026190
221135,202007,35,31,4,32395,4180,36575
221140,202007,44,38,6,39710,6270,45980
221150,202007,11,9,2,9405,2090,11495
221160,202007,13,13,0,13585,0,13585
221170,202007,15,15,0,15675,0,15675
230010,202007,167,153,14,159885,14630,174515
230015,202007,129,103,26,107635,27170,134805
230020,202007,1633,1384,249,1446280.5,260205,1706485.5
230030,202007,1683,1208,475,1262361,496375,1758736
230040,202007,222,189,33,197505,34485,231990
230050,202007,229,170,59,177650,61655,239305
230060,202007,166,132,34,137940,35530,173470
230070,202007,305,265,40,276925,41800,318725
230075,202007,857,737,120,770166.5,125400,895566.5
230080,202007,197,169,28,176605,29260,205865
230090,202007,124,89,35,93005,36575,129580
230100,202007,2148,1231,917,1287441.5,958265,2245706.5
230110,202007,2908,1886,1022,1971915.5,1069035.5,3040951.0
230120,202007,1006,793,213,828685,222585,1051270
230125,202007,153,127,26,132715,27170,159885
230130,202007,475,424,51,443080,53295,496375
230140,202007,225,187,38,195415,39710,235125
230150,202007,149,114,35,119130,36575,155705
230160,202007,937,795,142,831820,148390,980210
230170,202007,614,555,59,579975.5,62700,642675.5
230180,202007,72,67,5,70015,5225,75240
230185,202007,401,344,57,359480,59565,419045
230190,202007,2338,1845,493,1931160,515185,2446345
230195,202007,494,429,65,448305,68970,517275
230200,202007,403,338,65,353210,67925,421135
230205,202007,391,259,132,270655,137940,408595
230210,202007,1381,1071,310,1119195.38,323950,1443145.38
230220,202007,1585,1081,504,1130690,526680,1657370
230230,202007,907,777,130,813010,135850,948860
230240,202007,1741,1501,240,1569853.25,250800,1820653.25
230250,202007,1795,1481,314,1548690.5,330220,1878910.5
230260,202007,3251,2029,1222,2121350,1278035,3399385
230270,202007,1369,1102,267,1152636.88,279015.5,1431652.38
230280,202007,2742,2061,681,2154790,711645.5,2866435.5
230290,202007,406,362,44,379335.72,45980,425315.72
230300,202007,528,385,143,402325,149435,551760
230310,202007,423,320,103,334400,107635,442035
230320,202007,925,790,135,825551,141075,966626
230330,202007,311,251,60,262295,62700,324995
230340,202007,454,367,87,384560,90915,475475
230350,202007,3153,1996,1157,2088955,1213245,3302200
230360,202007,274,222,52,231990,54340,286330
230365,202007,137,116,21,121220,21945,143165
230370,202007,10089,4913,5176,5138268.42,5418326,10556594.42
230380,202007,474,405,69,423225.5,72105,495330.5
230390,202007,542,303,239,316635,250800.5,567435.5
230393,202007,247,204,43,213180,44935,258115
230395,202007,351,282,69,294690.7,72105,366795.7
230400,202007,624,494,130,516230,135850,652080
230410,202007,2696,1676,1020,1753510.97,1067990.5,2821501.47
230420,202007,6307,4172,2135,4366013.04,2235255.2,6601268.24
230423,202007,333,291,42,304095,43890,347985
230425,202007,426,350,76,365750.85,79420,445170.85
230426,202007,122,99,23,103455,24035,127490
230427,202007,76,73,3,76285,3135,79420
230428,202007,1518,755,763,790020,804650,1594670
230430,202007,456,371,85,387695,88825,476520
230435,202007,901,649,252,678205,264385.77,942590.77
230440,202007,88616,39436,49180,41256617,51469400.82,92726017.82
230445,202007,314,220,94,229900,98230,328130
230450,202007,559,442,117,463980,122265,586245
230460,202007,67,52,15,54340,15675,70015
230465,202007,310,251,59,262295,61655,323950
230470,202007,2020,1592,428,1664685,447260.25,2111945.25
230480,202007,157,148,9,154660,9405,164065
230490,202007,303,243,60,253935,62700,316635
230495,202007,449,330,119,344850,124355,469205
230500,202007,1028,758,270,793155,282150,1075305
230510,202007,59,46,13,48070,13585,61655
230520,202007,383,300,83,313500,86735,400235
230523,202007,2346,1473,873,1542420,920645.5,2463065.5
230526,202007,270,230,40,240350,41800,282150
230530,202007,697,519,178,542355,186010,728365
230533,202007,207,194,13,202730,13585,216315
230535,202007,369,274,95,286330,99275,385605
230540,202007,1799,1588,211,1661550,220495,1882045
230550,202007,3833,2465,1368,2579062.4,1432695,4011757.4
230560,202007,579,440,139,460845,145255,606100
230565,202007,227,165,62,172425,64790,237215
230570,202007,290,256,34,268565,35530,304095
230580,202007,1184,865,319,903925,334400,1238325
230590,202007,1010,783,227,818235.25,237215,1055450.25
230600,202007,242,220,22,229900,22990,252890
230610,202007,377,292,85,306185,88825,395010
230620,202007,189,159,30,166155.5,31350,197505.5
230625,202007,768,538,230,563255.25,241395,804650.25
230630,202007,1336,1045,291,1092025,304095,1396120
230640,202007,3782,3209,573,3354451,599831.25,3954282.25
230650,202007,455,391,64,408595,66880,475475
230655,202007,692,586,106,612370,110770,723140
230660,202007,367,305,62,318725,64790,383515
230670,202007,446,382,64,399190,66880,466070
230680,202007,207,188,19,196460,19855,216315
230690,202007,908,772,136,806740,142120,948860
230700,202007,842,707,135,738815,141075.5,879890.5
230710,202007,695,661,34,690745,35530,726275
230720,202007,154,134,20,140030,20900,160930
230725,202007,265,209,56,218405,58520,276925
230730,202007,12214,6656,5558,6962772.4,5824832.62,12787605.02
230740,202007,673,541,132,566390.5,137940,704330.5
230750,202007,828,700,128,731500,133760,865260
230760,202007,1464,1267,197,1325060,206910,1531970
230763,202007,326,270,56,282150,58520,340670
230765,202007,7530,3477,4053,3634510.51,4242701.25,7877211.76
230770,202007,5069,2587,2482,2703416.9,2598915.5,5302332.4
230780,202007,732,643,89,671935.5,93005,764940.5
230790,202007,287,241,46,251845,48070,299915
230800,202007,1137,820,317,856900,331265,1188165
230810,202007,1347,1188,159,1241460,166155,1407615
230820,202007,366,254,112,265430.5,118085,383515.5
230830,202007,959,820,139,857945,145255,1003200
230835,202007,275,240,35,251845,36575,288420
230837,202007,166,142,24,148390,25080,173470
230840,202007,924,729,195,761805.5,203775.5,965581.0
230850,202007,1473,1274,199,1331330,207955,1539285
230860,202007,300,225,75,235125,78375,313500
230870,202007,1839,1569,270,1642740,283195,1925935
230880,202007,69,53,16,55385,16720,72105
230890,202007,542,496,46,519365,49115,568480
230900,202007,280,204,76,213180,79420.31,292600.31
230910,202007,217,171,46,178695,49115,227810
230920,202007,427,341,86,357390,89870,447260
230930,202007,982,691,291,723140.72,305140,1028280.72
230940,202007,859,668,191,698060,199595,897655
230945,202007,520,424,96,443080.5,100320,543400.5
230950,202007,415,357,58,373065,60610,433675
230960,202007,2681,1799,882,1879955.5,922735.5,2802691.0
230970,202007,1708,955,753,997975,788975,1786950
230980,202007,206,169,37,176605,38665,215270
230990,202007,136,111,25,115995,26125,142120
231000,202007,207,189,18,197505,18810,216315
231010,202007,152,113,39,119130,40755,159885
231020,202007,1351,938,413,980210,432630,1412840
231025,202007,1063,789,274,824505,287375.5,1111880.5
231030,202007,1099,916,183,957220,192280,1149500
231040,202007,137,94,43,98230,44935,143165
231050,202007,949,840,109,878845,114950,993795
231060,202007,157,131,26,136895,27170,164065
231070,202007,1492,1044,448,1090980,470250,1561230
231080,202007,264,243,21,253935,21945,275880
231085,202007,609,368,241,386650,251845,638495
231090,202007,245,200,45,209000,47025,256025
231095,202007,169,133,36,138985,37620,176605
231100,202007,150,124,26,129580,27170,156750
231110,202007,370,315,55,329175,57475,386650
231120,202007,271,231,40,241395,41800,283195
231123,202007,155,146,9,152570,9405,161975
231126,202007,334,262,72,274835.5,75240,350075.5
231130,202007,4650,3625,1025,3791260.5,1074260.5,4865521.0
231135,202007,211,183,28,191235,29260,220495
231140,202007,3074,2258,816,2360655.5,855855,3216510.5
231150,202007,368,349,19,364705,19855,384560
231160,202007,1206,956,250,999020,262295,1261315
231170,202007,518,357,161,373065,168245,541310
231180,202007,1710,1466,244,1531970,254980,1786950
231190,202007,207,174,33,181830,34485,216315
231195,202007,214,182,32,191235,33440,224675
231200,202007,801,656,145,685520,153615,839135
231210,202007,580,490,90,512050,94050,606100
231220,202007,1049,767,282,802561.7,295735,1098296.7
231230,202007,1473,1170,303,1224740,317680,1542420
231240,202007,1465,1043,422,1090980,444125.5,1535105.5
231250,202007,113,104,9,108680,9405,118085
231260,202007,277,179,98,187055,102410,289465
231270,202007,1005,819,186,856901.44,195415,1052316.44
231280,202007,77,60,17,62700,17765,80465
231290,202007,7689,4315,3374,4513356.16,3539416.44,8052772.60
231300,202007,608,566,42,592515,43890,636405
231310,202007,753,697,56,728365.56,58520,786885.56
231320,202007,590,446,144,466071.5,150480,616551.5
231325,202007,98,85,13,88825,13585,102410
231330,202007,2000,1550,450,1620014.4,470250.5,2090264.9
231335,202007,255,226,29,236170,30305,266475
231340,202007,1715,1255,460,1313565,480700,1794265
231350,202007,1301,1054,247,1102475,258116.5,1360591.5
231355,202007,436,371,65,387695,67925,455620
231360,202007,512,380,132,397100.86,138985,536085.86
231370,202007,87,76,11,79420,11495,90915
231375,202007,295,213,82,222585,85690,308275
231380,202007,491,396,95,414865,99275,514140
231390,202007,207,164,43,171380,44935,216315
231395,202007,736,461,275,481745,288420,770165
231400,202007,1123,935,188,978120.25,196460.5,1174580.75
231410,202007,1331,1093,238,1142185,249755,1391940
240010,202007,394,174,220,181830,230945,412775
240020,202007,2269,1837,432,1919666.68,454575,2374241.68
240030,202007,120,102,18,106590,18810,125400
240040,202007,33,33,0,34485,0,34485
240050,202007,533,454,79,474430,83600,558030
240060,202007,67,63,4,65835,4180,70015
240070,202007,218,171,47,178695,49115,227810
240080,202007,518,355,163,372020,171380.01,543400.01
240090,202007,107,95,12,99275,12540,111815
240100,202007,1501,1421,80,1485990.37,83600,1569590.37
240110,202007,1056,696,360,727320.5,377245.75,1104566.25
240120,202007,133,109,24,113905,25080,138985
240130,202007,283,260,23,271700,24035,295735
240140,202007,77,57,20,59565,20900,80465
240145,202007,748,668,80,699105,83600,782705
240150,202007,20,16,4,16720,4180,20900
240160,202007,41,35,6,36575,6270,42845
240165,202007,36,28,8,29260.25,8360,37620.25
240170,202007,110,81,29,84645,30305,114950
240180,202007,88,69,19,72105,19855,91960
240185,202007,42,39,3,40755,3135,43890
240190,202007,16,14,2,14630,2090,16720
240200,202007,3093,1739,1354,1817257,1419111,3236368
240210,202007,173,134,39,140030,40755,180785
240220,202007,1111,809,302,846450.75,315590,1162040.75
240230,202007,851,782,69,817190.75,72105,889295.75
240240,202007,73,53,20,55385,20900,76285
240250,202007,90,78,12,81510,12540,94050
240260,202007,1811,1335,476,1396120,498465,1894585
240270,202007,183,161,22,168245,22990,191235
240280,202007,44,35,9,36575,9405,45980
240290,202007,52,49,3,51205,3135,54340
240300,202007,174,94,80,98230,83600,181830
240310,202007,2318,1276,1042,1333421.48,1090980.85,2424402.33
240320,202007,194,181,13,189145,13585,202730
240325,202007,4543,2702,1841,2824636.99,1925935.7,4750572.69
240330,202007,72,68,4,71060,4180,75240
240340,202007,67,43,24,44935,25080,70015
240350,202007,96,84,12,87780,12540,100320
240360,202007,558,346,212,363660,221540,585200
240370,202007,50,46,4,49115,4180,53295
240375,202007,68,40,28,41800,29260,71060
240380,202007,225,187,38,195415,39710.5,235125.5
240390,202007,13,12,1,12540,1045,13585
240400,202007,82,75,7,78375,7315,85690
240410,202007,14,8,6,8360,6270,14630
240420,202007,1005,739,266,772255,277970,1050225
240430,202007,265,249,16,260205,16720,276925
240440,202007,122,69,53,72105,55385,127490
240450,202007,226,151,75,158840.5,78375,237215.5
240460,202007,70,53,17,55385,17765,73150
240470,202007,237,212,25,221540,26125,247665
240480,202007,16,14,2,14630,2090,16720
240485,202007,80,67,13,70015,13585,83600
240490,202007,47,45,2,47025,2090,49115
240500,202007,85,63,22,66880,22990,89870
240510,202007,43,32,11,33440,11495,44935
240520,202007,116,111,5,115995,5225,121220
240530,202007,56,49,7,51205,7315,58520
240540,202007,78,66,12,68970,12540,81510
240550,202007,13,12,1,12540,1045,13585
240560,202007,379,277,102,289465.5,106590,396055.5
240570,202007,446,287,159,299915,168245.5,468160.5
240580,202007,1297,1023,274,1069035.25,287375,1356410.25
240590,202007,30,28,2,29260,2090,31350
240600,202007,107,102,5,106590,5225,111815
240610,202007,520,435,85,454575.5,88825,543400.5
240615,202007,19,18,1,18810,1045,19855
240620,202007,87,83,4,86735,4180,90915
240630,202007,38,33,5,34485,5225,39710
240640,202007,27,21,6,21945,6270,28215
240650,202007,242,201,41,210045,42845,252890
240660,202007,112,96,16,100320,16720,117040
240670,202007,306,177,129,184965.75,134805,319770.75
240680,202007,50,37,13,38665,13585,52250
240690,202007,47,44,3,45980,3135,49115
240700,202007,184,152,32,159885,33440,193325
240710,202007,2023,1252,771,1308340.75,807785,2116125.75
240720,202007,1067,790,277,825550,291555,1117105
240725,202007,64,59,5,61655,5225,66880
240730,202007,147,126,21,131670,21945,153615
240740,202007,232,198,34,206910,35530.85,242440.85
240750,202007,52,28,24,29260,25080,54340
240760,202007,46,41,5,42845,5225,48070
240770,202007,144,112,32,117040,33440,150480
240780,202007,673,556,117,581020,122265,703285
240790,202007,41,39,2,40755,2090,42845
240800,202007,9270,6312,2958,6605455.11,3097382.75,9702837.86
240810,202007,20418,11060,9358,11568160.7,9797923.9,21366084.6
240820,202007,236,140,96,146300.09,100320,246620.09
240830,202007,1621,1338,283,1398210.75,297825,1696035.75
240840,202007,77,67,10,70015,10450,80465
240850,202007,87,77,10,80465,10450,90915
240860,202007,107,103,4,107635,4180,111815
240870,202007,59,51,8,53295,8360,61655
240880,202007,31,28,3,29260,3135,32395
240890,202007,1124,648,476,677160.4,497420,1174580.4
240895,202007,62,41,21,42845,21945,64790
240910,202007,156,139,17,147345,17765,165110
240920,202007,13,10,3,10450,3135,13585
240930,202007,413,369,44,385605,45980,431585
240933,202007,48,32,16,33440,16720,50160
240940,202007,2386,2113,273,2209130.45,285285,2494415.45
240950,202007,47,43,4,44935,4180,49115
240960,202007,26,22,4,22990,4180,27170
240970,202007,113,84,29,87780,30305,118085
240980,202007,201,160,41,167200,42845,210045
240990,202007,131,87,44,90915,45980,136895
241000,202007,61,57,4,59565,4180,63745
241010,202007,69,53,16,55385,16720,72105
241020,202007,114,105,9,109725,9405,119130
241025,202007,14,7,7,7315,7315,14630
241030,202007,113,91,22,95095,22990,118085
241040,202007,45,32,13,33440,13585,47025
241050,202007,82,75,7,78375.5,7315,85690.5
241060,202007,29,24,5,25080,5225,30305
241070,202007,16,16,0,16720,0,16720
241080,202007,60,53,7,55385,7315,62700
241090,202007,58,46,12,48070,12540,60610
241100,202007,72,61,11,63745,11495,75240
241105,202007,9,3,6,3135,6270,9405
241110,202007,48,44,4,45980,4180,50160
241120,202007,1482,1123,359,1174580.5,376200,1550780.5
241140,202007,222,183,39,191235.5,40755,231990.5
241142,202007,41,35,6,36575,6270,42845
241150,202007,1180,1036,144,1082620,151525,1234145
241160,202007,17,16,1,16720,1045,17765
241170,202007,43,38,5,39710,5225,44935
241180,202007,42,36,6,37620,6270,43890
241190,202007,37,36,1,37620,1045,38665
241200,202007,3950,2049,1901,2143296.39,1990725,4134021.39
241210,202007,69,60,9,62700,9405,72105
241220,202007,1420,955,465,999020.86,486970,1485990.86
241230,202007,240,201,39,210045,40755,250800
241240,202007,55,44,11,45980,11495,57475
241250,202007,1134,1043,91,1092025.5,95095,1187120.5
241255,202007,51,40,11,41800,11495,53295
241260,202007,681,526,155,550715,163020,713735
241270,202007,65,44,21,45980,21945,67925
241280,202007,92,81,11,84645,11495,96140
241290,202007,121,86,35,89870,36575,126445
241300,202007,77,56,21,58520,21945,80465
241310,202007,51,37,14,38665.75,14630,53295.75
241320,202007,30,18,12,18810,12540,31350
241330,202007,60,55,5,57475,5225,62700
241335,202007,74,66,8,68970,8360,77330
241340,202007,181,133,48,138985,51205,190190
241350,202007,60,51,9,53295,9405,62700
241355,202007,50,43,7,44935,7315,52250
241360,202007,51,50,1,52250,1045,53295
241370,202007,52,42,10,43890,10450,54340
241380,202007,37,33,4,34485,4180,38665
241390,202007,86,66,20,68970,20900,89870
241400,202007,225,179,46,187055,48070,235125
241410,202007,184,165,19,172425,19855,192280
241415,202007,99,80,19,83600,19855,103455
241420,202007,104,75,29,78375,30305.1,108680.1
241430,202007,28,25,3,26125,3135,29260
241440,202007,538,431,107,452485,111815,564300
241445,202007,38,33,5,34485,5225,39710
241450,202007,278,228,50,239305,52250,291555
241460,202007,141,128,13,133760.25,13585,147345.25
241470,202007,36,31,5,32395,5225,37620
241475,202007,54,51,3,53295,3135,56430
241480,202007,94,67,27,70015,28215,98230
241490,202007,11,10,1,10450,1045,11495
241500,202007,47,36,11,37620,11495,49115
250010,202007,102,87,15,90915,15675,106590
250020,202007,33,30,3,31350,3135,34485
250030,202007,875,655,220,685520,229900,915420
250040,202007,374,308,66,321860,68970,390830
250050,202007,259,212,47,221540,49115,270655
250053,202007,55,42,13,43890,13585,57475
250057,202007,1,1,0,1045,0,1045
250060,202007,578,414,164,433675,171380,605055
250070,202007,706,564,142,589380.1,148390,737770.1
250073,202007,8,8,0,8360,0,8360
250077,202007,178,135,43,141075,44935,186010
250080,202007,426,334,92,350075.3,96140,446215.3
250090,202007,220,143,77,149435,80465,229900
250100,202007,512,425,87,445170,90915,536085
250110,202007,614,469,145,491150,151525,642675
250115,202007,20,7,13,7315,13585,20900
250120,202007,123,88,35,93005,36575,129580
250130,202007,578,470,108,491150,112860,604010
250135,202007,17,10,7,10450,7315,17765
250140,202007,87,77,10,80465,10450,90915
250150,202007,590,426,164,445170,171380,616550
250153,202007,9,6,3,6270,3135,9405
250157,202007,32,26,6,27170,6270,33440
250160,202007,235,183,52,191235,54340,245575
250170,202007,62,40,22,41800,22990,64790
250180,202007,4290,2923,1367,3059760.3,1430605,4490365.3
250190,202007,847,559,288,584155,302005.25,886160.25
250200,202007,52,43,9,44935,9405,54340
250205,202007,24,20,4,20900,4180,25080
250210,202007,85,75,10,78375,10450,88825
250215,202007,66,53,13,55385,13585,68970
250220,202007,25,18,7,18810,7315,26125
250230,202007,78,71,7,74195,7315,81510
250240,202007,234,194,40,202730,41800,244530
250250,202007,388,335,53,350075,55385,405460
250260,202007,45,38,7,39710,7315,47025
250270,202007,73,54,19,56430,19855,76285
250280,202007,385,316,69,330220,72105,402325
250290,202007,93,86,7,90915,7315,98230
250300,202007,561,378,183,395010,191235,586245
250310,202007,50,44,6,45980,6270,52250
250320,202007,1974,1330,644,1390895.85,672980.9,2063876.75
250330,202007,105,86,19,89870,19855,109725
250340,202007,25,23,2,24035,2090,26125
250350,202007,162,105,57,110770,59565,170335
250355,202007,33,25,8,26125,8360,34485
250360,202007,202,165,37,172425,38665,211090
250370,202007,2405,1604,801,1676180,838090,2514270
250375,202007,11,7,4,7315,4180,11495
250380,202007,56,42,14,43890,14630,58520
250390,202007,45,34,11,35530,11495,47025
250400,202007,16387,8326,8061,8711105.06,8456142.4,17167247.46
250403,202007,329,265,64,276925,66880,343805
250407,202007,59,49,10,51205,10450,61655
250410,202007,30,26,4,27170,4180,31350
250415,202007,44,30,14,31350,14630,45980
250420,202007,43,37,6,38665,6270,44935
250430,202007,1452,1246,206,1304421.25,215270,1519691.25
250435,202007,17,13,4,13585,4180,17765
250440,202007,678,566,112,591470,117040,708510
250450,202007,86,67,19,70015,19855,89870
250460,202007,468,313,155,327085,161975,489060
250470,202007,92,64,28,66880,29260,96140
250480,202007,331,266,65,277970,67925,345895
250485,202007,3,2,1,2090,1045,3135
250490,202007,225,182,43,190190,44935,235125
250500,202007,91,67,24,70015,25080,95095
250510,202007,766,602,164,632225,171380,803605
250520,202007,181,123,58,128535,60610,189145
250523,202007,120,97,23,101365,24035,125400
250527,202007,102,81,21,84645,21945,106590
250530,202007,10,6,4,6270,4180,10450
250535,202007,35,25,10,26125,10450,36575
250540,202007,133,103,30,107635,31350,138985
250550,202007,72,69,3,72105,3135,75240
250560,202007,50,36,14,37620,14630,52250
250570,202007,165,136,29,142120,30305,172425
250580,202007,109,84,25,87847,26125,113972
250590,202007,25,16,9,16720,9405,26125
250600,202007,1389,911,478,951996.46,499510,1451506.46
250610,202007,158,130,28,135850,29260,165110
250620,202007,22,17,5,17765,5225,22990
250625,202007,72,53,19,55385,19855,75240
250630,202007,3050,1943,1107,2031482.43,1158905,3190387.43
250640,202007,218,174,44,181830,45980,227810
250650,202007,30,20,10,20900,10450,31350
250660,202007,50,39,11,40755,11495,52250
250670,202007,64,43,21,44935,21945,66880
250680,202007,407,329,78,343805,81510,425315
250690,202007,2011,1393,618,1456730.96,647900,2104630.96
250700,202007,945,814,131,850630.25,136895,987525.25
250710,202007,429,337,92,353210,96140,449350
250720,202007,117,87,30,90915,31350,122265
250730,202007,390,324,66,338580,68970,407550
250740,202007,54,50,4,52250,4180,56430
250750,202007,22228,13367,8861,13987220.12,9276466.5,23263686.62
250760,202007,96,77,19,81510,19855,101365
250770,202007,365,239,126,249755.6,131670,381425.6
250780,202007,64,43,21,44935,21945,66880
250790,202007,459,300,159,313500,167200,480700
250800,202007,153,137,16,143165,16720,159885
250810,202007,79,61,18,63745,18810,82555
250820,202007,153,128,25,133760,26125,159885
250830,202007,436,295,141,309320.5,148390,457710.5
250840,202007,55,49,6,51205,6270,57475
250850,202007,57,47,10,49115,10450,59565
250855,202007,13,11,2,11495,2090,13585
250860,202007,214,147,67,153615,71060,224675
250870,202007,31,27,4,28215,4180,32395
250880,202007,83,63,20,65835,20900,86735
250890,202007,2826,2112,714,2211220,746130.5,2957350.5
250900,202007,49,40,9,41800,9405,51205
250905,202007,117,91,26,95095,28215,123310
250910,202007,1128,819,309,858990,323950,1182940
250915,202007,109,77,32,80465,33440,113905
250920,202007,139,102,37,106590,38665,145255
250930,202007,170,102,68,106590,71060,177650
250933,202007,5,3,2,3135,2090,5225
250937,202007,11,10,1,10450,1045,11495
250939,202007,34,25,9,26125,9405,35530
250940,202007,104,77,27,80465,28215,108680
250950,202007,72,49,23,51205,24035,75240
250960,202007,90,50,40,52250,41800,94050
250970,202007,1220,859,361,897655,378290,1275945
250980,202007,105,71,34,75240,35530,110770
250990,202007,162,127,35,132715,36575,169290
251000,202007,75,67,8,70015,8360,78375
251010,202007,116,86,30,90915,31350,122265
251020,202007,75,62,13,64790,13585,78375
251030,202007,46,35,11,36575,11495,48070
251040,202007,57,40,17,41800,17765,59565
251050,202007,24,21,3,21945,3135,25080
251060,202007,51,40,11,41800,11495,53295
251065,202007,4,4,0,4180,0,4180
251070,202007,20,16,4,16720,4180,20900
251080,202007,5025,2407,2618,2517405.75,2736857.14,5254262.89
251090,202007,187,160,27,167200,28215,195415
251100,202007,18,18,0,18810,0,18810
251110,202007,46,37,9,38665,9405,48070
251120,202007,1849,1136,713,1187122.75,745085.2,1932207.95
251130,202007,403,328,75,342760,78375,421135
251140,202007,557,361,196,377245,205865,583110
251150,202007,340,289,51,302005,53295,355300
251160,202007,90,73,17,76285,17765,94050
251170,202007,103,82,21,85690,22990,108680
251180,202007,292,178,114,186010,119130,305140
251190,202007,198,130,68,135850,71060,206910
251200,202007,273,221,52,230945,54340,285285
251203,202007,35,33,2,34485,2090,36575
251207,202007,88,72,16,75240,16720,91960
251210,202007,1480,1080,400,1128600,419045,1547645
251220,202007,49,36,13,37620,13585,51205
251230,202007,592,498,94,520410,98230,618640
251240,202007,94,65,29,67925,30305,98230
251250,202007,1407,1007,400,1052315.75,419045.75,1471361.50
251260,202007,13,7,6,7315,6270,13585
251270,202007,325,245,80,256025,83600,339625
251272,202007,65,59,6,61655,6270,67925
251274,202007,30,23,7,24035,7315,31350
251275,202007,34,20,14,20900,14630,35530
251276,202007,14,11,3,11495,3135,14630
251278,202007,10,8,2,8360,2090,10450
251280,202007,103,98,5,102410,5225,107635
251290,202007,798,581,217,608190,228855,837045
251300,202007,15,12,3,12540,3135,15675
251310,202007,372,270,102,282150,106590,388740
251315,202007,30,27,3,28215,3135,31350
251320,202007,64,50,14,52250,14630,66880
251330,202007,80,71,9,75240,9405,84645
251335,202007,15,10,5,10450,5225,15675
251340,202007,742,439,303,458755,317680,776435
251350,202007,34,33,1,34485,1045,35530
251360,202007,81,71,10,74195,10450,84645
251365,202007,15,15,0,15675,0,15675
251370,202007,5554,3735,1819,3906210.65,1905035,5811245.65
251380,202007,44,36,8,37620,8360,45980
251385,202007,3,3,0,3135,0,3135
251390,202007,811,615,196,643720,205865.5,849585.5
251392,202007,19,11,8,11495,8360,19855
251394,202007,11,11,0,11495,0,11495
251396,202007,11,7,4,7315,4180,11495
251398,202007,18,16,2,16720,2090,18810
251400,202007,37,33,4,34485,4180,38665
251410,202007,37,31,6,32395,6270,38665
251420,202007,99,70,29,74195,30305,104500
251430,202007,44,39,5,40755,5225,45980
251440,202007,41,24,17,25080,17765,42845
251445,202007,51,46,5,48070.25,5225,53295.25
251450,202007,408,356,52,373065,55385,428450
251455,202007,3,2,1,2090,1045,3135
251460,202007,15,13,2,13585,2090,15675
251465,202007,7,4,3,4180,3135,7315
251470,202007,48,39,9,40755,9405,50160
251480,202007,26,21,5,21945,5225,27170
251490,202007,129,83,46,86735,48070.5,134805.5
251500,202007,128,105,23,109725,24035,133760
251510,202007,52,32,20,33440,20900,54340
251520,202007,29,28,1,29260,1045,30305
251530,202007,4486,3166,1320,3314740.5,1382535,4697275.5
251540,202007,75,63,12,66880,12540,79420
251550,202007,414,315,99,329175,103455.75,432630.75
251560,202007,24,16,8,16720,8360,25080
251570,202007,20,19,1,19855,1045,20900
251580,202007,131,103,28,107635,29260,136895
251590,202007,116,85,31,90067.5,32395,122462.5
251593,202007,26,16,10,16720,10450,27170
251597,202007,94,71,23,74195,24035,98230
251600,202007,1108,785,323,821370.5,337535,1158905.5
251610,202007,240,182,58,190190,60610,250800
251615,202007,10,9,1,9405,1045,10450
251620,202007,4268,2784,1484,2910326.6,1551826.5,4462153.1
251630,202007,458,336,122,351120,127490,478610
251640,202007,145,102,43,106590,44935,151525
251650,202007,277,200,77,209000.75,80465,289465.75
251660,202007,188,169,19,176605,19855,196460
251670,202007,374,294,80,307230,83600,390830
251675,202007,8,6,2,6270,2090,8360
251680,202007,98,89,9,93005,9405,102410
251690,202007,325,267,58,279015,61655,340670
251700,202007,286,245,41,256025.9,42845,298870.9
251710,202007,22,14,8,14630,8360,22990
251720,202007,22,15,7,15675,7315.5,22990.5
251740,202007,11,8,3,8360,3135,11495
260005,202007,3282,1786,1496,1869509.21,1566455.5,3435964.71
260010,202007,1641,1183,458,1236235.55,478610.1,1714845.65
260020,202007,417,362,55,378290,57475,435765
260030,202007,612,425,187,444125,195415,639540
260040,202007,816,506,310,528770,323950,852720
260050,202007,1158,834,324,871530,338581,1210111
260060,202007,379,346,33,361570,34485,396055
260070,202007,1381,855,526,894520.5,549774.8,1444295.3
260080,202007,733,565,168,590425,175560,765985
260090,202007,496,327,169,341715,176605,518320
260100,202007,214,149,65,155705,68970,224675
260105,202007,235,128,107,133760,112860,246620
260110,202007,2871,2106,765,2204951,800470.5,3005421.5
260120,202007,2840,1445,1395,1511349.54,1458820.75,2970170.29
260130,202007,168,113,55,118085,57475,175560
260140,202007,2124,1378,746,1444191.8,781660,2225851.8
260150,202007,214,137,77,143165,80465,223630
260160,202007,325,269,56,282150,58520,340670
260170,202007,3395,2045,1350,2139116.45,1414930.5,3554046.95
260180,202007,158,127,31,133760,32395,166155
260190,202007,2336,1583,753,1655280,787930,2443210
260200,202007,974,781,193,817190.29,201685.5,1018875.79
260210,202007,1430,1019,411,1067990,430540,1498530
260220,202007,693,621,72,648945.5,75240,724185.5
260230,202007,1214,912,302,956175,315590,1271765
260240,202007,217,163,54,171380,56430,227810
260250,202007,94,69,25,72105,26125,98230
260260,202007,1048,734,314,769120,329175,1098295
260270,202007,417,327,90,341715,94050,435765
260280,202007,1295,918,377,959310.5,393965.5,1353276.0
260290,202007,6556,3544,3012,3708707.5,3159037.46,6867744.96
260300,202007,953,821,132,860035.5,137940,997975.5
260310,202007,517,410,107,428450,111815,540265
260320,202007,863,637,226,665665,236170,901835
260330,202007,60,42,18,44935,18810,63745
260340,202007,79,56,23,58520,24035,82555
260345,202007,5533,3026,2507,3167396.43,2625040,5792436.43
260350,202007,491,351,140,367840.5,146300,514140.5
260360,202007,254,139,115,145255,120175,265430
260370,202007,759,473,286,494285.25,298870,793155.25
260380,202007,588,431,157,450395,164065.47,614460.47
260390,202007,292,246,46,257070,48070,305140
260392,202007,111,96,15,100320,15675,115995
260400,202007,4185,2384,1801,2495461.22,1883090.5,4378551.72
260410,202007,14841,7754,7087,8113695.72,7419501.42,15533197.14
260415,202007,139,121,18,126445,18810,145255
260420,202007,1724,1055,669,1102476.77,699105,1801581.77
260430,202007,190,174,16,181830.35,16720,198550.35
260440,202007,201,144,57,150480,59565,210045
260450,202007,428,317,111,331265.96,117040,448305.96
260460,202007,815,433,382,453530,400235,853765
260470,202007,348,214,134,224675,140030.5,364705.5
260480,202007,242,156,86,163020,89870,252890
260490,202007,217,177,40,184965,41800,226765
260500,202007,1121,754,367,788975,383515,1172490
260510,202007,780,619,161,647900,168245,816145
260515,202007,242,217,25,226765,26125,252890
260520,202007,3268,2009,1259,2100450,1317745.95,3418195.95
260530,202007,790,653,137,683430,144210,827640
260540,202007,554,434,120,453530,125400,578930
260545,202007,15,11,4,11495,4180,15675
260550,202007,327,204,123,213180,129580,342760
260560,202007,523,396,127,413820.5,132715,546535.5
260570,202007,976,794,182,829730,192280,1022010
260580,202007,247,215,32,224675,33440,258115
260590,202007,642,369,273,385605,285285,670890
260600,202007,8081,4346,3735,4544707.84,3911436,8456143.84
260610,202007,488,325,163,339625,170335,509960
260620,202007,3683,1912,1771,2002221.65,1853830.58,3856052.23
260630,202007,88,82,6,85690,6270,91960
260640,202007,3551,1978,1573,2067010.8,1650055,3717065.8
260650,202007,329,240,89,251845,94050,345895
260660,202007,561,367,194,383515,202730,586245
260670,202007,105,78,27,81510,28215,109725
260680,202007,3714,2070,1644,2164195.22,1717980.5,3882175.72
260690,202007,131,95,36,99275,37620,136895
260700,202007,311,206,105,215270,109725,324995
260710,202007,42,36,6,37620,6270,43890
260720,202007,2440,1452,988,1518386,1033505,2551891
260730,202007,702,531,171,555940,178695,734635
260740,202007,62,57,5,59565,5225,64790
260750,202007,594,422,172,442035,181830,623865
260760,202007,668,344,324,359480.23,339625,699105.23
260765,202007,975,501,474,523545,496375,1019920
260770,202007,221,164,57,171362,59565.5,230927.5
260775,202007,791,442,349,462936.25,364705,827641.25
260780,202007,253,164,89,171380,93005,264385
260790,202007,13123,6768,6355,7079880.47,6653517.28,13733397.75
260795,202007,165,109,56,113905,59565,173470
260800,202007,288,239,49,249755.5,51205,300960.5
260805,202007,171,113,58,118085,60610,178695
260810,202007,750,649,101,678205,105545,783750
260820,202007,291,188,103,196460.85,107635,304095.85
260825,202007,211,149,62,155705,65835,221540
260830,202007,291,183,108,191235,113905,305140
260840,202007,242,176,66,183920,68970,252890
260845,202007,177,120,57,125400,59565,184965
260850,202007,444,326,118,341715,125400,467115
260860,202007,251,188,63,196460,65835,262295
260870,202007,369,276,93,288420.29,97185,385605.29
260875,202007,735,523,212,546535,221540,768075
260880,202007,1597,1015,582,1061720,608190,1669910
260890,202007,2376,1676,700,1754556,734635,2489191
260900,202007,986,700,286,731500,298870,1030370
260910,202007,256,204,52,213180,54340,267520
260915,202007,290,214,76,223630,79420,303050
260920,202007,180,95,85,99275,88825,188100
260930,202007,399,340,59,355300,61655,416955
260940,202007,2708,1463,1245,1531971.4,1304161,2836132.4
260950,202007,2018,1161,857,1216380.75,897655,2114035.75
260960,202007,13757,6953,6804,7274253.35,7126902.45,14401155.80
260970,202007,425,355,70,372020,73150,445170
260980,202007,192,172,20,180785,20900,201685
260990,202007,2614,2114,500,2210176.35,522500,2732676.35
261000,202007,4291,2568,1723,2687740.75,1801580,4489320.75
261010,202007,160,121,39,126445,40755,167200
261020,202007,604,452,152,472340.99,158840,631180.99
261030,202007,258,180,78,188100,81510,269610
261040,202007,374,326,48,340670,50160,390830
261050,202007,510,439,71,459800,74195,533995
261060,202007,1404,904,500,944680.75,522500,1467180.75
261070,202007,8792,4335,4457,4538438.15,4672197.87,9210636.02
261080,202007,378,292,86,305140,90915,396055
261090,202007,2197,1684,513,1760828.95,536085.83,2296914.78
261100,202007,1156,811,345,847495.75,361570,1209065.75
261110,202007,8630,5275,3355,5520735.8,3509111.5,9029847.3
261120,202007,260,224,36,234080,37620,271700
261130,202007,574,340,234,355300,244530.55,599830.55
261140,202007,204,127,77,132715,81510,214225
261150,202007,680,420,260,439945.03,272745,712690.03
261153,202007,68,63,5,65835,5225,71060
261160,202007,75962,37753,38209,39519925.51,40046497.61,79566423.12
261170,202007,473,358,115,375155,121220,496375
261180,202007,1799,1123,676,1176670,708510,1885180
261190,202007,636,442,194,461890.9,202730,664620.9
261200,202007,216,185,31,194370,32395,226765
261210,202007,32,27,5,28215,6270,34485
261220,202007,2695,1893,802,1980276.12,839135,2819411.12
261230,202007,341,253,88,264385,91960,356345
261240,202007,460,401,59,419045,61655,480700
261245,202007,234,193,41,201685,42845,244530
261247,202007,172,135,37,141075,38665,179740
261250,202007,3124,1535,1589,1606165.5,1666775,3272940.5
261255,202007,247,223,24,233035,26125,259160
261260,202007,852,741,111,775390.06,115995,891385.06
261270,202007,202,144,58,150480,60610,211090
261280,202007,178,146,32,152570,33440,186010
261290,202007,117,85,32,88825,33440,122265
261300,202007,1285,939,346,984390,362615,1347005
261310,202007,810,548,262,574750,274835,849585
261320,202007,547,373,174,389785,181830,571615
261330,202007,969,742,227,775390,237215.29,1012605.29
261340,202007,297,164,133,171380,138985,310365
261350,202007,850,604,246,632225.5,258115,890340.5
261360,202007,1297,845,452,883025,473385,1356410
261370,202007,4832,2891,1941,3022141.5,2030436,5052577.5
261380,202007,548,418,130,436810.69,136895.5,573706.19
261390,202007,3602,2423,1179,2535171,1234145.75,3769316.75
261400,202007,294,268,26,280060,27170,307230
261410,202007,1109,730,379,762850,397100,1159950
261420,202007,878,543,335,567435.55,351120,918555.55
261430,202007,330,298,32,311410,34485,345895
261440,202007,117,108,9,112860,9405,122265
261450,202007,2540,2047,493,2144341.25,517275.5,2661616.75
261460,202007,724,578,146,604010.85,152570,756580.85
261470,202007,247,198,49,206910.5,51205,258115.5
261480,202007,441,343,98,358435.5,103407.97,461843.47
261485,202007,350,210,140,220495,146300,366795
261500,202007,600,409,191,427405,199595,627000
261510,202007,50,32,18,33440,18810,52250
261520,202007,111,100,11,104500,11495,115995
261530,202007,4137,2627,1510,2749396.73,1585265.75,4334662.48
261540,202007,1350,794,556,831820,582065,1413885
261550,202007,267,133,134,138985.5,140030,279015.5
261560,202007,857,563,294,588336.75,307230.5,895567.25
261570,202007,397,311,86,326040,89870,415910
261580,202007,377,295,82,308275,85690,393965
261590,202007,190,153,37,159885,38665,198550
261600,202007,292,232,60,242440,62700.5,305140.5
261610,202007,89,76,13,79420,13585,93005
261618,202007,75,61,14,63745,14630,78375
261620,202007,206,127,79,132715,82555,215270
261630,202007,554,432,122,451440,127490,578930
261640,202007,6408,3383,3025,3538373.09,3168440.75,6706813.84
261650,202007,479,305,174,318725,181830,500555
270010,202007,524,464,60,485925,62700,548625
270020,202007,285,232,53,242440,55385,297825
270030,202007,8867,5722,3145,5990605.11,3294885.5,9285490.61
270040,202007,1997,1252,745,1309350.16,778525,2087875.16
270050,202007,151,114,37,119130,38665,157795
270060,202007,113,62,51,64790,53295,118085
270070,202007,869,638,231,666710,241395,908105
270080,202007,36,30,6,31350,6270,37620
270090,202007,22,16,6,16720,6270,22990
270100,202007,1239,825,414,862125,432630,1294755
270110,202007,124,96,28,100320,29260,129580
270120,202007,228,188,40,196460.5,41800,238260.5
270130,202007,255,176,79,183920,82555,266475
270135,202007,119,75,44,78375,45980,124355
270140,202007,1365,863,502,901835.5,525635,1427470.5
270150,202007,257,203,54,212135,56430,268565
270160,202007,502,397,105,414865,109725,524590
270170,202007,796,521,275,544445,288420,832865
270180,202007,71,55,16,57475,16720,74195
270190,202007,90,77,13,80465,13585,94050
270200,202007,106,93,13,97185,13585,110770
270210,202007,506,285,221,297825,230945.5,528770.5
270220,202007,177,141,36,147345,37620,184965
270230,202007,2098,1282,816,1340736.6,854810,2195546.6
270235,202007,708,554,154,578930,160930,739860
270240,202007,3047,2412,635,2526811.42,664620.85,3191432.27
270250,202007,158,116,42,121220,43890,165110
270255,202007,214,183,31,191235,32395,223630
270260,202007,367,298,69,311410,72105,383515
270270,202007,98,42,56,43890,58520,102410
270280,202007,240,134,106,140030,110770,250800
270290,202007,1167,894,273,934230,286330,1220560
270300,202007,320,223,97,233035,101365,334400
270310,202007,856,700,156,732545,164065,896610
270320,202007,829,707,122,738815.79,127490,866305.79
270330,202007,298,251,47,262295,49115,311410
270340,202007,60,47,13,49115,13585,62700
270350,202007,90,49,41,51205,42845,94050
270360,202007,66,38,28,39710,29260,68970
270370,202007,56,46,10,48070,10450,58520
270375,202007,71,44,27,45980,28215,74195
270380,202007,1015,645,370,674025,387695,1061720
270390,202007,193,116,77,121220,80465,201685
270400,202007,705,525,180,548625.79,188100,736725.79
270410,202007,658,485,173,506825,180785,687610
270420,202007,407,282,125,294690,130625,425315
270430,202007,32830,23602,9228,24699909.48,9664162.9,34364072.38
270440,202007,486,384,102,401280,106590,507870
270450,202007,793,447,346,468160,361570,829730
270460,202007,192,152,40,158840,41800,200640
270470,202007,1462,1010,452,1055450,472340,1527790
270480,202007,547,454,93,474430.5,97185,571615.5
270490,202007,24,19,5,19855,5225,25080
270500,202007,488,410,78,428450,82555,511005
270510,202007,802,496,306,518320,320815,839135
270520,202007,290,188,102,196460,107635,304095
270530,202007,67,59,8,61655,9405,71060
270540,202007,107,84,23,87780,24035,111815
270550,202007,1751,1346,405,1406570,424270,1830840
270560,202007,264,143,121,149435,126445,275880
270570,202007,515,363,152,379335,159885,539220
270580,202007,96,71,25,74195,26125,100320
270590,202007,68,55,13,57475,13585,71060
270600,202007,175,146,29,152570,30305,182875
270610,202007,239,179,60,187055,62700,249755
270620,202007,28,27,1,28215,1045,29260
270630,202007,3761,2858,903,2987412.16,943635.5,3931047.66
270640,202007,875,651,224,681340,234080,915420
270642,202007,221,189,32,197505,33440,230945
270644,202007,255,165,90,172425,94050,266475
270650,202007,322,192,130,201685.5,135850,337535.5
270660,202007,247,206,41,215270,42845,258115
270670,202007,3053,2329,724,2434853.55,756580,3191433.55
270680,202007,436,259,177,271700,184965,456665
270690,202007,1171,766,405,801654.78,424270,1225924.78
270700,202007,28,23,5,24035,5225,29260
270710,202007,878,681,197,712690,206910,919600
270720,202007,244,193,51,201685,53295,254980
270730,202007,1846,1109,737,1159950.5,771210.25,1931160.75
270740,202007,42,29,13,30305,13585,43890
270750,202007,647,486,161,507870,168245,676115
270760,202007,291,212,79,222585,82555,305140
270770,202007,2742,1817,925,1901901.55,967670,2869571.55
270780,202007,76,48,28,50160,29260,79420
270790,202007,273,177,96,184965,101365,286330
270800,202007,1968,1587,381,1659460,402325,2061785
270810,202007,280,221,59,230945,61655,292600
270820,202007,142,96,46,100320,49115.5,149435.5
270830,202007,795,594,201,620730,210045,830775
270840,202007,1385,1048,337,1096205,352165.85,1448370.85
270850,202007,1502,941,561,983345.5,588335,1571680.5
270860,202007,2525,1676,849,1753545.29,889295,2642840.29
270870,202007,122,65,57,67925,59565,127490
270880,202007,897,699,198,731500,207955,939455
270890,202007,295,220,75,229900,78375,308275
270895,202007,63,54,9,57475,9405,66880
270900,202007,91,71,20,74195,20900,95095
270910,202007,307,250,57,261250,59565,320815
270915,202007,1904,1209,695,1265112.58,728365.6,1993478.18
270920,202007,470,395,75,412775,78375,491150
270930,202007,5917,4438,1479,4643980,1547645.03,6191625.03
270940,202007,2312,1805,507,1886225,531905,2418130
280010,202007,40,34,6,35530,6270,41800
280020,202007,473,409,64,427405.45,66880,494285.45
280030,202007,20489,13261,7228,13873448.2,7565805.97,21439254.17
280040,202007,328,214,114,223630,119130,342760
280050,202007,398,305,93,318725,97185,415910
280060,202007,354,225,129,235125.7,134805,369930.7
280067,202007,1065,763,302,798380,316635.62,1115015.62
280070,202007,123,99,24,103455,25080,128535
280100,202007,627,487,140,509960.5,146300,656260.5
280110,202007,75,70,5,73150,5225,78375
280120,202007,655,535,120,560120,125400,685520
280130,202007,1722,1131,591,1181895,618640.5,1800535.5
280140,202007,479,391,88,408595.5,91960,500555.5
280150,202007,393,285,108,297825,112860,410685
280160,202007,108,90,18,94050,18810,112860
280170,202007,399,276,123,288420.25,128535,416955.25
280190,202007,29,26,3,28215,3135,31350
280200,202007,29,25,4,26125,4180,30305
280210,202007,2945,2109,836,2204827.36,873620.5,3078447.86
280220,202007,39,31,8,32395,8360,40755
280230,202007,326,269,57,281105,60610,341715
280240,202007,119,113,6,118085,6270,124355
280250,202007,16,10,6,10450,6270,16720
280260,202007,81,73,8,76285,8360,84645
280270,202007,147,115,32,120175,33440,153615
280280,202007,189,121,68,126445.37,71060,197505.37
280290,202007,3340,2422,918,2533014.16,963490.1,3496504.26
280300,202007,1601,1247,354,1303115.5,369930,1673045.5
280310,202007,101,95,6,100320.5,6270,106590.5
280320,202007,660,466,194,486970,202730,689700
280330,202007,322,233,89,243485,93005,336490
280340,202007,407,331,76,346940.5,79420,426360.5
280350,202007,3668,2858,810,2988701.66,847496,3836197.66
280360,202007,466,311,155,324995,163020,488015
280370,202007,96,84,12,87780.65,12540,100320.65
280380,202007,53,42,11,43890,11495,55385
280390,202007,170,147,23,153615,24035,177650
280400,202007,358,247,111,259161.4,117040,376201.4
280410,202007,287,235,52,245575,54340,299915
280420,202007,171,143,28,149435,29260,178695
280430,202007,39,30,9,31350,9405,40755
280440,202007,698,547,151,571615.65,157795,729410.65
280445,202007,118,108,10,112860,10450,123310
280450,202007,1197,1036,161,1083665,168245,1251910
280460,202007,615,448,167,468161.63,175560,643721.63
280470,202007,184,172,12,179740,12540.75,192280.75
280480,202007,2651,1857,794,1942657.09,831820.32,2774477.41
280490,202007,264,250,14,261250.66,14630,275880.66
280500,202007,42,38,4,39710,4180,43890
280510,202007,140,114,26,119130,27170.5,146300.5
280520,202007,53,39,14,40755,14630,55385
280530,202007,76,50,26,52250,27170,79420
280540,202007,533,446,87,467115,91960,559075
280550,202007,731,678,53,708511.71,55385,763896.71
280560,202007,498,440,58,459800,60610,520410
280570,202007,2218,1737,481,1815165.2,503690,2318855.2
280580,202007,597,460,137,481745,143165.5,624910.5
280590,202007,207,130,77,137940,80465,218405
280600,202007,388,324,64,338580,66880,405460
280610,202007,112,86,26,89870,27170,117040
280620,202007,556,457,99,479655,103455,583110
280630,202007,155,129,26,134805,27170,161975
280640,202007,195,154,41,160930,42845,203775
280650,202007,89,60,29,62700,30305,93005
280660,202007,147,109,38,113905,39710,153615
280670,202007,1852,1167,685,1219518.03,716871.05,1936389.08
280680,202007,182,159,23,166155.22,25080,191235.22
280690,202007,80,71,9,74195,9405,83600
280700,202007,22,22,0,22990,0,22990
280710,202007,1469,1131,338,1185030,354255,1539285
280720,202007,110,71,39,74195,40755,114950
280730,202007,25,20,5,20900,5225,26125
280740,202007,2522,1881,641,1967735.5,670890,2638625.5
280750,202007,234,204,30,213180,31350,244530
280760,202007,775,536,239,560120,251845,811965
290010,202007,205,142,63,148390,65835,214225
290020,202007,181,164,17,171380,17765,189145
290030,202007,622,400,222,418000,231990,649990
290035,202007,131,106,25,110770,26125,136895
290040,202007,301,202,99,211090,103455,314545
290050,202007,87,67,20,70015,20900,90915
290060,202007,267,117,150,122265,156750,279015
290070,202007,5736,2772,2964,2900921.45,3104695.75,6005617.20
290080,202007,454,206,248,215270.5,261250,476520.5
290090,202007,385,175,210,182875,220495,403370
290100,202007,1642,1065,577,1112925,602966,1715891
290110,202007,828,480,348,502645.75,363660,866305.75
290115,202007,195,180,15,188100,15675,203775
290120,202007,761,500,261,522500,272745,795245
290130,202007,426,264,162,275880,170335,446215
290135,202007,302,229,73,239305,76285,315590
290140,202007,319,264,55,277970,57475,335445
290150,202007,138,99,39,103455,40755,144210
290160,202007,243,186,57,194370,59565,253935
290170,202007,94,67,27,70015,28215,98230
290180,202007,179,130,49,135850,51205,187055
290190,202007,435,359,76,375155,79420,454575
290195,202007,317,203,114,212135,119130,331265
290200,202007,275,223,52,233035,54340,287375
290205,202007,151,91,60,95095,63745,158840
290210,202007,1171,861,310,899745.5,324995,1224740.5
290220,202007,220,121,99,126445,104500,230945
290225,202007,291,115,176,120175,183920,304095
290230,202007,76,49,27,51205,28215,79420
290240,202007,355,132,223,137940,234080,372020
290250,202007,254,234,20,244530,20900,265430
290260,202007,322,265,57,276925.5,59565,336490.5
290265,202007,187,162,25,169290,26125,195415
290270,202007,1417,1179,238,1232055,248710.5,1480765.5
290280,202007,482,340,142,355300,148390,503690
290290,202007,1331,796,535,832866.03,561165.5,1394031.53
290300,202007,439,373,66,390830.5,68970,459800.5
290310,202007,301,137,164,143165,171380,314545
290320,202007,4024,2490,1534,2605185.3,1606165.1,4211350.4
290323,202007,190,164,26,172425,27170,199595
290327,202007,168,133,35,138985,36575,175560
290330,202007,103,55,48,57475,50160,107635
290340,202007,830,340,490,357390,512050,869440
290350,202007,626,381,245,398145.5,257070,655215.5
290360,202007,350,268,82,280061.64,85690,365751.64
290370,202007,918,390,528,408595.75,553850,962445.75
290380,202007,317,198,119,206910,124355,331265
290390,202007,2444,1525,919,1594671.75,961400,2556071.75
290395,202007,248,142,106,148390.25,110770,259160.25
290400,202007,272,202,70,212135.5,73150,285285.5
290405,202007,248,215,33,226765,34485,261250
290410,202007,628,526,102,549670.53,106590,656260.53
290420,202007,253,203,50,212135,52250,264385
290430,202007,479,312,167,326040,175560,501600
290440,202007,75,67,8,70015,8360,78375
290450,202007,206,156,50,163020,52250,215270
290460,202007,1960,1184,776,1237280,810920,2048200
290470,202007,1394,604,790,632225,828685,1460910
290475,202007,561,523,38,546535.2,39710,586245.2
290480,202007,289,164,125,171380,130625,302005
290485,202007,238,221,17,230945,17765,248710
290490,202007,1215,874,341,914375,357390,1271765
290500,202007,745,383,362,400235,379335,779570
290510,202007,225,176,49,184965,52250,237215
290515,202007,152,94,58,98230,60610,158840
290520,202007,1419,935,484,977075,505781.44,1482856.44
290530,202007,300,277,23,289465,24035,313500
290540,202007,106,56,50,58520,52250,110770
290550,202007,160,136,24,142120,25080,167200
290560,202007,3201,1376,1825,1441055,1918620,3359675
290570,202007,6204,3007,3197,3145451.4,3341912,6487363.4
290580,202007,1289,767,522,803605,546535,1350140
290590,202007,568,470,98,492195,102410,594605
290600,202007,1775,1224,551,1280125.63,577885,1858010.63
290610,202007,206,185,21,193325,21945,215270
290620,202007,354,319,35,333355,36575,369930
290630,202007,2027,851,1176,889295,1229965.5,2119260.5
290640,202007,152,122,30,127490,31350,158840
290650,202007,1800,831,969,868395.94,1013650,1882045.94
290660,202007,279,225,54,235125,56430,291555
290670,202007,945,489,456,511006.5,477565,988571.5
290680,202007,1234,992,242,1038730,252890,1291620
290682,202007,307,231,76,241395.8,79420,320815.8
290685,202007,239,156,83,163020,86735,249755
290687,202007,1045,676,369,706590.1,386650,1093240.1
290689,202007,148,80,68,83600,71060,154660
290690,202007,617,257,360,268565,376200,644765
290700,202007,248,122,126,127490,131670,259160
290710,202007,748,512,236,537130,248710,785840
290720,202007,1028,833,195,872575,204820,1077395
290730,202007,1157,666,491,695970.75,513095,1209065.75
290740,202007,17,14,3,14630,3135,17765
290750,202007,1429,635,794,663575,830776.54,1494351.54
290755,202007,72,65,7,67925,7315,75240
290760,202007,295,256,39,267520,41800,309320
290770,202007,188,177,11,184965,11495,196460
290780,202007,1105,847,258,885116,269610,1154726
290790,202007,363,256,107,267520,111815.5,379335.5
290800,202007,2491,1007,1484,1053360.5,1554960,2608320.5
290810,202007,463,319,144,333355,150480,483835
290820,202007,399,234,165,244530,172425,416955
290830,202007,422,300,122,313500,127490,440990
290840,202007,1749,1085,664,1134871.7,694925.5,1829797.2
290850,202007,833,445,388,466070,405460,871530
290860,202007,653,294,359,307230,375155.5,682385.5
290870,202007,639,452,187,472340.6,196460.6,668801.2
290880,202007,122,66,56,68970,58520,127490
290890,202007,386,263,123,274835,129580,404415
290900,202007,167,127,40,132715,41800,174515
290910,202007,384,294,90,307230,94050,401280
290920,202007,211,184,27,192280,28215,220495
290930,202007,824,625,199,654170.5,207955,862125.5
290940,202007,247,205,42,214225,43890,258115
290950,202007,156,95,61,100320,63745,164065
290960,202007,473,333,140,347985,146300,494285
290970,202007,249,216,33,227810,34485,262295
290980,202007,1629,1149,480,1201750.7,501601,1703351.7
290990,202007,393,331,62,345895,64790,410685
291000,202007,862,254,608,265430,636405,901835
291005,202007,2318,1015,1303,1063810,1361635.42,2425445.42
291010,202007,161,144,17,150480,18810,169290
291020,202007,102,81,21,84645,21945,106590
291030,202007,97,71,26,74195,27170,101365
291040,202007,611,340,271,355300,283195,638495
291050,202007,1434,791,643,826595,674025,1500620
291060,202007,1540,850,690,888250,721050,1609300
291070,202007,1960,1460,500,1525700.62,522500.12,2048200.74
291072,202007,7221,2691,4530,2815231.1,4746392.5,7561623.6
291075,202007,242,195,47,203775,49115,252890
291077,202007,58,40,18,41800,18810,60610
291080,202007,20313,8899,11414,9310952.46,11948531.77,21259484.23
291085,202007,299,245,54,256025,56430,312455
291090,202007,305,125,180,130625.5,188100,318725.5
291100,202007,665,204,461,213180,481745,694925
291110,202007,421,319,102,334400,106590,440990
291120,202007,2419,1201,1218,1257135.75,1279080,2536215.75
291125,202007,64,31,33,32395,34485,66880
291130,202007,201,178,23,186010,24035,210045
291140,202007,136,110,26,114950,27170.5,142120.5
291150,202007,391,150,241,156750,252890,409640
291160,202007,384,313,71,327085.25,74195,401280.25
291165,202007,40,32,8,33440,8360,41800
291170,202007,3161,1583,1578,1655282.58,1650055.5,3305338.08
291180,202007,1267,507,760,529815.31,801515,1331330.31
291185,202007,91,86,5,89870,5225,95095
291190,202007,1371,620,751,647900.25,785840,1433740.25
291200,202007,171,127,44,132715,45980,178695
291210,202007,2286,916,1370,959310.2,1433740.5,2393050.7
291220,202007,274,207,67,216315,70015,286330
291230,202007,989,342,647,357390.5,676115,1033505.5
291240,202007,429,401,28,419045.5,29260,448305.5
291250,202007,440,356,84,372020,88825,460845
291260,202007,58,47,11,49115,11495,60610
291270,202007,1161,482,679,503690,709555,1213245
291280,202007,358,168,190,175560,198550,374110
291290,202007,1744,903,841,945725.5,878845.5,1824571.0
291300,202007,233,185,48,193325,50160,243485
291310,202007,220,200,20,209000,20900,229900
291320,202007,1370,965,405,1009470,424270,1433740
291330,202007,133,114,19,119130,19855,138985
291340,202007,205,118,87,123310,90915,214225
291345,202007,132,92,40,96140,41800,137940
291350,202007,1655,582,1073,608190,1123375.75,1731565.75
291360,202007,8441,4068,4373,4261510.75,4578146.25,8839657.00
291370,202007,1130,651,479,680295.5,500555,1180850.5
291380,202007,269,212,57,221540,59565,281105
291390,202007,3904,1716,2188,1794266.4,2287505.5,4081771.9
291400,202007,2095,1490,605,1559140,634315.84,2193455.84
291410,202007,191,167,24,174515,25080,199595
291420,202007,120,87,33,90915,34485,125400
291430,202007,165,91,74,95095,77330.02,172425.02
291440,202007,522,428,94,447261,98230,545491
291450,202007,913,585,328,611325.25,342760,954085.25
291460,202007,1849,1507,342,1574815.5,357390.5,1932206.0
291465,202007,2186,1037,1149,1083665.5,1202795,2286460.5
291470,202007,2870,1451,1419,1517340.97,1483900.5,3001241.47
291480,202007,11866,5255,6611,5495660.88,6919993.25,12415654.13
291490,202007,610,243,367,253935,383515,637450
291500,202007,378,221,157,230945,164065,395010
291510,202007,1226,476,750,497420,784795,1282215
291520,202007,945,426,519,446215,543400,989615
291530,202007,934,252,682,263340,713735,977075
291535,202007,125,102,23,106590,24035,130625
291540,202007,345,104,241,108680.5,251845,360525.5
291550,202007,1231,583,648,610280,681340.5,1291620.5
291560,202007,5276,2657,2619,2778655,2744171,5522826
291570,202007,198,104,94,108680,98230,206910
291580,202007,1213,744,469,778525.55,490105,1268630.55
291590,202007,86,35,51,36575,53295.5,89870.5
291600,202007,1151,569,582,595650.25,609235,1204885.25
291610,202007,1453,707,746,738815.5,780615,1519430.5
291620,202007,570,263,307,274835,320815,595650
291630,202007,488,149,339,155705,354255,509960
291640,202007,3997,2039,1958,2131802.2,2046111.5,4177913.7
291650,202007,422,288,134,300961.12,140030,440991.12
291660,202007,395,160,235,169290.29,246620,415910.29
291670,202007,223,135,88,141075,91960,233035
291680,202007,662,394,268,411730,281105.5,692835.5
291685,202007,585,325,260,339625,273790,613415
291690,202007,536,320,216,334400,225720.27,560120.27
291700,202007,977,761,216,795245,225720,1020965
291710,202007,1641,789,852,824505.25,892430.5,1716935.75
291720,202007,425,286,139,298870,147345,446215
291730,202007,940,555,385,579975,402325,982300
291733,202007,288,195,93,203775,97185,300960
291735,202007,76,57,19,59565,19855,79420
291740,202007,358,276,82,289465,85690,375155
291750,202007,2157,1403,754,1467180.38,788975,2256155.38
291760,202007,2981,1649,1332,1725295,1398210,3123505
291770,202007,787,531,256,554896.05,267520,822416.05
291780,202007,60,36,24,37620,25080,62700
291790,202007,163,81,82,84645,85690,170335
291800,202007,10063,4149,5914,4345113.09,6202076.5,10547189.59
291810,202007,1108,825,283,864215.5,295735,1159950.5
291820,202007,280,201,79,210045,82555,292600
291830,202007,1060,423,637,442036.46,667755,1109791.46
291835,202007,571,530,41,554895,43890,598785
291840,202007,4877,2468,2409,2584285.25,2524720.5,5109005.75
291845,202007,272,88,184,91960,192280,284240
291850,202007,327,291,36,304095,37620,341715
291855,202007,267,105,162,109725,169290,279015
291860,202007,172,108,64,112860,66880,179740
291870,202007,84,35,49,36575,51205,87780
291875,202007,180,166,14,173470,15675,189145
291880,202007,456,362,94,379335,98230,477565
291890,202007,243,77,166,80465,174515.5,254980.5
291900,202007,58,33,25,34485,26125,60610
291905,202007,128,93,35,97185.5,36575,133760.5
291910,202007,162,132,30,137940,31350,169290
291915,202007,431,383,48,400235.25,50160,450395.25
291920,202007,5083,2556,2527,2673110,2642805.5,5315915.5
291930,202007,172,102,70,106590.55,73150,179740.55
291940,202007,362,206,156,215270.5,163020,378290.5
291950,202007,1156,932,224,973941,235125.5,1209066.5
291955,202007,1252,743,509,777480,533995,1311475
291960,202007,189,137,52,143165,54340,197505
291970,202007,764,581,183,608190,192280,800470
291980,202007,1501,1330,171,1389851.23,178695.5,1568546.73
291990,202007,133,124,9,129580,9405,138985
291992,202007,171,88,83,91960,86735,178695
291995,202007,177,118,59,123310,61655,184965
292000,202007,398,306,92,319770,96140,415910
292010,202007,315,219,96,228855,100320,329175
292020,202007,304,223,81,233035,84645,317680
292030,202007,146,113,33,118085,34485,152570
292040,202007,629,318,311,332310,326040,658350
292045,202007,106,96,10,100320,10450,110770
292050,202007,947,688,259,720005,270655.5,990660.5
292060,202007,904,748,156,781660.65,163020,944680.65
292070,202007,57,21,36,21945,37620,59565
292080,202007,144,99,45,103455,47025,150480
292090,202007,542,186,356,194370,372020,566390
292100,202007,1485,633,852,664620,895565,1560185
292105,202007,193,171,22,178695,22990,201685
292110,202007,2270,822,1448,858990,1513160,2372150
292120,202007,700,552,148,577885,154660,732545
292130,202007,443,251,192,262295,200640,462935
292140,202007,210,170,40,177650,41800,219450
292145,202007,161,86,75,89870,78375,168245
292150,202007,1475,1205,270,1260270,284240,1544510
292160,202007,171,140,31,146300,32395,178695
292170,202007,1208,1050,158,1097250,165110,1262360
292180,202007,220,161,59,168245,61655,229900
292190,202007,162,105,57,109725,59565,169290
292200,202007,1348,493,855,515185,894520.5,1409705.5
292205,202007,126,110,16,114950,16720,131670
292210,202007,366,256,110,267520,114950.25,382470.25
292220,202007,28,22,6,22990,6270,29260
292225,202007,41,35,6,36575,6270,42845
292230,202007,965,768,197,802560.75,205865,1008425.75
292240,202007,612,441,171,460845.75,179740,640585.75
292250,202007,1739,1144,595,1196525,622820,1819345
292260,202007,415,250,165,261250,172425,433675
292265,202007,252,180,72,188100,75240,263340
292270,202007,738,338,400,353210,418000,771210
292273,202007,207,113,94,118085,98230,216315
292275,202007,172,86,86,89870,90915,180785
292280,202007,143,99,44,103455,45980,149435
292285,202007,77,63,14,65835,14630,80465
292290,202007,573,386,187,403370,195415.5,598785.5
292300,202007,1686,631,1055,659395,1103520.3,1762915.3
292303,202007,112,73,39,76285,40755,117040
292305,202007,114,84,30,87780,31350,119130
292310,202007,932,607,325,634316.25,341715.9,976032.15
292320,202007,601,455,146,475475,152570,628045
292330,202007,176,101,75,105545,79420,184965
292335,202007,283,222,61,231990,63745,295735
292340,202007,580,405,175,423225,183920,607145
292350,202007,273,147,126,153615,131670,285285
292360,202007,708,541,167,566390.9,174515,740905.9
292370,202007,736,564,172,589380,179740,769120
292380,202007,641,519,122,543400.35,127490,670890.35
292390,202007,470,188,282,196460,294690,491150
292400,202007,3631,2240,1391,2341847.61,1457775,3799622.61
292405,202007,265,174,91,181830,95095,276925
292410,202007,138,85,53,88825,55385,144210
292420,202007,294,255,39,266475,40755,307230
292430,202007,538,409,129,427405,134805,562210
292440,202007,599,515,84,538175.16,87780,625955.16
292450,202007,249,192,57,200640,59565,260205
292460,202007,555,414,141,433675.95,147345,581020.95
292465,202007,213,177,36,184965,37620,222585
292467,202007,128,76,52,79420,54340,133760
292470,202007,289,196,93,205865,97185,303050
292480,202007,369,254,115,265430,120175.5,385605.5
292490,202007,233,163,70,170335,73150,243485
292500,202007,874,388,486,407550.15,508915,916465.15
292510,202007,3454,1594,1860,1670955.6,1945790,3616745.6
292520,202007,1095,514,581,537130,607145,1144275
292525,202007,398,282,116,294690,121220,415910
292530,202007,4393,1765,2628,1846515.96,2752531.5,4599047.46
292540,202007,477,265,212,276925,221540,498465
292550,202007,1099,583,516,609235,542355,1151590
292560,202007,332,310,22,323950,22990,346940
292570,202007,304,238,66,248710,68970,317680
292575,202007,492,325,167,339625.5,175560,515185.5
292580,202007,992,661,331,690745,345895.5,1036640.5
292590,202007,567,494,73,516230,76285,592515
292593,202007,142,113,29,118085,31350,149435
292595,202007,200,156,44,163020,45980,209000
292600,202007,1255,915,340,957220.29,356345,1313565.29
292610,202007,132,102,30,106590,31350,137940
292620,202007,527,442,85,461890,88825,550715
292630,202007,1434,805,629,841225.42,657305,1498530.42
292640,202007,818,566,252,593560,264385,857945
292650,202007,190,156,34,163020.5,35530,198550.5
292660,202007,2032,1459,573,1524655,599830.42,2124485.42
292665,202007,141,99,42,103455,43890,147345
292670,202007,389,317,72,331265,75240,406505
292680,202007,257,193,64,201685,66880.5,268565.5
292690,202007,195,144,51,150480,53295,203775
292700,202007,975,647,328,676115,343805,1019920
292710,202007,115,100,15,104500,15675,120175
292720,202007,934,532,402,555940,420090,976030
292730,202007,196,91,105,95095,109725,204820
292740,202007,68874,33632,35242,35193528.1,36951209.83,72144737.93
292750,202007,388,275,113,287375.95,118085,405460.95
292760,202007,336,279,57,291556.45,59565,351121.45
292770,202007,827,353,474,370975,495330,866305
292780,202007,414,163,251,170335,262295,432630
292790,202007,771,392,379,409640,397100,806740
292800,202007,1256,755,501,788975,524590,1313565
292805,202007,397,120,277,125400,289465,414865
292810,202007,1500,851,649,890341.5,679250,1569591.5
292820,202007,715,593,122,620731.25,127490,748221.25
292830,202007,111,90,21,94050,21945,115995
292840,202007,683,561,122,587290,127490,714780
292850,202007,144,96,48,100320,50160,150480
292860,202007,2167,1264,903,1320880.5,945725,2266605.5
292870,202007,3492,2333,1159,2437985.45,1212200,3650185.45
292880,202007,1502,984,518,1028280.05,541310,1569590.05
292890,202007,518,442,76,462935,79420,542355
292895,202007,143,94,49,98230,51205,149435
292900,202007,391,279,112,291555.4,117040,408595.4
292905,202007,475,240,235,250800,246620,497420
292910,202007,459,346,113,361570.75,118085,479655.75
292920,202007,528,229,299,239305,312455,551760
292925,202007,492,453,39,473385,40755,514140
292930,202007,616,374,242,390830,252890,643720
292935,202007,285,123,162,129580,169290,298870
292937,202007,226,158,68,165110,71060,236170
292940,202007,191,148,43,154660,44935,199595
292950,202007,1175,590,585,618640.75,612370.6,1231011.35
292960,202007,585,416,169,434720,177650,612370
292970,202007,248,174,74,181830,77330,259160
292975,202007,115,66,49,68970,51205,120175
292980,202007,287,194,93,202730.52,97185,299915.52
292990,202007,1331,990,341,1034551.55,356345,1390896.55
293000,202007,114,80,34,83600,35530,119130
293010,202007,2806,1675,1131,1751420.75,1185030.72,2936451.47
293015,202007,636,519,117,542355,123310,665665
293020,202007,332,274,58,286330,60610,346940
293030,202007,601,523,78,546535,81510,628045
293040,202007,359,283,76,295735,79420,375155
293050,202007,2879,1709,1170,1785905.5,1224740.5,3010646.0
293060,202007,261,210,51,219450.6,53295,272745.6
293070,202007,3487,1756,1731,1835022.72,1816211.75,3651234.47
293075,202007,92,61,31,63745,32395,96140
293076,202007,75,52,23,54340,24035,78375
293077,202007,506,292,214,306185.5,223630,529815.5
293080,202007,442,397,45,414865.85,47025,461890.85
293090,202007,129,115,14,120175,14630,134805
293100,202007,530,370,160,386650,167200,553850
293105,202007,346,250,96,262295,100320,362615
293110,202007,166,116,50,123310,53295,176605
293120,202007,311,211,100,220495,105545,326040
293130,202007,244,168,76,175560,79420,254980
293135,202007,8069,3169,4900,3312651.75,5130954,8443605.75
293140,202007,211,132,79,137940,82555,220495
293150,202007,330,285,45,297825,47025,344850
293160,202007,423,251,172,262295,180785,443080
293170,202007,176,121,55,126445,57475,183920
293180,202007,517,368,149,384560.5,155705,540265.5
293190,202007,1344,935,409,978120.61,430540,1408660.61
293200,202007,546,482,64,503690,66880,570570
293210,202007,397,300,97,314545,101365,415910
293220,202007,2489,1048,1441,1098295,1506890,2605185
293230,202007,1749,644,1105,672980.94,1156815,1829795.94
293240,202007,233,215,18,224675,18810,243485
293245,202007,126,107,19,111815,19855,131670
293250,202007,721,258,463,269610.9,483835,753445.9
293260,202007,304,253,51,264385,53295,317680
293270,202007,1165,542,623,567435.25,654170,1221605.25
293280,202007,275,151,124,157795,129580,287375
293290,202007,3045,1981,1064,2072235,1112925,3185160
293300,202007,740,528,212,551760.75,221540,773300.75
293305,202007,194,154,40,160930,41800,202730
293310,202007,150,113,37,118085,38665,156750
293315,202007,164,129,35,134805,36575,171380
293317,202007,89,65,24,67925.5,25080,93005.5
293320,202007,1059,585,474,611325.92,496375,1107700.92
293325,202007,182,67,115,70015,120175,190190
293330,202007,13718,6417,7301,6713083.41,7659853.31,14372936.72
293340,202007,269,191,78,199595,81510,281105
293345,202007,247,200,47,209000,49115,258115
293350,202007,621,357,264,373065,275880,648945
293360,202007,1530,1095,435,1145320,454575,1599895
310010,202007,138,76,62,79420,64790.5,144210.5
310020,202007,1037,576,461,601920,482790,1084710
310030,202007,330,264,66,275880,68970,344850
310040,202007,43,29,14,30305,14630,44935
310050,202007,181,114,67,119130.5,70015,189145.5
310060,202007,242,167,75,175560.5,78375,253935.5
310070,202007,15,10,5,10450,5225,15675
310080,202007,41,25,16,26125,16720,42845
310090,202007,1014,527,487,550717,509961,1060678
310100,202007,306,223,83,233035,86735,319770
310110,202007,704,388,316,406505,330220,736725
310120,202007,373,215,158,224675,165110,389785
310130,202007,33,19,14,19855,14630,34485
310140,202007,26,13,13,13585,13585,27170
310150,202007,1206,823,383,860801.86,401281,1262082.86
310160,202007,2068,1010,1058,1056497.15,1109790.5,2166287.65
310163,202007,87,50,37,52250,38665,90915
310170,202007,2558,1131,1427,1181895.85,1492262,2674157.85
310180,202007,149,55,94,57475,98230,155705
310190,202007,480,331,149,346940,155705,502645
310200,202007,486,309,177,322905,184965,507870
310205,202007,57,39,18,40755,18810,59565
310210,202007,284,229,55,239305,57475,296780
310220,202007,63,34,29,35530,30305,65835
310230,202007,273,190,83,198550,86735,285285
310240,202007,107,94,13,98230,13585,111815
310250,202007,97,79,18,82555,18810,101365
310260,202007,767,407,360,426361.17,376200,802561.17
310270,202007,272,176,96,183920.6,100320,284240.6
310280,202007,376,276,100,288420,104500,392920
310285,202007,209,152,57,158840,59565,218405
310290,202007,241,130,111,135850,115995,251845
310300,202007,155,128,27,133760,28215,161975
310310,202007,9,7,2,7315,2090,9405
310320,202007,28,11,17,11495,17765,29260
310330,202007,42,27,15,28215,15675,43890
310340,202007,1747,1146,601,1198617,628045.5,1826662.5
310350,202007,2801,1495,1306,1565410,1371040.35,2936450.35
310360,202007,41,35,6,36575,6270,42845
310370,202007,112,94,18,98230,19855.5,118085.5
310375,202007,104,39,65,40755,68970,109725
310380,202007,47,27,20,28215,20900,49115
310390,202007,95,63,32,65835,34485,100320
310400,202007,2348,1515,833,1584221,872575,2456796
310410,202007,130,71,59,74195,61655,135850
310420,202007,667,351,316,367840,332310,700150
310430,202007,310,196,114,204820,119130,323950
310440,202007,78,45,33,47025,34485,81510
310445,202007,80,66,14,70015,14630,84645
310450,202007,625,386,239,403370,249755,653125
310460,202007,261,184,77,192280,80465,272745
310470,202007,510,321,189,335445,197505,532950
310480,202007,77,53,24,55385,25080,80465
310490,202007,531,249,282,260206.04,295735,555941.04
310500,202007,134,53,81,55385,84645,140030
310510,202007,607,421,186,439945,194370,634315
310520,202007,133,93,40,97185,41800,138985
310530,202007,107,46,61,48070,64790,112860
310540,202007,469,274,195,286330,204820,491150
310550,202007,76,48,28,50160,29260,79420
310560,202007,2968,2044,924,2138070.25,966625,3104695.25
310570,202007,95,64,31,66880,32395,99275
310590,202007,370,235,135,245575.25,141075,386650.25
310600,202007,150,82,68,85690.5,71060,156750.5
310610,202007,59,24,35,25080,36575,61655
310620,202007,47144,22490,24654,23534382.18,25841812.49,49376194.67
310630,202007,642,394,248,411730,259160.5,670890.5
310640,202007,128,99,29,103455,30305,133760
310650,202007,161,144,17,150480,17765,168245
310660,202007,103,68,35,72105,36575,108680
310665,202007,59,45,14,47025,14630,61655
310670,202007,6709,2878,3831,3010647.5,4007576,7018223.5
310680,202007,57,36,21,37620,21945,59565
310690,202007,613,427,186,449350.25,195415,644765.25
310700,202007,58,38,20,39710,20900,60610
310710,202007,1336,911,425,951995.5,445170.5,1397166.0
310720,202007,133,36,97,37620,101365,138985
310730,202007,1454,1001,453,1046046.25,473385,1519431.25
310740,202007,977,540,437,564301,456665.25,1020966.25
310750,202007,240,145,95,151525.65,100320,251845.65
310760,202007,64,47,17,49115,17765.5,66880.5
310770,202007,100,47,53,49115,56430,105545
310780,202007,363,294,69,307230,73150,380380
310790,202007,100,82,18,85690,18810,104500
310800,202007,448,210,238,219450.25,250800,470250.25
310810,202007,171,122,49,127490.72,51205,178695.72
310820,202007,336,264,72,276925,75240,352165
310825,202007,193,163,30,170335,31350,201685
310830,202007,473,225,248,237215.5,260205,497420.5
310840,202007,369,215,154,224675,163020,387695
310850,202007,96,76,20,79420,20900,100320
310855,202007,393,313,80,327085,84645,411730
310860,202007,1586,1172,414,1228923,436811.25,1665734.25
310870,202007,53,43,10,44935,10450,55385
310880,202007,84,64,20,66880,20900,87780
310890,202007,307,178,129,186010,135850,321860
310900,202007,648,298,350,311419.14,366807.96,678227.10
310910,202007,240,162,78,169290.5,81510,250800.5
310920,202007,454,268,186,281106.45,194370.5,475476.95
310925,202007,37,31,6,32395,6270,38665
310930,202007,1304,823,481,863170,503690,1366860
310940,202007,709,349,360,364705,377245,741950
310945,202007,117,74,43,77330,44935,122265
310950,202007,232,186,46,194370,48070,242440
310960,202007,79,24,55,25080,57475,82555
310970,202007,164,103,61,107635,63745.5,171380.5
310980,202007,49,32,17,33440,17765,51205
310990,202007,161,82,79,85690,82555,168245
311000,202007,824,408,416,427406.49,435765.5,863171.99
311010,202007,43,38,5,39710,5225,44935
311020,202007,46,28,18,29260,18810,48070
311030,202007,385,221,164,233035.5,171380,404415.5
311040,202007,42,32,10,33440,10450,43890
311050,202007,489,187,302,196460,317680,514140
311060,202007,782,432,350,451440,366795.5,818235.5
311070,202007,337,149,188,155705,197505,353210
311080,202007,108,58,50,60610,52250,112860
311090,202007,337,157,180,164065,188100,352165
311100,202007,585,354,231,369930,242440,612370
311110,202007,693,484,209,507870,220495,728365
311115,202007,74,53,21,55385,21945,77330
311120,202007,1078,572,506,599830.5,530860,1130690.5
311130,202007,347,210,137,220495,143165,363660
311140,202007,168,90,78,94050,81510,175560
311150,202007,344,223,121,233035,126445,359480
311160,202007,708,503,205,526680.5,215270,741950.5
311170,202007,86,68,18,71060,18810,89870
311180,202007,330,221,109,230945,113905.5,344850.5
311190,202007,44,22,22,22990,22990,45980
311200,202007,324,228,96,238260,100320,338580
311205,202007,34,23,11,24035,11495,35530
311210,202007,48,42,6,43890.5,6270,50160.5
311220,202007,26,22,4,22990,4180,27170
311230,202007,1635,1073,562,1123375.5,587290,1710665.5
311240,202007,186,120,66,125400,68970,194370
311250,202007,93,25,68,26125,71060,97185
311260,202007,550,345,205,361570,214225,575795
311265,202007,123,83,40,86735,41800,128535
311270,202007,289,195,94,203775,98230,302005
311280,202007,212,98,114,102410,120175,222585
311290,202007,105,86,19,89870,19855,109725
311300,202007,588,368,220,384560,230945,615505
311310,202007,21,16,5,16720,5225,21945
311320,202007,663,491,172,513095,179740,692835
311330,202007,1090,800,290,836000,303050.5,1139050.5
311340,202007,2628,1861,767,1944746,803605,2748351
311350,202007,276,215,61,224675,63745,288420
311360,202007,174,107,67,111815,70015,181830
311370,202007,1215,497,718,519365.25,750310,1269675.25
311380,202007,7,6,1,6270,1045,7315
311390,202007,251,138,113,144210,120175,264385
311400,202007,138,88,50,91960,53295,145255
311410,202007,114,60,54,62700,56430,119130
311420,202007,303,164,139,171380,145255,316635
311430,202007,850,565,285,590425,298870.5,889295.5
311440,202007,461,324,137,338580,144210,482790
311450,202007,314,189,125,199595,130625,330220
311455,202007,279,192,87,200640,90915,291555
311460,202007,140,61,79,63745,82555,146300
311470,202007,23,12,11,12540,11495,24035
311480,202007,48,22,26,22990,27170,50160
311490,202007,13,9,4,9405,4180,13585
311500,202007,25,12,13,12540,13585,26125
311510,202007,635,437,198,456665,206910,663575
311520,202007,40,32,8,34485,8360,42845
311530,202007,1809,1330,479,1394031.7,501600,1895631.7
311535,202007,65,44,21,47025,21945,68970
311540,202007,34,30,4,31350,4180,35530
311545,202007,177,131,46,136895,48070,184965
311547,202007,40,33,7,34485,7315,41800
311550,202007,704,321,383,335445,401280,736725
311560,202007,42,28,14,29260,14630,43890
311570,202007,286,190,96,198550,100320,298870
311580,202007,335,196,139,205865,145255,351120
311590,202007,32,29,3,30305,3135,33440
311600,202007,107,83,24,86735,25080,111815
311610,202007,252,219,33,228855.25,34485,263340.25
311615,202007,83,67,16,70015,16720,86735
311620,202007,25,14,11,14630,11495,26125
311630,202007,87,73,14,76285,14630,90915
311640,202007,137,67,70,70015,73150,143165
311650,202007,123,85,38,88825,39710,128535
311660,202007,403,199,204,207955,213180,421135
311670,202007,150,100,50,104500,52250,156750
311680,202007,211,157,54,164065,56430,220495
311690,202007,15,11,4,11495,4180,15675
311700,202007,196,137,59,143165,61655,204820
311710,202007,202,133,69,138985,72105,211090
311720,202007,41,30,11,31350.5,11495,42845.5
311730,202007,577,391,186,409640,195415,605055
311740,202007,37,26,11,27170,11495,38665
311750,202007,721,489,232,513095.76,242440,755535.76
311760,202007,66,29,37,30305,38665,68970
311770,202007,391,196,195,204821.35,206910,411731.35
311780,202007,175,88,87,91960.5,90915,182875.5
311783,202007,87,78,9,81510,9405,90915
311787,202007,38,13,25,13585,26125,39710
311790,202007,259,115,144,120175,151525,271700
311800,202007,679,447,232,467115.95,243485,710600.95
311810,202007,49,40,9,41800,9405,51205
311820,202007,119,98,21,102410,21945,124355
311830,202007,1895,1167,728,1222651.49,762850,1985501.49
311840,202007,1005,561,444,586246,465025.25,1051271.25
311850,202007,12,8,4,8360,4180,12540
311860,202007,9598,4170,5428,4366012.25,5691070.5,10057082.75
311870,202007,126,66,60,68970,62700,131670
311880,202007,926,673,253,703285,264385,967670
311890,202007,205,100,105,104414,109725,214139
311900,202007,74,30,44,31350,45980,77330
311910,202007,1405,883,522,922735.75,545490.5,1468226.25
311920,202007,233,151,82,157795,85690,243485
311930,202007,906,514,392,538175.5,410685,948860.5
311940,202007,2494,1303,1191,1363725,1247730.15,2611455.15
311950,202007,54,40,14,41800,14630,56430
311960,202007,60,44,16,45980,15675,61655
311970,202007,23,14,9,14630,9405,24035
311980,202007,44,34,10,35530,10450,45980
311990,202007,38,29,9,30305,9405,39710
311995,202007,58,37,21,38665,21945,60610
312000,202007,30,22,8,22990,8360,31350
312010,202007,78,61,17,63745,17765,81510
312015,202007,75,57,18,59565,18810,78375
312020,202007,128,86,42,90915,44935,135850
312030,202007,58,44,14,45980,14630,60610
312040,202007,86,52,34,54340.5,35530,89870.5
312050,202007,208,114,94,120175,98230,218405
312060,202007,22,12,10,12540,10450,22990
312070,202007,76,50,26,52250,27170,79420
312080,202007,531,240,291,251845,304095,555940
312083,202007,60,38,22,39710,22990,62700
312087,202007,106,83,23,86735,24035,110770
312090,202007,3191,1905,1286,1992816.5,1343870.5,3336687.0
312100,202007,151,106,45,110530.15,47025,157555.15
312110,202007,118,69,49,72105,51205,123310
312120,202007,141,102,39,106591.14,40755,147346.14
312125,202007,91,51,40,53295,41800,95095
312130,202007,127,83,44,86735,45980,132715
312140,202007,136,106,30,110770.5,31350,142120.5
312150,202007,42,32,10,33440,10450,43890
312160,202007,1559,1023,536,1070176.5,560120.5,1630297.0
312170,202007,10,8,2,8360,2090,10450
312180,202007,116,70,46,73150,48070.5,121220.5
312190,202007,34,30,4,31350,4180,35530
312200,202007,755,643,112,671935.5,117040,788975.5
312210,202007,111,60,51,62700,53295,115995
312220,202007,139,104,35,108680.25,36575,145255.25
312230,202007,3641,1681,1960,1758735.4,2050291,3809026.4
312235,202007,168,111,57,115995,59565,175560
312240,202007,97,69,28,72105,29260,101365
312245,202007,189,129,60,134805,62700,197505
312247,202007,73,51,22,53295,22990,76285
312250,202007,179,84,95,88825,99275,188100
312260,202007,109,73,36,76285,37620,113905
312270,202007,131,77,54,80465,57475,137940
312280,202007,26,13,13,13585,13585,27170
312290,202007,146,104,42,108680,43890,152570
312300,202007,212,135,77,141075,80465,221540
312310,202007,61,54,7,56430,7315,63745
312320,202007,424,268,156,280060,164065.75,444125.75
312330,202007,90,79,11,82555,11495,94050
312340,202007,36,17,19,17765,19855,37620
312350,202007,18,11,7,11495,7315,18810
312352,202007,92,68,24,71060,25080,96140
312360,202007,585,248,337,260205,352165,612370
312370,202007,307,171,136,178695,142120,320815
312380,202007,143,94,49,98230,51205,149435
312385,202007,163,130,33,135850,34485,170335
312390,202007,300,187,113,195415,119130.5,314545.5
312400,202007,381,284,97,296780,101365.5,398145.5
312410,202007,999,315,684,329175,715825,1045000
312420,202007,624,476,148,501600.5,155705,657305.5
312430,202007,865,632,233,661486.11,244530,906016.11
312440,202007,42,31,11,32395,11495,43890
312450,202007,209,131,78,137940,81510,219450
312460,202007,31,16,15,16720,15675,32395
312470,202007,46,31,15,32395,15675,48070
312480,202007,191,118,73,123310,76285,199595
312490,202007,267,187,80,196460,83600,280060
312500,202007,36,21,15,21945,15675,37620
312510,202007,525,204,321,213180,336490,549670
312520,202007,30,9,21,9405,21945,31350
312530,202007,47,32,15,33440,15675,49115
312540,202007,95,83,12,86735,12540,99275
312550,202007,35,28,7,29260,7315,36575
312560,202007,217,164,53,171380.5,55385,226765.5
312570,202007,440,260,180,271700,188100,459800
312580,202007,86,47,39,49115,41800,90915
312590,202007,246,196,50,204820,52250,257070
312595,202007,133,119,14,124355,14630,138985
312600,202007,70,38,32,39710.25,33440,73150.25
312610,202007,1597,819,778,855857,815100.5,1670957.5
312620,202007,212,151,61,157795,63745,221540
312630,202007,66,56,10,58520,10450,68970
312640,202007,45,14,31,14630,32395,47025
312650,202007,147,121,26,126445.5,27170,153615.5
312660,202007,94,65,29,67925.76,30305,98230.76
312670,202007,920,593,327,619685,341715,961400
312675,202007,29,23,6,24035,6270,30305
312680,202007,78,48,30,50160,31350,81510
312690,202007,244,128,116,133760,121220,254980
312695,202007,33,27,6,28215,6270,34485
312700,202007,228,132,96,137940,100320,238260
312705,202007,85,68,17,71060,17765,88825
312707,202007,128,89,39,93005,40755,133760
312710,202007,1880,999,881,1045000.91,923780,1968780.91
312720,202007,57,30,27,32395,28215,60610
312730,202007,286,165,121,172425,126445,298870
312733,202007,54,44,10,45980,10450,56430
312735,202007,22,14,8,14630,8360,22990
312737,202007,72,39,33,40755,35530,76285
312738,202007,59,40,19,41800,19855,61655
312740,202007,83,54,29,56430,30305,86735
312750,202007,83,58,25,60610,26125,86735
312760,202007,289,206,83,215270,86735,302005
312770,202007,7976,3640,4336,3809029.25,4542615,8351644.25
312780,202007,431,329,102,343805,107635,451440
312790,202007,22,16,6,16720,6270,22990
312800,202007,1597,1110,487,1159950.75,508915,1668865.75
312810,202007,370,236,134,247665,141075,388740
312820,202007,188,144,44,150480,45980,196460
312825,202007,24,15,9,15675,9405,25080
312830,202007,232,132,100,138985,104500,243485
312840,202007,157,106,51,110770,53295,164065
312850,202007,44,39,5,40755,5225,45980
312860,202007,154,97,57,101365,59565,160930
312870,202007,1062,551,511,576840.75,533995,1110835.75
312880,202007,126,88,38,91960,39710,131670
312890,202007,154,110,44,115995,45980,161975
312900,202007,193,145,48,151525,51205,202730
312910,202007,180,95,85,99275,88825,188100
312920,202007,156,85,71,88825,74195,163020
312930,202007,328,227,101,238260,105545,343805
312940,202007,115,82,33,85690,35530,121220
312950,202007,702,479,223,500555,234080,734635
312960,202007,170,128,42,133760.9,43890,177650.9
312965,202007,75,64,11,66880,11495,78375
312970,202007,275,225,50,236170.25,52250,288420.25
312980,202007,2453,1235,1218,1291621,1274900,2566521
312990,202007,44,23,21,24035,21945,45980
313000,202007,51,28,23,29260,24035,53295
313005,202007,173,134,39,141075,40755.5,181830.5
313010,202007,918,358,560,375155.5,585200,960355.5
313020,202007,194,103,91,107635,95095,202730
313030,202007,193,131,62,136895.35,64790,201685.35
313040,202007,75,23,52,24035,54340,78375
313050,202007,180,131,49,136895,51205,188100
313055,202007,37,27,10,28215,10450,38665
313060,202007,130,89,41,93005,42845,135850
313065,202007,63,45,18,47025,18810.5,65835.5
313070,202007,136,70,66,73150,68970,142120
313080,202007,38,17,21,17765,21945,39710
313090,202007,652,434,218,453530,227810,681340
313100,202007,186,65,121,67925,126445,194370
313110,202007,138,74,64,77330,66880,144210
313115,202007,208,116,92,121220,96140,217360
313120,202007,823,470,353,491150,368885.5,860035.5
313130,202007,5680,3083,2597,3225917.2,2722227.42,5948144.62
313140,202007,141,75,66,78375,68970,147345
313150,202007,309,243,66,254980,68970,323950
313160,202007,186,138,48,144210.5,50160,194370.5
313170,202007,1397,947,450,990660.5,470250,1460910.5
313180,202007,299,176,123,183920.5,128535,312455.5
313190,202007,748,444,304,463980.5,319770,783750.5
313200,202007,29,22,7,22990,7315,30305
313210,202007,1002,847,155,885117.55,161975,1047092.55
313220,202007,272,169,103,176605,107635.5,284240.5
313230,202007,261,198,63,206910.87,65835,272745.87
313240,202007,2137,1098,1039,1148458,1088890,2237348
313250,202007,1261,959,302,1004245.5,315590.8,1319836.3
313260,202007,90,47,43,49115,44935,94050
313270,202007,971,559,412,584155.75,430541.5,1014697.25
313280,202007,52,44,8,45980,8360,54340
313290,202007,220,176,44,183920,45980,229900
313300,202007,347,180,167,188100,176605,364705
313310,202007,261,123,138,128535,144210,272745
313320,202007,380,282,98,294690,103455,398145
313330,202007,1398,854,544,895565,568480,1464045
313340,202007,324,231,93,242440,97185,339625
313350,202007,503,332,171,347985,178695,526680
313360,202007,135,70,65,73150,67925,141075
313370,202007,214,69,145,72105,151525,223630
313375,202007,290,175,115,182875,120175,303050
313380,202007,1348,701,647,735680.5,677160,1412840.5
313390,202007,53,47,6,49115,6270,55385
313400,202007,401,273,128,285285,133761,419046
313410,202007,25,15,10,15675,10450,26125
313420,202007,4598,2449,2149,2566521,2248840.5,4815361.5
313430,202007,144,69,75,72105,78375,150480
313440,202007,1425,972,453,1018876.81,473387,1492263.81
313450,202007,68,27,41,28215,42845,71060
313460,202007,388,172,216,179740.5,225720,405460.5
313470,202007,527,247,280,258115.5,293646,551761.5
313480,202007,148,109,39,113905.5,40755,154660.5
313490,202007,519,236,283,247665.5,296780.25,544445.75
313500,202007,25,14,11,14630,11495,26125
313505,202007,1019,803,216,840180,227810,1067990
313507,202007,102,60,42,62700,43890,106590
313510,202007,2817,1776,1041,1858011.54,1088890,2946901.54
313520,202007,3462,2693,769,2819412.41,806740,3626152.41
313530,202007,34,22,12,22990,12540,35530
313535,202007,65,50,15,52250,15675,67925
313540,202007,70,52,18,54340,18810.5,73150.5
313545,202007,112,95,17,99275,17765,117040
313550,202007,231,195,36,203775,37620.5,241395.5
313560,202007,342,167,175,174515,182875,357390
313570,202007,65,26,39,27170,40755,67925
313580,202007,1311,737,574,770165.5,599831.5,1369997.0
313590,202007,68,38,30,39710,31350,71060
313600,202007,677,408,269,426360,282150.5,708510.5
313610,202007,61,47,14,49115,14630,63745
313620,202007,1386,696,690,730456,721050.5,1451506.5
313630,202007,1621,1228,393,1284306,411730,1696036
313640,202007,119,73,46,76285,48070,124355
313650,202007,234,109,125,113905,130625,244530
313652,202007,18,18,0,18810,0,18810
313655,202007,66,44,22,45980,22990,68970
313657,202007,49,45,4,47025,4180,51205
313660,202007,134,93,41,97185,42863.81,140048.81
313665,202007,646,299,347,313500.75,364705,678205.75
313670,202007,10318,7046,3272,7369343.82,3425511.06,10794854.88
313680,202007,41,31,10,33440,10450.95,43890.95
313690,202007,144,109,35,113905,37620,151525
313695,202007,77,58,19,60610,19855,80465
313700,202007,311,252,59,263340.5,61655,324995.5
313710,202007,143,99,44,103455,45980,149435
313720,202007,1116,519,597,544445.5,624911.5,1169357.0
313730,202007,74,44,30,45980,31350,77330
313740,202007,150,121,29,126445,30305,156750
313750,202007,430,311,119,326040,125400,451440
313753,202007,233,172,61,179740,63745,243485
313760,202007,1293,470,823,492195,862126.25,1354321.25
313770,202007,374,274,100,286330.25,104500,390830.25
313780,202007,775,406,369,424270,387695,811965
313790,202007,28,27,1,28215,1045,29260
313800,202007,139,84,55,87780,57475,145255
313810,202007,80,44,36,45980,37620,83600
313820,202007,1311,625,686,653126,718961.5,1372087.5
313830,202007,58,41,17,42845,17765,60610
313835,202007,62,51,11,53295,11495,64790
313840,202007,1659,993,666,1039776.5,698060.5,1737837.0
313850,202007,206,75,131,78375,136895,215270
313860,202007,476,360,116,376200.5,121220,497420.5
313862,202007,163,109,54,113905,56430,170335
313865,202007,119,89,30,93005,31350,124355
313867,202007,47,37,10,38665,10450,49115
313868,202007,33,20,13,20900,13585,34485
313870,202007,118,62,56,64790,58520,123310
313880,202007,378,231,147,241395,153615,395010
313890,202007,336,174,162,181830,170335,352165
313900,202007,882,478,404,499510,424270.25,923780.25
313910,202007,148,106,42,110770,43890,154660
313920,202007,646,451,195,473385,203775.94,677160.94
313925,202007,33,29,4,30305,4180,34485
313930,202007,861,668,193,699105,202730,901835
313940,202007,1864,1164,700,1218470,733590,1952060
313950,202007,877,551,326,575795,341715,917510
313960,202007,1410,810,600,846450.9,629092,1475542.9
313970,202007,159,103,56,107635,58520,166155
313980,202007,206,131,75,136895.25,78375,215270.25
313990,202007,239,159,80,166155,83600,249755
314000,202007,900,599,301,627000.85,317680,944680.85
314010,202007,86,51,35,53295,36575,89870
314015,202007,65,17,48,17765,50160,67925
314020,202007,54,34,20,35530,20900,56430
314030,202007,75,35,40,37620,41800,79420
314040,202007,44,25,19,26125,19855,45980
314050,202007,284,170,114,177650,119130,296780
314053,202007,98,64,34,66880,35530,102410
314055,202007,299,184,115,192280,120175,312455
314060,202007,134,116,18,121220.04,18810,140030.04
314070,202007,1057,544,513,568480,537130,1105610
314080,202007,209,134,75,140030.75,78375.4,218406.15
314085,202007,144,97,47,101365,49115,150480
314090,202007,383,271,112,284240.25,117040,401280.25
314100,202007,487,391,96,408595.75,100320,508915.75
314110,202007,755,390,365,407550.5,383515,791065.5
314120,202007,91,55,36,57475,37620,95095
314130,202007,19,10,9,10450,9405,19855
314140,202007,1109,678,431,708510,450395,1158905
314150,202007,181,116,65,121220,67925,189145
314160,202007,333,253,80,264385,83600,347985
314170,202007,84,64,20,66880,20900,87780
314180,202007,734,648,86,677160.5,89870.25,767030.75
314190,202007,100,60,40,62700,42845,105545
314200,202007,486,332,154,346940,160930.5,507870.5
314210,202007,244,188,56,196460,58520.5,254980.5
314220,202007,308,226,82,236170.5,85690,321860.5
314225,202007,61,45,16,47025,16720,63745
314230,202007,117,53,64,55385,66880,122265
314240,202007,146,109,37,113905,38665,152570
314250,202007,52,29,23,30305,24035,54340
314260,202007,211,104,107,108680,111815,220495
314270,202007,365,282,83,294690,86735,381425
314280,202007,703,380,323,399190,337535,736725
314290,202007,543,436,107,455620,111815,567435
314300,202007,362,260,102,271700.25,106590.25,378290.50
314310,202007,1373,932,441,974202.57,460845,1435047.57
314315,202007,33,26,7,27170,7315,34485
314320,202007,591,390,201,407550.5,210045,617595.5
314330,202007,11134,5419,5715,5669126.75,5980536,11649662.75
314340,202007,604,275,329,287375,343806,631181
314345,202007,46,30,16,31350,16720,48070
314350,202007,182,114,68,119130,71060,190190
314360,202007,60,37,23,38665,24035,62700
314370,202007,64,44,20,45980,20900,66880
314380,202007,95,61,34,63745,35530,99275
314390,202007,3334,2133,1201,2233166.85,1259225,3492391.85
314400,202007,692,494,198,517276.3,206910,724186.3
314410,202007,481,316,165,330220,172425,502645
314420,202007,14,7,7,7315,7315,14630
314430,202007,2427,884,1543,924825.36,1615570.5,2540395.86
314435,202007,197,119,78,124355,81510,205865
314437,202007,27,21,6,21945,6270,28215
314440,202007,97,69,28,72105,29260,101365
314450,202007,157,108,49,112860,51205,164065
314460,202007,646,305,341,318725,356345,675070
314465,202007,97,60,37,62700,38665,101365
314467,202007,69,57,12,59565,12540,72105
314470,202007,414,207,207,216315.95,216315,432630.95
314480,202007,1064,502,562,524590,588335,1112925
314490,202007,47,32,15,33440,15675,49115
314500,202007,281,194,87,202730,91960,294690
314505,202007,118,78,40,81510,41800,123310
314510,202007,239,195,44,203775,45980,249755
314520,202007,1304,685,619,716876.04,647901.5,1364777.54
314530,202007,742,596,146,622821.01,152570,775391.01
314535,202007,184,110,74,114950,77330,192280
314537,202007,61,37,24,38665,25080,63745
314540,202007,16,10,6,10450,6270,16720
314545,202007,53,34,19,35530,19855,55385
314550,202007,80,41,39,42845,40755,83600
314560,202007,864,469,395,490105.5,412775,902880.5
314570,202007,21,16,5,16720,5225,21945
314580,202007,13,5,8,5225,8360,13585
314585,202007,24,17,7,17765,7315,25080
314587,202007,84,71,13,74195,13585,87780
314590,202007,563,402,161,421135.25,169290,590425.25
314600,202007,939,598,341,624911,356345.29,981256.29
314610,202007,956,493,463,515185.5,486970,1002155.5
314620,202007,137,102,35,106590,37620,144210
314625,202007,96,69,27,72105,28215,100320
314630,202007,1183,627,556,655215,583110,1238325
314640,202007,80,51,29,53295,30305.5,83600.5
314650,202007,181,102,79,106590,82555,189145
314655,202007,60,45,15,47025,15675,62700
314660,202007,16,13,3,13585,3135,16720
314670,202007,200,152,48,158840.5,50160,209000.5
314675,202007,210,122,88,127490,93005,220495
314690,202007,587,311,276,324995,288420,613415
314700,202007,2282,1224,1058,1281172,1106655,2387827
314710,202007,1689,973,716,1018876.75,749266,1768142.75
314720,202007,393,233,160,243485,167200,410685
314730,202007,518,265,253,277971,265430,543401
314740,202007,723,347,376,362615,392920,755535
314750,202007,22,19,3,19855,3135,22990
314760,202007,335,154,181,161975,190190,352165
314770,202007,106,73,33,76285,34485,110770
314780,202007,20,8,12,8360,12540,20900
314790,202007,2399,1504,895,1574815.5,936320,2511135.5
314795,202007,53,42,11,43890,11495,55385
314800,202007,2936,1707,1229,1786952.22,1288485,3075437.22
314810,202007,1524,858,666,897655,697015,1594670
314820,202007,107,58,49,60610,51205,111815
314830,202007,213,172,41,179740,42845,222585
314840,202007,85,52,33,54340,34485,88825
314850,202007,389,193,196,201685.5,206910,408595.5
314860,202007,671,512,159,536085,166155,702240
314870,202007,1525,795,730,831820.5,763895,1595715.5
314875,202007,58,50,8,52250,8360,60610
314880,202007,45,31,14,32395,14630,47025
314890,202007,55,33,22,34485,22990,57475
314900,202007,31,24,7,25080,7315,32395
314910,202007,242,158,84,165110,87780,252890
314915,202007,142,128,14,133760,14630,148390
314920,202007,104,65,39,67925,40755,108680
314930,202007,1059,516,543,539220.5,567436,1106656.5
314940,202007,47,37,10,38665,10450,49115
314950,202007,29,20,9,20900,9405,30305
314960,202007,37,29,8,30305,8360,38665
314970,202007,147,72,75,76285,78375,154660
314980,202007,309,196,113,204820,118085,322905
314990,202007,444,239,205,249755,215270,465025
314995,202007,209,68,141,71060,147345,218405
315000,202007,94,72,22,75240,22990,98230
315010,202007,42,27,15,28215,16720,44935
315015,202007,170,135,35,141075,36575,177650
315020,202007,69,56,13,58520,13585,72105
315030,202007,113,87,26,90915.5,27170,118085.5
315040,202007,71,49,22,51205,22990,74195
315050,202007,186,108,78,112860,81510,194370
315053,202007,45,37,8,38665,8360,47025
315057,202007,107,81,26,84645,27170,111815
315060,202007,75,64,11,66880.8,11495,78375.8
315070,202007,104,58,46,60610,48070,108680
315080,202007,378,304,74,317680,77330,395010
315090,202007,94,56,38,58520,39710,98230
315100,202007,83,40,43,41800,44935,86735
315110,202007,275,146,129,152570,134805,287375
315120,202007,1718,833,885,870485,925870.2,1796355.2
315130,202007,346,251,95,262295,100320,362615
315140,202007,526,302,224,315590.5,235125.5,550716.0
315150,202007,976,463,513,483835,539220,1023055
315160,202007,217,108,109,112860,113905,226765
315170,202007,318,210,108,220495.5,112860,333355.5
315180,202007,3265,1350,1915,1413886.5,2009536.25,3423422.75
315190,202007,322,190,132,198550,138985,337535
315200,202007,1240,734,506,768075,531905,1299980
315210,202007,1671,948,723,991705.75,758670,1750375.75
315213,202007,40,22,18,22990,18810,41800
315217,202007,215,167,48,174515,50160,224675
315220,202007,1581,1184,397,1241460.95,414865,1656325.95
315230,202007,173,123,50,128535.5,52250,180785.5
315240,202007,424,270,154,282150,160931,443081
315250,202007,2583,1253,1330,1313565,1389850.5,2703415.5
315260,202007,147,83,64,86735,66880,153615
315270,202007,130,90,40,94050,41800,135850
315280,202007,653,419,234,439945,244530,684475
315290,202007,188,118,70,123310,73150,196460
315300,202007,79,58,21,60610,21945,82555
315310,202007,75,67,8,70015,8360,78375
315320,202007,168,100,68,104500,71060,175560
315330,202007,57,47,10,49115,10450,59565
315340,202007,394,282,112,294690,117040,411730
315350,202007,154,91,63,95095,65835,160930
315360,202007,94,45,49,47025,51205,98230
315370,202007,55,35,20,36575,20900,57475
315380,202007,8,8,0,8360,0,8360
315390,202007,69,18,51,18810,53295.5,72105.5
315400,202007,840,624,216,652080.5,227810,879890.5
315410,202007,322,190,132,198550.5,137941.5,336492.0
315415,202007,56,42,14,43890,14630,58520
315420,202007,199,143,56,149435.5,59565,209000.5
315430,202007,653,371,282,388740.5,294690,683430.5
315440,202007,92,63,29,65835,32395,98230
315445,202007,232,192,40,200640,42845,243485
315450,202007,184,138,46,144210,48070,192280
315460,202007,4044,1954,2090,2045065,2189275,4234340
315470,202007,43,17,26,17765,27170,44935
315480,202007,69,20,49,20900,51205,72105
315490,202007,674,411,263,429495,274835,704330
315500,202007,18,12,6,12540,6270,18810
315510,202007,148,100,48,104500,50160,154660
315520,202007,72,63,9,65835,9405,75240
315530,202007,48,25,23,26125,24035,50160
315540,202007,248,168,80,175560,84645,260205
315550,202007,178,144,34,150480,35530,186010
315560,202007,742,594,148,622820.5,154660,777480.5
315570,202007,311,157,154,164067.19,161975,326042.19
315580,202007,711,476,235,498465,245575.5,744040.5
315590,202007,196,105,91,109725,95095,204820
315600,202007,303,228,75,238260,78375,316635
315610,202007,102,52,50,54340,52250,106590
315620,202007,36,28,8,29260,8360,37620
315630,202007,129,85,44,88825,45980,134805
315640,202007,75,45,30,47025,31350,78375
315645,202007,46,32,14,33440,14630.5,48070.5
315650,202007,175,124,51,129580.5,53295,182875.5
315660,202007,457,199,258,209000.5,270655,479655.5
315670,202007,2387,1140,1247,1193392,1306250,2499642
315680,202007,843,593,250,619685,261250,880935
315690,202007,676,465,211,485926.97,220495,706421.97
315700,202007,1893,993,900,1039776.21,942590,1982366.21
315710,202007,347,102,245,106590,256025,362615
315720,202007,453,280,173,292600.5,181830,474430.5
315725,202007,190,153,37,159885.5,38665,198550.5
315727,202007,53,22,31,22990,32395,55385
315730,202007,46,43,3,44935,3135,48070
315733,202007,88,58,30,60610,31350,91960
315737,202007,50,37,13,38665,13585,52250
315740,202007,34,26,8,27170,8360,35530
315750,202007,160,120,40,125400,41800.5,167200.5
315760,202007,40,30,10,31350,10450,41800
315765,202007,121,71,50,74195,52250,126445
315770,202007,224,140,84,146300,87780.5,234080.5
315780,202007,3510,1748,1762,1830840.75,1844425.06,3675265.81
315790,202007,231,179,52,187055,54340,241395
315800,202007,294,205,89,214225,93005,307230
315810,202007,96,57,39,59565,40755.5,100320.5
315820,202007,748,542,206,567435.5,215270,782705.5
315830,202007,131,80,51,83600,53295,136895
315840,202007,85,56,29,58520,30305,88825
315850,202007,259,182,77,190190.75,80465,270655.75
315860,202007,15,6,9,6270,9405,15675
315870,202007,38,29,9,30305,9405,39710
315880,202007,107,67,40,70015,41800,111815
315890,202007,90,68,22,71060,22990,94050
315895,202007,437,289,148,302005,154661,456666
315900,202007,72,34,38,35530,39710,75240
315910,202007,41,25,16,26125,16720,42845
315920,202007,160,106,54,110770,56430.75,167200.75
315930,202007,49,18,31,18810,32395,51205
315935,202007,133,102,31,106590.5,32395,138985.5
315940,202007,101,74,27,77330,28215,105545
315950,202007,43,33,10,34485,10450,44935
315960,202007,535,254,281,265430,293645.5,559075.5
315970,202007,34,27,7,28215,7315,35530
315980,202007,687,338,349,353210,364705,717915
315990,202007,253,149,104,155705,108680.5,264385.5
316000,202007,51,33,18,34485,18810,53295
316010,202007,79,68,11,71060,11495,82555
316020,202007,117,100,17,104500,17765,122265
316030,202007,386,214,172,223630.5,180785.75,404416.25
316040,202007,525,219,306,228855.5,319770.5,548626.0
316045,202007,62,55,7,57475,7315,64790
316050,202007,15,11,4,11495,4180,15675
316060,202007,95,63,32,65835,33440,99275
316070,202007,1085,694,391,727320.75,409640,1136960.75
316080,202007,100,67,33,71060,34485,105545
316090,202007,44,21,23,21945,24035,45980
316095,202007,101,83,18,86735,18810,105545
316100,202007,314,181,133,189145.25,138985,328130.25
316105,202007,41,28,13,29260,13585,42845
316110,202007,1873,1479,394,1549735.62,411730,1961465.62
316120,202007,81,58,23,61655,24035,85690
316130,202007,124,92,32,96140.5,33440,129580.5
316140,202007,31,20,11,20900,11495,32395
316150,202007,204,143,61,149435,63745,213180
316160,202007,84,47,37,49115,38665,87780
316165,202007,65,48,17,51205,17765,68970
316170,202007,182,121,61,126445,63745,190190
316180,202007,201,84,117,87780,122265.5,210045.5
316190,202007,136,97,39,101365,40755,142120
316200,202007,660,362,298,378290,313500,691790
316210,202007,773,512,261,536264.74,272745,809009.74
316220,202007,119,77,42,80465,43890,124355
316225,202007,27,15,12,15675,12540,28215
316230,202007,33,19,14,19855,14630,34485
316240,202007,644,517,127,542355,134805,677160
316245,202007,129,111,18,115995,18810,134805
316250,202007,1525,1034,491,1080531.5,513095,1593626.5
316255,202007,130,102,28,106590,29260,135850
316257,202007,181,94,87,98230,90915,189145
316260,202007,194,137,57,143165.25,60610,203775.25
316265,202007,27,18,9,18810,9405,28215
316270,202007,681,480,201,503690.5,210045.6,713736.1
316280,202007,549,342,207,357390.29,216315.5,573705.79
316290,202007,745,492,253,515185.65,264385,779570.65
316292,202007,508,199,309,207955,323950,531905
316294,202007,99,60,39,62700,40755,103455
316295,202007,309,133,176,138985.5,184965,323950.5
316300,202007,104,70,34,73150,35530,108680
316310,202007,30,16,14,16720,14630,31350
316320,202007,51,27,24,28215,25080,53295
316330,202007,162,109,53,113905.25,55385,169290.25
316340,202007,135,92,43,96140,44935,141075
316350,202007,194,137,57,143165.74,59565,202730.74
316360,202007,18,13,5,13585,6270,19855
316370,202007,1106,568,538,593561.25,562210,1155771.25
316380,202007,117,88,29,91960,30305,122265
316390,202007,115,83,32,86735,33440,120175
316400,202007,131,101,30,105545,31350,136895
316410,202007,292,211,81,220495,84645,305140
316420,202007,201,136,65,142120,67925,210045
316430,202007,153,80,73,83600,77330,160930
316440,202007,88,42,46,43890,48070,91960
316443,202007,41,39,2,40755,2090,42845
316447,202007,59,43,16,45980,16720,62700
316450,202007,224,171,53,178695,55385,234080
316460,202007,80,26,54,27170,56430,83600
316470,202007,1689,1230,459,1285343.01,479655.5,1764998.51
316480,202007,12,8,4,8360,4180,12540
316490,202007,19,6,13,6270,13585,19855
316500,202007,149,101,48,105545,50160,155705
316510,202007,152,116,36,121220,37620,158840
316520,202007,194,118,76,123310,79420,202730
316530,202007,162,106,56,110770,58520,169290
316540,202007,139,74,65,77330,67925,145255
316550,202007,128,87,41,90915,42845,133760
316553,202007,296,131,165,137940,172425.72,310365.72
316555,202007,42,36,6,37620,6270,43890
316556,202007,12,9,3,9405,3135,12540
316557,202007,22,18,4,18810,4180,22990
316560,202007,67,47,20,49115,20900,70015
316570,202007,217,197,20,205865,20900,226765
316580,202007,18,13,5,13585,5225,18810
316590,202007,102,87,15,90915,15675,106590
316600,202007,179,146,33,152570.5,34485,187055.5
316610,202007,66,50,16,52250,16720,68970
316620,202007,138,102,36,107635,37620,145255
316630,202007,43,34,9,36575,9405,45980
316640,202007,22,14,8,14630,8360,22990
316650,202007,73,60,13,62700,13585,76285
316660,202007,8,3,5,3135,5225,8360
316670,202007,439,153,286,159885,298870,458755
316680,202007,160,111,49,115995,51205,167200
316690,202007,187,116,71,121220,74195,195415
316695,202007,63,53,10,55385,10450,65835
316700,202007,18,12,6,12540,6270,18810
316710,202007,782,586,196,612370.25,205865,818235.25
316720,202007,5036,2452,2584,2565477.74,2702371,5267848.74
316730,202007,17,16,1,16720,1045,17765
316740,202007,140,90,50,94050,52250,146300
316750,202007,18,10,8,10450,8360,18810
316760,202007,327,259,68,270655,71060,341715
316770,202007,156,83,73,86735,76285,163020
316780,202007,70,43,27,44935,28215,73150
316790,202007,52,39,13,40755,13585,54340
316800,202007,1753,1091,662,1142185,692835.5,1835020.5
316805,202007,24,16,8,16720,8360,25080
316810,202007,66,42,24,43890,25080,68970
316820,202007,42,21,21,21945,21945,43890
316830,202007,97,43,54,44935,56430,101365
316840,202007,531,306,225,319770,235125,554895
316850,202007,331,221,110,230945,115995,346940
316860,202007,5914,2610,3304,2729543.4,3461040.75,6190584.15
316870,202007,1547,989,558,1033507.25,586245.5,1619752.75
316880,202007,128,61,67,63745,70015,133760
316890,202007,240,165,75,172425,78375,250800
316900,202007,418,294,124,307230.65,129580,436810.65
316905,202007,23,11,12,11495,12540,24035
316910,202007,69,28,41,29260,42845,72105
316920,202007,135,108,27,112860,28215,141075
316930,202007,1904,971,933,1015741.5,976030.75,1991772.25
316935,202007,914,553,361,578930.1,377245.5,956175.6
316940,202007,1093,621,472,648945.5,496375.5,1145321.0
316950,202007,178,87,91,90915,95095,186010
316960,202007,1110,622,488,652081,511005,1163086
316970,202007,656,518,138,543400.5,144210,687610.5
316980,202007,79,44,35,45980,36575,82555
316990,202007,2167,1445,722,1512115.85,754490.74,2266606.59
317000,202007,333,255,78,267520,82555,350075
317005,202007,238,166,72,173470,75240,248710
317010,202007,6395,3536,2859,3703485.3,2992880.5,6696365.8
317020,202007,16092,7038,9054,7369513.26,9477110,16846623.26
317030,202007,78,30,48,31350,50160,81510
317040,202007,3055,1898,1157,1989681,1213245,3202926
317043,202007,74,55,19,57475,19855,77330
317047,202007,31,16,15,16720,15675,32395
317050,202007,164,128,36,133760,37620,171380
317052,202007,135,102,33,106590,34485,141075
317057,202007,170,131,39,136895,40755,177650
317060,202007,63,39,24,40755,25080,65835
317065,202007,55,44,11,45980,11495,57475
317070,202007,1960,899,1061,939455.25,1110835.5,2050290.75
317075,202007,105,57,48,59565,50160,109725
317080,202007,920,468,452,489060.75,472340,961400.75
317090,202007,659,521,138,544445,144210,688655
317100,202007,428,321,107,336490,111815,448305
317103,202007,103,83,20,86735,20900,107635
317107,202007,45,39,6,40755,6270,47025
317110,202007,117,51,66,53295,68970,122265
317115,202007,41,36,5,37620,5225,42845
317120,202007,1931,933,998,976031.5,1046045.5,2022077.0
317130,202007,1970,1311,659,1369996.18,688655,2058651.18
317140,202007,9,7,2,7315,2090,9405
317150,202007,259,152,107,158840.5,111815,270655.5
317160,202007,317,238,79,248710.79,82555,331265.79
317170,202007,220,149,71,155705,74195,229900
317180,202007,448,305,143,318725,149435,468160
317190,202007,264,185,79,193325,83600,276925
317200,202007,826,579,247,606102.9,258115,864217.9
317210,202007,185,100,85,104500,88825,193325
317220,202007,23,12,11,13585,11495,25080
320010,202007,603,438,165,457710.25,173470,631180.25
320013,202007,125,90,35,94050,36575,130625
320016,202007,274,173,101,181830,106590,288420
320020,202007,715,418,297,437857.37,312455,750312.37
320030,202007,151,106,45,110770.04,48070.08,158840.12
320035,202007,140,102,38,106590,39710,146300
320040,202007,487,249,238,260205,248710,508915
320050,202007,108,76,32,79420,33440,112860
320060,202007,1671,790,881,825550.25,923781.75,1749332.00
320070,202007,103,64,39,66880,40755,107635
320080,202007,796,459,337,479655.75,353210,832865.75
320090,202007,1249,837,412,875710,430540,1306250
320100,202007,331,188,143,196460,150480,346940
320110,202007,126,81,45,84646.25,47025,131671.25
320115,202007,111,91,20,95095,20900,115995
320120,202007,3453,1843,1610,1929072.65,1682450.5,3611523.15
320130,202007,7490,3390,4100,3546732.52,4300176.5,7846909.02
320140,202007,437,289,148,302005,154661.16,456666.16
320150,202007,2061,1158,903,1212200.75,944680.5,2156881.25
320160,202007,656,299,357,313500,373065.5,686565.5
320170,202007,110,89,21,93005.02,21945,114950.02
320180,202007,54,31,23,32395,24035,56430
320190,202007,239,153,86,159885,90915,250800
320200,202007,60,44,16,45980,16720,62700
320210,202007,904,494,410,516231,429495.5,945726.5
320220,202007,297,104,193,108680,202730,311410
320225,202007,85,67,18,70015,18810,88825
320230,202007,613,384,229,403370,240350,643720
320240,202007,3278,1579,1699,1652147.5,1779635.5,3431783.0
320245,202007,472,319,153,333355.5,159885,493240.5
320250,202007,226,114,112,119130,117040,236170
320255,202007,145,113,32,118085,33440,151525
320260,202007,215,142,73,148390.18,76285.12,224675.30
320265,202007,165,129,36,134805,37620,172425
320270,202007,154,122,32,127490,34485,161975
320280,202007,1039,589,450,616551.07,470250.02,1086801.09
320290,202007,59,50,9,52250,9405,61655
320300,202007,571,394,177,412776.35,186011.6,598787.95
320305,202007,677,364,313,381425,328130.5,709555.5
320310,202007,198,113,85,118085.9,88825,206910.9
320313,202007,335,164,171,171380.25,178695.5,350075.75
320316,202007,112,86,26,89870,27170,117040
320320,202007,3430,1544,1886,1617661.15,1977140,3594801.15
320330,202007,255,192,63,200640,65835,266475
320332,202007,832,510,322,532951.5,336490.25,869441.75
320334,202007,242,146,96,152570.52,102410,254980.52
320335,202007,147,100,47,104500,49115,153615
320340,202007,555,386,169,403370.75,176605.5,579976.25
320350,202007,976,419,557,437855.97,584155.5,1022011.47
320360,202007,168,93,75,97185,78375,175560
320370,202007,240,180,60,188100.9,62700.5,250801.4
320380,202007,282,197,85,205865.5,88825,294690.5
320390,202007,1156,690,466,722095,486970.5,1209065.5
320400,202007,311,228,83,238260,86735,324995
320405,202007,957,399,558,416955.25,583110.5,1000065.75
320410,202007,996,506,490,529815,512050.25,1041865.25
320420,202007,508,242,266,253935.75,277970,531905.75
320425,202007,187,100,87,104500,90915,195415
320430,202007,386,209,177,218405.25,184965,403370.25
320435,202007,155,104,51,108680,53295,161975
320440,202007,195,113,82,118085.26,85690.22,203775.48
320450,202007,125,67,58,70015,61655,131670
320455,202007,252,204,48,213180.5,50160,263340.5
320460,202007,271,165,106,172425,110770,283195
320465,202007,116,78,38,81510,39710,121220
320470,202007,696,421,275,440990.5,287375,728365.5
320480,202007,198,128,70,133760,73150.25,206910.25
320490,202007,3085,1521,1564,1593626.26,1639607.74,3233234.00
320495,202007,110,69,41,72105,42845.5,114950.5
320500,202007,9684,4745,4939,4962175.3,5166485.95,10128661.25
320501,202007,553,285,268,297825,282150,579975
320503,202007,291,203,88,212135.1,91960.02,304095.12
320506,202007,263,185,78,193325,81510,274835
320510,202007,1031,457,574,478610,599830,1078440
320515,202007,85,67,18,70015,18810,88825
320517,202007,210,150,60,156750,62700,219450
320520,202007,6951,2979,3972,3124551.3,4158058,7282609.3
320530,202007,6120,3029,3091,3169469.22,3235320,6404789.22
330010,202007,3127,1582,1545,1653192.5,1619750,3272942.5
330015,202007,163,67,96,71060.9,100320,171380.9
330020,202007,3694,1563,2131,1633336.1,2231075,3864411.1
330022,202007,251,126,125,131670,130625,262295
330023,202007,606,192,414,200640,432630,633270
330025,202007,570,109,461,113905,481745,595650
330030,202007,1915,1211,704,1266540.77,737770.5,2004311.27
330040,202007,2441,1245,1196,1302070,1251910.5,2553980.5
330045,202007,8881,2695,6186,2819411,6480045,9299456
330050,202007,891,569,322,594605,336490,931095
330060,202007,1004,599,405,625955.5,424270,1050225.5
330070,202007,3692,1320,2372,1379400.4,2485010.5,3864410.9
330080,202007,1589,702,887,734635.75,929005,1663640.75
330090,202007,378,222,156,233035,164065,397100
330093,202007,263,116,147,121220,153615,274835
330095,202007,80,46,34,48070,35530,83600
330100,202007,9877,4942,4935,5168572.67,5166481.75,10335054.42
330110,202007,479,205,274,215270.75,286330,501600.75
330115,202007,531,279,252,291555,264385,555940
330120,202007,377,192,185,202730,193326,396056
330130,202007,1536,380,1156,397100,1210110,1607210
330140,202007,612,326,286,340670,298870,639540
330150,202007,512,294,218,307230,227810,535040
330160,202007,210,125,85,130625,89870,220495
330170,202007,27148,9126,18022,9551303.1,18904054.91,28455358.01
330180,202007,243,143,100,149435,104500,253935
330185,202007,960,337,623,352165,651035,1003200
330187,202007,372,113,259,118085,271700,389785
330190,202007,5759,2203,3556,2305271.9,3725425.5,6030697.4
330200,202007,4709,1393,3316,1460911.81,3471490.5,4932402.31
330205,202007,443,256,187,268565,195415.5,463980.5
330210,202007,980,598,382,624910,400236,1025146
330220,202007,2661,1579,1082,1651100.2,1130690.5,2781790.7
330225,202007,574,292,282,305140,296780,601920
330227,202007,2431,732,1699,765985,1776500.25,2542485.25
330230,202007,254,144,110,151525,114950,266475
330240,202007,3858,1902,1956,1987590.75,2048202,4035792.75
330245,202007,148,66,82,68970.1,85690,154660.1
330250,202007,6678,3368,3310,3527921.25,3467312.02,6995233.27
330260,202007,596,157,439,165110,458755,623865
330270,202007,3588,1209,2379,1265495,2489191,3754686
330280,202007,450,287,163,299915.5,170335.45,470250.95
330285,202007,7051,2197,4854,2300045.75,5082882.25,7382928.00
330290,202007,648,235,413,245575.77,434720,680295.77
330300,202007,765,496,269,518442.22,282150,800592.22
330310,202007,444,246,198,258115.75,207955,466070.75
330320,202007,7887,2916,4971,3056626.49,5207237.57,8263864.06
330330,202007,9003,3406,5597,3563452.27,5868721,9432173.27
330340,202007,2685,1575,1110,1647965,1162040.88,2810005.88
330350,202007,18519,7042,11477,7378751.15,12023776.67,19402527.82
330360,202007,2251,1082,1169,1134871,1223695,2358566
330370,202007,1028,513,515,537132,538175,1075307
330380,202007,888,373,515,389785,540265.01,930050.01
330385,202007,636,323,313,337535.25,329175,666710.25
330390,202007,5606,2955,2651,3092156,2773430.5,5865586.5
330395,202007,315,191,124,199595,129580.75,329175.75
330400,202007,713,374,339,390830,355300,746130
330410,202007,510,367,143,383515.25,149435.5,532950.75
330411,202007,259,138,121,144210.55,126445,270655.55
330412,202007,243,97,146,101365.5,152570,253935.5
330414,202007,5412,2170,3242,2272877.7,3398340.5,5671218.2
330415,202007,605,263,342,274836.5,359480,634316.5
330420,202007,2234,1139,1095,1190256.55,1146365.5,2336622.05
330430,202007,1786,805,981,841226,1027237.5,1868463.5
330440,202007,288,138,150,145255,156750,302005
330450,202007,124,54,70,56430,73150,129580
330452,202007,2046,887,1159,927960,1212200.5,2140160.5
330455,202007,112562,39169,73393,41011197.82,76967408.06,117978605.88
330460,202007,263,111,152,115995,158840,274835
330470,202007,1227,669,558,701197,585201.75,1286398.75
330475,202007,1518,398,1120,415910,1170400,1586310
330480,202007,813,434,379,454575,397100,851675
330490,202007,14630,4678,9952,4895826.25,10424921.5,15320747.75
330500,202007,1418,608,810,635360,849585.14,1484945.14
330510,202007,10897,3735,7162,3908302.15,7502056.83,11410358.98
330513,202007,101,51,50,54340,53295,107635
330515,202007,817,335,482,351121.25,505780.5,856901.75
330520,202007,2488,874,1614,916465.35,1690810,2607275.35
330530,202007,203,116,87,121220.25,93005,214225.25
330540,202007,376,182,194,190190.5,204820.5,395011.0
330550,202007,2907,1005,1902,1051271.2,1991771,3043042.2
330555,202007,799,309,490,322905,515185,838090
330560,202007,700,224,476,235125,498465,733590
330570,202007,268,194,74,202730,78375,281105
330575,202007,783,285,498,297825,520411.66,818236.66
330580,202007,3406,1894,1512,1980277.62,1586311,3566588.62
330590,202007,285,146,139,153615.09,146300,299915.09
330600,202007,1191,744,447,777481,468160,1245641
330610,202007,1598,850,748,888252.75,783750,1672002.75
330615,202007,212,164,48,171380,50160,221540
330620,202007,1074,419,655,439945,685520,1125465
330630,202007,4116,2555,1561,2675200.94,1637516.11,4312717.05
350010,202007,595,392,203,410686.47,212135,622821.47
350020,202007,51,21,30,22990,31350,54340
350030,202007,511,317,194,331265.5,205865.5,537131.0
350040,202007,126,52,74,54340,77330,131670
350050,202007,308,160,148,167200,154660,321860
350055,202007,94,49,45,51205,47025,98230
350060,202007,88,31,57,32395,59565,91960
350070,202007,793,466,327,488015.49,343805.5,831820.99
350075,202007,73,49,24,51205,25080,76285
350080,202007,60,29,31,30305,32395,62700
350090,202007,81,49,32,51205,33440,84645
350100,202007,284,174,110,181830,114950,296780
350110,202007,60,42,18,43890,18810,62700
350115,202007,143,88,55,91960,58520,150480
350120,202007,110,69,41,72105,42845,114950
350130,202007,367,164,203,172425.03,212135,384560.03
350140,202007,44,27,17,28215,17765,45980
350150,202007,71,54,17,56430,17765,74195
350160,202007,2452,948,1504,995886,1577950,2573836
350170,202007,385,225,160,236171.85,167200.5,403372.35
350180,202007,167,97,70,101365,73150.5,174515.5
350190,202007,1003,522,481,545490.29,502645.5,1048135.79
350200,202007,68,24,44,25080,45980,71060
350210,202007,1304,727,577,760761,602965.29,1363726.29
350220,202007,672,552,120,579975.29,125400,705375.29
350230,202007,73,50,23,52250,24035,76285
350240,202007,58,41,17,42845,17765,60610
350250,202007,1141,541,600,567436,628046.25,1195482.25
350260,202007,93,66,27,68970,28215,97185
350270,202007,876,580,296,607146,310365.5,917511.5
350275,202007,301,127,174,132715,182875,315590
350280,202007,4604,2330,2274,2436944.9,2377375,4814319.9
350290,202007,450,204,246,213180.5,259160.5,472341.0
350300,202007,53,27,26,28215,27170,55385
350310,202007,87,55,32,57475,33440,90915
350315,202007,52,26,26,27170,27170,54340
350320,202007,3321,1612,1709,1685585.5,1786950,3472535.5
350330,202007,1676,892,784,934232.12,822415.5,1756647.62
350335,202007,16,11,5,11495,5225,16720
350340,202007,124,54,70,56430,73150.75,129580.75
350350,202007,87,43,44,44935,47025,91960
350360,202007,116,76,40,79420,41800,121220
350370,202007,84,49,35,52250.29,36575,88825.29
350380,202007,782,333,449,347985,469206,817191
350390,202007,1584,603,981,631180.37,1028280.5,1659460.87
350395,202007,24,19,5,19855,5225,25080
350400,202007,1697,859,838,897657.12,876755.29,1774412.41
350410,202007,2693,1159,1534,1211155,1609319.29,2820474.29
350420,202007,255,154,101,160930.79,105545,266475.79
350430,202007,74,43,31,44935,32395,77330
350440,202007,154,112,42,117040.5,43890.5,160931.0
350450,202007,1639,964,675,1008425.56,706420.5,1714846.06
350460,202007,397,129,268,134805,281105,415910
350470,202007,19,10,9,10450,9405,19855
350480,202007,175,97,78,102410,81510,183920
350490,202007,231,113,118,118085,123310,241395
350500,202007,50,20,30,20900,31350,52250
350510,202007,168,110,58,114950,60610,175560
350520,202007,457,230,227,240350,237215,477565
350530,202007,439,202,237,213180,248710,461890
350535,202007,81,65,16,67925,17765,85690
350540,202007,377,190,187,199595,195415,395010
350550,202007,2702,1592,1110,1666775,1162041.08,2828816.08
350560,202007,626,428,198,448305,207955,656260
350570,202007,4187,1713,2474,1790086.64,2596826.35,4386912.99
350580,202007,366,180,186,188100,194370,382470
350590,202007,910,499,411,521455,430540,951995
350600,202007,6108,2916,3192,3055582.75,3336685.5,6392268.25
350610,202007,1518,782,736,818235.29,770165,1588400.29
350620,202007,29,19,10,21945,10450,32395
350630,202007,246,139,107,145255.29,111815.29,257070.58
350635,202007,970,379,591,397101.35,619685.5,1016786.85
350640,202007,122,90,32,95095,33440,128535
350650,202007,1887,1255,632,1314610.45,661485.29,1976095.74
350660,202007,750,315,435,329175,455620,784795
350670,202007,307,151,156,158840,164065,322905
350680,202007,177,92,85,96140,88826,184966
350690,202007,194,97,97,101365,101365,202730
350700,202007,791,377,414,393966,432630,826596
350710,202007,379,141,238,147345,248710,396055
350715,202007,56,45,11,48070,11495,59565
350720,202007,19,13,6,13585,6270,19855
350730,202007,46,30,16,31350,16720,48070
350740,202007,220,125,95,130625,99275,229900
350745,202007,24,11,13,11495,13585,25080
350750,202007,2220,1371,849,1433740.75,891385,2325125.75
350760,202007,3753,1605,2148,1680360.59,2249885,3930245.59
350770,202007,60,43,17,44935,17765,62700
350775,202007,45,33,12,34485,12540,47025
350780,202007,431,221,210,231990,219450,451440
350790,202007,370,152,218,158840,228855,387695
350800,202007,476,276,200,288420,209000,497420
350810,202007,518,414,104,434720.75,108680,543400.75
350820,202007,89,52,37,54340,38665,93005
350830,202007,79,40,39,41800,40755,82555
350840,202007,768,305,463,318725.5,483835,802560.5
350850,202007,1743,962,781,1005290.5,818235.5,1823526.0
350860,202007,596,332,264,347985.75,276925,624910.75
350870,202007,428,283,145,296780,151525,448305
350880,202007,285,160,125,168245.25,131670,299915.25
350890,202007,38,25,13,26125,13585,39710
350900,202007,1470,461,1009,481745.75,1056495.29,1538241.04
350910,202007,27,17,10,17765,10450,28215
350920,202007,700,366,334,382470,349030,731500
350925,202007,1212,642,570,671936.45,596697.39,1268633.84
350930,202007,101,59,42,61655,43890,105545
350940,202007,714,396,318,413820,334400,748220
350945,202007,108,78,30,81510,31350,112860
350950,202007,16455,7651,8804,8004706.09,9228397.25,17233103.34
350960,202007,1405,626,779,655215,816145,1471360
350970,202007,1100,572,528,601809.19,552805.5,1154614.69
350980,202007,99,66,33,68970,34485,103455
350990,202007,376,134,242,140030,252890,392920
350995,202007,36,17,19,17765,19855,37620
351000,202007,635,430,205,450395.58,214225,664620.58
351010,202007,53,32,21,33440,21945,55385
351015,202007,49,34,15,35530,15675,51205
351020,202007,1581,945,636,988570.5,665665,1654235.5
351030,202007,339,220,119,230945,124355,355300
351040,202007,896,462,434,482790.95,454575.89,937366.84
351050,202007,3334,1503,1831,1571683.3,1917575,3489258.3
351060,202007,5318,2047,3271,2142251.7,3431780.5,5574032.2
351070,202007,404,255,149,267521.64,156750,424271.64
351080,202007,722,526,196,551760.5,205865,757625.5
351090,202007,55,24,31,25080,32395,57475
351100,202007,438,249,189,260205.7,197505,457710.7
351110,202007,2048,972,1076,1017831.31,1127556,2145387.31
351120,202007,68,35,33,36575,34485,71060
351130,202007,195,59,136,61655,142120,203775
351140,202007,316,210,106,220495,110770,331265
351150,202007,435,227,208,240350.75,217360.5,457711.25
351160,202007,273,181,92,189145.5,96140,285285.5
351170,202007,188,98,90,102410,95095,197505
351190,202007,90,63,27,65835,28215,94050
351200,202007,364,243,121,253935.5,126445,380380.5
351210,202007,115,57,58,60610,60610,121220
351220,202007,537,319,218,334401.91,228855,563256.91
351230,202007,272,187,85,195415,88825,284240
351240,202007,239,115,124,120175,130625,250800
351250,202007,81,58,23,60610.57,24035,84645.57
351260,202007,148,109,39,114950,40755,155705
351270,202007,45,19,26,19855,28215,48070
351280,202007,1000,451,549,471295,573705.79,1045000.79
351290,202007,251,107,144,111815,150480,262295
351300,202007,3770,1651,2119,1727305.06,2222715.29,3950020.35
351310,202007,755,373,382,391875,399190,791065
351320,202007,114,67,47,70015.29,49115,119130.29
351330,202007,40,25,15,26125,15675,41800
351340,202007,1255,734,521,768075.35,546535,1314610.35
351350,202007,2402,1384,1018,1449416.25,1064855,2514271.25
351360,202007,782,374,408,390830,427405,818235
351370,202007,391,197,194,206910.5,202730,409640.5
351380,202007,9022,4045,4977,4235392.1,5216641.79,9452033.89
351385,202007,27,17,10,17765,10450,28215
351390,202007,273,204,69,213180.35,72105,285285.35
351400,202007,69,45,24,47025,25080,72105
351410,202007,435,276,159,289465.77,166155,455620.77
351420,202007,70,52,18,54340,18810,73150
351430,202007,70,39,31,40755,32395,73150
351440,202007,788,550,238,575796.83,250800,826596.83
351450,202007,264,130,134,135850,142120,277970
351460,202007,126,56,70,58520,73150,131670
351470,202007,142,79,63,82555,65835,148390
351480,202007,494,284,210,296780.5,219450,516230.5
351490,202007,290,108,182,112860,191235,304095
351492,202007,27,20,7,20900,7315,28215
351495,202007,25,18,7,18810,7315,26125
351500,202007,3538,1474,2064,1541376.35,2164196.9,3705573.25
351510,202007,1941,740,1201,773301,1258180.5,2031481.5
351512,202007,17,13,4,13585,4180,17765
351515,202007,186,106,80,110770,83600,194370
351518,202007,740,464,276,485925,288420,774345
351519,202007,81,48,33,50160,34485,84645
351520,202007,149,90,59,94050,61655,155705
351530,202007,24,14,10,14630,10450,25080
351535,202007,131,77,54,80465,56430,136895
351540,202007,446,319,127,334400.46,132715,467115.46
351550,202007,1416,843,573,884072.08,599830,1483902.08
351560,202007,71,40,31,41800,32395,74195
351565,202007,9,7,2,7315,2090,9405
351570,202007,2707,1316,1391,1379400.5,1459865,2839265.5
351580,202007,39,34,5,35530,5225,40755
351590,202007,60,39,21,40755,21945,62700
351600,202007,184,132,52,137940,54340,192280
351610,202007,46,21,25,21945,26125,48070
351620,202007,5880,3278,2602,3432827.96,2723270.75,6156098.71
351630,202007,2830,1394,1436,1456731,1503755,2960486
351640,202007,2004,927,1077,970805.02,1127556.29,2098361.31
351650,202007,27,23,4,24035,4180,28215
351660,202007,142,92,50,96140,52250,148390
351670,202007,709,444,265,463981.5,279015,742996.5
351680,202007,73,62,11,64790,11495,76285
351685,202007,26,15,11,15675,12540,28215
351690,202007,298,204,94,213180.37,98230,311410.37
351700,202007,155,107,48,111815.5,51205,163020.5
351710,202007,69,46,23,48070,24035,72105
351720,202007,135,76,59,79420,61655,141075
351730,202007,110,70,40,73150,41800.29,114950.29
351740,202007,721,465,256,488015.6,268565,756580.6
351750,202007,354,146,208,152570,217360,369930
351760,202007,763,579,184,605055,193325,798380
351770,202007,306,256,50,267520.29,52250,319770.29
351780,202007,160,96,64,100320,66880,167200
351790,202007,255,136,119,143165,125400.75,268565.75
351800,202007,39,24,15,25080,15675,40755
351810,202007,121,82,39,86735,41800,128535
351820,202007,816,593,223,620730.5,233035,853765.5
351830,202007,547,194,353,202730,369930,572660
351840,202007,1914,925,989,968716,1035595.82,2004311.82
351850,202007,236,169,67,177650,70015,247665
351860,202007,660,458,202,479655.45,211090,690745.45
351870,202007,5570,2586,2984,2705508.54,3125596.04,5831104.58
351880,202007,19486,7922,11564,8289988.44,12112597.1,20402585.54
351885,202007,82,51,31,54340,32395,86735
351890,202007,73,59,14,61655,14630,76285
351900,202007,229,132,97,137940,101365,239305
351905,202007,81,32,49,34485,51205,85690
351907,202007,3452,1421,2031,1489126.35,2128665.5,3617791.85
351910,202007,179,74,105,77330,109725,187055
351920,202007,121,67,54,71060,56430,127490
351925,202007,92,59,33,61655,34485,96140
351930,202007,398,255,143,266475,150480,416955
351940,202007,242,107,135,111815,141075,252890
351950,202007,134,72,62,75240,64790,140030
351960,202007,929,455,474,476847.37,496375.5,973222.87
351970,202007,1904,990,914,1035595.5,959310.5,1994906.0
351980,202007,158,74,84,77330,87780,165110
351990,202007,260,170,90,177651,95095,272746
352000,202007,345,222,123,231990.5,129580,361570.5
352010,202007,390,246,144,257070,150480,407550
352020,202007,188,70,118,73150,123310,196460
352030,202007,1097,553,544,577885,569525,1147410
352040,202007,579,242,337,253935,356345,610280
352042,202007,295,86,209,89870,218406,308276
352044,202007,359,223,136,233035.94,142120,375155.94
352050,202007,3213,1242,1971,1298937.14,2060740.5,3359677.64
352060,202007,108,65,43,67925,44935,112860
352070,202007,91,68,23,71060.58,25080,96140.58
352080,202007,68,43,25,44935,26125,71060
352090,202007,159,106,53,110770,55385,166155
352100,202007,287,136,151,142120.5,158840.5,300961.0
352110,202007,115,36,79,37620,82555,120175
352115,202007,61,20,41,20900,42845,63745
352120,202007,86,59,27,61655.29,28215,89870.29
352130,202007,223,187,36,195415,37620,233035
352140,202007,185,86,99,89870,103455,193325
352150,202007,117,61,56,64790,58520,123310
352160,202007,143,91,52,95095,54340,149435
352170,202007,391,265,126,276925,131670,408595
352180,202007,628,397,231,414865.29,241395,656260.29
352190,202007,242,98,144,103455,151525,254980
352200,202007,30,15,15,15675,15675,31350
352210,202007,4123,1685,2438,1761872,2561295.5,4323167.5
352215,202007,59,33,26,34485,27170,61655
352220,202007,6712,2520,4192,2636536.55,4394226.29,7030762.84
352230,202007,3332,2146,1186,2244661.44,1242506.62,3487168.06
352240,202007,2483,1418,1065,1481810.5,1113970.5,2595781.0
352250,202007,2771,1323,1448,1383581.58,1515250,2898831.58
352260,202007,990,517,473,541310.5,496375.5,1037686.0
352265,202007,57,28,29,29260,30305,59565
352270,202007,398,229,169,240350,176605.25,416955.25
352280,202007,450,278,172,291555.58,179740,471295.58
352290,202007,173,102,71,107635,74195,181830
352300,202007,95,66,29,68970,30305,99275
352310,202007,6394,2824,3570,2958396.19,3741100.8,6699496.99
352320,202007,1030,540,490,566390.5,512050,1078440.5
352330,202007,541,260,281,273790,294690.5,568480.5
352340,202007,1358,617,741,645812,775392,1421204
352350,202007,342,205,137,214225,145255.5,359480.5
352360,202007,221,98,123,102410,128535,230945
352370,202007,105,69,36,72105,37620,109725
352380,202007,118,75,43,78375,44935,123310
352390,202007,2457,1045,1412,1092025.5,1481811.3,2573836.8
352400,202007,495,216,279,225720,291555.5,517275.5
352410,202007,865,602,263,630135.79,274835,904970.79
352420,202007,97,67,30,70015,31350,101365
352430,202007,1747,797,950,833911.87,996930.58,1830842.45
352440,202007,3216,1586,1630,1661552.34,1707530,3369082.34
352450,202007,197,161,36,168245,37620,205865
352460,202007,621,316,305,331265,319770,651035
352470,202007,653,221,432,230945,451440,682385
352480,202007,1412,783,629,819280,660440.5,1479720.5
352490,202007,63,23,40,24035,41800,65835
352500,202007,1239,519,720,543400.85,754490.5,1297891.35
352510,202007,723,383,340,405460.58,356345,761805.58
352520,202007,670,322,348,336490,364705,701195
352530,202007,1764,916,848,960355,886160.5,1846515.5
352540,202007,74,47,27,49115,28215,77330
352550,202007,193,115,78,120175,81510,201685
352560,202007,49,39,10,40755,10450,51205
352570,202007,680,343,337,359480.29,352165,711645.29
352580,202007,55,42,13,43890,13585,57475
352585,202007,20,6,14,6270,14630,20900
352590,202007,4411,2192,2219,2291686.29,2324081,4615767.29
352600,202007,346,249,97,260205,101365,361570
352610,202007,941,431,510,450395.67,533995,984390.67
352620,202007,1039,399,640,416955,668800,1085755
352630,202007,176,64,112,66880,117040,183920
352640,202007,518,349,169,364705,177650,542355
352650,202007,84,61,23,63745,24035,87780
352660,202007,64,38,26,39710,27170,66880
352670,202007,1669,886,783,926916.32,822415,1749331.32
352680,202007,928,579,349,608190,364705,972895
352690,202007,4531,2036,2495,2132847.38,2614590.29,4747437.67
352700,202007,102,61,41,63745,42845,106590
352710,202007,1379,726,653,762850.5,684475.65,1447326.15
352720,202007,1378,630,748,659395,782705.5,1442100.5
352725,202007,22,17,5,18810,5225,24035
352730,202007,396,198,198,207955,207955,415910
352740,202007,418,266,152,279016.4,158840.11,437856.51
352750,202007,18,12,6,12540,6270,18810
352760,202007,181,117,64,122265,66880,189145
352770,202007,89,66,23,68970,24035,93005
352780,202007,79,41,38,42845,39710,82555
352790,202007,26,20,6,20900,6270,27170
352800,202007,239,176,63,183920,66880,250800
352810,202007,155,95,60,99275.12,62700,161975.12
352820,202007,59,46,13,48070,13585,61655
352830,202007,77,52,25,54340,26125,80465
352840,202007,657,323,334,337535.25,349030,686565.25
352850,202007,1553,501,1052,524590,1099340,1623930
352860,202007,116,75,41,78375,42845,121220
352870,202007,46,30,16,31350,16720,48070
352880,202007,180,121,59,126445,62700,189145
352885,202007,32,22,10,22990,10450,33440
352890,202007,53,35,18,36575,18810.5,55385.5
352900,202007,4783,2318,2465,2426491.61,2585330.79,5011822.40
352910,202007,37,30,7,31350,7315,38665
352920,202007,666,401,265,419045,276925,695970
352930,202007,1228,588,640,616550.5,671936.25,1288486.75
352940,202007,6160,2516,3644,2637630.07,3815295.5,6452925.57
352950,202007,114,43,71,44935,74195,119130
352960,202007,60,41,19,42845,20900,63745
352965,202007,18,9,9,9405,9405,18810
352970,202007,516,394,122,411730.23,127490,539220.23
352980,202007,155,86,69,89870,72105,161975
352990,202007,984,450,534,471295,564300,1035595
353000,202007,62,27,35,28215,36575,64790
353010,202007,546,339,207,354255,216315,570570
353020,202007,302,220,82,229900,85690,315590
353030,202007,1255,572,683,599830.85,716870,1316700.85
353040,202007,85,53,32,55385,33440,88825
353050,202007,1325,857,468,895566.19,490105,1385671.19
353060,202007,8433,3644,4789,3814254.71,5017045,8831299.71
353070,202007,1762,1077,685,1127556.33,716683.99,1844240.32
353080,202007,1277,685,592,720005.47,620730,1340735.47
353090,202007,58,31,27,32395,28215,60610
353100,202007,52,42,10,43890,10450,54340
353110,202007,2099,633,1466,661485.5,1533015,2194500.5
353120,202007,97,49,48,51205,50160.5,101365.5
353130,202007,861,422,439,440990.41,458755,899745.41
353140,202007,556,228,328,238260.29,344850,583110.29
353150,202007,333,188,145,197505.29,153615,351120.29
353160,202007,94,75,19,78375,19855,98230
353170,202007,221,70,151,73150,157795,230945
353180,202007,1077,484,593,505780.75,619686,1125466.75
353190,202007,499,365,134,382470,141075,523545
353200,202007,223,106,117,110770,122265,233035
353205,202007,19,12,7,12540,7315,19855
353210,202007,72,40,32,41800,33440,75240
353215,202007,46,26,20,27170,20900,48070
353220,202007,77,45,32,47025,34485,81510
353230,202007,158,60,98,63745,104500,168245
353240,202007,317,161,156,168245,164065,332310
353250,202007,211,104,107,108680,111815,220495
353260,202007,463,317,146,332310.8,153615,485925.8
353270,202007,72,53,19,55385,19855,75240
353280,202007,100,49,51,52250,53295,105545
353282,202007,132,94,38,98230,39710,137940
353284,202007,24,16,8,16720,8360,25080
353286,202007,2,0,2,0,2090,2090
353290,202007,72,42,30,43890,31350,75240
353300,202007,443,236,207,248711.33,216315,465026.33
353310,202007,49,42,7,43890,7315,51205
353320,202007,53,30,23,31350,24035,55385
353325,202007,52,31,21,32395,21945.5,54340.5
353330,202007,60,40,20,41800.75,20900,62700.75
353340,202007,640,227,413,238260,432630.5,670890.5
353350,202007,905,437,468,456665,493240.5,949905.5
353360,202007,105,84,21,87780,21945,109725
353370,202007,115,66,49,68970,51205,120175
353380,202007,32,18,14,18810,14630,33440
353390,202007,1126,534,592,558030,619685.5,1177715.5
353400,202007,45,25,20,26125,20900,47025
353410,202007,110,66,44,70015,45980.25,115995.25
353420,202007,58,23,35,24035,36575,60610
353430,202007,583,392,191,410685.91,201685,612370.91
353440,202007,11078,4801,6277,5020181.79,6585591,11605772.79
353450,202007,56,30,26,31350,27170,58520
353460,202007,600,325,275,340670.52,290510,631180.52
353470,202007,2158,1128,1030,1179805.38,1080530,2260335.38
353475,202007,248,163,85,170335.5,88825,259160.5
353480,202007,186,155,31,161975,33440,195415
353490,202007,242,144,98,150480,102410.5,252890.5
353500,202007,202,116,86,122265.29,90915,213180.29
353510,202007,104,72,32,75240,33440,108680
353520,202007,209,147,62,153615,64790,218405
353530,202007,468,253,215,264385,226765,491150
353540,202007,382,252,130,263340,135850,399190
353550,202007,718,465,253,485926.47,264385,750311.47
353560,202007,589,235,354,245575,370975,616550
353570,202007,67,37,30,38665.5,32395,71060.5
353580,202007,350,257,93,269611.35,98230,367841.35
353590,202007,88,64,24,66880,25080,91960
353600,202007,276,159,117,167200.29,123310,290510.29
353610,202007,126,70,56,73150,58520,131670
353620,202007,617,323,294,338580.5,308275,646855.5
353625,202007,52,27,25,28215,26125,54340
353630,202007,234,171,63,178695.45,65835,244530.45
353640,202007,133,84,49,87780,51205,138985
353650,202007,935,350,585,365750,614460,980210
353657,202007,22,16,6,16720,6270,22990
353660,202007,275,147,128,153615,133760,287375
353670,202007,762,450,312,471295.79,327085.5,798381.29
353680,202007,105,76,29,79420.25,30305,109725.25
353690,202007,44,30,14,31350,14630,45980
353700,202007,269,191,78,200640,81510,282150
353710,202007,469,219,250,228855,261250.5,490105.5
353715,202007,46,33,13,34485,13585,48070
353720,202007,347,159,188,166155.5,198550,364705.5
353730,202007,1097,672,425,703285,447260.5,1150545.5
353740,202007,617,341,276,356345.5,290510,646855.5
353750,202007,77,46,31,49115,32395,81510
353760,202007,2988,1123,1865,1174518.53,1953106.65,3127625.18
353770,202007,92,75,17,78375,17765,96140
353780,202007,1229,586,643,612370.29,677160,1289530.29
353790,202007,504,306,198,319770.9,207955.5,527726.4
353800,202007,3439,1657,1782,1733675.5,1868532.5,3602208.0
353810,202007,233,133,100,138985,104500,243485
353820,202007,209,93,116,97185,121220,218405
353830,202007,52,45,7,47025,7315,54340
353850,202007,175,83,92,86735,96140,182875
353860,202007,502,224,278,235125,291555,526680
353870,202007,5365,2703,2662,2831953.58,2794332.49,5626286.07
353880,202007,678,469,209,491150,218405,709555
353890,202007,555,319,236,335445.5,247665.61,583111.11
353900,202007,135,70,65,73150,67925,141075
353910,202007,174,75,99,78375,103455,181830
353920,202007,439,243,196,254980.75,204820,459800.75
353930,202007,1009,592,417,618640,435766.35,1054406.35
353940,202007,191,95,96,99275,100320,199595
353950,202007,504,308,196,322905,204820,527725
353960,202007,75,61,14,63745,14630,78375
353970,202007,55,30,25,32395,26125,58520
353980,202007,1699,785,914,820325.5,956175.61,1776501.11
353990,202007,71,43,28,44935,29260,74195
354000,202007,384,182,202,190190,211090,401280
354010,202007,90,50,40,52250,41800.5,94050.5
354020,202007,511,326,185,342760,193325,536085
354025,202007,49,41,8,42845,9405,52250
354030,202007,51,31,20,32395,20900,53295
354040,202007,100,76,24,79420,25080,104500
354050,202007,178,100,78,104500.79,81510,186010.79
354060,202007,756,361,395,379335,412775,792110
354070,202007,916,524,392,547581,411730,959311
354075,202007,216,103,113,107635,118085,225720
354080,202007,313,133,180,138985,189145,328130
354085,202007,20,13,7,13585,7315,20900
354090,202007,293,167,126,175472,131670,307142
354100,202007,5601,2264,3337,2366925.75,3490302.35,5857228.10
354105,202007,95,46,49,48070,51205,99275
354110,202007,46,22,24,22990,26125,49115
354120,202007,138,97,41,101365,43890,145255
354130,202007,717,454,263,474430,274835.5,749265.5
354140,202007,3171,1464,1707,1531971.02,1790085.5,3322056.52
354150,202007,639,380,259,398145.87,271700,669845.87
354160,202007,651,414,237,432630.5,248711.39,681341.89
354165,202007,16,14,2,14630,2090,16720
354170,202007,176,120,56,127490,58520,186010
354180,202007,62,36,26,37620.59,27170,64790.59
354190,202007,195,82,113,85690,118085,203775
354200,202007,115,60,55,62700,57475,120175
354210,202007,59,23,36,24035,37620,61655
354220,202007,657,411,246,429495.29,257070,686565.29
354230,202007,163,69,94,72105,98230,170335
354240,202007,336,213,123,222585.62,128535,351120.62
354250,202007,84,51,33,53295,34485,87780
354260,202007,2073,967,1106,1011561.82,1158906.6,2170468.42
354270,202007,91,65,26,67925,27170,95095
354280,202007,45,22,23,22990,24035,47025
354290,202007,147,102,45,106590,47025,153615
354300,202007,377,266,111,277970.29,115995,393965.29
354310,202007,91,68,23,71060.5,25080,96140.5
354320,202007,204,101,103,105545,108680,214225
354323,202007,10,9,1,9405,1045,10450
354325,202007,116,67,49,70015.83,51205,121220.83
354330,202007,2445,814,1631,852571.5,1707530.5,2560102.0
354340,202007,10377,4945,5432,5183202.63,5691073.25,10874275.88
354350,202007,133,88,45,91960,47025,138985
354360,202007,75,42,33,43890,34485,78375
354370,202007,245,130,115,136895,120175,257070
354380,202007,185,112,73,117040,77330,194370
354390,202007,2704,970,1734,1015740,1819345.45,2835085.45
354400,202007,308,167,141,174515,148390,322905
354410,202007,614,294,320,309321.6,337535.5,646857.1
354420,202007,271,172,99,179740,104500,284240
354425,202007,307,184,123,192329,129580,321909
354430,202007,184,107,77,111815,80465,192280
354440,202007,38,27,11,28215,11495,39710
354450,202007,50,34,16,36575,16720,53295
354460,202007,103,58,45,60610,47025,107635
354470,202007,34,18,16,18810,16720,35530
354480,202007,112,61,51,63745,53295,117040
354490,202007,144,89,55,93005,57475,150480
354500,202007,382,181,201,189145,210045,399190
354510,202007,94,65,29,68970,30305,99275
354515,202007,36,12,24,12540,25080,37620
354520,202007,1592,678,914,710451.9,958265.5,1668717.4
354530,202007,756,379,377,396055.5,395010,791065.5
354540,202007,269,145,124,151525,129580,281105
354550,202007,38,24,14,25080,14630,39710
354560,202007,150,79,71,82555,74195,156750
354570,202007,133,89,44,93005.25,47025,140030.25
354580,202007,1881,887,994,929006.5,1041865.5,1970872.0
354600,202007,255,140,115,146300,121220,267520
354610,202007,72,61,11,63745.15,11495,75240.15
354620,202007,65,20,45,20900,47025,67925
354625,202007,16,10,6,10450,6270,16720
354630,202007,306,198,108,207955,112860,320815
354640,202007,794,502,292,526680.75,305140,831820.75
354650,202007,71,43,28,44935,30305,75240
354660,202007,789,586,203,614460.25,213180,827640.25
354670,202007,238,88,150,91960,156750,248710
354680,202007,1264,469,795,490105,831820,1321925
354690,202007,82,56,26,58520.5,27170,85690.5
354700,202007,66,47,19,49115,19855,68970
354710,202007,45,32,13,34485,13585,48070
354720,202007,19,19,0,20900,0,20900
354730,202007,1741,729,1012,761805.55,1062765.5,1824571.05
354740,202007,79,55,24,57475,25080,82555
354750,202007,425,245,180,256025,190190,446215
354760,202007,463,281,182,294691.25,191235.5,485926.75
354765,202007,10,5,5,5225,5225,10450
354770,202007,343,228,115,238260.06,120175,358435.06
354780,202007,8220,3237,4983,3387894.21,5231271.7,8619165.91
354790,202007,101,57,44,59565,45980,105545
354800,202007,454,246,208,259160,218405,477565
354805,202007,103,46,57,48070.5,59565,107635.5
354810,202007,102,60,42,63745,43890,107635
354820,202007,205,83,122,86735.9,127490,214225.9
354830,202007,42,23,19,24035,19855,43890
354840,202007,57,40,17,42845,17765,60610
354850,202007,4498,1989,2509,2080596.54,2630265.77,4710862.31
354860,202007,329,160,169,167200,176605.04,343805.04
354870,202007,12129,5408,6721,5655545.78,7037032.75,12692578.53
354880,202007,2784,1035,1749,1083665.88,1837111.65,2920777.53
354890,202007,2921,1558,1363,1628111.75,1427470,3055581.75
354900,202007,63,43,20,44935,20900,65835
354910,202007,1237,645,592,677161,618640,1295801
354920,202007,43,35,8,37620,8360,45980
354925,202007,13,6,7,6270,7315,13585
354930,202007,35,32,3,33440.78,3135,36575.78
354940,202007,808,587,221,614723.04,231990,846713.04
354950,202007,201,130,71,135850.25,74195,210045.25
354960,202007,148,56,92,58520,96140,154660
354970,202007,975,642,333,670891.64,347985.5,1018877.14
354980,202007,8778,3160,5618,3309517.92,5893801.02,9203318.94
354990,202007,9369,4288,5081,4489323.5,5322185,9811508.5
354995,202007,546,178,368,186010,386650,572660
355000,202007,469,161,308,168245,321860,490105
355010,202007,598,367,231,384560.5,242440.29,627000.79
355020,202007,775,490,285,512050,297825.5,809875.5
355030,202007,208463,80131,128332,83874970.83,134455000.7,218329971.53
355040,202007,764,356,408,372020.5,427405,799425.5
355050,202007,151,94,57,98230,59565,157795
355060,202007,1626,819,807,856901.5,843315.5,1700217.0
355070,202007,1441,683,758,715825.77,794200.29,1510026.06
355080,202007,201,123,78,128535,81510,210045
355090,202007,281,165,116,173470,121220.19,294690.19
355100,202007,5018,2366,2652,2477594.1,2774476.64,5252070.74
355110,202007,252,169,83,176605.5,86735,263340.5
355120,202007,76,54,22,57475,22990,80465
355130,202007,50,28,22,30305,22990,53295
355140,202007,185,113,72,118085,75240,193325
355150,202007,672,396,276,414866,290510,705376
355160,202007,473,226,247,236170.29,259160.5,495330.79
355170,202007,2050,1075,975,1126510.4,1020965,2147475.4
355180,202007,682,287,395,300960,412775,713735
355190,202007,214,145,69,151525,72105,223630
355200,202007,113,64,49,66880,51205,118085
355210,202007,698,395,303,412775,317680,730455
355220,202007,7172,3673,3499,3843514,3666907.5,7510421.5
355230,202007,100,58,42,60610,43890,104500
355240,202007,4478,1860,2618,1946837.66,2745216.5,4692054.16
355250,202007,5830,2603,3227,2726424.6,3380575.25,6106999.85
355255,202007,48,28,20,29260,20900,50160
355260,202007,183,111,72,115995.5,75240,191235.5
355270,202007,161,102,59,107635,61655,169290
355280,202007,6377,2505,3872,2620862,4057735.5,6678597.5
355290,202007,78,62,16,64790,16720,81510
355300,202007,196,119,77,124355,80465,204820
355310,202007,109,59,50,61655,52250,113905
355320,202007,89,46,43,48070,44935,93005
355330,202007,279,160,119,168245,125400,293645
355340,202007,1473,512,961,538175.77,1006335,1544510.77
355350,202007,134,66,68,68970,71060,140030
355360,202007,169,112,57,117040.88,59565,176605.88
355365,202007,21,17,4,17765,4180,21945
355370,202007,1036,608,428,637451.08,449350,1086801.08
355380,202007,821,520,301,545490.5,314545,860035.5
355385,202007,72,51,21,53295,21945,75240
355390,202007,111,63,48,65835,50160,115995
355395,202007,195,112,83,117040.92,86735,203775.92
355400,202007,1674,997,677,1041782.03,710600.29,1752382.32
355410,202007,4887,2290,2597,2395142.5,2724315.25,5119457.75
355420,202007,49,34,15,35530,15675,51205
355430,202007,373,229,144,240350.5,150480,390830.5
355440,202007,81,46,35,48070,36575,84645
355450,202007,463,227,236,237216.2,247665.75,484881.95
355460,202007,64,48,16,50160.35,16720,66880.35
355465,202007,44,28,16,29260,16720,45980
355470,202007,175,73,102,76285.75,106590,182875.75
355475,202007,11,7,4,7315,4180,11495
355480,202007,522,218,304,229900,318725,548625
355490,202007,119,84,35,87780,36575,124355
355495,202007,65,25,40,26125,41800,67925
355500,202007,1576,874,702,915422.05,733590.5,1649012.55
355510,202007,268,198,70,206910,73150,280060
355520,202007,34,24,10,25080,10450,35530
355530,202007,20,12,8,12540,8360,20900
355535,202007,73,33,40,34485,42845,77330
355540,202007,2465,968,1497,1011707.84,1570635.79,2582343.63
355550,202007,57,35,22,36575,22990,59565
355560,202007,250,116,134,121220,140030,261250
355570,202007,23,15,8,15675,8360,24035
355580,202007,243,171,72,178695,75240.5,253935.5
355590,202007,16,10,6,10450,6270,16720
355600,202007,277,141,136,147345,142120,289465
355610,202007,227,152,75,158840,78375,237215
355620,202007,1328,603,725,631180.5,759715,1390895.5
355630,202007,440,324,116,338580,122265.29,460845.29
355635,202007,112,52,60,55385,62700,118085
355640,202007,567,321,246,335445,257070,592515
355645,202007,843,332,511,347985,535040.5,883025.5
355650,202007,1987,837,1150,875710.5,1202795,2078505.5
355660,202007,247,133,114,138985,119130,258115
355670,202007,566,232,334,242440,349030,591470
355680,202007,207,116,91,121220,95095,216315
355690,202007,94,43,51,44935,53295.66,98230.66
355695,202007,17,11,6,11495,6270,17765
355700,202007,1148,597,551,624910.65,578931,1203841.65
355710,202007,2218,1200,1018,1257135.99,1064855.5,2321991.49
355715,202007,19,15,4,15675,4180,19855
355720,202007,225,132,93,137940.6,98230,236170.6
355730,202007,101,57,44,60610,45980,106590
410010,202007,130,107,23,111815,24035,135850
410020,202007,113,87,26,90915,27170,118085
410030,202007,165,96,69,100320.42,72105,172425.42
410040,202007,1188,590,598,616550,625955,1242505
410045,202007,40,30,10,31350,10450,41800
410050,202007,473,265,208,276925,217360,494285
410060,202007,285,213,72,222585,75240,297825
410070,202007,298,247,51,259160,53295,312455
410080,202007,170,106,64,110770,66880,177650
410090,202007,80,69,11,72105.9,11495,83600.9
410100,202007,286,200,86,210045,89870,299915
410105,202007,49,30,19,31350,19855,51205
410110,202007,330,199,131,207955.25,137940,345895.25
410115,202007,34,25,9,26125,9405,35530
410120,202007,415,210,205,219450,215270,434720
410130,202007,46,29,17,30305,17765,48070
410140,202007,3122,1506,1616,1575862.67,1694994.29,3270856.96
410150,202007,2685,1043,1642,1094116.35,1719026,2813142.35
410160,202007,512,315,197,329175,206910,536085
410165,202007,68,43,25,44935,26125,71060
410170,202007,174,115,59,120175,61655,181830
410180,202007,2264,1261,1003,1319835,1052315,2372150
410185,202007,38,33,5,34485,5225,39710
410190,202007,486,316,170,331265.89,177650,508915.89
410200,202007,945,686,259,718960,270655,989615
410210,202007,603,315,288,329175,300960,630135
410220,202007,47,22,25,22990,26125,49115
410230,202007,151,70,81,73150,84645,157795
410240,202007,751,489,262,511005,274835,785840
410250,202007,381,276,105,288420,109725,398145
410260,202007,297,167,130,174515,135850.5,310365.5
410270,202007,28,20,8,20900,8360,29260
410275,202007,56,44,12,45980,12540,58520
410280,202007,322,186,136,194370,142120,336490
410290,202007,247,152,95,159885,99275,259160
410300,202007,79,57,22,59565,22990,82555
410302,202007,19,12,7,12540,7315,19855
410304,202007,41,29,12,30305,12540,42845
410305,202007,215,112,103,117040,107635,224675
410310,202007,218,128,90,133760,95095,228855
410315,202007,48,35,13,36575,13585,50160
410320,202007,135,94,41,98230,42845,141075
410322,202007,34,22,12,22990,12540,35530
410330,202007,179,124,55,129580,57475,187055
410335,202007,100,57,43,59565,44935,104500
410337,202007,43,33,10,34485,10450,44935
410340,202007,37,31,6,32395,6270,38665
410345,202007,211,122,89,127490,93005,220495
410347,202007,47,36,11,37620,11495,49115
410350,202007,231,141,90,148390,94050,242440
410360,202007,469,295,174,309320.5,181831,491151.5
410370,202007,2348,995,1353,1039775.45,1418066.35,2457841.80
410380,202007,208,131,77,136895,80465,217360
410390,202007,391,269,122,281105,128535,409640
410395,202007,37,24,13,25080,13585,38665
410400,202007,849,386,463,403370.27,484880,888250.27
410405,202007,90,67,23,70015,24035,94050
410410,202007,32,22,10,22990,10450,33440
410420,202007,1669,786,883,823367.49,924825.85,1748193.34
410425,202007,175,70,105,73150,109725,182875
410430,202007,2288,1273,1015,1334465,1063811.4,2398276.4
410440,202007,377,275,102,287375,106590,393965
410442,202007,365,241,124,251845,130625,382470
410445,202007,422,299,123,312455,128535,440990
410450,202007,398,198,200,206910,209000,415910
410460,202007,506,261,245,273790,257070,530860
410465,202007,226,135,91,141075,95095,236170
410470,202007,242,146,96,152570,100320,252890
410480,202007,6187,2976,3211,3113059.2,3364901.75,6477960.95
410490,202007,1421,863,558,902880.51,585200.5,1488081.01
410500,202007,269,148,121,154660,126445,281105
410510,202007,168,125,43,130625,44935,175560
410520,202007,253,190,63,198550,65835,264385
410530,202007,285,101,184,105545,192280,297825
410540,202007,324,235,89,245575,93005,338580
410550,202007,1676,721,955,754490.2,999020.5,1753510.7
410560,202007,148,104,44,108680,45980,154660
410570,202007,429,288,141,300961.3,148390,449351.3
410580,202007,3465,1499,1966,1570636.7,2060740.5,3631377.2
410590,202007,395,265,130,280042,135850,415892
410600,202007,194,166,28,173470,30305,203775
410610,202007,52,43,9,44935,9405,54340
410620,202007,246,166,80,173470.03,83600,257070.03
410630,202007,437,248,189,259160,197505,456665
410640,202007,1020,639,381,667755.75,399190,1066945.75
410645,202007,110,79,31,82555,32395,114950
410650,202007,357,229,128,239305,133760,373065
410655,202007,88,63,25,65835,26125,91960
410657,202007,26,9,17,9405,17765,27170
410660,202007,602,419,183,437855.52,192280,630135.52
410670,202007,75,63,12,65835,12540,78375
410680,202007,215,172,43,179740,44935,224675
410685,202007,18,11,7,11495,7315,18810
410690,202007,28506,12050,16456,12610970.15,17224740.75,29835710.90
410700,202007,330,242,88,252890,91960,344850
410710,202007,130,105,25,109725,26125,135850
410712,202007,35,26,9,27170,9405,36575
410715,202007,87,64,23,66880,25080,91960
410720,202007,701,398,303,416955,317680,734635
410725,202007,184,136,48,142120,51205,193325
410730,202007,95,48,47,50160,49115,99275
410740,202007,107,76,31,79420,32395,111815
410750,202007,260,174,86,181830,89870,271700
410752,202007,25,15,10,15675,10450,26125
410753,202007,55,23,32,25080,33440,58520
410754,202007,49,25,24,26125.5,25080,51205.5
410755,202007,83,50,33,52250,34485,86735
410760,202007,775,423,352,442035.5,368885,810920.5
410765,202007,1771,815,956,852720,1000066,1852786
410770,202007,109,85,24,88825,25080,113905
410773,202007,56,41,15,42845,15675,58520
410775,202007,183,136,47,142120,49115,191235
410780,202007,87,47,40,50160,41800,91960
410785,202007,59,46,13,48070,13585,61655
410790,202007,80,36,44,37620,45980,83600
410800,202007,290,175,115,182875,120175.5,303050.5
410810,202007,22,16,6,16720,6270.5,22990.5
410820,202007,171,125,46,130625,48070,178695
410830,202007,8573,3712,4861,3883221.78,5089150.5,8972372.28
410832,202007,105,72,33,75240,34485,109725
410840,202007,1455,788,667,824506.44,699105.25,1523611.69
410845,202007,70,44,26,45980,27170,73150
410850,202007,191,133,58,138985,60610,199595
410855,202007,60,47,13,49115,13585,62700
410860,202007,730,398,332,415910.5,346940,762850.5
410865,202007,103,76,27,79420,28215,107635
410870,202007,155,131,24,137940,25080,163020
410880,202007,1116,565,551,590425.5,576840,1167265.5
410890,202007,90,65,25,67925,26125,94050
410895,202007,71,54,17,56430,17765,74195
410900,202007,24,18,6,18810,6270,25080
410910,202007,16,13,3,13585,3135,16720
410920,202007,37,25,12,26125,12540,38665
410930,202007,524,324,200,338580,209000,547580
410940,202007,4382,2455,1927,2570701.57,2018940.5,4589642.07
410950,202007,106,77,29,80465,30305,110770
410960,202007,825,341,484,357390,507870,865260
410965,202007,62,47,15,49115,15675,64790
410970,202007,633,447,186,467115,194370,661485
410975,202007,124,76,48,79420.91,50160,129580.91
410980,202007,1623,725,898,757625.45,940500,1698125.45
410990,202007,267,187,80,195415,84645,280060
411000,202007,67,42,25,43890,26125.5,70015.5
411005,202007,27,22,5,22990,5225,28215
411007,202007,260,153,107,159885,111815,271700
411010,202007,607,408,199,426360,209000,635360
411020,202007,288,198,90,206910.85,94050,300960.85
411030,202007,19,11,8,11495,8360,19855
411040,202007,56,38,18,39710,18810,58520
411050,202007,205,158,47,165110,49115,214225
411060,202007,516,346,170,361570,177650,539220
411065,202007,54,46,8,48070,8360,56430
411070,202007,1243,754,489,792110,512050,1304160
411080,202007,246,174,72,181830,75240,257070
411090,202007,100,76,24,79420,25080,104500
411095,202007,282,108,174,112860,182875,295735
411100,202007,116,94,22,98230,22990,121220
411110,202007,130,85,45,88825,47025,135850
411120,202007,208,142,66,148390,68970,217360
411125,202007,244,104,140,108680,146300,254980
411130,202007,133,114,19,119130,19855,138985
411140,202007,210,139,71,145255,74195,219450
411150,202007,1216,799,417,836000,436810.54,1272810.54
411155,202007,120,80,40,83600,41800,125400
411160,202007,27,13,14,13585,14630,28215
411170,202007,52,47,5,49115,5225,54340
411180,202007,967,636,331,667755,345895,1013650
411190,202007,328,190,138,198550,144210,342760
411200,202007,668,408,260,428450,272745,701195
411210,202007,691,365,326,381425,340670.5,722095.5
411220,202007,154,111,43,115995,44935,160930
411230,202007,39,33,6,34485,6270,40755
411240,202007,120,77,43,80465,44935,125400
411250,202007,433,316,117,330220,122265,452485
411260,202007,17,12,5,12540,5225,17765
411270,202007,277,150,127,157795,133760,291555
411275,202007,185,162,23,169290,24035,193325
411280,202007,210,148,62,154660.29,64790,219450.29
411290,202007,61,47,14,49115,14630,63745
411295,202007,140,109,31,113905,32395,146300
411300,202007,79,36,43,37620,44935,82555
411310,202007,90,70,20,73150,20900,94050
411320,202007,787,527,260,551760,271700,823460
411325,202007,61,41,20,42845,20900,63745
411330,202007,907,580,327,606100.5,343805.99,949906.49
411340,202007,29,19,10,19855,10450,30305
411342,202007,65,50,15,53295,15675,68970
411345,202007,117,58,59,60610,63745,124355
411350,202007,478,366,112,384943.61,119130.5,504074.11
411360,202007,53,35,18,36575,18810,55385
411370,202007,14230,5780,8450,6047420.24,8844882.63,14892302.87
411373,202007,176,127,49,132715,51205,183920
411375,202007,76,61,15,63745,16720,80465
411380,202007,85,63,22,65835,22990,88825
411390,202007,124,78,46,81510,48070,129580
411400,202007,376,277,99,289465,103455,392920
411410,202007,442,224,218,234080,228855.5,462935.5
411420,202007,990,429,561,448305,586245,1034550
411430,202007,465,268,197,280060,206910,486970
411435,202007,33,20,13,20900,13585,34485
411440,202007,449,352,97,368885,102410,471295
411450,202007,422,358,64,374110,66880,440990
411460,202007,771,295,476,308275,497420.57,805695.57
411470,202007,86,63,23,65835,24035,89870
411480,202007,672,375,297,391875.5,311410,703285.5
411490,202007,293,187,106,195415,110770,306185
411500,202007,99,81,18,84645,18810,103455
411510,202007,225,180,45,188100,47025,235125
411520,202007,6039,2276,3763,2381556,3942787.26,6324343.26
411530,202007,125,84,41,87780,42845,130625
411535,202007,50,19,31,19855,32395,52250
411540,202007,350,242,108,252890,112860,365750
411545,202007,55,41,14,43890,14630,58520
411550,202007,81,63,18,65835,18810,84645
411560,202007,402,173,229,180785,239305,420090
411570,202007,840,300,540,314545.2,564300,878845.2
411573,202007,24,15,9,15675,9405,25080
411575,202007,295,189,106,197505,110770,308275
411580,202007,1273,459,814,479655,853765,1333420
411585,202007,77,37,40,38665,41800,80465
411590,202007,23,16,7,16720,7315,24035
411600,202007,26,12,14,12540,14630,27170
411605,202007,237,95,142,99275,148390,247665
411610,202007,207,136,71,142120,74195,216315
411620,202007,377,200,177,209000,184965,393965
411630,202007,59,39,20,40755,20900,61655
411640,202007,33,24,9,25080,9405,34485
411650,202007,12,7,5,7315,5225,12540
411660,202007,36,24,12,25080,12540,37620
411670,202007,241,175,66,182875,68970,251845
411680,202007,166,137,29,143165,30305,173470
411690,202007,587,312,275,327085,288420,615505
411695,202007,60,44,16,45980,16720,62700
411700,202007,140,115,25,120175,26125,146300
411705,202007,104,69,35,72105,36575,108680
411710,202007,302,203,99,214225,103455,317680
411720,202007,131,89,42,93005,43890,136895
411721,202007,66,56,10,58520,10450,68970
411722,202007,101,43,58,44935,61655,106590
411725,202007,157,117,40,122265.5,41800,164065.5
411727,202007,87,67,20,70015,21945,91960
411729,202007,37,30,7,31350,7315,38665
411730,202007,550,348,202,363660,211090,574750
411740,202007,39,24,15,25080,15675,40755
411745,202007,69,49,20,51205,20900,72105
411750,202007,858,383,475,401280.5,501600,902880.5
411760,202007,1182,875,307,914375.6,320815,1235190.6
411770,202007,459,302,157,316635,164065,480700
411780,202007,344,226,118,236170,124355,360525
411790,202007,517,289,228,303050.22,238260,541310.22
411800,202007,154,119,35,124355.96,36575,160930.96
411810,202007,180,136,44,142120,45980,188100
411820,202007,2214,970,1244,1013651.7,1303115,2316766.7
411830,202007,11,10,1,10450,1045,11495
411840,202007,2021,1229,792,1286395,829731,2116126
411845,202007,54,20,34,20900,35530,56430
411850,202007,1221,677,544,707465.5,570570.75,1278036.25
411860,202007,50,32,18,33440.5,18810,52250.5
411870,202007,70,46,24,49115,25080,74195
411880,202007,424,268,156,280060,163020,443080
411885,202007,104,68,36,71060,37620,108680
411890,202007,311,201,110,210046.49,115995,326041.49
411900,202007,79,61,18,63745.5,18810,82555.5
411910,202007,182,145,37,151525,38665,190190
411915,202007,2173,883,1290,923780,1350140.05,2273920.05
411920,202007,118,96,22,100320,22990,123310
411925,202007,12,8,4,8360,4180,12540
411930,202007,806,583,223,611325.85,234080,845405.85
411940,202007,583,398,185,415910.85,193325,609235.85
411950,202007,1009,484,525,506825.76,549670,1056495.76
411960,202007,1042,701,341,732545.75,356345,1088890.75
411965,202007,20,14,6,14630,6270,20900
411970,202007,82,73,9,76285,9405,85690
411980,202007,163,107,56,111815,60610,172425
411990,202007,5173,2934,2239,3067082.14,2340802.25,5407884.39
411995,202007,497,168,329,175560,344850,520410
412000,202007,316,203,113,212135,119130,331265
412010,202007,45,28,17,29260,17765,47025
412015,202007,42,30,12,31350,12540,43890
412020,202007,31,25,6,26125,6270,32395
412030,202007,48,46,2,48070,2090,50160
412033,202007,48,29,19,30305,19855,50160
412035,202007,71,45,26,47025,27170,74195
412040,202007,43,25,18,26125.5,18810,44935.5
412050,202007,200,153,47,159885,49115,209000
412060,202007,784,583,201,610280,211090,821370
412065,202007,47,31,16,32395,17765,50160
412070,202007,163,110,53,114950,55385,170335
412080,202007,290,147,143,153615,150480,304095
412085,202007,36,16,20,16720,20900,37620
412090,202007,811,512,299,535040.25,313500,848540.25
412100,202007,241,203,38,212135,39710,251845
412110,202007,69,53,16,55385.5,16720,72105.5
412120,202007,324,196,128,204820,135850,340670
412125,202007,81,49,32,51205,33440,84645
412130,202007,36,23,13,24035.4,13585,37620.4
412135,202007,29,17,12,17765,12540,30305
412140,202007,346,228,118,238260,123310,361570
412150,202007,252,167,85,175560,88825,264385
412160,202007,91,51,40,53295,41800,95095
412170,202007,686,471,215,494285.5,224675,718960.5
412175,202007,38,28,10,29260,10450,39710
412180,202007,197,149,48,155705,50160,205865
412190,202007,332,265,67,276925,70015,346940
412200,202007,183,118,65,123310,67925,191235
412210,202007,73,57,16,59565,16720,76285
412215,202007,231,162,69,169597.23,72105,241702.23
412217,202007,67,53,14,55385,14630,70015
412220,202007,838,592,246,618640,258115,876755
412230,202007,329,199,130,207955,135850,343805
412240,202007,1348,667,681,697015,712690,1409705
412250,202007,405,252,153,264385,159885,424270
412260,202007,109,77,32,80465,33440,113905
412265,202007,178,139,39,145255,40755,186010
412270,202007,87,59,28,61655,29260,90915
412280,202007,90,72,18,75240,18810,94050
412290,202007,94,65,29,67925,30305,98230
412300,202007,204,136,68,142120,71060,213180
412310,202007,48,41,7,42845,7315,50160
412320,202007,99,81,18,84645,18810,103455
412330,202007,185,158,27,165110,28215,193325
412340,202007,155,109,46,113905,48070.5,161975.5
412350,202007,622,303,319,316635,333355,649990
412360,202007,26,22,4,22990,4180,27170
412370,202007,163,142,21,148390.3,21945,170335.3
412380,202007,259,197,62,205865,64790,270655
412382,202007,62,33,29,34485,30305,64790
412385,202007,151,107,44,112860,45980,158840
412390,202007,283,216,67,225720,70015,295735
412395,202007,70,58,12,60610,12540,73150
412400,202007,92,62,30,64790,31350,96140
412402,202007,231,115,116,120175.5,121220,241395.5
412405,202007,861,313,548,328130,572660,900790
412410,202007,971,598,373,627000.5,391875,1018875.5
412420,202007,13,12,1,12540,1045,13585
412430,202007,19,15,4,15675,4180,19855
412440,202007,614,333,281,349030,293645,642675
412450,202007,76,66,10,68970,10450,79420
412460,202007,93,71,22,74195,22990,97185
412470,202007,218,174,44,181830,45980,227810
412480,202007,145,107,38,111815.75,39710,151525.75
412490,202007,159,142,17,148390,17765,166155
412500,202007,435,356,79,372020.5,82555,454575.5
412510,202007,176,145,31,151525,32395,183920
412520,202007,92,61,31,63745,32395,96140
412530,202007,104,55,49,57475,51205,108680
412535,202007,91,68,23,71060,24035,95095
412540,202007,84,40,44,41800,45980,87780
412545,202007,90,61,29,64790,30305,95095
412550,202007,3828,1634,2194,1709620.5,2299000.5,4008621.0
412555,202007,13,9,4,9405,4180,13585
412560,202007,616,431,185,450396.5,194370.75,644767.25
412570,202007,767,392,375,410685,391875,802560
412575,202007,91,62,29,64790,30305,95095
412580,202007,179,117,62,122265,64790,187055
412590,202007,37,33,4,34485,4180,38665
412600,202007,169,124,45,129580.85,47025,176605.85
412610,202007,35,17,18,17765,18810,36575
412620,202007,149,125,24,130625,25080,155705
412625,202007,2142,1119,1023,1170401.04,1070082.35,2240483.39
412627,202007,68,52,16,54340,16720,71060
412630,202007,411,272,139,284240,145255,429495
412635,202007,64,18,46,18810,49115,67925
412640,202007,105,73,32,76285,33440,109725
412650,202007,337,219,118,228855,123310,352165
412660,202007,473,282,191,294690,199595,494285
412665,202007,46,41,5,42845,5225,48070
412667,202007,296,202,94,212135,98230,310365
412670,202007,64,52,12,54340,12540,66880
412680,202007,298,231,67,242440,70015.7,312455.7
412690,202007,104,67,37,70015,38665.5,108680.5
412700,202007,161,108,53,113905,55385,169290
412710,202007,1381,828,553,867351.25,578930,1446281.25
412720,202007,229,142,87,149435,90915,240350
412730,202007,186,157,29,164065,31350,195415
412740,202007,431,226,205,236170,214225,450395
412750,202007,432,246,186,257070,197505,454575
412760,202007,281,143,138,149435,144210,293645
412770,202007,2145,1186,959,1242505.29,1006336,2248841.29
412780,202007,142,109,33,113905,34485,148390
412785,202007,283,138,145,144210,151525,295735
412788,202007,37,21,16,21945,16720,38665
412790,202007,123,104,19,109725,19855,129580
412795,202007,147,105,42,109725,43890,153615
412796,202007,319,208,111,217360,115995,333355
412800,202007,619,375,244,392920.25,254980,647900.25
412810,202007,2943,1595,1348,1669912.75,1409705,3079617.75
412820,202007,938,585,353,611326.75,369930,981256.75
412830,202007,14,11,3,11495,3135,14630
412840,202007,232,167,65,174515.5,67925,242440.5
412850,202007,757,490,267,512050,279015,791065
412853,202007,172,86,86,90915,89870,180785
412855,202007,187,99,88,104500.09,91960,196460.09
412860,202007,93,63,30,65835,31350,97185
412862,202007,57,38,19,39710,19855,59565
412863,202007,6,5,1,5225,1045,6270
412865,202007,45,32,13,33440,13585,47025
412870,202007,108,67,41,70015,42845,112860
412880,202007,93,68,25,71060.5,26125,97185.5
420005,202007,42,38,4,39710,4180,43890
420010,202007,362,233,129,243485,134805,378290
420020,202007,82,69,13,72105,13585,85690
420030,202007,23,21,2,21945,2090,24035
420040,202007,105,82,23,85690,24035,109725
420050,202007,59,36,23,37620,24035,61655
420055,202007,18,18,0,18810,0,18810
420060,202007,28,22,6,22990,6270,29260
420070,202007,104,86,18,89870,18810,108680
420075,202007,11,11,0,11495,0,11495
420080,202007,44,38,6,39710,6270,45980
420090,202007,34,30,4,31350,4180,35530
420100,202007,150,126,24,131670.5,25080,156750.5
420110,202007,19,19,0,19855,0,19855
420120,202007,61,44,17,45980,17765,63745
420125,202007,80,62,18,64790,18810,83600
420127,202007,31,26,5,27170,5225,32395
420130,202007,426,254,172,265430,180785,446215
420140,202007,1295,719,576,752400.75,604010,1356410.75
420150,202007,43,36,7,37620,7315,44935
420160,202007,33,31,2,32395,2090,34485
420165,202007,19,13,6,13585,6270,19855
420170,202007,76,50,26,52250,27170,79420
420180,202007,21,18,3,18810,3135,21945
420190,202007,25,22,3,22990,3135,26125
420195,202007,131,63,68,65835,71060,136895
420200,202007,1266,557,709,582065.5,741950,1324015.5
420205,202007,81,46,35,48070,36575,84645
420207,202007,119,65,54,67925,56430,124355
420208,202007,19,15,4,15675,4180,19855
420209,202007,18,15,3,15675,3135,18810
420210,202007,511,234,277,244530,290510,535040
420213,202007,45,36,9,37620,9405,47025
420215,202007,27,24,3,25080,3135,28215
420220,202007,64,42,22,43890,22990,66880
420230,202007,824,466,358,486970,374110.5,861080.5
420240,202007,2251,1464,787,1533015.9,822415,2355430.9
420243,202007,41,31,10,32395,10450,42845
420245,202007,156,83,73,86735,76285,163020
420250,202007,62,41,21,42845,21945,64790
420253,202007,31,25,6,26125,6270,32395
420257,202007,13,10,3,10450,3135,13585
420260,202007,102,85,17,89870,17765,107635
420270,202007,29,24,5,25080,5225,30305
420280,202007,294,223,71,234080.75,74195.75,308276.50
420285,202007,22,12,10,12540,10450,22990
420287,202007,49,33,16,34485,16720,51205
420290,202007,968,669,299,700150.5,312455,1012605.5
420300,202007,1429,1128,301,1180853.1,315590.65,1496443.75
420310,202007,53,36,17,37620,17765,55385
420315,202007,35,28,7,29260.47,7315,36575.47
420320,202007,923,454,469,474430.1,491150,965580.1
420325,202007,0,,,,,0.0
420330,202007,118,77,41,80465,42845,123310
420340,202007,158,104,54,108680,56430,165110
420350,202007,252,180,72,188100,75240,263340
420360,202007,730,554,176,578930.83,183920,762850.83
420370,202007,118,69,49,72105,51205.5,123310.5
420380,202007,1178,817,361,853765.75,379335,1233100.75
420390,202007,250,177,73,184965,76285,261250
420395,202007,197,142,55,149435,57475,206910
420400,202007,237,181,56,190191.15,58520,248711.15
420410,202007,59,45,14,48070,14630,62700
420415,202007,34,29,5,30305,5225,35530
420417,202007,49,38,11,39710,11495,51205
420419,202007,11,11,0,11495,0,11495
420420,202007,2853,1754,1099,1837113.24,1151590.5,2988703.74
420425,202007,67,55,12,57475,12540,70015
420430,202007,1165,838,327,877800.45,341715,1219515.45
420435,202007,15,13,2,13585,2090,15675
420440,202007,101,72,29,75240.5,30305,105545.5
420445,202007,26,25,1,26125,1045,27170
420450,202007,76,38,38,39710,39710,79420
420455,202007,215,162,53,169290,55385,224675
420460,202007,2331,1504,827,1573772.32,869440,2443212.32
420470,202007,104,75,29,78375,30305,108680
420475,202007,7,7,0,7315,0,7315
420480,202007,854,643,211,671936,222585.5,894521.5
420490,202007,105,76,29,79420,30305.65,109725.65
420500,202007,449,237,212,247666.09,221540,469206.09
420510,202007,17,15,2,15675,2090,17765
420515,202007,23,16,7,16720,7315,24035
420517,202007,9,9,0,9405,0,9405
420519,202007,0,,,,,0.0
420520,202007,67,51,16,53295,16720,70015
420530,202007,161,108,53,112860.75,55385,168245.75
420535,202007,19,17,2,17765,2090,19855
420540,202007,5505,3281,2224,3434136.61,2325125.5,5759262.11
420543,202007,23,22,1,22990,1045,24035
420545,202007,210,149,61,155705,64790,220495
420550,202007,854,702,152,733590.9,159885,893475.9
420555,202007,35,26,9,27170,9405,36575
420560,202007,62,52,10,54340,10450,64790
420570,202007,159,90,69,94050,72105,166155
420580,202007,278,128,150,133760,156750,290510
420590,202007,512,349,163,365750,171380,537130
420600,202007,116,62,54,64790,57475,122265
420610,202007,38,34,4,35530,4180,39710
420620,202007,87,68,19,71060,19855,90915
420630,202007,155,105,50,109725,52250,161975
420640,202007,83,74,9,77330,9405,86735
420650,202007,246,125,121,130625,127490,258115
420660,202007,49,39,10,40755.5,10450,51205.5
420665,202007,38,29,9,30305,9405,39710
420670,202007,298,229,69,240350,72105,312455
420675,202007,13,12,1,12540,1045,13585
420680,202007,39,28,11,29260,11495,40755
420690,202007,173,135,38,141075,40755,181830
420700,202007,682,463,219,485925.46,228855,714780.46
420710,202007,146,81,65,84645,67925,152570
420720,202007,111,90,21,94050,21945,115995
420730,202007,615,382,233,400235.4,245575.5,645810.9
420740,202007,51,50,1,53295,1045,54340
420750,202007,498,337,161,353210,169290,522500
420757,202007,16,14,2,14630,2090,16720
420760,202007,37,29,8,30305,8360,38665
420765,202007,78,60,18,62700,18810,81510
420768,202007,53,47,6,49115,6270,55385
420770,202007,72,62,10,64790,10450,75240
420775,202007,40,36,4,37620,4180,41800
420780,202007,219,172,47,179740,49115,228855
420785,202007,11,9,2,9405,2090,11495
420790,202007,162,134,28,140030,29260,169290
420800,202007,67,50,17,53295,17765,71060
420810,202007,250,209,41,218405,42845,261250
420820,202007,2370,1347,1023,1409705.5,1071126.22,2480831.72
420830,202007,610,327,283,342760.5,295735,638495.5
420840,202007,147,107,40,111815,41800,153615
420845,202007,409,177,232,184965,243485.5,428450.5
420850,202007,261,194,67,203775,70015,273790
420860,202007,59,50,9,52250,9405,61655
420870,202007,126,87,39,90915,40755,131670
420880,202007,182,118,64,123310,67925,191235
420890,202007,935,467,468,489060.25,489060,978120.25
420895,202007,9,9,0,9405,0,9405
420900,202007,404,321,83,335445,88825,424270
420910,202007,5887,3265,2622,3418199.83,2747305,6165504.83
420915,202007,68,62,6,64790,6270,71060
420917,202007,22,15,7,15675,7315,22990
420920,202007,22,15,7,15675,7315,22990
420930,202007,2796,1739,1057,1820324.4,1105612.88,2925937.28
420940,202007,595,439,156,458756,163020.9,621776.9
420945,202007,9,7,2,7315,2090,9405
420950,202007,56,49,7,51205,7315,58520
420960,202007,110,86,24,89870,25080,114950
420970,202007,295,237,58,247666,61655,309321
420980,202007,24,23,1,24035,1045,25080
420985,202007,56,50,6,53295,6270,59565
420990,202007,80,58,22,60610,22990,83600
421000,202007,42,25,17,26125,17765,43890
421003,202007,51,35,16,36575,16720,53295
421005,202007,6,3,3,3135,3135,6270
421010,202007,776,523,253,547580,264385,811965
421020,202007,25,20,5,20900,5225,26125
421030,202007,118,99,19,103455.75,19855,123310.75
421040,202007,74,54,20,56430,20900,77330
421050,202007,348,246,102,257071,108680,365751
421055,202007,21,17,4,17765,4180,21945
421060,202007,91,52,39,54340,40755,95095
421070,202007,49,43,6,44935.5,6270,51205.5
421080,202007,34,30,4,31350,4180,35530
421085,202007,21,15,6,15675,6270,21945
421090,202007,36,27,9,28215,9405,37620
421100,202007,126,92,34,96140,35530,131670
421105,202007,198,163,35,171380,37620,209000
421110,202007,111,87,24,90915,27170,118085
421120,202007,164,120,44,125400.42,45980,171380.42
421125,202007,17,12,5,12540,5225,17765
421130,202007,822,519,303,543400,317680.5,861080.5
421140,202007,29,20,9,20900,9405,30305
421145,202007,40,32,8,33440,8360,41800
421150,202007,102,73,29,76285,30305,106590
421160,202007,68,46,22,48070,22990,71060
421165,202007,16,15,1,15675,1045,16720
421170,202007,182,154,28,161056,29260,190316
421175,202007,164,112,52,117040,54340,171380
421180,202007,47,33,14,34485.1,14630,49115.1
421185,202007,18,14,4,14630,4180,18810
421187,202007,1,0,1,0,1045,1045
421189,202007,47,31,16,32395,16720,49115
421190,202007,1696,1056,640,1103520,668800,1772320
421200,202007,96,71,25,74195,26125,100320
421205,202007,27,18,9,18810,9405,28215
421210,202007,171,117,54,122265,56430,178695
421220,202007,273,213,60,222585,62700,285285
421223,202007,49,39,10,40755,10450,51205
421225,202007,72,45,27,47025,28215,75240
421227,202007,87,67,20,70015,20900,90915
421230,202007,54,39,15,40755,15675,56430
421240,202007,18,18,0,18810,0,18810
421250,202007,373,221,152,230945.5,158840,389785.5
421260,202007,24,20,4,20900,4180,25080
421265,202007,2,2,0,2090,0,2090
421270,202007,46,41,5,42845,5225,48070
421280,202007,349,189,160,197505,167200,364705
421290,202007,336,222,114,231990,120175.5,352165.5
421300,202007,23,19,4,19855,4180,24035
421310,202007,46,33,13,34485,13585,48070
421315,202007,30,18,12,18810,12540,31350
421320,202007,127,81,46,84645,48070,132715
421330,202007,107,77,30,80465,31350,111815
421335,202007,39,27,12,28215,12540,40755
421340,202007,239,154,85,161975.25,88825,250800.25
421350,202007,191,109,82,113905.82,85690,199595.82
421360,202007,646,476,170,498465.25,177650,676115.25
421370,202007,203,153,50,159885,52250,212135
421380,202007,129,101,28,105545,29260,134805
421390,202007,19,13,6,13585,6270,19855
421400,202007,123,109,14,113905,14630,128535
421410,202007,17,15,2,15675,2090,17765
421415,202007,21,20,1,20900,1045,21945
421420,202007,136,113,23,118085,24035,142120
421430,202007,17,13,4,13585,4180,17765
421440,202007,59,50,9,52250,9405,61655
421450,202007,93,77,16,80465,16720,97185
421460,202007,62,50,12,52250,12540,64790
421470,202007,69,42,27,43890,28215,72105
421480,202007,728,554,174,578930,181830,760760
421490,202007,23,22,1,22990,1045,24035
421500,202007,493,313,180,327085.5,188100.25,515185.75
421505,202007,25,18,7,18810,7315,26125
421507,202007,33,25,8,26125,8360,34485
421510,202007,70,45,25,47025,26125,73150
421520,202007,55,46,9,48070,9405,57475
421530,202007,50,42,8,43890,8360,52250
421535,202007,26,24,2,25080,2090,27170
421540,202007,50,43,7,44935,7315,52250
421545,202007,103,75,28,78375,29260,107635
421550,202007,283,203,80,212135,83600,295735
421555,202007,21,18,3,18810,3135.5,21945.5
421560,202007,9,8,1,8360,1045,9405
421565,202007,120,80,40,83600,41800,125400
421567,202007,30,23,7,24035,7315,31350
421568,202007,32,28,4,29260,4180,33440
421569,202007,10,10,0,10450,0,10450
421570,202007,204,138,66,144210,70015,214225
421575,202007,27,22,5,22990,5225,28215
421580,202007,711,424,287,444193,300960,745153
421590,202007,19,18,1,18810,1045,19855
421600,202007,152,99,53,103455.5,55385.5,158841.0
421605,202007,107,75,32,81510.75,34485,115995.75
421610,202007,178,136,42,142120,43890,186010
421620,202007,1024,598,426,625955,446215,1072170
421625,202007,21,18,3,18810,3135,21945
421630,202007,302,188,114,196460.25,119131.5,315591.75
421635,202007,19,9,10,9405,10450,19855
421640,202007,99,82,17,85690,17765,103455
421650,202007,300,178,122,186010,127490,313500
421660,202007,2241,1344,897,1404481.5,938411,2342892.5
421670,202007,182,131,51,136895,54340,191235
421680,202007,178,161,17,168245,17765,186010
421690,202007,346,244,102,254980.5,106590.6,361571.1
421700,202007,52,36,16,37620,17765,55385
421710,202007,24,23,1,24035,1045,25080
421715,202007,6,5,1,5225,1045,6270
421720,202007,636,444,192,465026.21,201685,666711.21
421725,202007,16,6,10,6270,10450,16720
421730,202007,33,24,9,25080,10450,35530
421740,202007,89,33,56,34485,59565,94050
421750,202007,209,155,54,163020,56430,219450
421755,202007,23,21,2,21945,2090,24035
421760,202007,100,68,32,71060,33440,104500
421770,202007,653,413,240,431586.75,250800,682386.75
421775,202007,29,17,12,17765,12540,30305
421780,202007,188,147,41,154660.5,43890,198550.5
421790,202007,150,127,23,132715,24035,156750
421795,202007,18,15,3,15675,3135,18810
421800,202007,517,330,187,345895,196460,542355
421810,202007,69,55,14,57475,14630,72105
421820,202007,316,203,113,212135.5,119130,331265.5
421825,202007,140,119,21,124355,21945,146300
421830,202007,138,90,48,94050,50160,144210
421835,202007,6,4,2,4180,2090,6270
421840,202007,50,44,6,45980,6270,52250
421850,202007,80,68,12,71060,12540,83600
421860,202007,37,30,7,31350,7315,38665
421870,202007,1019,760,259,795246.25,270655,1065901.25
421875,202007,54,44,10,45980,10450,56430
421880,202007,171,119,52,124355,54340.5,178695.5
421885,202007,22,17,5,17765,5225,22990
421890,202007,134,94,40,98230,41800,140030
421895,202007,45,40,5,41800,5225,47025
421900,202007,152,120,32,125400,33440,158840
421910,202007,67,40,27,41800,28215,70015
421915,202007,30,25,5,26125,5225,31350
421917,202007,38,29,9,30305,9405,39710
421920,202007,41,37,4,38665,4180,42845
421930,202007,674,541,133,565345,138985,704330
421935,202007,50,43,7,44935,7315,52250
421940,202007,42,36,6,37620,6270,43890
421950,202007,875,583,292,609235.5,306185,915420.5
421960,202007,45,40,5,41800.85,5225,47025.85
421970,202007,353,226,127,237215.5,133760,370975.5
421985,202007,23,13,10,13585,10450,24035
422000,202007,0,,,,,0.0
430003,202007,188,57,131,59565,136895,196460
430005,202007,38,26,12,28215,12540,40755
430010,202007,265,193,72,201685,75240,276925
430020,202007,144,96,48,100320.5,50160,150480.5
430030,202007,123,99,24,103455,25080,128535
430040,202007,2928,1720,1208,1799492,1265495.5,3064987.5
430045,202007,67,56,11,58520,11495,70015
430047,202007,6,6,0,6270,0,6270
430050,202007,77,64,13,67925,13585,81510
430055,202007,12,11,1,11495,1045,12540
430057,202007,5,4,1,4180,1045,5225
430060,202007,3715,2151,1564,2253021.25,1639605,3892626.25
430063,202007,52,48,4,50160,4180,54340
430064,202007,154,123,31,128535,32395,160930
430066,202007,5,2,3,2090,3135,5225
430070,202007,42,29,13,30305,13585,43890
430080,202007,68,47,21,49115,21945,71060
430085,202007,29,10,19,10450,19855,30305
430087,202007,26,19,7,20900.75,7315,28215.75
430090,202007,72,65,7,67925,7315,75240
430100,202007,123,83,40,86735,41800,128535
430105,202007,151,83,68,86735,71060,157795
430107,202007,18,12,6,12540,6270,18810
430110,202007,445,257,188,268565,197505,466070
430120,202007,154,143,11,149435,11495,160930
430130,202007,794,486,308,508915.5,321860,830775.5
430140,202007,124,115,9,120175,9405,129580
430150,202007,110,72,38,75240,39710,114950
430155,202007,36,31,5,32395,5225,37620
430160,202007,3641,2131,1510,2228987.75,1584220.5,3813208.25
430163,202007,367,160,207,167200,217360,384560
430165,202007,29,20,9,20900,9405,30305
430170,202007,90,75,15,78375,15675,94050
430175,202007,77,59,18,61655,18810,80465
430180,202007,105,87,18,90915,18810,109725
430185,202007,30,21,9,21945,9405,31350
430187,202007,84,38,46,39710,48070,87780
430190,202007,220,120,100,126445,104500,230945
430192,202007,13,11,2,11495,2090,13585
430195,202007,16,11,5,11495,5225,16720
430200,202007,163,140,23,146300,24035,170335
430205,202007,21,20,1,20900,1045,21945
430210,202007,679,523,156,546535.75,163020.5,709556.25
430215,202007,14,11,3,11495,3135,14630
430220,202007,73,50,23,52250,24035,76285
430222,202007,12,6,6,6270,6270,12540
430223,202007,15,8,7,8360,7315,15675
430225,202007,2,1,1,1045,1045,2090
430230,202007,316,186,130,194370,135850.5,330220.5
430235,202007,55,43,12,44935,12540,57475
430237,202007,27,21,6,21945,6270,28215
430240,202007,125,83,42,86735,43890,130625
430245,202007,70,56,14,58520,14630,73150
430250,202007,187,111,76,115995,79420,195415
430258,202007,9,8,1,8360,1045,9405
430260,202007,31,27,4,28215,4180,32395
430265,202007,36,30,6,31350,6270,37620
430270,202007,523,389,134,406506.25,141075,547581.25
430280,202007,1037,626,411,657305,430540,1087845
430290,202007,402,216,186,227810,195415,423225
430300,202007,2082,1148,934,1201750.75,980210.5,2181961.25
430310,202007,2001,1013,988,1060675.5,1038731.21,2099406.71
430320,202007,57,47,10,49115,10450,59565
430330,202007,100,88,12,91960,12540,104500
430340,202007,71,58,13,60610,13585,74195
430350,202007,1662,1125,537,1176670.5,563255,1739925.5
430355,202007,19,17,2,17765,2090,19855
430360,202007,86,43,43,44935,44935,89870
430367,202007,35,26,9,27170,9405,36575
430370,202007,53,47,6,49115,6270,55385
430380,202007,132,101,31,106590,32395,138985
430390,202007,584,362,222,379335,233035,612370
430400,202007,257,181,76,190190.5,79420,269610.5
430410,202007,54,43,11,44935,11495,56430
430420,202007,506,332,174,349030.85,181830,530860.85
430430,202007,55,54,1,55735,1045,56780
430435,202007,155,114,41,120175,43890,164065
430440,202007,491,321,170,335445,178695,514140
430450,202007,1150,949,201,992750,210045,1202795
430460,202007,5249,2741,2508,2869571.4,2626085,5495656.4
430461,202007,16,15,1,15675,1045,16720
430462,202007,10,6,4,6270,4180,10450
430463,202007,1093,591,502,617595,525635,1143230
430465,202007,25,13,12,13585,12540,26125
430466,202007,674,478,196,500555.5,205865,706420.5
430467,202007,105,57,48,59565,50160,109725
430468,202007,122,71,51,74195,53295,127490
430469,202007,23,18,5,18810,5225,24035
430470,202007,1158,643,515,673291.62,539220,1212511.62
430471,202007,54,36,18,37620,18810,56430
430480,202007,102,66,36,68970,37620,106590
430485,202007,6,6,0,6270.5,0,6270.5
430490,202007,76,61,15,63745,15675,79420
430495,202007,34,26,8,27170,8360,35530
430500,202007,188,127,61,132715,63745,196460
430510,202007,3444,2221,1223,2323035.63,1283260,3606295.63
430511,202007,16,16,0,16720,0,16720
430512,202007,153,106,47,110770,49115,159885
430513,202007,53,43,10,44935,10450,55385
430515,202007,28,26,2,27170,2090,29260
430517,202007,167,146,21,152570,21945,174515
430520,202007,343,240,103,250800,107635,358435
430530,202007,84,49,35,51205,36575,87780
430535,202007,449,307,142,320815,149435,470250
430537,202007,10,10,0,10450,0,10450
430540,202007,83,57,26,59565,27170,86735
430543,202007,349,112,237,117040,248710,365750
430544,202007,43,40,3,41800,3135,44935
430545,202007,377,189,188,197505,196460,393965
430550,202007,41,33,8,34485,8360,42845
430558,202007,2,2,0,2090,0,2090
430560,202007,55,29,26,30305,27170,57475
430570,202007,105,41,64,42845,66880,109725
430580,202007,131,106,25,110770,26125,136895
430583,202007,13,13,0,13585,0,13585
430585,202007,12,5,7,5225,7315,12540
430587,202007,14,7,7,7315,7315,14630
430590,202007,142,116,26,121220,27170,148390
430593,202007,2,2,0,2090,0,2090
430595,202007,16,13,3,13585,3135,16720
430597,202007,43,21,22,21945,22990,44935
430600,202007,219,161,58,168245,60610,228855
430605,202007,159,100,59,104500,61655,166155
430607,202007,25,20,5,20900,5225,26125
430610,202007,1620,755,865,787930,906015.5,1693945.5
430613,202007,2,2,0,2090,0,2090
430620,202007,109,78,31,81510,33440,114950
430630,202007,47,41,6,42845,6270,49115
430632,202007,31,26,5,27170,5225,32395
430635,202007,32,30,2,31350,2090,33440
430637,202007,60,30,30,31350,31350,62700
430640,202007,178,96,82,100320,85690,186010
430642,202007,21,17,4,17765,4180,21945
430645,202007,34,28,6,29260,7315,36575
430650,202007,247,201,46,210045.5,48070,258115.5
430655,202007,2,2,0,2090,0,2090
430660,202007,963,479,484,500555,505780.5,1006335.5
430670,202007,75,50,25,52250,26125,78375
430673,202007,68,41,27,42845,28215,71060
430675,202007,11,9,2,9405,2090,11495
430676,202007,518,306,212,319770,222585,542355
430680,202007,238,163,75,171381,78375,249756
430690,202007,530,326,204,340670,214225.29,554895.29
430692,202007,8,6,2,6270,2090,8360
430693,202007,137,88,49,91960,51205,143165
430695,202007,67,55,12,57475,12540,70015
430697,202007,56,35,21,37620,21945,59565
430700,202007,1492,1039,453,1086800.9,475475,1562275.9
430705,202007,22,20,2,20900,2090,22990
430710,202007,258,164,94,171380,99275,270655
430720,202007,106,91,15,95095,15675,110770
430730,202007,138,119,19,124355,19855,144210
430740,202007,71,49,22,51205,24035,75240
430745,202007,29,23,6,24035,6270,30305
430750,202007,326,218,108,227810,113905,341715
430755,202007,85,45,40,47025,41800,88825
430760,202007,383,218,165,227810.6,172425,400235.6
430770,202007,1502,785,717,821370.5,750310.5,1571681.0
430780,202007,295,186,109,195415,113905,309320
430781,202007,26,22,4,22990,4180,27170
430783,202007,61,49,12,51205,12540,63745
430786,202007,5,3,2,3135,2090,5225
430790,202007,512,339,173,354255,180785.5,535040.5
430800,202007,149,121,28,126445.76,29260,155705.76
430805,202007,39,35,4,36575,4180,40755
430807,202007,46,24,22,25080,22990,48070
430810,202007,73,44,29,45980,31350,77330
430820,202007,146,86,60,89870,62700,152570
430825,202007,10,8,2,8360,2090,10450
430830,202007,238,219,19,228855.5,19855,248710.5
430840,202007,127,86,41,89870,42845,132715
430843,202007,5,3,2,3135,2090,5225
430845,202007,73,41,32,42845,33440,76285
430850,202007,582,411,171,431550.16,179740,611290.16
430860,202007,162,103,59,107635,61655,169290
430865,202007,74,42,32,43890,34485,78375
430870,202007,80,65,15,67925,15675,83600
430880,202007,149,109,40,115995,41800,157795
430885,202007,8,6,2,6270,2090,8360
430890,202007,348,209,139,218405,145255,363660
430900,202007,510,352,158,367840,165110,532950
430905,202007,120,52,68,54340,71060,125400
430910,202007,282,155,127,161975,132715,294690
430912,202007,5,5,0,5225,0,5225
430915,202007,34,30,4,31350,4180,35530
430920,202007,4295,2290,2005,2397230,2105675,4502905
430925,202007,4,3,1,3135,1045,4180
430930,202007,2093,1209,884,1267587.25,927960.5,2195547.75
430940,202007,256,167,89,174515,93005,267520
430950,202007,154,124,30,129580,31350,160930
430955,202007,22,11,11,11495,11495,22990
430957,202007,18,16,2,16720,2090,18810
430960,202007,245,166,79,174515,82555,257070
430965,202007,113,71,42,74195,43890,118085
430970,202007,80,68,12,71060,12540,83600
430975,202007,42,38,4,39710,4180,43890
430980,202007,44,27,17,28215,17765,45980
430990,202007,110,85,25,88825,26125,114950
430995,202007,114,109,5,113905,5225,119130
431000,202007,296,141,155,147346.1,161975,309321.1
431010,202007,353,201,152,211090,159885,370975
431020,202007,1847,1069,778,1119195.5,814055,1933250.5
431030,202007,42,34,8,35530,8360,43890
431033,202007,408,196,212,204820,221540,426360
431036,202007,11,6,5,6270,5225,11495
431040,202007,139,87,52,90915,54340,145255
431041,202007,40,27,13,28215.5,13585,41800.5
431043,202007,43,26,17,27170,17765,44935
431046,202007,10,6,4,6270,4180,10450
431050,202007,200,127,73,132715,77330,210045
431053,202007,69,41,28,42845,29260,72105
431055,202007,63,43,20,44935,20900,65835
431057,202007,18,18,0,18810,0,18810
431060,202007,1615,1047,568,1096206.34,593560.75,1689767.09
431065,202007,16,10,6,10450,6270,16720
431070,202007,67,61,6,63745,6270,70015
431075,202007,7,7,0,7315,0,7315
431080,202007,137,82,55,85690,57475,143165
431085,202007,34,31,3,32395,3135,35530
431087,202007,15,13,2,13585,2090,15675
431090,202007,56,44,12,45980,12540,58520
431100,202007,1219,733,486,765986.3,507870,1273856.3
431110,202007,230,139,91,145255,95095.5,240350.5
431112,202007,27,16,11,16720,11495,28215
431113,202007,34,25,9,26125,9405,35530
431115,202007,153,107,46,111815,48070,159885
431120,202007,607,361,246,377245,259160,636405
431123,202007,3,2,1,2090,1045,3135
431125,202007,96,87,9,90915,9405,100320
431127,202007,10,5,5,5225,5225,10450
431130,202007,685,449,236,469205,246620,715825
431140,202007,752,516,236,541310.5,247665,788975.5
431142,202007,26,22,4,22990.67,4180,27170.67
431150,202007,195,147,48,153615,50160,203775
431160,202007,50,45,5,47025,5225,52250
431162,202007,5,4,1,4180,1045,5225
431164,202007,6,6,0,6270,0,6270
431170,202007,105,83,22,86735,22990,109725
431171,202007,69,41,28,42845,29260,72105
431173,202007,1,1,0,1045,0,1045
431175,202007,197,101,96,105545.5,100320,205865.5
431177,202007,82,58,24,60610,26125,86735
431179,202007,12,10,2,10450,2090,12540
431180,202007,432,260,172,271700,180785,452485
431190,202007,79,61,18,63745,18810,82555
431198,202007,74,53,21,55385,21945,77330
431200,202007,20,16,4,16720,4180,20900
431205,202007,20,19,1,19855,1045,20900
431210,202007,96,60,36,62700,37620,100320
431213,202007,32,27,5,28215,5225,33440
431215,202007,23,20,3,20900,3135,24035
431217,202007,4,3,1,3135,1045,4180
431220,202007,67,58,9,60610.87,9405,70015.87
431225,202007,149,95,54,99275,56430,155705
431230,202007,98,85,13,88825,13585,102410
431235,202007,7,7,0,7315,0,7315
431237,202007,21,15,6,15675,6270,21945
431238,202007,10,6,4,6270,4180,10450
431240,202007,1005,634,371,662530,389785.5,1052315.5
431242,202007,39,38,1,39710,1045,40755
431244,202007,13,9,4,9405,4180,13585
431245,202007,50,38,12,39710,12540,52250
431247,202007,9,6,3,6270,3135,9405
431250,202007,279,144,135,150480,143165,293645
431260,202007,57,45,12,47025,13585,60610
431261,202007,18,11,7,11495,7315,18810
431262,202007,17,16,1,16720,1045,17765
431265,202007,150,80,70,83600,73150,156750
431267,202007,18,15,3,15675,3135,18810
431270,202007,326,264,62,275880,64790,340670
431275,202007,37,34,3,35530,3135,38665
431280,202007,19,15,4,15675,4180,19855
431290,202007,24,21,3,21945,3135,25080
431295,202007,2,2,0,2090,0,2090
431300,202007,21,18,3,18810,3135,21945
431301,202007,5,5,0,5225,0,5225
431303,202007,59,38,21,39710,21945,61655
431306,202007,248,133,115,138798.99,120175,258973.99
431308,202007,7,5,2,5225,2090,7315
431310,202007,65,54,11,56430,11495,67925
431320,202007,147,89,58,93005,60610,153615
431330,202007,176,114,62,119130,64790,183920
431333,202007,24,19,5,19855,5225,25080
431335,202007,9,5,4,5225,4180,9405
431337,202007,346,154,192,161975,201685,363660
431339,202007,19,17,2,18810,2090,20900
431340,202007,3018,1655,1363,1730438.24,1428516.25,3158954.49
431342,202007,36,24,12,25080,12540,37620
431344,202007,19,19,0,19855,0,19855
431346,202007,5,5,0,5225,0,5225
431349,202007,36,32,4,33440,4180,37620
431350,202007,932,540,392,564300.25,409640,973940.25
431360,202007,45,38,7,39710,7315,47025
431365,202007,341,157,184,164065,193325,357390
431370,202007,1206,690,516,721050.5,543400,1264450.5
431380,202007,98,84,14,87780,14630,102410
431390,202007,501,266,235,277970,245575,523545
431395,202007,292,126,166,132715,173470,306185
431400,202007,43,29,14,30305,14630,44935
431402,202007,106,75,31,78375,32395,110770
431403,202007,24,14,10,14630,10450,25080
431405,202007,669,371,298,387695.25,314545,702240.25
431406,202007,29,25,4,26125,4180,30305
431407,202007,55,43,12,44935,12540,57475
431410,202007,3391,2068,1323,2162105.5,1385670.75,3547776.25
431413,202007,15,12,3,12540,3135,15675
431415,202007,68,51,17,53295,18810,72105
431417,202007,23,11,12,11495,12540,24035
431420,202007,321,217,104,226765,108680,335445
431430,202007,51,22,29,22990,30305,53295
431440,202007,8873,6163,2710,6451837.9,2840311.76,9292149.66
431442,202007,28,13,15,13585,15675,29260
431445,202007,23,21,2,21945,2090,24035
431446,202007,4,4,0,4180,0,4180
431447,202007,83,57,26,59565,27170,86735
431449,202007,52,45,7,48070,7315,55385
431450,202007,415,275,140,287375,146300,433675
431454,202007,0,,,,,0.0
431455,202007,53,41,12,42845,12540,55385
431460,202007,513,354,159,369930,166155,536085
431470,202007,118,89,29,94050,30305,124355
431475,202007,11,9,2,9405,2090,11495
431477,202007,36,25,11,26125,11495,37620
431478,202007,9,8,1,8360,1045,9405
431480,202007,511,307,204,322905,214225,537130
431490,202007,28572,15984,12588,16730459.84,13200164.58,29930624.42
431500,202007,78,63,15,65835,15675,81510
431505,202007,26,16,10,16720,10450,27170
431507,202007,10,8,2,8360,2090,10450
431510,202007,253,179,74,187055.25,77330,264385.25
431513,202007,24,21,3,21945,3135,25080
431514,202007,5,4,1,4180,1045,5225
431515,202007,82,68,14,71060,14630,85690
431517,202007,6,4,2,4180,2090,6270
431520,202007,42,37,5,38665,5225,43890
431530,202007,1450,658,792,687610,828685,1516295
431531,202007,24,23,1,24035,1045,25080
431532,202007,34,25,9,26125,9405,35530
431535,202007,28,16,12,16720,12540,29260
431540,202007,140,118,22,123310,22990,146300
431545,202007,14,12,2,12540,2090,14630
431550,202007,346,191,155,199595,161975,361570
431555,202007,12,12,0,12540,0,12540
431560,202007,4536,3100,1436,3247863.17,1505845,4753708.17
431570,202007,817,426,391,447261,411730,858991
431575,202007,40,22,18,22990,18810,41800
431580,202007,96,63,33,65835,34485,100320
431590,202007,141,120,21,125400,21945,147345
431595,202007,19,15,4,15675,4180,19855
431600,202007,244,142,102,148390,106590,254980
431610,202007,114,83,31,86735,32395,119130
431620,202007,43,36,7,37620,7315,44935
431630,202007,130,108,22,112860,22990,135850
431640,202007,1338,849,489,887205.5,511005.5,1398211.0
431642,202007,36,34,2,35530,2090,37620
431643,202007,44,21,23,21945,24035,45980
431645,202007,314,187,127,195415,132715,328130
431647,202007,8,8,0,8360,0,8360
431650,202007,34,23,11,24035,11495,35530
431660,202007,323,206,117,215270,122265,337535
431670,202007,227,102,125,106590,130625,237215
431673,202007,3,3,0,3135,0,3135
431675,202007,25,20,5,20900,5225,26125
431680,202007,1118,818,300,854810,313500,1168310
431690,202007,4730,2839,1891,2976164.42,1981321,4957485.42
431695,202007,23,16,7,16720,7315,24035
431697,202007,1,0,1,0,1045,1045
431700,202007,179,138,41,144210,42845,187055
431710,202007,3990,1742,2248,1820390.5,2355430,4175820.5
431720,202007,1328,822,506,858468,529815,1388283
431725,202007,1,1,0,1045,0,1045
431730,202007,1156,787,369,824507.9,386650,1211157.9
431740,202007,1343,659,684,688655,714780.5,1403435.5
431750,202007,1822,1188,634,1243550.55,664620,1908170.55
431755,202007,5,4,1,4180,1045,5225
431760,202007,1033,654,379,684477,398145,1082622
431770,202007,413,295,118,309320,123310,432630
431775,202007,28,20,8,20900,8360,29260
431780,202007,545,331,214,347985.25,223630,571615.25
431790,202007,165,128,37,133760,38665,172425
431795,202007,12,10,2,10450,2090,12540
431800,202007,3207,1684,1523,1760827.7,1596761,3357588.7
431805,202007,17,15,2,15675,2090,17765
431810,202007,602,394,208,411730,217360,629090
431820,202007,326,194,132,202730,138985,341715
431830,202007,2306,1387,919,1451505.5,961400,2412905.5
431840,202007,480,320,160,334400,167200,501600
431842,202007,33,26,7,28215,7315,35530
431843,202007,11,8,3,8360,3135,11495
431844,202007,19,14,5,14630,5225,19855
431845,202007,27,25,2,26125,2090,28215
431846,202007,25,21,4,22990,4180,27170
431848,202007,11,9,2,9405,2090,11495
431849,202007,7,6,1,6270,1045,7315
431850,202007,788,638,150,666710,156750,823460
431860,202007,113,76,37,79420,38665,118085
431861,202007,7,2,5,2090,5225,7315
431862,202007,55,38,17,39710,17765,57475
431870,202007,3489,2005,1484,2098360.5,1554960,3653320.5
431880,202007,917,672,245,704330,256025,960355
431890,202007,1309,784,525,820325.5,549670,1369995.5
431900,202007,180,128,52,133760,54340,188100
431910,202007,53,38,15,40755,15675,56430
431912,202007,42,24,18,25080,18810,43890
431915,202007,121,94,27,98230,28215,126445
431920,202007,156,113,43,118085,44935,163020
431930,202007,81,66,15,68970,15675,84645
431935,202007,3,3,0,3135,0,3135
431936,202007,12,11,1,11495,1045,12540
431937,202007,19,15,4,15675,4180,19855
431940,202007,457,304,153,317680,159885.25,477565.25
431950,202007,495,311,184,326040.5,192280,518320.5
431960,202007,734,400,334,419045.5,350075,769120.5
431970,202007,70,63,7,65835,7315,73150
431971,202007,3,3,0,3135,0,3135
431973,202007,21,17,4,17765,4180,21945
431975,202007,9,8,1,8360,1045,9405
431980,202007,212,131,81,136895,84645,221540
431990,202007,1143,612,531,639472.52,555940,1195412.52
432000,202007,1725,908,817,949906.75,854811,1804717.75
432010,202007,277,188,89,197505,93005,290510
432020,202007,169,139,30,145255,31350,176605
432023,202007,16,13,3,13585,3135,16720
432026,202007,66,61,5,63745,5225,68970
432030,202007,66,33,33,34485,34485,68970
432032,202007,20,16,4,16720,4180,20900
432035,202007,54,44,10,45980,10450,56430
432040,202007,99,67,32,70015,33440,103455
432045,202007,5,4,1,4180,1045,5225
432050,202007,82,48,34,50160,35530,85690
432055,202007,122,89,33,93005,34485,127490
432057,202007,8,6,2,6270.5,2090,8360.5
432060,202007,34,31,3,32395,3135,35530
432065,202007,32,28,4,29260,4180,33440
432067,202007,91,82,9,85690,9405,95095
432070,202007,394,300,94,313762.5,98230,411992.5
432080,202007,815,565,250,590425,261250,851675
432085,202007,10,8,2,8360,2090,10450
432090,202007,265,177,88,184965,91960,276925
432100,202007,172,115,57,120175,59565,179740
432110,202007,561,379,182,396055,190190,586245
432120,202007,952,553,399,581020.02,421135.5,1002155.52
432130,202007,478,344,134,359480,142120,501600
432132,202007,22,19,3,19855,3135,22990
432135,202007,82,67,15,70015,15675,85690
432140,202007,268,208,60,217360,62700,280060
432143,202007,209,131,78,136895,81510,218405
432145,202007,275,187,88,196460,93005,289465
432146,202007,14,13,1,13585,1045,14630
432147,202007,101,58,43,60610,44935,105545
432149,202007,16,10,6,10450,6270,16720
432150,202007,879,536,343,561165,358435,919600
432160,202007,1491,768,723,803605.22,758670,1562275.22
432162,202007,4,3,1,3135,1045,4180
432163,202007,19,14,5,14630,5225,19855
432166,202007,121,89,32,93267.5,33440,126707.5
432170,202007,222,111,111,115995,117040,233035
432180,202007,545,335,210,350075,220495.5,570570.5
432183,202007,7,7,0,7315,0,7315
432185,202007,76,66,10,70015,10450,80465
432190,202007,479,279,200,292600,210045,502645
432195,202007,87,72,15,75240,15675,90915
432200,202007,408,258,150,269610,157795,427405
432210,202007,117,74,43,77330,44935,122265
432215,202007,42,38,4,39710,4180,43890
432218,202007,20,19,1,19855,1045,20900
432220,202007,661,344,317,359480,331265.29,690745.29
432225,202007,14,8,6,8360,6270,14630
432230,202007,135,91,44,96140,45980,142120
432232,202007,12,11,1,11495,1045,12540
432234,202007,3,2,1,2090,1045,3135
432235,202007,2,2,0,2090,0,2090
432237,202007,28,17,11,17765,11495,29260
432240,202007,4305,2404,1901,2513226,1993861.5,4507087.5
432250,202007,1102,720,382,752400,401280,1153680
432252,202007,46,43,3,44935,3135,48070
432253,202007,61,49,12,51205,12540,63745
432254,202007,25,11,14,11495,14630,26125
432255,202007,15,12,3,12540,3135,15675
432260,202007,811,636,175,665665.5,182875,848540.5
432270,202007,241,182,59,190190,62700,252890
432280,202007,139,106,33,110770,34485,145255
432285,202007,2,2,0,2090,0,2090
432290,202007,66,57,9,59565,9405,68970
432300,202007,4701,2563,2138,2686627.07,2242570.5,4929197.57
432310,202007,128,103,25,107635,26125,133760
432320,202007,22,17,5,17765,5225,22990
432330,202007,18,12,6,12540,6270,18810
432335,202007,8,6,2,6270,2090,8360
432340,202007,39,33,6,34485,6270,40755
432345,202007,102,70,32,73150,33440,106590
432350,202007,20,19,1,19855,1045,20900
432360,202007,6,5,1,5225,1045,6270
432370,202007,25,24,1,25080,1045,26125
432375,202007,30,27,3,28215,3135,31350
432377,202007,8,8,0,8360,0,8360
432380,202007,172,76,96,79420,100320,179740
500020,202007,241,130,111,135850,115995,251845
500025,202007,137,68,69,71060,72105,143165
500060,202007,1446,904,542,945725.5,567435.5,1513161.0
500070,202007,797,376,421,392920.29,439945.5,832865.79
500080,202007,128,100,28,104500,29260,133760
500085,202007,135,111,24,115995.5,25080,141075.5
500090,202007,349,157,192,165110,200640,365750
500100,202007,721,378,343,395010,358436,753446
500110,202007,2259,1050,1209,1098296.31,1266540.75,2364837.06
500124,202007,263,144,119,150480,125400,275880
500150,202007,340,135,205,141075,215270,356345
500190,202007,518,354,164,369930,171380.5,541310.5
500200,202007,188,162,26,170335.2,27170,197505.2
500210,202007,1560,541,1019,565345,1065900.25,1631245.25
500215,202007,247,139,108,145255,112860,258115
500220,202007,748,483,265,505780.77,277970,783750.77
500230,202007,243,151,92,157795,96140,253935
500240,202007,669,459,210,481745.4,219450.5,701195.9
500260,202007,594,228,366,238260,385605,623865
500270,202007,30034,12808,17226,13403579.79,18034615.56,31438195.35
500280,202007,202,70,132,73150,137940,211090
500290,202007,1172,709,463,740905.5,488015,1228920.5
500295,202007,437,282,155,296780.5,160931.04,457711.54
500310,202007,75,25,50,26125,52250,78375
500315,202007,742,428,314,447260,328130,775390
500320,202007,3592,1775,1817,1856966.04,1905035,3762001.04
500325,202007,942,504,438,528771,457710.5,986481.5
500330,202007,1500,706,794,737770.5,832865,1570635.5
500345,202007,309,234,75,244530.5,78375,322905.5
500348,202007,254,148,106,154660,110770,265430
500350,202007,116,55,61,57475,63745,121220
500370,202007,5586,2494,3092,2608321,3237411,5845732
500375,202007,346,245,101,256025,106590,362615
500380,202007,589,334,255,351120,266475,617595
500390,202007,77,37,40,38665,41800,80465
500400,202007,214,139,75,145255,78375,223630
500410,202007,542,222,320,233035,334400,567435
500430,202007,516,368,148,384560,154660,539220
500440,202007,197,102,95,107635,99275,206910
500450,202007,395,170,225,177650,236170,413820
500460,202007,269,144,125,150480,130625,281105
500470,202007,432,344,88,361570.5,91960,453530.5
500480,202007,101,62,39,64790,40755,105545
500490,202007,105,45,60,47025,62700,109725
500500,202007,1444,523,921,547580,962445,1510025
500510,202007,43,35,8,36575,8360,44935
500515,202007,102,70,32,73150,33440,106590
500520,202007,317,167,150,174515,156750.5,331265.5
500525,202007,89,49,40,51205,41800,93005
500540,202007,885,382,503,399190,527725.5,926915.5
500560,202007,938,524,414,547580,433676,981256
500568,202007,983,557,426,582065,446215.5,1028280.5
500570,202007,1204,700,504,732546,527725.5,1260271.5
500580,202007,340,173,167,180785,174515,355300
500600,202007,340,163,177,170335,186010,356345
500620,202007,898,633,265,661485.42,279015,940500.42
500625,202007,78,61,17,63745,17765,81510
500627,202007,21,10,11,10450,11495,21945
500630,202007,1571,875,696,917512.04,728365,1645877.04
500635,202007,516,309,207,322905,218405,541310
500640,202007,385,203,182,212135,190190,402325
500660,202007,5490,2008,3482,2098360.5,3641826.5,5740187.0
500690,202007,602,208,394,218405,412775,631180
500710,202007,403,207,196,217360,204820,422180
500720,202007,950,546,404,572661.23,423225,995886.23
500730,202007,193,116,77,121220,80465,201685
500740,202007,895,374,521,390830,544445,935275
500750,202007,143,46,97,48070,101365,149435
500755,202007,122,89,33,93005.5,35530,128535.5
500769,202007,753,411,342,429495.5,357390,786885.5
500770,202007,404,213,191,223630,200640,424270
500780,202007,154,101,53,105545,55385,160930
500790,202007,1070,542,528,568480,552805,1121285
500793,202007,279,149,130,156750,136895.5,293645.5
500795,202007,171,117,54,122265,56430,178695
500797,202007,50,36,14,37620,14630,52250
500800,202007,438,193,245,201685,256025,457710
500830,202007,2222,1239,983,1294755,1028280,2323035
500840,202007,135,101,34,105545,35530,141075
510010,202007,171,90,81,95095,84645,179740
510020,202007,500,221,279,230945,291555,522500
510025,202007,1682,958,724,1001110,757625.5,1758735.5
510030,202007,666,345,321,360525,337535.5,698060.5
510035,202007,126,62,64,64790,66880,131670
510040,202007,403,187,216,195415,225720.3,421135.3
510050,202007,409,217,192,226765,200640.73,427405.73
510060,202007,119,59,60,61655,62700,124355
510080,202007,232,88,144,91960,150480,242440
510100,202007,66,28,38,29260,39710,68970
510120,202007,38,23,15,24035,15675,39710
510125,202007,385,239,146,249755,152570,402325
510130,202007,555,318,237,332310,248710.5,581020.5
510140,202007,426,124,302,129580,315590,445170
510160,202007,112,37,75,38665,78375,117040
510170,202007,801,484,317,506825.03,332310,839135.03
510180,202007,2939,1384,1555,1446281.7,1628111.25,3074392.95
510185,202007,19,8,11,8360,11495,19855
510190,202007,228,81,147,85690,153615,239305
510250,202007,2587,1524,1063,1592580.5,1111881,2704461.5
510260,202007,176,129,47,134805,49115,183920
510263,202007,469,265,204,276925.5,213180,490105.5
510267,202007,676,378,298,397100.5,311410,708510.5
510268,202007,61,27,34,29260,35530,64790
510269,202007,74,34,40,36575,41800,78375
510270,202007,386,194,192,202730,200640,403370
510279,202007,215,161,54,168245,56430,224675
510285,202007,182,73,109,76285,113905,190190
510300,202007,519,272,247,284240,259160,543400
510305,202007,207,99,108,103455,112860,216315
510310,202007,104,54,50,56430,52250,108680
510320,202007,852,537,315,561165,330220,891385
510325,202007,409,170,239,177650,249755,427405
510330,202007,431,238,193,248710,201685,450395
510335,202007,639,364,275,380380,287375,667755
510336,202007,55,39,16,40755,16720,57475
510337,202007,107,46,61,48070,64790,112860
510340,202007,17343,7849,9494,8218927.17,9949446.75,18168373.92
510343,202007,64,45,19,47025,19855,66880
510345,202007,159,103,56,108680,58520.5,167200.5
510350,202007,645,356,289,372020,302005.5,674025.5
510360,202007,203,123,80,129580,83600,213180
510370,202007,148,72,76,75240,80465,155705
510380,202007,86,64,22,66880,22990,89870
510385,202007,61,27,34,28215,35530,63745
510390,202007,109,47,62,49115,64790,113905
510395,202007,47,34,13,35530,13585,49115
510410,202007,710,466,244,486970,254980,741950
510420,202007,573,276,297,288420,311410,599830
510450,202007,49,24,25,25080,26125,51205
510452,202007,50,23,27,24035,28215,52250
510454,202007,52,24,28,25080,29260,54340
510455,202007,134,79,55,82555,57475,140030
510460,202007,177,83,94,86735,98230,184965
510480,202007,721,423,298,442035.2,311410,753445.2
510490,202007,352,178,174,186010,181830,367840
510500,202007,237,178,59,186010,61655,247665
510510,202007,786,461,325,481745.5,339625.5,821371.0
510515,202007,1224,633,591,662530,618640,1281170
510517,202007,255,110,145,114950,152570,267520
510520,202007,233,149,84,156750,87780,244530
510523,202007,98,75,23,78375,24035,102410
510525,202007,806,478,328,500555,344850,845405
510530,202007,20,14,6,14630,6270,20900
510550,202007,248,110,138,114950,146300,261250
510558,202007,287,142,145,148390,152570,300960
510560,202007,415,243,172,253935.5,179740,433675.5
510562,202007,648,467,181,488015,190190,678205
510590,202007,756,391,365,408595,382470,791065
510600,202007,239,124,115,129580,120175,249755
510610,202007,204,84,120,87780,126445,214225
510615,202007,182,83,99,86735,104500,191235
510617,202007,19,10,9,11495,9405,20900
510618,202007,120,56,64,58520,66880,125400
510619,202007,97,67,30,70015,31350,101365
510620,202007,169,95,74,99275,78375,177650
510621,202007,177,114,63,119130,65835,184965
510622,202007,498,305,193,320815,201685,522500
510623,202007,325,224,101,234080,105545,339625
510624,202007,94,47,47,49115,49115,98230
510625,202007,529,326,203,341715,214225.29,555940.29
510626,202007,113,69,44,72105,45980,118085
510627,202007,71,50,21,52250,21945,74195
510628,202007,151,91,60,95095,62700,157795
510629,202007,262,160,102,167200,106609,273809
510630,202007,439,226,213,236170,223630,459800
510631,202007,13,3,10,3135,10450,13585
510637,202007,350,200,150,209000,156750,365750
510642,202007,997,532,465,555940,485925,1041865
510645,202007,2,0,2,0,2090,2090
510650,202007,1422,928,494,969760.5,518320,1488080.5
510665,202007,79,35,44,36575,45980,82555
510670,202007,58,33,25,34485,26125,60610
510675,202007,1152,725,427,758670.5,446215,1204885.5
510677,202007,346,177,169,184965,178695,363660
510680,202007,108,61,47,63745,49115,112860
510682,202007,202,104,98,109725,102410,212135
510685,202007,55,41,14,42845,14630,57475
510700,202007,582,333,249,347985,260205,608190
510704,202007,1163,608,555,635360,581020,1216380
510706,202007,135,66,69,70015,72105,142120
510710,202007,382,268,114,281105,119130,400235
510715,202007,58,41,17,42845,17765,60610
510718,202007,208,105,103,109725,108680,218405
510719,202007,39,17,22,17765,22990,40755
510720,202007,191,130,61,135850,63745,199595
510724,202007,86,33,53,34485,55385,89870
510726,202007,48,25,23,26125,24035,50160
510729,202007,69,31,38,32395,39710,72105
510730,202007,476,263,213,274835,222585,497420
510735,202007,118,48,70,51205,73150,124355
510740,202007,21,11,10,11495,10450,21945
510757,202007,24,19,5,19855,5225,25080
510760,202007,7186,3688,3498,3856051.5,3662727.25,7518778.75
510770,202007,687,322,365,336490,381425,717915
510774,202007,18,7,11,7315,11495,18810
510775,202007,104,80,24,83600,25080,108680
510776,202007,28,10,18,10450,18810,29260
510777,202007,194,83,111,86735,115995,202730
510779,202007,51,23,28,24035,29260,53295
510780,202007,282,156,126,163020,131670,294690
510785,202007,389,211,178,220495,186010,406505
510787,202007,196,94,102,99275,106590,205865
510788,202007,4,0,4,0,4180,4180
510790,202007,2470,1286,1184,1344999.58,1239370,2584369.58
510792,202007,1153,646,507,676115,529815.66,1205930.66
510794,202007,114,61,53,63745,55385,119130
510795,202007,2343,1364,979,1425380.5,1024101,2449481.5
510800,202007,175,104,71,108680,74195,182875
510805,202007,183,120,63,125400,66880,192280
510810,202007,97,43,54,44935,56430,101365
510820,202007,236,119,117,124355.45,122265.12,246620.57
510830,202007,73,42,31,43890,32395,76285
510835,202007,14,9,5,9405,5225,14630
510840,202007,9141,4355,4786,4557248.13,5017045.5,9574293.63
510850,202007,221,89,132,93005,137940,230945
510860,202007,377,169,208,176605,218405.5,395010.5
510880,202007,67,50,17,52250,17765,70015
510885,202007,72,40,32,42845,33440,76285
510890,202007,68,39,29,40755,30305,71060
510895,202007,176,104,72,108680,75240.5,183920.5
520005,202007,118,51,67,53295,70015,123310
520010,202007,278,127,151,132715,158840.5,291555.5
520013,202007,718,461,257,482790,268565,751355
520015,202007,53,40,13,41800,13585,55385
520017,202007,86,48,38,50160.5,39710,89870.5
520020,202007,19,10,9,10450,9405,19855
520025,202007,2245,1160,1085,1213245.5,1134870,2348115.5
520030,202007,799,422,377,443080.5,395010,838090.5
520050,202007,69,48,21,50160,21945,72105
520055,202007,50,31,19,32395,19855,52250
520060,202007,177,117,60,122265,62700,184965
520080,202007,584,419,165,437855,175560,613415
520082,202007,17,11,6,12540,6270,18810
520085,202007,92,69,23,72105,24035,96140
520090,202007,93,62,31,64790,32395,97185
520110,202007,9261,3962,5299,4144471.79,5546862.5,9691334.29
520120,202007,13,8,5,8360,5225,13585
520130,202007,800,558,242,583110,252890.5,836000.5
520140,202007,12031,6677,5354,6987918,5617920.8,12605838.8
520145,202007,54,32,22,33440,22990,56430
520150,202007,165,130,35,135850,36575,172425
520160,202007,38,27,11,28215,11495,39710
520170,202007,253,146,107,152570,111815,264385
520180,202007,165,78,87,81510,90915,172425
520215,202007,201,135,66,141075,68970,210045
520235,202007,80,61,19,63745,19855,83600
520250,202007,131,77,54,80465,56430,136895
520260,202007,115,72,43,75240,44935,120175
520280,202007,49,33,16,34485,16720,51205
520310,202007,40,27,13,28215,13585,41800
520320,202007,178,113,65,118085,67925,186010
520330,202007,787,421,366,439945,383515,823460
520340,202007,365,216,149,225720,155705,381425
520350,202007,508,237,271,247665,283195,530860
520355,202007,87,51,36,53295,37620,90915
520357,202007,25,18,7,18810,7315,26125
520360,202007,1,1,0,1045,0,1045
520380,202007,134,72,62,76285,64790,141075
520390,202007,260,108,152,112860.5,158840,271700.5
520393,202007,15,11,4,11495,4180,15675
520396,202007,76,49,27,51205,28215,79420
520400,202007,204,119,85,124355,88825,213180
520410,202007,196,97,99,101365,104500,205865
520420,202007,20,13,7,13585,7315,20900
520425,202007,287,141,146,147345,152570,299915
520430,202007,484,243,241,254031.14,251845.25,505876.39
520440,202007,693,499,194,522500,202730,725230
520450,202007,1972,853,1119,891385,1170400,2061785
520455,202007,53,30,23,32395,24035,56430
520460,202007,37,22,15,22990,15675,38665
520465,202007,32,27,5,28215,5225,33440
520470,202007,433,279,154,291555,160930,452485
520480,202007,78,48,30,50160,31350,81510
520485,202007,117,40,77,41800,81510,123310
520490,202007,411,305,106,318725,110770,429495
520495,202007,162,97,65,101365,67925,169290
520500,202007,188,145,43,151525,44935,196460
520505,202007,187,107,80,112860,84645,197505
520510,202007,1808,859,949,898701,992752.25,1891453.25
520520,202007,45,33,12,34485,12540,47025
520530,202007,225,171,54,178695,56430,235125
520540,202007,578,398,180,416955,188100,605055
520545,202007,135,81,54,84645,56430,141075
520547,202007,56,32,24,33440,25080,58520
520549,202007,1221,569,652,594605.3,682385,1276990.3
520551,202007,304,161,143,168245,149435.5,317680.5
520552,202007,41,26,15,27170,15675,42845
520570,202007,15,9,6,9405,6270,15675
520580,202007,281,173,108,180785,112860,293645
520590,202007,151,93,58,97185,60610,157795
520620,202007,1145,528,617,553850.5,645810.25,1199660.75
520630,202007,37,21,16,21945,16720,38665
520640,202007,387,224,163,234080,170335,404415
520650,202007,64,36,28,37620,29260,66880
520660,202007,44,23,21,24035,21945,45980
520670,202007,38,31,7,32395,7315,39710
520680,202007,51,34,17,36575,17765,54340
520690,202007,42,11,31,11495,32395,43890
520710,202007,33,30,3,31350,3135,34485
520725,202007,201,147,54,154660,56430,211090
520735,202007,55,37,18,38665,18810,57475
520740,202007,420,200,220,209000,229900.5,438900.5
520750,202007,36,26,10,27170,10450,37620
520753,202007,65,46,19,48070,19855,67925
520760,202007,101,67,34,70015,35530,105545
520780,202007,289,212,77,221540,80465,302005
520790,202007,158,90,68,94050,71060,165110
520800,202007,3412,1836,1576,1922800.5,1650055,3572855.5
520810,202007,158,120,38,125400,39710,165110
520815,202007,5,4,1,4180,1045,5225
520830,202007,148,101,47,105545,49115,154660
520840,202007,349,234,115,244530,120175,364705
520850,202007,102,62,40,64790,41800,106590
520860,202007,1745,1128,617,1179805.5,645810.5,1825616.0
520870,202007,31882,15021,16861,15715763.3,17678273.5,33394036.8
520880,202007,1165,620,545,648945.5,570570.5,1219516.0
520890,202007,789,480,309,501600,323950,825550
520910,202007,963,513,450,536085.93,473385,1009470.93
520915,202007,100,76,24,79420,25080,104500
520920,202007,419,200,219,209000,228855,437855
520929,202007,18,16,2,16720,2090,18810
520940,202007,69,46,23,48070,24035,72105
520945,202007,18,12,6,12540,6270,18810
520960,202007,45,30,15,31350,15675,47025
520970,202007,339,207,132,218405,137940,356345
520980,202007,97,69,28,72105,29260,101365
520990,202007,450,305,145,318725,151525,470250
520993,202007,127,60,67,62700,70015,132715
520995,202007,246,142,104,148390.65,108680.5,257071.15
521000,202007,1557,909,648,950950,680295.5,1631245.5
521010,202007,676,329,347,343805,364705,708510
521015,202007,14,9,5,9405,5225,14630
521020,202007,1428,1010,418,1055450,436810.5,1492260.5
521030,202007,52,36,16,37620,16720,54340
521040,202007,946,597,349,623865.25,366795.5,990660.75
521056,202007,48,33,15,34485,15675,50160
521060,202007,130,86,44,89870,45980,135850
521080,202007,420,323,97,337535.33,102410,439945.33
521090,202007,548,354,194,369930,203775,573705
521100,202007,275,207,68,216315,72105,288420
521120,202007,1070,751,319,786885.5,334400,1121285.5
521130,202007,353,252,101,263340,105545.5,368885.5
521140,202007,179,98,81,102410,85690,188100
521150,202007,2647,1145,1502,1199660.35,1571680,2771340.35
521160,202007,32,16,16,16720,16720,33440
521170,202007,211,117,94,122265,98230,220495
521180,202007,1187,760,427,794200,447260.25,1241460.25
521190,202007,2535,1066,1469,1116060,1538240.5,2654300.5
521200,202007,54,41,13,42845,13585,56430
521205,202007,11,8,3,8360,3135,11495
521210,202007,123,72,51,75240,54340,129580
521220,202007,778,542,236,569525,246620.25,816145.25
521225,202007,33,22,11,22990,11495,34485
521230,202007,106,70,36,73150,37620,110770
521250,202007,6185,3505,2680,3665864.8,2808963,6474827.8
521260,202007,28,14,14,14630,14630,29260
521270,202007,143,111,32,115995,33440,149435
521280,202007,430,261,169,272745,176605,449350
521290,202007,27,13,14,13585,14630,28215
521295,202007,98,64,34,66880,35530,102410
521300,202007,219,121,98,126445,102410.5,228855.5
521305,202007,37,26,11,27170,11495,38665
521308,202007,1075,823,252,860035,263340,1123375
521310,202007,1339,772,567,806740,594605,1401345
521340,202007,19,15,4,15675,4180,19855
521350,202007,126,94,32,98230,33440,131670
521370,202007,178,126,52,131670,54340,186010
521375,202007,175,93,82,97185,86735,183920
521377,202007,46,35,11,36575,11495,48070
521380,202007,1066,677,389,708511.05,406505,1115016.05
521385,202007,14,9,5,9405,5225,14630
521390,202007,102,83,19,86735,20900,107635
521400,202007,345,229,116,240350,121220,361570
521405,202007,147,79,68,82555,71060,153615
521410,202007,68,47,21,49115,21945,71060
521440,202007,196,143,53,149435,55385,204820
521450,202007,731,411,320,429495,334400,763895
521460,202007,1158,745,413,780615,433675,1214290
521470,202007,12,8,4,8360,4180,12540
521480,202007,42,29,13,30305,13585.25,43890.25
521483,202007,312,183,129,191236,134805,326041
521486,202007,275,179,96,187055,101365,288420
521487,202007,23,11,12,12540,12540,25080
521490,202007,24,13,11,13585,11495,25080
521500,202007,124,78,46,81510,48070,129580
521520,202007,46,33,13,34485,13585,48070
521523,202007,717,426,291,445170,304095,749265
521525,202007,47,30,17,31350,17765,49115
521530,202007,247,134,113,140030,118085,258115
521540,202007,30,16,14,16720,14630,31350
521550,202007,87,37,50,38665,52250,90915
521560,202007,826,558,268,584155.5,280061.25,864216.75
521565,202007,61,40,21,41800,21945,63745
521570,202007,526,347,179,363660.5,188100.25,551760.75
521580,202007,57,32,25,33440,26125,59565
521590,202007,36,17,19,17765,19855,37620
521600,202007,22,12,10,12540,10450,22990
521630,202007,243,130,113,135850,118085.25,253935.25
521640,202007,308,166,142,173470,148390,321860
521645,202007,30,16,14,16720,14630,31350
521680,202007,241,149,92,155705,96140,251845
521690,202007,2,2,0,2090,0,2090
521710,202007,1151,551,600,575795,628045,1203840
521720,202007,570,399,171,416955,178695.85,595650.85
521730,202007,646,311,335,326040.5,350075,676115.5
521740,202007,905,386,519,403370,544445.5,947815.5
521760,202007,1909,991,918,1038138.78,962445.5,2000584.28
521770,202007,822,519,303,544445,318725,863170
521800,202007,2005,1294,711,1353276.5,745085,2098361.5
521805,202007,32,18,14,18810,15675,34485
521810,202007,84,54,30,56430,31350,87780
521830,202007,947,679,268,712690.09,280060,992750.09
521839,202007,88,54,34,56430,35530,91960
521850,202007,1106,579,527,606100.36,550715.5,1156815.86
521860,202007,342,212,130,221540,135850,357390
521870,202007,74,44,30,45980,31350,77330
521878,202007,33,16,17,16720,17765,34485
521880,202007,4754,2122,2632,2219581.5,2760892.5,4980474.0
521890,202007,602,428,174,447260,181830,629090
521900,202007,285,234,51,244530,53295,297825
521910,202007,162,115,47,120175,49115,169290
521920,202007,46,22,24,22990,25080,48070
521925,202007,54,31,23,32395,24035,56430
521930,202007,1165,641,524,670890.5,547580,1218470.5
521935,202007,34,25,9,26125,9405,35530
521940,202007,203,98,105,102410,110770,213180
521945,202007,15,13,2,13585,2090,15675
521950,202007,8,4,4,4180,4180,8360
521960,202007,68,51,17,53295,17765,71060
521970,202007,400,256,144,267520,150480,418000
521971,202007,99,53,46,55385,48070,103455
521973,202007,34,17,17,17765,17765,35530
521975,202007,1444,725,719,758670.41,752401.47,1511071.88
521980,202007,245,166,79,173470.5,82555,256025.5
521990,202007,79,56,23,58520,24035,82555
522000,202007,289,184,105,192960.29,110770,303730.29
522005,202007,19,10,9,10450,9405,19855
522010,202007,1129,629,500,657305,522500.5,1179805.5
522015,202007,61,37,24,38665,25080,63745
522020,202007,896,518,378,543400,396055.5,939455.5
522026,202007,23,14,9,14630,9405,24035
522028,202007,15,11,4,11495,4180,15675
522040,202007,777,317,460,333355.25,480700,814055.25
522045,202007,2333,1425,908,1490171.25,951996.25,2442167.50
522050,202007,155,75,80,78375,83600,161975
522060,202007,546,344,202,359480,211090,570570
522068,202007,113,79,34,82555,35530,118085
522070,202007,10,10,0,10450,0,10450
522100,202007,36,21,15,21945,15675,37620
522108,202007,41,31,10,32395,10450,42845
522119,202007,56,30,26,31350,27170,58520
522130,202007,79,33,46,34485,48070,82555
522140,202007,4099,2130,1969,2227940.6,2059695.5,4287636.1
522145,202007,47,32,15,33440,15675,49115
522150,202007,90,67,23,70015,24035,94050
522155,202007,52,35,17,36575,17765,54340
522157,202007,5,3,2,3135,2090,5225
522160,202007,1701,1008,693,1053360,726275,1779635
522170,202007,396,266,130,279015,135850,414865
522180,202007,39,18,21,18810,21945,40755
522185,202007,2072,827,1245,865261,1302070,2167331
522190,202007,49,26,23,27170,24035,51205
522200,202007,298,175,123,182875,128535,311410
522205,202007,143,97,46,101365,48070,149435
522220,202007,149,110,39,114950,40755,155705
522230,202007,35,25,10,26125,10450,36575
530010,202007,54384,27479,26905,28755556.8,28186801.55,56942358.35
110001,202008,500,400,100,418000,105545,523545
110002,202008,2826,1753,1073,1835020.5,1124420.5,2959441.0
110003,202008,83,69,14,72105,14630,86735
110004,202008,2018,1319,699,1380446.5,730455,2110901.5
110005,202008,437,347,90,363660.5,94050,457710.5
110006,202008,447,345,102,360525.5,107635,468160.5
110007,202008,69,57,12,59565,12540,72105
110008,202008,237,135,102,141075,106590,247665
110009,202008,875,633,242,662530,253935,916465
110010,202008,1712,1054,658,1104565.5,687610,1792175.5
110011,202008,1770,1373,397,1436875,414865,1851740
110012,202008,4106,2381,1725,2489190.56,1805760.5,4294951.06
110013,202008,771,616,155,644765,161975,806740
110014,202008,374,325,49,339625.5,51205,390830.5
110015,202008,1375,1109,266,1158906.55,279015,1437921.55
110018,202008,1101,686,415,716870,436810,1153680
110020,202008,15537,8892,6645,9302597.56,6953432.1,16256029.66
110025,202008,624,460,164,480700.5,172425,653125.5
110026,202008,38,27,11,28215,11495,39710
110028,202008,1627,1177,450,1232055.85,472341.5,1704397.35
110029,202008,138,124,14,130625,14630,145255
110030,202008,2428,1616,812,1689598.22,851676.35,2541274.57
110032,202008,314,241,73,251845.17,76285,328130.17
110033,202008,662,484,178,505780,186010,691790
110034,202008,353,262,91,274835.67,96140,370975.67
110037,202008,99,86,13,89870,13585,103455
110040,202008,375,254,121,265430,126445,391875
110045,202008,933,642,291,671239.33,304095.6,975334.93
110050,202008,92,80,12,83600.5,12540,96140.5
110060,202008,67,39,28,40755,29260,70015
110070,202008,109,71,38,74195,39710,113905
110080,202008,480,266,214,277970,223630,501600
110090,202008,30,26,4,27170,4180,31350
110092,202008,98,53,45,55385,47025,102410
110094,202008,201,145,56,151525,58520,210045
110100,202008,35,27,8,28215,8360,36575
110110,202008,91,49,42,51205,44935,96140
110120,202008,67,56,11,59565,11495,71060
110130,202008,289,236,53,248710,55385,304095
110140,202008,237,164,73,171380,77330,248710
110143,202008,45,37,8,38665,8360,47025
110145,202008,26,20,6,20900,6270,27170
110146,202008,22,12,10,12540,10450,22990
110147,202008,38,27,11,28215,11495,39710
110148,202008,34,23,11,24035,11495,35530
110149,202008,311,220,91,229900,95095,324995
110150,202008,130,99,31,103455,32395,135850
110155,202008,8,7,1,7315,1045,8360
110160,202008,68,54,14,56430,14630,71060
110170,202008,220,170,50,177650,52250,229900
110175,202008,67,50,17,52250,17765,70015
110180,202008,89,74,15,77330,15675,93005
120001,202008,214,160,54,167200,56430,223630
120005,202008,197,115,82,120175,86735,206910
120010,202008,1108,692,416,723140.72,435765,1158905.72
120013,202008,144,98,46,102410,48070,150480
120017,202008,107,61,46,63745,48070,111815
120020,202008,3549,2864,685,2993926.18,716870.5,3710796.68
120025,202008,541,307,234,320815.77,245575,566390.77
120030,202008,1079,923,156,965581.36,163020,1128601.36
120032,202008,37,35,2,36575,2090,38665
120033,202008,214,188,26,196460,27170,223630
120034,202008,173,125,48,130625.5,50160,180785.5
120035,202008,40,32,8,33440,8360,41800
120038,202008,406,265,141,276925,148390,425315
120039,202008,29,28,1,29260,1045,30305
120040,202008,14108,9643,4465,10083556.27,4674285.5,14757841.77
120042,202008,43,38,5,39710,5225,44935
120043,202008,11,3,8,3135,8360,11495
120045,202008,546,347,199,362615,209000,571615
120050,202008,1283,978,305,1023055.69,318725,1341780.69
120060,202008,1469,1207,262,1263405,275880,1539285
120070,202008,430,307,123,322905.82,128535,451440.82
120080,202008,176,109,67,113905,70015,183920
130002,202008,147,106,41,110770,42845,153615
130006,202008,102,65,37,67925,38665,106590
130008,202008,133,72,61,75240,63745,138985
130010,202008,148,83,65,86735,67925,154660
130014,202008,277,202,75,211090,78375,289465
130020,202008,103,63,40,65835,41800,107635
130030,202008,959,571,388,596695,405460,1002155
130040,202008,340,167,173,174515,180785,355300
130050,202008,567,292,275,305140,289465,594605
130060,202008,854,584,270,610280,282150,892430
130063,202008,595,341,254,356345,265430,621775
130068,202008,190,121,69,126445,72105,198550
130070,202008,1328,906,422,946770,440990,1387760
130080,202008,700,460,240,480700,250800,731500
130083,202008,71,39,32,40755,33440,74195
130090,202008,334,166,168,173470,175560,349030
130100,202008,1106,474,632,495330,660440,1155770
130110,202008,739,307,432,320815,452485,773300
130115,202008,161,67,94,71060,99275,170335
130120,202008,1632,1038,594,1085755,621775,1707530
130130,202008,620,422,198,440990,206910,647900
130140,202008,1534,1197,337,1250865,352165,1603030
130150,202008,416,364,52,380380,54340,434720
130160,202008,461,265,196,276925,204820,481745
130165,202008,41,32,9,33440,9405,42845
130170,202008,963,663,300,692768.12,315590,1008358.12
130180,202008,234,174,60,181830,62700,244530
130185,202008,2325,1079,1246,1127555,1303116,2430671
130190,202008,3428,2161,1267,2262425.5,1325060,3587485.5
130195,202008,278,222,56,231990,58520,290510
130200,202008,178,78,100,82555,104500,187055
130210,202008,77,38,39,39710,40755,80465
130220,202008,180,123,57,128535,59565,188100
130230,202008,379,246,133,258115,138985,397100
130240,202008,1331,838,493,875710,519365,1395075
130250,202008,4702,3007,1695,3143360,1773365,4916725
130255,202008,421,196,225,204820,235125,439945
130260,202008,57178,26911,30267,28158495.08,31666641.5,59825136.58
130270,202008,1525,1030,495,1078534.05,520410,1598944.05
130280,202008,123,70,53,73150,55385,128535
130290,202008,2121,1480,641,1546600,669845,2216445
130300,202008,430,303,127,316635,132715,449350
130310,202008,921,484,437,506825,456665,963490
130320,202008,519,277,242,289465,252890,542355
130330,202008,748,467,281,488015,293645,781660
130340,202008,3525,2017,1508,2107766,1577950.5,3685716.5
130350,202008,483,322,161,336490,168245,504735
130353,202008,933,400,533,420090,558030,978120
130356,202008,807,363,444,379335,463980,843315
130360,202008,88,66,22,68970,22990,91960
130370,202008,710,547,163,572660,170335,742995
130380,202008,675,521,154,544445,160930,705375
130390,202008,488,393,95,410685,99275,509960
130395,202008,163,38,125,39710,131670,171380
130400,202008,67,44,23,45980,24035,70015
130406,202008,2082,1258,824,1314610.5,861080,2175690.5
130410,202008,443,206,237,215270,248710,463980
130420,202008,2938,2385,553,2495460.75,583110,3078570.75
130423,202008,153,80,73,83600,76285,159885
130426,202008,152,81,71,84645,74195,158840
130430,202008,408,255,153,266475,161975,428450
130440,202008,195,64,131,66880,137069.16,203949.16
140002,202008,33,10,23,10450,24035,34485
140005,202008,202,123,79,128535,82555,211090
140010,202008,10371,6611,3760,6918950.76,3938607.15,10857557.91
140015,202008,126,56,70,58520,74195,132715
140017,202008,122,77,45,80465,47025,127490
140020,202008,471,308,163,321860,170335,492195
140023,202008,48,22,26,22990.35,27170,50160.35
140028,202008,22,13,9,13585,9405,22990
140030,202008,350,244,106,254980,110770,365750
140040,202008,64,41,23,42845,24035,66880
140045,202008,250,97,153,101365,159885,261250
140047,202008,633,407,226,425315.5,236170,661485.5
140050,202008,155,94,61,98230,63745,161975
140060,202008,48,34,14,35530,14630,50160
140070,202008,31,29,2,30305,2090,32395
150010,202008,4673,2844,1829,2973025.5,1913395.5,4886421.0
150013,202008,160,109,51,113905,53295,167200
150020,202008,1084,581,503,607145,525635,1132780
150030,202008,667,279,388,291555,405460,697015
150034,202008,193,124,69,129580,72105,201685
150040,202008,1473,843,630,880935,660440,1541375
150050,202008,663,375,288,391875,300960,692835
150060,202008,4841,3066,1775,3208062,1859487.63,5067549.63
150070,202008,335,147,188,153615,196460,350075
150080,202008,15048,7097,7951,7420548.2,8311933.5,15732481.7
150085,202008,425,267,158,279015,165110,444125
150090,202008,730,616,114,643720,119130,762850
150095,202008,359,224,135,234080,141075,375155
150100,202008,60,38,22,39710,22990,62700
150110,202008,200,103,97,107635,101365,209000
150120,202008,408,294,114,308275,119130,427405
150125,202008,46,17,29,17765,30305,48070
150130,202008,2003,1057,946,1105610,988570,2094180
150140,202008,54524,24696,29828,25831364.92,31207886.92,57039251.84
150145,202008,200,105,95,109725,100320,210045
150150,202008,2927,1275,1652,1333420,1726341,3059761
150157,202008,393,275,118,287375.5,124355,411730.5
150160,202008,130,101,29,105545,30305,135850
150170,202008,3618,2688,930,2808960,971850,3780810
150172,202008,337,232,105,242440,109725,352165
150175,202008,79,48,31,50160,32395,82555
150178,202008,765,504,261,526680,272745,799425
150180,202008,3153,1547,1606,1618705.25,1679315.5,3298020.75
150190,202008,338,213,125,222585,130625,353210
150195,202008,108,57,51,59565,53295,112860
150200,202008,195,93,102,97185,106590,203775
150210,202008,3121,2506,615,2620860,642675,3263535
150215,202008,550,354,196,369930,205865,575795
150220,202008,3608,2414,1194,2524721.32,1249820.6,3774541.92
150230,202008,1185,953,232,995885.37,242440,1238325.37
150240,202008,6278,3576,2702,3737965.6,2824635,6562600.6
150250,202008,46,19,27,19855,28215,48070
150260,202008,88,56,32,58520,33440,91960
150270,202008,2231,1450,781,1516295,816145.5,2332440.5
150275,202008,523,329,194,343805,202730,546535
150276,202008,107,42,65,43890,67925,111815
150277,202008,777,333,444,349030,465025,814055
150280,202008,338,215,123,224675,128535,353210
150285,202008,103,52,51,54340,53295,107635
150290,202008,976,578,398,604010,415910.5,1019920.5
150293,202008,669,312,357,326040,373065,699105
150295,202008,495,222,273,231990,286330.5,518320.5
150300,202008,80,37,43,38665,44935,83600
150304,202008,174,104,70,108680,73150,181830
150307,202008,395,326,69,340670,72105,412775
150309,202008,574,410,164,428450,172425,600875
150310,202008,238,157,81,164065,84645,248710
150320,202008,1900,1325,575,1385670,600875,1986545
150330,202008,2017,1170,847,1223695,885115,2108810
150340,202008,195,130,65,135850,67925,203775
150345,202008,631,349,282,364705,296780,661485
150350,202008,408,318,90,332310,94050,426360
150360,202008,4664,2886,1778,3016915.75,1863235,4880150.75
150370,202008,818,554,264,578930.71,275880,854810.71
150375,202008,193,89,104,93005,108680,201685
150380,202008,1482,982,500,1027235,522500,1549735
150390,202008,794,459,335,479655,350075,829730
150400,202008,107,89,18,94050,18810,112860
150405,202008,1234,782,452,818235,472340,1290575
150410,202008,122,80,42,83600,43890,127490
150420,202008,7326,3952,3374,4135236.5,3528965.5,7664202.0
150430,202008,594,381,213,398145,222585,620730
150440,202008,585,362,223,378290,233035,611325
150442,202008,2300,1217,1083,1271766,1132780,2404546
150445,202008,542,349,193,364705,201685,566390
150450,202008,224,118,106,123310,110770,234080
150460,202008,736,547,189,571615,197505,769120
150470,202008,1305,777,528,811965,551760,1363725
150475,202008,228,174,54,181830,56430,238260
150480,202008,1303,901,402,941545,420090,1361635
150490,202008,663,391,272,409640,284240,693880
150495,202008,333,246,87,257070,90915,347985
150497,202008,283,193,90,201685,94050,295735
150500,202008,221,136,85,142120,88825,230945
150503,202008,1019,503,516,525635.5,539220,1064855.5
150506,202008,919,611,308,638495,322905,961400
150510,202008,1244,690,554,721050.5,581020,1302070.5
150520,202008,278,182,96,190190,100320,290510
150530,202008,1714,936,778,979165.64,813010,1792175.64
150540,202008,226,164,62,171380,64790,236170
150543,202008,817,424,393,444125,411730,855855
150548,202008,469,333,136,347985,142120,490105
150549,202008,60,42,18,43890,18810,62700
150550,202008,2926,1474,1452,1542420.25,1519430,3061850.25
150553,202008,3338,1895,1443,1986547,1510025,3496572
150555,202008,145,77,68,80465,71060,151525
150560,202008,31,14,17,14630,17765,32395
150563,202008,93,47,46,49115,48070,97185
150565,202008,186,110,76,114950,79420,194370
150570,202008,428,285,143,297825,149435,447260
150580,202008,1662,797,865,832865,903925,1736790
150590,202008,809,532,277,555940,290510,846450
150600,202008,465,279,186,291555,194370,485925
150610,202008,143,119,24,124355,25080,149435
150611,202008,120,82,38,85690,39710,125400
150613,202008,3226,1913,1313,2003265,1375220.5,3378485.5
150616,202008,523,300,223,313500,233035,546535
150618,202008,1319,696,623,727320,652080,1379400
150619,202008,388,294,94,308275,98230,406505
150620,202008,1252,728,524,761805,547580,1309385
150630,202008,305,196,109,204820,113905,318725
150635,202008,455,190,265,198550,276925,475475
150640,202008,53,27,26,28215,27170,55385
150650,202008,2364,1365,999,1427470.5,1043955.5,2471426.0
150655,202008,239,179,60,187055,62700,249755
150658,202008,86,48,38,50160,39710,89870
150660,202008,538,350,188,365750,196460,562210
150670,202008,1065,372,693,389785,724185,1113970
150680,202008,10024,5235,4789,5473711.19,5009730,10483441.19
150690,202008,19,10,9,10450,9405,19855
150700,202008,478,312,166,326040,173470,499510
150710,202008,278,150,128,156750,133760,290510
150715,202008,817,505,312,527725,326040,853765
150720,202008,410,316,94,330220,98230,428450
150730,202008,1017,513,504,536085,526680,1062765
150740,202008,230,152,78,158840,81510,240350
150745,202008,786,429,357,448305,373065,821370
150746,202008,62,35,27,36575,28215,64790
150747,202008,229,174,55,181830,57475,239305
150750,202008,137,76,61,79420,63745,143165
150760,202008,1822,1183,639,1237280.62,668800,1906080.62
150770,202008,393,216,177,225720,184965,410685
150775,202008,101,47,54,49115,56430,105545
150780,202008,190,107,83,111815,86735,198550
150790,202008,830,455,375,476520,392920,869440
150795,202008,1520,899,621,940500,648945,1589445
150796,202008,356,204,152,213180,158840,372020
150797,202008,331,161,170,168245,177650,345895
150800,202008,1477,842,635,879890,663575,1543465
150803,202008,548,443,105,462935,109725,572660
150805,202008,201,119,82,124355,85690,210045
150808,202008,986,530,456,554895,477565,1032460
150810,202008,3262,2221,1041,2320945.97,1088890.5,3409836.47
150812,202008,434,221,213,230945,223630,454575
150815,202008,1029,641,388,670890,405460,1076350
150820,202008,1532,909,623,950950,652080,1603030
150830,202008,738,543,195,567435,203775,771210
150835,202008,204,118,86,123310,89870,213180
150840,202008,1382,844,538,881980,563255,1445235
160005,202008,62,43,19,44935,19855,64790
160010,202008,193,125,68,130625,71060,201685
160015,202008,129,75,54,78375,56430,134805
160020,202008,134,76,58,79420,61655,141075
160021,202008,60,26,34,28215,35530,63745
160023,202008,65,44,21,45980,21945,67925
160025,202008,23,11,12,11495,14630,26125
160027,202008,1487,844,643,883025.25,672980,1556005.25
160030,202008,15862,8124,7738,8497942.6,8095615.5,16593558.1
160040,202008,290,167,123,174515,128535,303050
160050,202008,712,362,350,379335,366795,746130
160053,202008,280,166,114,173470.16,120175,293645.16
160055,202008,28,19,9,19855,9405,29260
160060,202008,6531,3440,3091,3595846.25,3233230.5,6829076.75
160070,202008,173,102,71,106590,74195,180785
160080,202008,108,51,57,53295,59565,112860
170025,202008,28,15,13,15675,13585,29260
170030,202008,212,171,41,178695.62,42845,221540.62
170035,202008,225,107,118,111815,123310,235125
170040,202008,182,137,45,143165.08,47025,190190.08
170070,202008,319,197,122,205865,128535,334400
170100,202008,353,258,95,270655,100320,370975
170105,202008,57,45,12,47025,12540,59565
170110,202008,117,72,45,75240,47025,122265
170130,202008,70,33,37,34485,38665,73150
170190,202008,98,59,39,61655,40755,102410
170200,202008,376,256,120,267520,125400,392920
170210,202008,6138,3228,2910,3376396.63,3044087.43,6420484.06
170215,202008,116,49,67,51205,70015,121220
170220,202008,1381,1016,365,1061720,383515,1445235
170230,202008,149,97,52,101365,54340,155705
170240,202008,520,349,171,366795,180785,547580
170255,202008,1079,876,203,916465,212135,1128600
170270,202008,45,32,13,33440,13585,47025
170290,202008,116,78,38,81510,39710,121220
170300,202008,95,62,33,64790,34485,99275
170305,202008,48,37,11,38665,11495,50160
170307,202008,64,49,15,51205,15675,66880
170310,202008,117,65,52,67925,54340,122265
170320,202008,26,17,9,17765,9405,27170
170330,202008,27,24,3,25080,3135,28215
170360,202008,31,18,13,18810,13585,32395
170370,202008,104,51,53,53295,55385,108680
170380,202008,74,57,17,59565,17765,77330
170382,202008,44,36,8,37620,8360,45980
170384,202008,139,108,31,112860,32395,145255
170386,202008,65,25,40,26125,41800,67925
170388,202008,47,18,29,18810,30305,49115
170389,202008,26,21,5,21945,5225,27170
170390,202008,70,40,30,41800,31350,73150
170410,202008,33,26,7,27170,7315,34485
170460,202008,17,11,6,11495,6270,17765
170510,202008,36,28,8,29260,8360,37620
170550,202008,1561,904,657,944680,687610,1632290
170555,202008,109,79,30,82555,31350,113905
170560,202008,109,76,33,79420,34485,113905
170600,202008,37,16,21,16720,21945,38665
170610,202008,196,102,94,106590,98230.5,204820.5
170625,202008,35,20,15,20900,15675,36575
170650,202008,79,57,22,59565,22990,82555
170700,202008,580,437,143,456665.25,149435,606100.25
170710,202008,160,100,60,104500,63745,168245
170720,202008,90,72,18,75240,18810,94050
170730,202008,83,49,34,51205,35530,86735
170740,202008,84,60,24,62700,25080,87780
170755,202008,64,33,31,34485,32395,66880
170765,202008,140,75,65,78375,67925,146300
170770,202008,206,129,77,135850,80465,216315
170820,202008,604,400,204,418000,213180.5,631180.5
170825,202008,36,19,17,19855,17765,37620
170830,202008,83,68,15,71060,15675,86735
170900,202008,180,140,40,146300,41800,188100
170930,202008,911,484,427,505780.8,446215.5,951996.3
170950,202008,3131,1425,1706,1491215,1786950.88,3278165.88
170980,202008,15,10,5,10450,5225,15675
171050,202008,145,112,33,117040,34485,151525
171070,202008,36,30,6,31350,6270,37620
171090,202008,47,34,13,35530,13585,49115
171110,202008,23,16,7,16720,7315,24035
171150,202008,40,21,19,21945,19855,41800
171180,202008,27,14,13,14630,13585,28215
171190,202008,153,86,67,89870,70015,159885
171195,202008,65,55,10,57475,10450,67925
171200,202008,49,25,24,26125,25080,51205
171215,202008,4,3,1,3135,1045,4180
171240,202008,60,42,18,43890,18810,62700
171245,202008,56,48,8,50160,8360,58520
171250,202008,75,42,33,43890,34485,78375
171270,202008,15,10,5,10450,5225,15675
171280,202008,40,36,4,37620,5225,42845
171320,202008,994,572,422,597740,440990,1038730
171330,202008,426,211,215,220495,225720,446215
171360,202008,87,62,25,64790,26125,90915
171370,202008,37,18,19,18810,19855,38665
171380,202008,131,112,19,117040,19855,136895
171395,202008,53,33,20,34485,20900,55385
171420,202008,282,182,100,190190,104500,294690
171430,202008,72,59,13,61655,13585,75240
171488,202008,178,99,79,103455,82555,186010
171500,202008,57,34,23,35530,24035,59565
171510,202008,72,46,26,48070,27170,75240
171515,202008,44,35,9,36575,9405,45980
171525,202008,31,29,2,30305,2090,32395
171550,202008,13,9,4,9405,4180,13585
171570,202008,52,27,25,28215,26125,54340
171575,202008,307,200,107,209000,111815,320815
171610,202008,1757,885,872,924825,917510,1842335
171620,202008,139,96,43,100320,44935,145255
171630,202008,56,28,28,29260,29260,58520
171650,202008,297,203,94,212135,99275,311410
171660,202008,267,151,116,157795,121220.5,279015.5
171665,202008,62,42,20,43890,20900,64790
171670,202008,431,258,173,269610.25,180785,450395.25
171700,202008,64,58,6,60610,6270,66880
171720,202008,28,10,18,10450,18810,29260
171750,202008,100,52,48,55385,50160,105545
171780,202008,71,56,15,59565,15675,75240
171790,202008,80,68,12,71060,12540,83600
171800,202008,32,23,9,24035,9405,33440
171820,202008,2100,1199,901,1252955.46,942590.5,2195545.96
171830,202008,33,26,7,27170,7315,34485
171840,202008,65,42,23,43890,25080,68970
171845,202008,31,19,12,19855,12540,32395
171850,202008,41,31,10,32395,10450,42845
171855,202008,78,60,18,62700,18810,81510
171865,202008,7,6,1,6270,1045,7315
171870,202008,34,24,10,25080,10450,35530
171875,202008,79,55,24,57475,25080,82555
171880,202008,35,22,13,22990,13585,36575
171884,202008,50,27,23,28215,24035,52250
171886,202008,134,54,80,56430,83600,140030
171888,202008,29,23,6,24035,6270,30305
171889,202008,18,12,6,12540,6270,18810
171890,202008,56,48,8,50160,8360,58520
171900,202008,34,25,9,26125,9405,35530
172000,202008,40,31,9,33440,9405,42845
172010,202008,52,41,11,42845,11495,54340
172015,202008,27,17,10,17765.45,10450,28215.45
172020,202008,141,88,53,93005,55385,148390
172025,202008,40,26,14,27170,14630,41800
172030,202008,42,24,18,25080,18810,43890
172049,202008,84,55,29,58520,30305,88825
172065,202008,141,91,50,95095,52250,147345
172080,202008,107,70,37,73150,38665,111815
172085,202008,27,14,13,14630,13585,28215
172090,202008,427,325,102,339625.03,106590,446215.03
172093,202008,14,12,2,13585,2090,15675
172097,202008,20,13,7,13585,7315,20900
172100,202008,5094,2881,2213,3012735.75,2318855.7,5331591.45
172110,202008,79,48,31,50160,32395,82555
172120,202008,1650,1386,264,1450462.45,275880,1726342.45
172125,202008,11,10,1,10450,1045,11495
172130,202008,22,13,9,13585,9405,22990
172208,202008,200,122,78,127490,82555,210045
172210,202008,387,184,203,193325,212135,405460
210005,202008,2976,1863,1113,1947880.15,1164134,3112014.15
210010,202008,160,91,69,95095,72105,167200
210015,202008,39,29,10,30305,10450,40755
210020,202008,356,199,157,207955,164065,372020
210030,202008,327,213,114,222585,119130,341715
210040,202008,139,111,28,115995,29260,145255
210043,202008,253,191,62,199595,64790,264385
210047,202008,521,311,210,324995,219450,544445
210050,202008,284,209,75,218405,78375,296780
210055,202008,48,38,10,39710,10450,50160
210060,202008,546,435,111,454575,115995,570570
210070,202008,411,317,94,331265,98230,429495
210080,202008,121,109,12,113905,12540,126445
210083,202008,298,146,152,152570,158840,311410
210087,202008,2,1,1,1045,1045,2090
210090,202008,446,320,126,335445,131670,467115
210095,202008,435,333,102,347985,106590,454575
210100,202008,706,547,159,571615,166155,737770
210110,202008,124,78,46,81510,48070,129580
210120,202008,5055,3945,1110,4124617.35,1159950.12,5284567.47
210125,202008,197,120,77,125400,80465,205865
210130,202008,475,271,204,283195,213180,496375
210135,202008,27,19,8,19855,8360,28215
210140,202008,4372,3409,963,3564495,1008425,4572920
210150,202008,377,238,139,248710,145255,393965
210160,202008,3279,2783,496,2908236.36,518320,3426556.36
210170,202008,1153,927,226,968715,236170,1204885
210173,202008,126,111,15,115995,15675,131670
210177,202008,358,203,155,212135,161975,374110
210180,202008,31,17,14,17765,14630,32395
210190,202008,429,285,144,297825,150480,448305
210193,202008,1,1,0,1045,0,1045
210197,202008,73,53,20,55385,20900,76285
210200,202008,618,512,106,535040,110770,645810
210203,202008,229,154,75,160930,78375,239305
210207,202008,365,300,65,313500,67925,381425
210210,202008,751,693,58,724185,60610,784795
210215,202008,72,65,7,67925,7315,75240
210220,202008,386,328,58,342760,60610,403370
210230,202008,311,248,63,259160,65835,324995
210232,202008,1383,942,441,984390,460845,1445235
210235,202008,166,126,40,131670,41800,173470
210237,202008,37,23,14,24035,14630,38665
210240,202008,87,75,12,78375,12540,90915
210250,202008,179,154,25,160930,26125,187055
210255,202008,352,265,87,276925,90915,367840
210260,202008,393,271,122,283195,127490,410685
210270,202008,648,435,213,454575,222585,677160
210275,202008,76,60,16,62700,16720,79420
210280,202008,1047,698,349,729410.7,365750,1095160.7
210290,202008,534,359,175,375155,182875,558030
210300,202008,5322,3358,1964,3509110.93,2052380,5561490.93
210310,202008,113,78,35,81510,36575,118085
210312,202008,117,79,38,82555,39710,122265
210315,202008,106,87,19,90915,19855,110770
210317,202008,132,99,33,103455,34485,137940
210320,202008,2318,1970,348,2059695,363660,2423355
210325,202008,138,88,50,93005.5,53295.5,146301.0
210330,202008,4524,2597,1927,2715955.75,2014760,4730715.75
210340,202008,1250,935,315,978120,330220.5,1308340.5
210350,202008,630,524,106,547580,110770,658350
210355,202008,145,119,26,124355,27170,151525
210360,202008,2232,1539,693,1608255,724185,2332440
210370,202008,1218,598,620,624910,647900,1272810
210375,202008,187,95,92,99275,96140,195415
210380,202008,706,541,165,565345,172425,737770
210390,202008,194,166,28,173470,29260,202730
210400,202008,394,342,52,357390,54340,411730
210405,202008,985,688,297,720005,311410,1031415
210407,202008,52,42,10,43890,10450,54340
210408,202008,59,52,7,54340,7315,61655
210409,202008,326,284,42,296780,43890,340670
210410,202008,439,343,96,358435,100320,458755
210420,202008,201,167,34,176605,35530,212135
210430,202008,52,35,17,36575,17765,54340
210440,202008,335,227,108,237215,112860,350075
210450,202008,141,113,28,118085,29260,147345
210455,202008,228,121,107,126445.5,111815,238260.5
210460,202008,300,202,98,211090,102410,313500
210462,202008,64,53,11,55385,11495,66880
210465,202008,142,110,32,114950,33440,148390
210467,202008,522,384,138,401280,144210,545490
210470,202008,50,43,7,44935,7315,52250
210480,202008,1266,908,358,948860,374110,1322970
210490,202008,203,134,69,140030,72105,212135
210500,202008,510,309,201,322905,210045,532950
210510,202008,556,441,115,460845,120175,581020
210515,202008,365,229,136,239305,142120,381425
210520,202008,400,361,39,377245,40755,418000
210530,202008,9305,4900,4405,5125730.05,4606363.74,9732093.79
210535,202008,129,96,33,100320,34485,134805
210540,202008,1500,1002,498,1047090,520410,1567500
210542,202008,1182,610,572,637450,597741,1235191
210545,202008,18,16,2,16720,2090,18810
210547,202008,128,112,16,117040,16720,133760
210550,202008,679,495,184,518320.6,192280,710600.6
210560,202008,158,139,19,145255,19855,165110
210565,202008,21,16,5,16720,5225,21945
210570,202008,1298,1056,242,1104565.11,252890,1357455.11
210580,202008,122,104,18,108680,18810,127490
210590,202008,730,602,128,629090,133760,762850
210592,202008,35,33,2,34485,2090,36575
210594,202008,110,94,16,98230,16720,114950
210596,202008,98,83,15,86735,15675,102410
210598,202008,134,101,33,105545,34485,140030
210600,202008,316,272,44,284240,45980,330220
210610,202008,256,241,15,252890,16720,269610
210620,202008,42,28,14,29260,14630,43890
210630,202008,73,71,2,75240,2090,77330
210632,202008,1020,720,300,754490,314545,1069035
210635,202008,22,19,3,19855,3135,22990
210637,202008,116,85,31,88825,32395,121220
210640,202008,596,522,74,545490,77330,622820
210650,202008,397,329,68,343805,71060,414865
210660,202008,378,298,80,311410,83600,395010
210663,202008,34,24,10,25080,10450,35530
210667,202008,100,40,60,41800,62700,104500
210670,202008,246,219,27,228855,29260,258115
210675,202008,538,296,242,309320,252890,562210
210680,202008,223,144,79,150480,82555,233035
210690,202008,617,510,107,533995,111815,645810
210700,202008,156,119,37,124355,38665,163020
210710,202008,245,157,88,164065,91960,256025
210720,202008,129,115,14,120175,14630,134805
210725,202008,66,58,8,60610,8360,68970
210730,202008,25,18,7,18810,7315,26125
210735,202008,287,204,83,213180,86735.5,299915.5
210740,202008,524,452,72,473385,75240,548625
210745,202008,153,114,39,119130,40755,159885
210750,202008,2371,1206,1165,1260270.25,1218471,2478741.25
210760,202008,262,200,62,209000,64790,273790
210770,202008,379,297,82,310365,85690,396055
210780,202008,446,332,114,346940,119130,466070
210790,202008,185,152,33,158840,34485,193325
210800,202008,175,133,42,138985,43890,182875
210805,202008,54,49,5,51205,5225,56430
210810,202008,469,382,87,399190,90915,490105
210820,202008,2129,1766,363,1846515.9,379335,2225850.9
210825,202008,156,90,66,94050,68970,163020
210830,202008,740,488,252,509960,263340,773300
210840,202008,196,138,58,144210,60610,204820
210845,202008,231,164,67,171380,70015,241395
210850,202008,758,520,238,543400,248710,792110
210860,202008,3728,2100,1628,2195545.25,1701260,3896805.25
210870,202008,428,341,87,356345,91960,448305
210880,202008,73,56,17,58520,17765,76285
210890,202008,320,276,44,288420,45980,334400
210900,202008,627,408,219,426360,229900,656260
210905,202008,61,32,29,33440,30305,63745
210910,202008,1945,1467,478,1534061.06,499510,2033571.06
210920,202008,160,63,97,65835,101365,167200
210923,202008,83,65,18,67925,18810,86735
210927,202008,410,191,219,199595,228855,428450
210930,202008,73,58,15,60610,15675,76285
210940,202008,83,65,18,67925,18810,86735
210945,202008,193,103,90,107635,94050,201685
210950,202008,531,385,146,402325,153615,555940
210955,202008,83,53,30,55385,31350,86735
210960,202008,2154,1084,1070,1132780,1118150,2250930
210970,202008,116,102,14,106590,14630,121220
210975,202008,81,75,6,78375,6270,84645
210980,202008,1084,526,558,549670,583110.5,1132780.5
210990,202008,4021,2655,1366,2776565,1428515,4205080
211000,202008,1319,1067,252,1116060.5,264385,1380445.5
211003,202008,983,702,281,733590,295735,1029325
211010,202008,502,447,55,467115,57475,524590
211020,202008,1437,617,820,644765,856900,1501665
211023,202008,33,30,3,31350,3135,34485
211027,202008,72,53,19,55385,19855,75240
211030,202008,372,264,108,275880,112860,388740
211040,202008,299,248,51,259160.5,53295,312455.5
211050,202008,1158,773,385,807785,402325.5,1210110.5
211060,202008,631,550,81,574751,85690.46,660441.46
211065,202008,21,17,4,17765,4180,21945
211070,202008,894,743,151,776436.15,157795,934231.15
211080,202008,87,83,4,86735,4180,90915
211085,202008,54,28,26,29260,27170,56430
211090,202008,81,67,14,70015,14630,84645
211100,202008,492,406,86,424270,89870.5,514140.5
211102,202008,253,180,73,188100,76285,264385
211105,202008,220,155,65,161975,67925,229900
211107,202008,131,83,48,86735,50160,136895
211110,202008,812,530,282,554895,296780,851675
211120,202008,5272,2628,2644,2748351.05,2764025.4,5512376.45
211125,202008,34,25,9,26125,9405,35530
211130,202008,41505,19058,22447,19929200.85,23474882.75,43404083.60
211140,202008,400,348,52,363660,54340,418000
211150,202008,1217,819,398,856900,415910.5,1272810.5
211153,202008,169,105,64,109725,66880,176605
211157,202008,65,51,14,53295,14630,67925
211160,202008,703,601,102,628045,106590,734635
211163,202008,1,1,0,1045,0,1045
211167,202008,10,9,1,9405,1045,10450
211170,202008,424,313,111,327085,115995,443080
211172,202008,119,82,37,85690,38665,124355
211174,202008,252,156,96,163020,100320,263340
211176,202008,483,360,123,376200.5,128535,504735.5
211178,202008,93,63,30,65835,31350,97185
211180,202008,203,162,41,169290,42845,212135
211190,202008,72,66,6,68970,6270,75240
211195,202008,35,24,11,25080,11495,36575
211200,202008,149,129,20,134805,20900,155705
211210,202008,437,321,116,336490,121220,457710
211220,202008,4082,2386,1696,2494417.07,1775456.5,4269873.57
211223,202008,93,90,3,94050,3135,97185
211227,202008,67,53,14,55385,14630,70015
211230,202008,736,607,129,634315,134805,769120
211240,202008,403,316,87,330220,90915,421135
211245,202008,182,90,92,94050,96140,190190
211250,202008,1552,1334,218,1396120,227810,1623930
211260,202008,810,664,146,693880,152570,846450
211270,202008,1949,1599,350,1673045.5,365750.5,2038796.0
211280,202008,1745,1124,621,1175625,649990,1825615
211285,202008,203,125,78,130625,81510,212135
211290,202008,696,486,210,507870,219450,727320
211300,202008,764,606,158,633270,165110,798380
211400,202008,1516,942,574,985435,599830,1585265
220005,202008,15,14,1,14630,1045,15675
220010,202008,87,68,19,71060,19855,90915
220020,202008,698,554,144,579975,150480,730455
220025,202008,110,108,2,112860,2090,114950
220027,202008,44,35,9,36575,9405,45980
220030,202008,112,90,22,94050,22990,117040
220040,202008,1245,945,300,990660,314545,1305205
220045,202008,34,22,12,22990,12540,35530
220050,202008,685,574,111,599830.61,115995,715825.61
220060,202008,167,147,20,153615,20900,174515
220070,202008,110,100,10,104500,10450,114950
220080,202008,15,13,2,13585,2090,15675
220090,202008,33,27,6,28215,6270,34485
220095,202008,2,1,1,1045,1045,2090
220100,202008,20,16,4,16720,4180,20900
220105,202008,25,23,2,24035.5,2090,26125.5
220110,202008,224,204,20,213180,20900,234080
220115,202008,36,35,1,36575,1045,37620
220117,202008,21,20,1,20900,1045,21945
220120,202008,1477,1127,350,1178760,366795,1545555
220130,202008,31,30,1,31350,1045,32395
220140,202008,107,84,23,87780,24035,111815
220150,202008,498,368,130,385605,135850,521455
220155,202008,6,6,0,6270,0,6270
220157,202008,19,15,4,15675,4180,19855
220160,202008,90,80,10,83600,10450,94050
220170,202008,33,32,1,33440,1045,34485
220173,202008,7,7,0,7315,0,7315
220177,202008,9,9,0,9405,0,9405
220180,202008,67,66,1,68970,1045,70015
220190,202008,1064,946,118,988570,123310,1111880
220191,202008,46,39,7,40755,7315,48070
220192,202008,79,76,3,79420,3135,82555
220194,202008,54,51,3,53295,3135,56430
220196,202008,101,85,16,88825,16720,105545
220198,202008,3,2,1,2090,1045,3135
220200,202008,412,344,68,359480.25,71060,430540.25
220202,202008,41,35,6,36575,6270,42845
220205,202008,53,47,6,49115,6270,55385
220207,202008,12,12,0,12540,0,12540
220208,202008,80,43,37,44935,38665,83600
220209,202008,32,29,3,30305,3135,33440
220210,202008,20,14,6,14630,6270,20900
220211,202008,28,26,2,27170,2090,29260
220213,202008,41,36,5,37620,5225.5,42845.5
220217,202008,41,32,9,33440,9405,42845
220220,202008,2176,1432,744,1496440,777480.5,2273920.5
220225,202008,9,3,6,3135,6270,9405
220230,202008,962,750,212,784795,221540,1006335
220240,202008,161,146,15,152570,15675,168245
220245,202008,32,29,3,30305.97,3135,33440.97
220250,202008,120,108,12,112860,12540,125400
220253,202008,46,39,7,40755,7315,48070
220255,202008,31,28,3,29260,3135,32395
220260,202008,701,523,178,546535,186010,732545
220265,202008,9,7,2,7315,2090,9405
220270,202008,752,676,76,706420,80465,786885
220271,202008,42,34,8,35530,8360,43890
220272,202008,24,24,0,25080,0,25080
220273,202008,17,15,2,15675,2090,17765
220275,202008,56,46,10,48070,10450,58520
220277,202008,17,14,3,14630,3135,17765
220280,202008,16,12,4,12540,4180,16720
220285,202008,44,41,3,42845,3135,45980
220290,202008,1472,1264,208,1320881,217360.25,1538241.25
220300,202008,36,34,2,35530,2090,37620
220310,202008,326,278,48,291555,50160,341715
220320,202008,440,407,33,425315.5,34485,459800.5
220323,202008,0,,,,,0.0
220325,202008,12,10,2,10450,2090,12540
220327,202008,11,11,0,11495,0,11495
220330,202008,229,166,63,173470,65835,239305
220335,202008,142,124,18,129580,18810,148390
220340,202008,40,27,13,28215,13585,41800
220342,202008,58,50,8,52250,8360,60610
220345,202008,79,72,7,75240,7315,82555
220350,202008,443,381,62,398145,64790,462935
220360,202008,41,30,11,31350,11495,42845
220370,202008,1237,1024,213,1073215,222585,1295800
220375,202008,20,18,2,18810,2090,20900
220380,202008,22,17,5,17765,5225,22990
220385,202008,14,13,1,13585,1045,14630
220390,202008,2319,1320,999,1380445.6,1046045.75,2426491.35
220400,202008,33,29,4,30305,4180,34485
220410,202008,21,18,3,18810,3135,21945
220415,202008,13,11,2,11495,2090,13585
220420,202008,126,106,20,110770,20900,131670
220430,202008,128,114,14,119130,14630,133760
220435,202008,23,16,7,16720,7315,24035
220440,202008,291,247,44,258115,45980,304095
220450,202008,331,170,161,177650,168245,345895
220455,202008,53,52,1,54340,1045,55385
220460,202008,19,18,1,18810,1045,19855
220465,202008,97,65,32,67925,33440,101365
220470,202008,244,212,32,221540,33440,254980
220480,202008,72,64,8,66880,8360,75240
220490,202008,89,76,13,79420,13585,93005
220500,202008,107,91,16,95095,16720,111815
220510,202008,417,326,91,340670,95095,435765
220515,202008,22,20,2,20900,2090,22990
220520,202008,369,331,38,345895.85,39710,385605.85
220525,202008,10,7,3,7315,3135,10450
220527,202008,19,14,5,14630,5225,19855
220530,202008,34,14,20,14630,20900,35530
220535,202008,4,4,0,4180,0,4180
220540,202008,67,55,12,57475,12540,70015
220545,202008,39,26,13,27170,13585,40755
220550,202008,710,559,151,586245,157795,744040
220551,202008,14,11,3,11495,3135,14630
220552,202008,14,14,0,14630,0,14630
220553,202008,54,49,5,51205,5225,56430
220554,202008,9,7,2,7315,2090,9405
220555,202008,32,29,3,30305,3135,33440
220556,202008,46,44,2,45980,2090,48070
220557,202008,56,53,3,55385,3135,58520
220558,202008,9,4,5,4180,5225,9405
220559,202008,2,2,0,2090,0,2090
220560,202008,71,47,24,49115,25080,74195
220570,202008,742,461,281,481745,293645,775390
220580,202008,556,511,45,533995,47025,581020
220585,202008,10,9,1,9405,1045,10450
220590,202008,15,15,0,15675,0,15675
220595,202008,63,47,16,50160,16720,66880
220600,202008,19,11,8,11495,8360,19855
220605,202008,26,24,2,25080,2090,27170
220610,202008,77,66,11,69562.16,11495,81057.16
220620,202008,562,465,97,485925,102410,588335
220630,202008,5,4,1,4180,1045,5225
220635,202008,37,32,5,33440,5225,38665
220640,202008,105,87,18,90915,18810,109725
220650,202008,113,106,7,110770,7315,118085
220660,202008,54,42,12,43890,12540,56430
220665,202008,4,4,0,4180,0,4180
220667,202008,22,20,2,20900,2090,22990
220669,202008,27,24,3,25080,3135,28215
220670,202008,65,53,12,55385,12540,67925
220672,202008,74,51,23,53295,24035,77330
220675,202008,35,28,7,29260,7315,36575
220680,202008,42,37,5,38665,5225,43890
220690,202008,47,44,3,45980,3135,49115
220695,202008,36,19,17,19855,17765,37620
220700,202008,1689,1305,384,1363725.5,401280,1765005.5
220710,202008,6,4,2,4180,2090,6270
220720,202008,104,89,15,93005,16720,109725
220730,202008,17,17,0,17765,0,17765
220735,202008,5,1,4,1045,4180,5225
220740,202008,48,45,3,47025,3135,50160
220750,202008,112,97,15,101365,15675,117040
220755,202008,15,14,1,14630,1045,15675
220760,202008,68,62,6,64790,6270,71060
220770,202008,5613,3057,2556,3197702.01,2673110.5,5870812.51
220775,202008,18,11,7,11495,7315,18810
220777,202008,18,17,1,17765,1045,18810
220779,202008,1,0,1,0,1045,1045
220780,202008,898,766,132,800470,137940.5,938410.5
220785,202008,4,1,3,1045,3135,4180
220790,202008,1087,858,229,896610.05,239305,1135915.05
220793,202008,6,6,0,6270,0,6270
220795,202008,15,14,1,14630,1045,15675
220800,202008,4002,3085,917,3225915.81,959310,4185225.81
220810,202008,65,57,8,59565.5,8360,67925.5
220820,202008,240,219,21,228855,21945,250800
220830,202008,1237,1066,171,1115015,178695,1293710
220840,202008,2434,1696,738,1773368.84,775390.95,2548759.79
220850,202008,54,45,9,47025,9405,56430
220855,202008,8,5,3,5225,3135,8360
220860,202008,14,12,2,12540,2090,14630
220865,202008,31,29,2,30305,2090,32395
220870,202008,74,66,8,68970,8360,77330
220880,202008,323,257,66,268565,68970,337535
220885,202008,35,32,3,33440,3135,36575
220887,202008,13,12,1,12540,1045,13585
220890,202008,95,84,11,87780,11495,99275
220900,202008,23,14,9,14630,9405,24035
220910,202008,52,43,9,44935,9405,54340
220915,202008,10,9,1,9405,1045,10450
220920,202008,52,47,5,49115,5225,54340
220930,202008,43,42,1,43890,1045,44935
220935,202008,15,15,0,15675,0,15675
220937,202008,36,35,1,36575,1045,37620
220940,202008,54,50,4,52250,4180,56430
220945,202008,1,1,0,1045,0,1045
220950,202008,44,36,8,37620,8360,45980
220955,202008,23,21,2,21945,2090,24035
220960,202008,11,10,1,10450,1045,11495
220965,202008,37,33,4,34485,4180,38665
220970,202008,62,51,11,53295,11495,64790
220975,202008,16,14,2,14630,2090,16720
220980,202008,33,30,3,31350,3135,34485
220985,202008,64,57,7,59565,7315,66880
220987,202008,29,28,1,29260,1045,30305
220990,202008,22,21,1,21945,1045,22990
220995,202008,19,15,4,15675,4180,19855
220997,202008,66,54,12,56430,12540,68970
221000,202008,1174,1061,113,1108745,118085,1226830
221005,202008,55,48,7,50160,7315,57475
221010,202008,16,12,4,12540,4180,16720
221020,202008,39,38,1,39710,1045,40755
221030,202008,40,32,8,33440,8360,41800
221035,202008,23,23,0,24035,0,24035
221037,202008,12,8,4,8360,4180,12540
221038,202008,26,23,3,24035,3135,27170
221039,202008,22,22,0,22990,0,22990
221040,202008,249,214,35,223630,36575,260205
221050,202008,237,201,36,210045,37620,247665
221060,202008,1859,1621,238,1693945,248710,1942655
221062,202008,33,33,0,34485,0,34485
221063,202008,13,9,4,9405,4180,13585
221065,202008,60,48,12,50160,12540,62700
221070,202008,139,120,19,125400,19855,145255
221080,202008,370,321,49,335445,51205,386650
221090,202008,27,25,2,26125,2090,28215
221093,202008,47,33,14,34485,14630,49115
221095,202008,7,7,0,7315,0,7315
221097,202008,13,10,3,10450,3135,13585
221100,202008,25371,15082,10289,15776369.44,10760365.95,26536735.39
221110,202008,1095,831,264,868395,275880,1144275
221120,202008,539,395,144,412775.5,150480,563255.5
221130,202008,979,790,189,826595,197505,1024100
221135,202008,35,31,4,32395,4180,36575
221140,202008,44,38,6,39710,6270,45980
221150,202008,11,9,2,9405,2090,11495
221160,202008,13,13,0,13585,0,13585
221170,202008,15,15,0,15675,0,15675
230010,202008,166,153,13,159885,13585,173470
230015,202008,128,103,25,107635,26125,133760
230020,202008,1634,1383,251,1445235.5,262295,1707530.5
230030,202008,1680,1206,474,1260271,496375,1756646
230040,202008,221,188,33,197505,34485,231990
230050,202008,229,170,59,177650,61655,239305
230060,202008,165,131,34,137940,35530,173470
230070,202008,306,266,40,279015,41800,320815
230075,202008,855,735,120,769122,125400,894522
230080,202008,196,168,28,175560,29260,204820
230090,202008,126,90,36,94050,37620,131670
230100,202008,2151,1228,923,1286396.5,964535,2250931.5
230110,202008,2900,1883,1017,1968780.5,1064855.5,3033636.0
230120,202008,1013,798,215,833910,224675,1058585
230125,202008,154,127,27,132715,28215,160930
230130,202008,477,426,51,445170,53295,498465
230140,202008,225,187,38,195415,39710,235125
230150,202008,148,114,34,119130,35530,154660
230160,202008,938,795,143,830775,149435,980210
230170,202008,612,553,59,577885.5,61655,639540.5
230180,202008,72,67,5,70015,5225,75240
230185,202008,402,346,56,361570.5,58520,420090.5
230190,202008,2336,1844,492,1928025,514140,2442165
230195,202008,493,428,65,447260,67925,515185
230200,202008,404,338,66,353210,68970,422180
230205,202008,390,258,132,269610,137940,407550
230210,202008,1374,1067,307,1115015.38,321860,1436875.38
230220,202008,1585,1082,503,1130690,525635,1656325
230230,202008,905,774,131,809875,137940,947815
230240,202008,1747,1505,242,1574033.25,253935,1827968.25
230250,202008,1791,1480,311,1546600.56,327085,1873685.56
230260,202008,3246,2027,1219,2119260,1278035,3397295
230270,202008,1367,1099,268,1151591.88,280060.5,1431652.38
230280,202008,2743,2058,685,2151655,716870.5,2868525.5
230290,202008,404,361,43,377245.72,44935,422180.72
230300,202008,534,385,149,403370,155705,559075
230310,202008,421,319,102,333355,106590,439945
230320,202008,927,791,136,826596,142120,968716
230330,202008,310,250,60,262295,62700,324995
230340,202008,452,365,87,382470,90915,473385
230350,202008,3151,1995,1156,2084775,1209065,3293840
230360,202008,273,222,51,233035,53295,286330
230365,202008,136,115,21,120175,21945,142120
230370,202008,10088,4911,5177,5137223.42,5415191,10552414.42
230380,202008,475,406,69,424270.5,72105.5,496376.0
230390,202008,542,303,239,316635,250800.5,567435.5
230393,202008,247,204,43,213180,44935,258115
230395,202008,350,281,69,293645.7,72105,365750.7
230400,202008,619,491,128,513095,133760,646855
230410,202008,2698,1680,1018,1756645.97,1066945.5,2823591.47
230420,202008,6275,4153,2122,4351383.04,2225850.2,6577233.24
230423,202008,334,290,44,304095,45980,350075
230425,202008,425,350,75,365750.85,78375,444125.85
230426,202008,121,99,22,103455,22990,126445
230427,202008,76,72,4,76285,4180,80465
230428,202008,1517,753,764,786885,799425,1586310
230430,202008,459,372,87,388740,90915,479655
230435,202008,899,649,250,679250,261250.77,940500.77
230440,202008,88635,39413,49222,41221086.98,51501795.54,92722882.52
230445,202008,315,220,95,229900,99275,329175
230450,202008,560,442,118,461890,123310,585200
230460,202008,67,52,15,54340,15675,70015
230465,202008,309,251,58,262295,60610,322905
230470,202008,2016,1590,426,1662595,446215.25,2108810.25
230480,202008,157,148,9,154660,9405,164065
230490,202008,305,244,61,254980,63745,318725
230495,202008,449,330,119,344850,124355,469205
230500,202008,1030,762,268,796290,280060,1076350
230510,202008,59,46,13,48070,13585,61655
230520,202008,384,301,83,314545,86735,401280
230523,202008,2353,1478,875,1544510,914375.5,2458885.5
230526,202008,268,229,39,239305,40755,280060
230530,202008,691,516,175,539220,182875,722095
230533,202008,208,194,14,202730,14630,217360
230535,202008,369,275,94,287375,99275,386650
230540,202008,1802,1590,212,1661550,221540,1883090
230550,202008,3824,2458,1366,2573837.4,1430605,4004442.4
230560,202008,581,441,140,460845.5,146300,607145.5
230565,202008,227,165,62,172425,64790,237215
230570,202008,289,256,33,267520,34485,302005
230580,202008,1184,863,321,903925,335445,1239370
230590,202008,1009,783,226,818235.25,237215,1055450.25
230600,202008,241,219,22,228855,22990,251845
230610,202008,379,292,87,306185,90915,397100
230620,202008,202,172,30,179740.5,31350,211090.5
230625,202008,765,537,228,561165.25,239305,800470.25
230630,202008,1334,1042,292,1090980,305140,1396120
230640,202008,3776,3201,575,3345045.5,600876.25,3945921.75
230650,202008,456,392,64,409640,66880,476520
230655,202008,691,585,106,611325,110770,722095
230660,202008,370,308,62,321860,64790,386650
230670,202008,448,382,66,399190,68970,468160
230680,202008,207,188,19,196460,19855,216315
230690,202008,914,772,142,806740,148390,955130
230700,202008,846,710,136,741950,142120.5,884070.5
230710,202008,693,660,33,689700,35530,725230
230720,202008,155,134,21,140030,21945,161975
230725,202008,264,209,55,218405,57475,275880
230730,202008,12200,6649,5551,6952322.05,5808112.62,12760434.67
230740,202008,670,540,130,565345.5,136895,702240.5
230750,202008,828,701,127,732545,133760,866305
230760,202008,1464,1268,196,1325060,204820,1529880
230763,202008,325,270,55,282150,58520,340670
230765,202008,7552,3474,4078,3634510.51,4261511.25,7896021.76
230770,202008,5072,2589,2483,2705506.9,2601005.5,5306512.4
230780,202008,731,642,89,670890.5,93005,763895.5
230790,202008,289,242,47,252890,49115,302005
230800,202008,1138,821,317,857945,331265,1189210
230810,202008,1347,1188,159,1241460,167200,1408660
230820,202008,366,253,113,264385.5,118085,382470.5
230830,202008,957,818,139,855855,146300,1002155
230835,202008,275,240,35,250800,36575,287375
230837,202008,167,142,25,148390,26125,174515
230840,202008,925,729,196,761805.5,204820.5,966626.0
230850,202008,1472,1272,200,1330285,209000,1539285
230860,202008,302,226,76,236170,79420,315590
230870,202008,1840,1570,270,1642740,284240,1926980
230880,202008,67,51,16,53295,16720,70015
230890,202008,542,497,45,519365,47025,566390
230900,202008,280,204,76,213180,79420.31,292600.31
230910,202008,217,171,46,178695,48070,226765
230920,202008,427,341,86,356345,89870,446215
230930,202008,983,693,290,724185,303050,1027235
230940,202008,854,664,190,694925,199595,894520
230945,202008,520,423,97,444125.5,101365,545490.5
230950,202008,413,356,57,372020,59565,431585
230960,202008,2686,1802,884,1883090.5,923780.5,2806871.0
230970,202008,1713,958,755,1002155,788975,1791130
230980,202008,204,168,36,175560,37620,213180
230990,202008,136,111,25,115995,26125,142120
231000,202008,193,177,16,184965,17765,202730
231010,202008,153,112,41,117040,42845,159885
231020,202008,1350,937,413,979165,432630,1411795
231025,202008,1064,788,276,823460,288420.5,1111880.5
231030,202008,1099,915,184,958265,192280,1150545
231040,202008,137,94,43,98230,44935,143165
231050,202008,948,839,109,876755,113905,990660
231060,202008,156,130,26,135850,27170,163020
231070,202008,1494,1043,451,1090980,471295,1562275
231080,202008,263,242,21,252890,21945,274835
231085,202008,607,369,238,385605,248710,634315
231090,202008,245,200,45,209000,47025,256025
231095,202008,170,134,36,140030,37620,177650
231100,202008,148,123,25,128535,27170,155705
231110,202008,370,314,56,328130,58520,386650
231120,202008,270,230,40,240350,41800,282150
231123,202008,155,146,9,153615,9405,163020
231126,202008,335,262,73,273790.5,76285,350075.5
231130,202008,4673,3640,1033,3805891,1080530.5,4886421.5
231135,202008,212,184,28,192280,29260,221540
231140,202008,3074,2260,814,2362746.28,850630,3213376.28
231150,202008,369,350,19,365750,19855,385605
231160,202008,1208,955,253,1000065,264385,1264450
231170,202008,518,356,162,372020,169290,541310
231180,202008,1711,1466,245,1533015,256025,1789040
231190,202008,208,175,33,182875,34485,217360
231195,202008,215,182,33,190190,34485,224675
231200,202008,798,653,145,682385,151525,833910
231210,202008,580,490,90,513095,94050,607145
231220,202008,1047,766,281,801516.7,293645,1095161.7
231230,202008,1476,1171,305,1224740,319770,1544510
231240,202008,1471,1044,427,1092025,446215.5,1538240.5
231250,202008,112,103,9,108680,9405,118085
231260,202008,277,179,98,187055,102410,289465
231270,202008,1002,817,185,855856.44,193325,1049181.44
231280,202008,76,60,16,62700,16720,79420
231290,202008,7661,4306,3355,4500815.63,3511201.14,8012016.77
231300,202008,606,564,42,592515,43890,636405
231310,202008,750,694,56,726275.56,58520,784795.56
231320,202008,591,447,144,467116.5,150480,617596.5
231325,202008,98,85,13,88825,13585,102410
231330,202008,1998,1546,452,1617924.4,472340.5,2090264.9
231335,202008,255,226,29,236170,30305,266475
231340,202008,1714,1254,460,1311475,481745,1793220
231350,202008,1302,1054,248,1101430,259161.5,1360591.5
231355,202008,435,372,63,388740,65835,454575
231360,202008,513,378,135,395010.86,141075,536085.86
231370,202008,87,76,11,79420,11495,90915
231375,202008,294,212,82,221540,85690,307230
231380,202008,490,397,93,415910,98230,514140
231390,202008,207,164,43,171380,44935,216315
231395,202008,740,463,277,483835,289465,773300
231400,202008,1125,936,189,978120.25,197505.5,1175625.75
231410,202008,1331,1093,238,1142185,248710,1390895
240010,202008,398,173,225,180785,235125,415910
240020,202008,2267,1836,431,1920711.68,451440,2372151.68
240030,202008,120,101,19,106590,19855,126445
240040,202008,33,33,0,34485,0,34485
240050,202008,530,452,78,473385,81510,554895
240060,202008,67,63,4,65835,4180,70015
240070,202008,216,170,46,178695,48070,226765
240080,202008,523,357,166,373065,173470.01,546535.01
240090,202008,104,93,11,97185,11495,108680
240100,202008,1502,1420,82,1485990.37,85690,1571680.37
240110,202008,1055,696,359,728365.5,375155.75,1103521.25
240120,202008,136,111,25,115995,26125,142120
240130,202008,283,260,23,271700,24035,295735
240140,202008,77,57,20,59565,20900,80465
240145,202008,745,664,81,695970,84645,780615
240150,202008,20,16,4,16720,4180,20900
240160,202008,41,35,6,36575,6270,42845
240165,202008,36,28,8,29260.25,8360,37620.25
240170,202008,110,81,29,84645,30305,114950
240180,202008,89,70,19,73150,19855,93005
240185,202008,42,39,3,40755,3135,43890
240190,202008,16,14,2,14630,2090,16720
240200,202008,3087,1735,1352,1814122,1412841,3226963
240210,202008,173,133,40,138985,41800,180785
240220,202008,1109,809,300,845405.75,315590,1160995.75
240230,202008,850,781,69,816145.75,72105,888250.75
240240,202008,71,52,19,55385,19855,75240
240250,202008,89,77,12,81510,12540,94050
240260,202008,1803,1330,473,1389850,497420,1887270
240270,202008,184,162,22,169290,22990,192280
240280,202008,44,35,9,36575,9405,45980
240290,202008,49,46,3,49115,3135,52250
240300,202008,174,94,80,98230,83600,181830
240310,202008,2326,1276,1050,1334466.48,1099340.85,2433807.33
240320,202008,194,182,12,190190,12540,202730
240325,202008,4551,2707,1844,2829862.49,1926980.7,4756843.19
240330,202008,72,68,4,71060,4180,75240
240340,202008,67,42,25,43890,26125,70015
240350,202008,95,84,11,87780,11495,99275
240360,202008,557,348,209,363660.5,218405,582065.5
240370,202008,50,46,4,48070,4180,52250
240375,202008,68,40,28,41800,29260,71060
240380,202008,228,188,40,196460,41800.5,238260.5
240390,202008,12,11,1,11495,1045,12540
240400,202008,82,75,7,78375,7315,85690
240410,202008,14,8,6,8360,6270,14630
240420,202008,1008,738,270,773300,282150,1055450
240430,202008,265,249,16,261250,16720,277970
240440,202008,122,69,53,72105,55385,127490
240450,202008,228,153,75,159885.5,78375,238260.5
240460,202008,71,53,18,55385,18810,74195
240470,202008,237,212,25,221540,26125,247665
240480,202008,16,14,2,14630,2090,16720
240485,202008,82,68,14,71060,14630,85690
240490,202008,46,44,2,47025,2090,49115
240500,202008,86,64,22,66880,22990,89870
240510,202008,43,32,11,33440,11495,44935
240520,202008,115,110,5,115995,5225,121220
240530,202008,56,49,7,51205,7315,58520
240540,202008,78,66,12,68970,12540,81510
240550,202008,13,12,1,12540,1045,13585
240560,202008,377,276,101,288420.5,105545,393965.5
240570,202008,445,287,158,302005,165110.5,467115.5
240580,202008,1296,1020,276,1067990.25,289465,1357455.25
240590,202008,30,28,2,29260,2090,31350
240600,202008,107,102,5,106590,5225,111815
240610,202008,520,435,85,454575.5,88825,543400.5
240615,202008,19,18,1,18810,1045,19855
240620,202008,87,83,4,86735,4180,90915
240630,202008,38,33,5,34485,5225,39710
240640,202008,27,21,6,21945,6270,28215
240650,202008,242,201,41,210045,42845,252890
240660,202008,111,95,16,99275,16720,115995
240670,202008,306,177,129,184965.75,135850,320815.75
240680,202008,49,37,12,38665,12540,51205
240690,202008,47,44,3,45980,3135,49115
240700,202008,186,153,33,159885,34485,194370
240710,202008,2024,1253,771,1310431.25,808830,2119261.25
240720,202008,1068,790,278,825550,290510,1116060
240725,202008,64,59,5,61655,5225,66880
240730,202008,149,127,22,132715,22990,155705
240740,202008,232,198,34,206910,35530.85,242440.85
240750,202008,52,28,24,29260,25080,54340
240760,202008,46,41,5,42845,5225,48070
240770,202008,144,112,32,117040,33440,150480
240780,202008,674,558,116,584155,122265,706420
240790,202008,41,39,2,40755,2090,42845
240800,202008,9256,6295,2961,6584554.43,3097382.75,9681937.18
240810,202008,20388,11034,9354,11539945.7,9784338.9,21324284.6
240820,202008,237,142,95,148390.09,99275,247665.09
240830,202008,1619,1334,285,1394030.75,297825,1691855.75
240840,202008,77,67,10,70015,10450,80465
240850,202008,87,77,10,80465,10450,90915
240860,202008,107,103,4,107635,4180,111815
240870,202008,59,51,8,53295,8360,61655
240880,202008,31,28,3,29260,3135,32395
240890,202008,1122,643,479,672980.4,500555,1173535.4
240895,202008,60,41,19,42845,19855,62700
240910,202008,156,139,17,145255,17765,163020
240920,202008,13,10,3,10450,3135,13585
240930,202008,414,370,44,386650,45980,432630
240933,202008,48,32,16,33440,16720,50160
240940,202008,2384,2112,272,2208085.45,284240,2492325.45
240950,202008,48,43,5,44935,5225,50160
240960,202008,26,22,4,22990,4180,27170
240970,202008,112,83,29,86735,30305,117040
240980,202008,200,159,41,166155,42845,209000
240990,202008,131,87,44,90915,45980,136895
241000,202008,61,57,4,59565,4180,63745
241010,202008,68,52,16,54340,16720,71060
241020,202008,113,104,9,108680,9405,118085
241025,202008,13,6,7,6270,7315,13585
241030,202008,115,92,23,96140,24035,120175
241040,202008,45,32,13,33440,13585,47025
241050,202008,82,75,7,78375,7315,85690
241060,202008,29,24,5,25080,5225,30305
241070,202008,16,16,0,16720,0,16720
241080,202008,60,53,7,55385,7315,62700
241090,202008,60,47,13,49115,13585,62700
241100,202008,72,61,11,63745,11495,75240
241105,202008,9,3,6,3135,6270,9405
241110,202008,48,44,4,45980,4180,50160
241120,202008,1480,1121,359,1172490.5,375155,1547645.5
241140,202008,221,183,38,191235.5,39710,230945.5
241142,202008,41,35,6,36575,6270,42845
241150,202008,1180,1036,144,1083665,150480,1234145
241160,202008,17,16,1,16720,1045,17765
241170,202008,43,38,5,39710,5225,44935
241180,202008,43,36,7,37620,7315,44935
241190,202008,37,36,1,37620,1045,38665
241200,202008,3971,2056,1915,2149566.89,2005355,4154921.89
241210,202008,69,60,9,62700,9405,72105
241220,202008,1421,956,465,999020.86,486970,1485990.86
241230,202008,243,203,40,212135,41800,253935
241240,202008,55,44,11,45980,11495,57475
241250,202008,1137,1046,91,1094115.5,95095,1189210.5
241255,202008,51,40,11,41800,11495,53295
241260,202008,681,525,156,548625,163020,711645
241270,202008,63,44,19,45980,19855,65835
241280,202008,95,83,12,86735,12540,99275
241290,202008,121,86,35,89870,36575,126445
241300,202008,77,56,21,58520,21945,80465
241310,202008,52,38,14,39710.75,14630,54340.75
241320,202008,30,18,12,18810,12540,31350
241330,202008,60,55,5,57475,5225,62700
241335,202008,74,66,8,68970,8360,77330
241340,202008,181,133,48,138985,50160,189145
241350,202008,60,51,9,53295,9405,62700
241355,202008,50,43,7,44935,7315,52250
241360,202008,51,50,1,52250,1045,53295
241370,202008,52,42,10,43890,10450,54340
241380,202008,37,33,4,34485,4180,38665
241390,202008,86,66,20,68970,20900,89870
241400,202008,223,176,47,183920,49115,233035
241410,202008,184,165,19,172425,19855,192280
241415,202008,99,80,19,83600,19855,103455
241420,202008,104,75,29,78375,30305.1,108680.1
241430,202008,27,24,3,25080,3135,28215
241440,202008,537,430,107,449350,111815,561165
241445,202008,38,33,5,34485,5225,39710
241450,202008,277,227,50,238260,52250,290510
241460,202008,141,128,13,134805.25,13585,148390.25
241470,202008,34,29,5,31350,5225,36575
241475,202008,55,52,3,54340,3135,57475
241480,202008,95,67,28,70015,29260,99275
241490,202008,11,10,1,10450,1045,11495
241500,202008,47,36,11,37620,11495,49115
250010,202008,102,87,15,90915,15675,106590
250020,202008,32,29,3,30305,3135,33440
250030,202008,869,651,218,681340,227810,909150
250040,202008,375,309,66,322905,70015,392920
250050,202008,258,211,47,220495,49115,269610
250053,202008,54,41,13,42845,13585,56430
250057,202008,1,1,0,1045,0,1045
250060,202008,577,413,164,431585,172425,604010
250070,202008,712,569,143,594605.1,149435,744040.1
250073,202008,7,7,0,7315,0,7315
250077,202008,178,135,43,141075,44935,186010
250080,202008,428,335,93,350075.3,97185,447260.3
250090,202008,222,144,78,150480,81510,231990
250100,202008,515,428,87,447260,90915,538175
250110,202008,617,469,148,490105,154660,644765
250115,202008,20,7,13,7315,13585,20900
250120,202008,123,88,35,91960,36575,128535
250130,202008,582,471,111,492195,115995,608190
250135,202008,16,9,7,9405,7315,16720
250140,202008,87,77,10,80465,10450,90915
250150,202008,593,428,165,448305,172425,620730
250153,202008,9,6,3,6270,3135,9405
250157,202008,32,26,6,27170,6270,33440
250160,202008,234,183,51,191235,53295,244530
250170,202008,62,40,22,41800,22990,64790
250180,202008,4286,2917,1369,3051400.3,1432695,4484095.3
250190,202008,846,556,290,581020,304095.25,885115.25
250200,202008,52,43,9,44935,9405,54340
250205,202008,24,20,4,20900,4180,25080
250210,202008,85,75,10,78375,10450,88825
250215,202008,67,54,13,56430,13585,70015
250220,202008,25,18,7,18810,7315,26125
250230,202008,78,71,7,74195,7315,81510
250240,202008,234,194,40,202730,41800,244530
250250,202008,389,334,55,349030,57475,406505
250260,202008,45,38,7,39710,7315,47025
250270,202008,74,54,20,56430,20900,77330
250280,202008,385,316,69,330220,72105,402325
250290,202008,93,85,8,88825,8360,97185
250300,202008,558,376,182,392920,190190,583110
250310,202008,50,44,6,45980,6270,52250
250320,202008,1971,1327,644,1387760.85,672980.9,2060741.75
250330,202008,104,85,19,88825,19855,108680
250340,202008,25,23,2,24035,2090,26125
250350,202008,164,106,58,110770,60610,171380
250355,202008,33,25,8,26125,8360,34485
250360,202008,201,165,36,172425,37620,210045
250370,202008,2404,1602,802,1676180,840180,2516360
250375,202008,11,7,4,7315,4180,11495
250380,202008,56,42,14,43890,14630,58520
250390,202008,46,35,11,36575,11495,48070
250400,202008,16411,8333,8078,8721555.41,8453008.09,17174563.50
250403,202008,330,266,64,277970,66880,344850
250407,202008,60,50,10,52250,10450,62700
250410,202008,30,26,4,27170,4180,31350
250415,202008,44,30,14,31350,14630,45980
250420,202008,43,37,6,38665,6270,44935
250430,202008,1449,1246,203,1302331.25,212135,1514466.25
250435,202008,17,13,4,13585,4180,17765
250440,202008,676,565,111,591470,115995,707465
250450,202008,86,66,20,68970,20900,89870
250460,202008,464,307,157,320815,164065,484880
250470,202008,93,64,29,66880,30305,97185
250480,202008,331,265,66,276925,68970,345895
250485,202008,4,2,2,2090,2090,4180
250490,202008,224,181,43,189145,44935,234080
250500,202008,92,68,24,71060,25080,96140
250510,202008,767,601,166,628045,173470,801515
250520,202008,181,124,57,129580,59565,189145
250523,202008,121,96,25,100320,26125,126445
250527,202008,103,82,21,85690,21945,107635
250530,202008,10,6,4,6270,4180,10450
250535,202008,35,25,10,26125,10450,36575
250540,202008,135,105,30,109725,31350,141075
250550,202008,72,69,3,72105,3135,75240
250560,202008,50,36,14,37620,14630,52250
250570,202008,166,136,30,142120,31350,173470
250580,202008,109,84,25,87847,26125,113972
250590,202008,26,16,10,16720,10450,27170
250600,202008,1392,911,481,951996.46,502645,1454641.46
250610,202008,158,130,28,135850,29260,165110
250620,202008,22,17,5,17765,5225,22990
250625,202008,72,53,19,55385,19855,75240
250630,202008,3047,1944,1103,2033572.43,1152635,3186207.43
250640,202008,217,173,44,180785,45980,226765
250650,202008,30,20,10,20900,10450,31350
250660,202008,50,39,11,40755,11495,52250
250670,202008,64,43,21,44935,21945,66880
250680,202008,405,327,78,341715,81510,423225
250690,202008,2057,1426,631,1490170.96,659395,2149565.96
250700,202008,942,812,130,849585.25,135850,985435.25
250710,202008,430,340,90,355300,94050,449350
250720,202008,118,88,30,91960,31350,123310
250730,202008,388,324,64,339625,67925,407550
250740,202008,55,51,4,53295,4180,57475
250750,202008,22263,13372,8891,13981994.78,9303637,23285631.78
250760,202008,98,78,20,81510,20900,102410
250770,202008,365,239,126,249755.6,131670,381425.6
250780,202008,64,43,21,44935,21945,66880
250790,202008,460,300,160,313500,167200,480700
250800,202008,153,137,16,143165,16720,159885
250810,202008,77,61,16,63745,16720,80465
250820,202008,154,128,26,133760,27170,160930
250830,202008,436,294,142,308275.5,148390,456665.5
250840,202008,55,49,6,51205,6270,57475
250850,202008,57,47,10,49115,10450,59565
250855,202008,13,11,2,11495,2090,13585
250860,202008,216,148,68,154660,71060,225720
250870,202008,30,26,4,27170,4180,31350
250880,202008,85,64,21,66880,21945,88825
250890,202008,2826,2112,714,2209130,746130.5,2955260.5
250900,202008,49,40,9,41800,9405,51205
250905,202008,117,90,27,94050,28215,122265
250910,202008,1129,821,308,857945,321860,1179805
250915,202008,110,76,34,79420,35530,114950
250920,202008,140,102,38,106590,39710,146300
250930,202008,169,101,68,105545,71060,176605
250933,202008,5,3,2,3135,2090,5225
250937,202008,10,10,0,10450,1045,11495
250939,202008,35,25,10,26125,10450,36575
250940,202008,104,78,26,81510,27170,108680
250950,202008,72,49,23,51205,24035,75240
250960,202008,90,50,40,52250,41800,94050
250970,202008,1216,858,358,897655,375155,1272810
250980,202008,104,70,34,73150,35530,108680
250990,202008,163,128,35,133760,36575,170335
251000,202008,74,66,8,70015,8360,78375
251010,202008,115,85,30,88825,31350,120175
251020,202008,74,61,13,64790,13585,78375
251030,202008,46,35,11,36575,11495,48070
251040,202008,57,40,17,41800,17765,59565
251050,202008,24,21,3,21945,3135,25080
251060,202008,52,41,11,42845,11495,54340
251065,202008,4,4,0,4180,0,4180
251070,202008,20,16,4,16720,4180,20900
251080,202008,5024,2405,2619,2515315.75,2737902.14,5253217.89
251090,202008,184,157,27,164065,28215,192280
251100,202008,17,17,0,18810,0,18810
251110,202008,46,37,9,38665,9405,48070
251120,202008,1846,1133,713,1185032.75,745085.2,1930117.95
251130,202008,406,330,76,344850,79420,424270
251140,202008,560,361,199,377245,207955,585200
251150,202008,339,288,51,300960,53295,354255
251160,202008,90,73,17,76285,17765,94050
251170,202008,101,81,20,84645,20900,105545
251180,202008,294,178,116,186010,121220,307230
251190,202008,202,132,70,137940,73150,211090
251200,202008,276,223,53,233035,55385,288420
251203,202008,35,33,2,34485,2090,36575
251207,202008,88,72,16,75240,16720,91960
251210,202008,1486,1086,400,1134870,419045,1553915
251220,202008,49,36,13,37620,13585,51205
251230,202008,590,496,94,518320,98230,616550
251240,202008,96,66,30,68970,31350,100320
251250,202008,1412,1009,403,1054405.75,422180.75,1476586.50
251260,202008,13,7,6,7315,6270,13585
251270,202008,320,243,77,253935,81510,335445
251272,202008,65,59,6,61655,6270,67925
251274,202008,30,23,7,24035,7315,31350
251275,202008,34,20,14,20900,14630,35530
251276,202008,14,11,3,11495,3135,14630
251278,202008,10,8,2,8360,2090,10450
251280,202008,101,96,5,100320,5225,105545
251290,202008,797,578,219,605055,228855,833910
251300,202008,15,12,3,12540,3135,15675
251310,202008,330,238,92,248710,97185,345895
251315,202008,30,27,3,28215,3135,31350
251320,202008,64,50,14,52250,14630,66880
251330,202008,79,70,9,73150,9405,82555
251335,202008,15,10,5,10450,5225,15675
251340,202008,742,441,301,460845,315590,776435
251350,202008,34,33,1,34485,1045,35530
251360,202008,81,71,10,74195,10450,84645
251365,202008,15,15,0,15675,0,15675
251370,202008,5554,3726,1828,3895760.65,1912350,5808110.65
251380,202008,44,36,8,37620,8360,45980
251385,202008,3,3,0,3135,0,3135
251390,202008,813,616,197,643720,205865.5,849585.5
251392,202008,19,11,8,11495,8360,19855
251394,202008,10,10,0,10450,0,10450
251396,202008,12,8,4,8360,4180,12540
251398,202008,18,16,2,16720,2090,18810
251400,202008,39,33,6,34485,6270,40755
251410,202008,37,31,6,32395,6270,38665
251420,202008,101,71,30,74195,31350,105545
251430,202008,44,40,4,41800,4180,45980
251440,202008,41,24,17,25080,17765,42845
251445,202008,51,46,5,48070.25,5225,53295.25
251450,202008,406,354,52,370975,54340,425315
251455,202008,3,2,1,2090,1045,3135
251460,202008,15,13,2,13585,2090,15675
251465,202008,7,4,3,4180,3135,7315
251470,202008,49,39,10,40755,10450,51205
251480,202008,26,21,5,21945,5225,27170
251490,202008,129,83,46,86735,48070.5,134805.5
251500,202008,129,105,24,109725,25080,134805
251510,202008,52,32,20,33440,20900,54340
251520,202008,29,28,1,29260,1045,30305
251530,202008,4492,3169,1323,3312650.5,1386715,4699365.5
251540,202008,76,64,12,66880,12540,79420
251550,202008,414,315,99,329175,103455.25,432630.25
251560,202008,24,16,8,16720,8360,25080
251570,202008,19,18,1,18810,1045,19855
251580,202008,133,105,28,109725,29260,138985
251590,202008,116,85,31,89022.5,32395,121417.5
251593,202008,26,16,10,16720,10450,27170
251597,202008,101,76,25,79420,26125,105545
251600,202008,1108,785,323,821370.5,337535,1158905.5
251610,202008,239,181,58,190190,60610,250800
251615,202008,10,9,1,9405,1045,10450
251620,202008,4257,2777,1480,2901966.6,1546601.5,4448568.1
251630,202008,459,336,123,351120,128535,479655
251640,202008,142,101,41,105545,42845,148390
251650,202008,276,200,76,209000.75,79420,288420.75
251660,202008,188,169,19,176605,19855,196460
251670,202008,371,291,80,304095,83600,387695
251675,202008,8,6,2,6270,2090,8360
251680,202008,99,89,10,93005,10450,103455
251690,202008,326,268,58,280060,60610,340670
251700,202008,287,245,42,256025.9,43890,299915.9
251710,202008,21,13,8,13585,8360,21945
251720,202008,22,15,7,15675,7315.5,22990.5
251740,202008,11,8,3,8360,3135,11495
260005,202008,3279,1787,1492,1870555.95,1564365.5,3434921.45
260010,202008,1633,1184,449,1240241.38,469205.1,1709446.48
260020,202008,417,362,55,378290,57475,435765
260030,202008,608,422,186,440990,194370,635360
260040,202008,814,506,308,528770,324995,853765
260050,202008,1160,833,327,870485,341716,1212201
260060,202008,381,348,33,363660,34485,398145
260070,202008,1371,847,524,888250.5,550715.3,1438965.8
260080,202008,731,564,167,589380,176605,765985
260090,202008,494,325,169,340670,176605,517275
260100,202008,215,150,65,156750,67925,224675
260105,202008,237,129,108,134805,112860,247665
260110,202008,2879,2106,773,2200771,807785.5,3008556.5
260120,202008,2834,1441,1393,1506124.3,1457775.75,2963900.05
260130,202008,169,113,56,118085,58520,176605
260140,202008,2124,1379,745,1445236.8,780615,2225851.8
260150,202008,210,135,75,141075,78375,219450
260160,202008,324,268,56,281105,59565,340670
260170,202008,3382,2038,1344,2131801.45,1407615.5,3539416.95
260180,202008,159,127,32,132715,33440,166155
260190,202008,2335,1579,756,1650055,792110,2442165
260200,202008,975,781,194,816145.29,202730.5,1018875.79
260210,202008,1433,1018,415,1064855,433675,1498530
260220,202008,694,621,73,648945.5,76285,725230.5
260230,202008,1210,910,300,950950,314545,1265495
260240,202008,220,163,57,170335,59565,229900
260250,202008,93,68,25,71060,26125,97185
260260,202008,1041,731,310,763895,323950,1087845
260270,202008,414,325,89,339625,93005,432630
260280,202008,1295,917,378,958265,395010.5,1353275.5
260290,202008,6556,3547,3009,3709752.78,3147542.46,6857295.24
260300,202008,952,819,133,856900.5,140030,996930.5
260310,202008,516,410,106,428450,110770,539220
260320,202008,859,632,227,661485,238260,899745
260330,202008,61,42,19,43890,19855,63745
260340,202008,78,56,22,58520,22990,81510
260345,202008,5518,3015,2503,3154856.43,2617725,5772581.43
260350,202008,494,349,145,365750.5,151525,517275.5
260360,202008,250,137,113,143165,119130,262295
260370,202008,771,473,298,495330.25,311410,806740.25
260380,202008,588,432,156,451440,163020.47,614460.47
260390,202008,290,245,45,258115,47025,305140
260392,202008,111,96,15,100320,15675,115995
260400,202008,4191,2385,1806,2495461.22,1891450.5,4386911.72
260410,202008,14845,7752,7093,8109202.22,7423681.42,15532883.64
260415,202008,140,121,19,126445,19855,146300
260420,202008,1725,1056,669,1104566.77,700150,1804716.77
260430,202008,189,174,15,181830.35,15675,197505.35
260440,202008,199,144,55,150480,57475,207955
260450,202008,429,318,111,332310.96,115995,448305.96
260460,202008,816,431,385,450395,402325,852720
260470,202008,346,213,133,223630,140030.5,363660.5
260480,202008,241,155,86,161975,89870,251845
260490,202008,218,177,41,184965,42845,227810
260500,202008,1116,752,364,785840,380380,1166220
260510,202008,780,618,162,646855,169290,816145
260515,202008,242,217,25,226765,26125,252890
260520,202008,3272,2014,1258,2106720,1317745.95,3424465.95
260530,202008,791,652,139,683430,145255,828685
260540,202008,553,433,120,452485,125400,577885
260545,202008,17,11,6,11495,6270,17765
260550,202008,326,203,123,212135,128535,340670
260560,202008,521,394,127,412775.5,132715,545490.5
260570,202008,973,792,181,827640,189145,1016785
260580,202008,248,215,33,225720,34485,260205
260590,202008,639,368,271,384560,284240,668800
260600,202008,8077,4334,3743,4536347.84,3920840.94,8457188.78
260610,202008,485,323,162,337535,169290,506825
260620,202008,3675,1907,1768,1995951.65,1849650.58,3845602.23
260630,202008,86,81,5,84645,5225,89870
260640,202008,3547,1974,1573,2063875.8,1645875,3709750.8
260650,202008,331,240,91,250800,95095,345895
260660,202008,557,364,193,380380,201685,582065
260670,202008,105,78,27,81510,28215,109725
260680,202008,3725,2069,1656,2163150.22,1731565.5,3894715.72
260690,202008,129,93,36,98230,37620,135850
260700,202008,309,206,103,215270,108680,323950
260710,202008,41,36,5,37620,5225,42845
260720,202008,2441,1449,992,1518386,1037685,2556071
260730,202008,702,531,171,554895,178695,733590
260740,202008,64,58,6,60610,6270,66880
260750,202008,596,421,175,439945,182875,622820
260760,202008,660,340,320,355300.23,335445,690745.23
260765,202008,978,503,475,525635,496375,1022010
260770,202008,221,164,57,171362,59565.5,230927.5
260775,202008,791,442,349,462936.25,364705,827641.25
260780,202008,251,160,91,168245,95095,263340
260790,202008,13143,6758,6385,7072565.47,6680686.67,13753252.14
260795,202008,165,109,56,113905,58520,172425
260800,202008,287,238,49,248710.5,51205,299915.5
260805,202008,175,116,59,121220,61655,182875
260810,202008,753,650,103,679250,107635,786885
260820,202008,286,185,101,194370.85,105545,299915.85
260825,202008,214,149,65,155705,67925,223630
260830,202008,295,184,111,192280,117040,309320
260840,202008,241,176,65,183920,67925,251845
260845,202008,177,120,57,125400,59565,184965
260850,202008,442,325,117,340670,122265,462935
260860,202008,253,190,63,198550,65835,264385
260870,202008,368,275,93,287375.29,97185,384560.29
260875,202008,732,522,210,545490,220495,765985
260880,202008,1598,1016,582,1061720,610280,1672000
260890,202008,2366,1671,695,1747241,727320,2474561
260900,202008,981,700,281,732545,293645,1026190
260910,202008,256,203,53,212135,55385,267520
260915,202008,289,213,76,223630,79420,303050
260920,202008,181,95,86,99275,89870,189145
260930,202008,395,337,58,353210,61655,414865
260940,202008,2706,1467,1239,1533852.4,1295801,2829653.4
260950,202008,2016,1157,859,1211155.75,898700,2109855.75
260960,202008,13706,6929,6777,7250218.35,7089283.32,14339501.67
260970,202008,425,355,70,370975,73150,444125
260980,202008,192,172,20,179740,20900,200640
260990,202008,2618,2119,499,2215401.35,522500,2737901.35
261000,202008,4267,2560,1707,2677290.75,1787995,4465285.75
261010,202008,162,120,42,125400,43890,169290
261020,202008,601,452,149,473385.99,155705,629090.99
261030,202008,256,179,77,187055,80465,267520
261040,202008,373,325,48,339625,50160,389785
261050,202008,509,438,71,457710,74195,531905
261060,202008,1401,899,502,939455.81,524590,1464045.81
261070,202008,8807,4332,4475,4532168.15,4683693.37,9215861.52
261080,202008,379,291,88,304095,91960,396055
261090,202008,2196,1681,515,1757693.95,539220.83,2296914.78
261100,202008,1157,810,347,846450.75,362615,1209065.75
261110,202008,8635,5274,3361,5516555.8,3516426.5,9032982.3
261120,202008,259,223,36,233035,37620,270655
261130,202008,572,339,233,354255,243485.55,597740.55
261140,202008,203,126,77,132715,80465,213180
261150,202008,680,421,259,439945.03,271700,711645.03
261153,202008,69,64,5,66880,5225,72105
261160,202008,75845,37676,38169,39418560.25,39945133.11,79363693.36
261170,202008,467,352,115,367840,120175,488015
261180,202008,1797,1123,674,1173535,704330,1877865
261190,202008,635,441,194,460845.9,203775,664620.9
261200,202008,214,183,31,192280,32395,224675
261210,202008,32,27,5,28215,5225,33440
261220,202008,2697,1898,799,1983411.12,836000,2819411.12
261230,202008,338,252,86,263340,89870,353210
261240,202008,456,399,57,416955,59565,476520
261245,202008,235,193,42,201685,43890,245575
261247,202008,170,134,36,140030,37620,177650
261250,202008,3140,1544,1596,1613480.5,1667820,3281300.5
261255,202008,246,222,24,231990,25080,257070
261260,202008,849,739,110,773300.06,114950,888250.06
261270,202008,201,144,57,150480,59565,210045
261280,202008,178,146,32,152570,33440,186010
261290,202008,117,85,32,88825,33440,122265
261300,202008,1280,935,345,978120,360525,1338645
261310,202008,810,547,263,571615,275880,847495
261320,202008,547,372,175,389785,183920,573705
261330,202008,964,739,225,772255,236170.29,1008425.29
261340,202008,295,164,131,171380,137940,309320
261350,202008,852,605,247,632225.5,258115,890340.5
261360,202008,1296,844,452,883025,472340,1355365
261370,202008,4832,2888,1944,3019006.5,2035661,5054667.5
261380,202008,550,419,131,437855.69,136895.5,574751.19
261390,202008,3601,2422,1179,2533081,1234145.75,3767226.75
261400,202008,295,269,26,281105,27170,308275
261410,202008,1103,726,377,758670,395010,1153680
261420,202008,877,544,333,568480.55,349030,917510.55
261430,202008,329,297,32,310365,33440,343805
261440,202008,117,108,9,112860,9405,122265
261450,202008,2532,2039,493,2132846.25,516230.5,2649076.75
261460,202008,725,578,147,604010.85,153615,757625.85
261470,202008,246,198,48,206910.5,50160,257070.5
261480,202008,444,344,100,359480.22,104452.97,463933.19
261485,202008,348,208,140,218405,146300,364705
261500,202008,603,411,192,429495.86,200640,630135.86
261510,202008,50,32,18,33440,18810,52250
261520,202008,105,94,11,98230,11495,109725
261530,202008,4130,2619,1511,2739991.73,1582130.75,4322122.48
261540,202008,1351,793,558,828685,583110,1411795
261550,202008,266,132,134,137940.5,140030,277970.5
261560,202008,848,561,287,586246.75,299915.5,886162.25
261570,202008,395,308,87,321860,90915,412775
261580,202008,377,295,82,308275,85690,393965
261590,202008,192,154,38,160930,39710,200640
261600,202008,292,232,60,242440,62700.5,305140.5
261610,202008,88,75,13,78375,13585,91960
261618,202008,73,59,14,61655,14630,76285
261620,202008,203,126,77,131670,80465,212135
261630,202008,554,433,121,453530,126445,579975
261640,202008,6399,3382,3017,3538373.09,3157990.75,6696363.84
261650,202008,481,306,175,319770,182875,502645
270010,202008,523,463,60,483835,62700,546535
270020,202008,286,233,53,243485,55385,298870
270030,202008,8850,5717,3133,5978483.11,3279539.16,9258022.27
270040,202008,2004,1258,746,1314610,779570,2094180
270050,202008,150,115,35,120175,36575,156750
270060,202008,113,61,52,63745,54340,118085
270070,202008,866,637,229,665665,239305,904970
270080,202008,38,32,6,33440,6270,39710
270090,202008,22,16,6,16720,6270,22990
270100,202008,1238,825,413,862159.83,431585,1293744.83
270110,202008,125,97,28,101365,29260,130625
270120,202008,228,188,40,197505,41800,239305
270130,202008,254,178,76,186010,79420,265430
270135,202008,118,74,44,77330,45980,123310
270140,202008,1367,862,505,901382.66,527725,1429107.66
270150,202008,256,203,53,213180,56430,269610
270160,202008,501,396,105,414865,109725,524590
270170,202008,796,519,277,542355,289465,831820
270180,202008,73,57,16,59565,16720,76285
270190,202008,90,77,13,80465,13585,94050
270200,202008,105,92,13,96140,13585,109725
270210,202008,508,287,221,300960,230945,531905
270220,202008,178,141,37,147345,38665,186010
270230,202008,2101,1284,817,1342826.6,854810,2197636.6
270235,202008,705,552,153,576840,159885,736725
270240,202008,3037,2409,628,2518486.25,657305.85,3175792.10
270250,202008,157,115,42,121220,43890,165110
270255,202008,214,184,30,192280,31350,223630
270260,202008,367,296,71,309320,74195,383515
270270,202008,100,42,58,43890,60610,104500
270280,202008,238,133,105,138985,109725,248710
270290,202008,1159,889,270,930050,283195,1213245
270300,202008,320,223,97,233035,101365,334400
270310,202008,857,700,157,731500,164065,895565
270320,202008,826,707,119,739860.79,126445,866305.79
270330,202008,298,251,47,263340,49115,312455
270340,202008,60,47,13,49115,13585,62700
270350,202008,90,49,41,51205,42845,94050
270360,202008,67,38,29,39710,30305,70015
270370,202008,57,46,11,48070,11495,59565
270375,202008,72,44,28,45980,29260,75240
270380,202008,1011,642,369,673990.16,386650,1060640.16
270390,202008,193,116,77,121220,80465,201685
270400,202008,707,526,181,550715.79,189145,739860.79
270410,202008,660,488,172,509960,180785,690745
270420,202008,407,282,125,294690,130625,425315
270430,202008,32850,23623,9227,24711474.64,9661027.9,34372502.54
270440,202008,486,383,103,400235,107635,507870
270450,202008,792,447,345,467115,361570,828685
270460,202008,191,151,40,157795,41800,199595
270470,202008,1472,1020,452,1065900,472340,1538240
270480,202008,546,452,94,472340.5,98230.5,570571.0
270490,202008,24,19,5,19855,5225,25080
270500,202008,488,410,78,428450,81510,509960
270510,202008,802,498,304,520410,318725,839135
270520,202008,289,188,101,196460,105545,302005
270530,202008,69,61,8,63745,8360,72105
270540,202008,107,84,23,87780,24035,111815
270550,202008,1746,1341,405,1404445.16,423225,1827670.16
270560,202008,265,144,121,150480,126445,276925
270570,202008,518,363,155,379335,161975,541310
270580,202008,97,72,25,75240,26125,101365
270590,202008,68,55,13,57475,13585,71060
270600,202008,176,146,30,152570,31350,183920
270610,202008,233,179,54,187055,57475,244530
270620,202008,28,27,1,28215,1045,29260
270630,202008,3763,2863,900,2994971,940500.5,3935471.5
270640,202008,875,652,223,681340,233035,914375
270642,202008,221,189,32,197505,33440,230945
270644,202008,254,165,89,172425,93005,265430
270650,202008,327,196,131,204820.5,136895,341715.5
270660,202008,246,205,41,215270,42845,258115
270670,202008,3050,2320,730,2426389.05,764940,3191329.05
270680,202008,435,259,176,270655,184965,455620
270690,202008,1172,769,403,803606.37,421135,1224741.37
270700,202008,28,23,5,24035,5225,29260
270710,202008,877,682,195,713735,204820,918555
270720,202008,243,192,51,200640,53295,253935
270730,202008,1848,1108,740,1159950.5,774693.58,1934644.08
270740,202008,43,30,13,31350,13585,44935
270750,202008,643,484,159,505780,167200,672980
270760,202008,290,211,79,221540,82555,304095
270770,202008,2753,1827,926,1909216.55,970805,2880021.55
270780,202008,78,50,28,52250,29260,81510
270790,202008,274,177,97,184965,101365,286330
270800,202008,1972,1591,381,1662595,399190,2061785
270810,202008,281,223,58,233035,61655,294690
270820,202008,142,96,46,100320,48070.5,148390.5
270830,202008,794,594,200,621775,209000,830775
270840,202008,1378,1044,334,1093070,350075.85,1443145.85
270850,202008,1501,942,559,984390.5,584155,1568545.5
270860,202008,2528,1679,849,1757481.45,887205,2644686.45
270870,202008,121,64,57,66880,59565,126445
270880,202008,899,702,197,733590,206910,940500
270890,202008,297,221,76,230945,79420,310365
270895,202008,63,54,9,56430,9405,65835
270900,202008,90,70,20,73150,20900,94050
270910,202008,305,248,57,259160,59565,318725
270915,202008,1899,1206,693,1261141.57,725230.6,1986372.17
270920,202008,474,398,76,415910,79420,495330
270930,202008,5913,4436,1477,4638755,1545555.03,6184310.03
270940,202008,2307,1802,505,1883090,528770,2411860
280010,202008,40,34,6,35530,6270,41800
280020,202008,475,410,65,428450.45,67925,496375.45
280030,202008,20485,13272,7213,13879715.29,7552220.97,21431936.26
280040,202008,327,213,114,222585,119130,341715
280050,202008,401,305,96,318725,100320,419045
280060,202008,351,223,128,234080.7,133760,367840.7
280067,202008,1066,764,302,800470,316635.62,1117105.62
280070,202008,123,99,24,103455,25080,128535
280100,202008,626,488,138,509960.85,145255,655215.85
280110,202008,75,70,5,73150,5225,78375
280120,202008,660,540,120,564300,125400,689700
280130,202008,1721,1131,590,1181895,617595.5,1799490.5
280140,202008,479,390,89,408595.72,93005,501600.72
280150,202008,395,285,110,297825,114950,412775
280160,202008,106,89,17,93005,17765,110770
280170,202008,398,276,122,288420.25,127490,415910.25
280190,202008,27,24,3,25080,3135,28215
280200,202008,29,25,4,26125,4180,30305
280210,202008,2939,2103,836,2201692.36,873620.5,3075312.86
280220,202008,39,31,8,32395,8360,40755
280230,202008,326,268,58,280060,60610,340670
280240,202008,118,112,6,117040,6270,123310
280250,202008,16,10,6,10450,6270,16720
280260,202008,81,73,8,76285,8360,84645
280270,202008,149,116,33,121220,34485,155705
280280,202008,190,122,68,127490.37,71060,198550.37
280290,202008,3329,2412,917,2521519.66,961400.1,3482919.76
280300,202008,1601,1245,356,1301025.5,372020,1673045.5
280310,202008,101,95,6,99275.5,6270,105545.5
280320,202008,657,465,192,486970,200640,687610
280330,202008,324,234,90,244530,94050,338580
280340,202008,407,330,77,344850,80465,425315
280350,202008,3670,2858,812,2986612.16,850631,3837243.16
280360,202008,465,307,158,321860,165110,486970
280370,202008,96,84,12,87780.65,12540,100320.65
280380,202008,53,42,11,43890,11495,55385
280390,202008,170,147,23,153615,24035,177650
280400,202008,357,246,111,257071.4,115995,373066.4
280410,202008,287,235,52,245575,54340,299915
280420,202008,171,143,28,149435,29260,178695
280430,202008,41,32,9,33440,9405,42845
280440,202008,695,546,149,571615.65,155705,727320.65
280445,202008,120,110,10,114950,10450,125400
280450,202008,1198,1036,162,1083665,169290,1252955
280460,202008,622,455,167,475476.63,175560,651036.63
280470,202008,184,172,12,179740,12540.75,192280.75
280480,202008,2655,1856,799,1940567.09,834955.32,2775522.41
280490,202008,264,250,14,261250.66,14630,275880.66
280500,202008,42,38,4,39710,4180,43890
280510,202008,138,112,26,117040,27170.5,144210.5
280520,202008,54,40,14,41800,14630,56430
280530,202008,75,49,26,51205,27170,78375
280540,202008,535,449,86,469205,89870,559075
280550,202008,731,678,53,708511.71,56430,764941.71
280560,202008,495,438,57,457710,60610,518320
280570,202008,2213,1735,478,1814120.2,499510,2313630.2
280580,202008,594,459,135,479655,141075.5,620730.5
280590,202008,207,130,77,135850,80465,216315
280600,202008,388,324,64,338580,66880,405460
280610,202008,112,86,26,89870,27170,117040
280620,202008,557,457,100,477565,104500,582065
280630,202008,152,126,26,132715,27170,159885
280640,202008,194,154,40,160930,41800,202730
280650,202008,89,60,29,62700,30305,93005
280660,202008,146,108,38,112860,39710,152570
280670,202008,1849,1166,683,1218472.78,713736.05,1932208.83
280680,202008,179,156,23,163020,24035,187055
280690,202008,79,70,9,74195,9405,83600
280700,202008,22,22,0,22990,0,22990
280710,202008,1466,1127,339,1179805,354255,1534060
280720,202008,110,71,39,74195,40755,114950
280730,202008,25,20,5,20900,5225,26125
280740,202008,2518,1882,636,1969825.5,665665,2635490.5
280750,202008,233,205,28,214225,29260,243485
280760,202008,777,538,239,562210,249755,811965
290010,202008,205,142,63,148390,65835,214225
290020,202008,182,164,18,171380,18810,190190
290030,202008,616,398,218,415910,228855,644765
290035,202008,131,106,25,110770,26125,136895
290040,202008,304,203,101,212135,106590,318725
290050,202008,86,66,20,70015,20900,90915
290060,202008,269,118,151,123310,157795,281105
290070,202008,5724,2768,2956,2894651.35,3094245.75,5988897.10
290080,202008,453,207,246,216315,257070,473385
290090,202008,386,175,211,182875,221540,404415
290100,202008,1643,1065,578,1115015,604011,1719026
290110,202008,831,481,350,503690.75,365750,869440.75
290115,202008,194,179,15,187055,15675,202730
290120,202008,762,504,258,526680,270655,797335
290130,202008,427,264,163,275880,170335,446215
290135,202008,300,227,73,237215,76285,313500
290140,202008,317,262,55,274835,57475,332310
290150,202008,137,98,39,102410,40755,143165
290160,202008,241,185,56,193325,58520,251845
290170,202008,93,67,26,70015,27170,97185
290180,202008,179,130,49,135850,51205,187055
290190,202008,436,360,76,376200,79420,455620
290195,202008,319,204,115,213180,120175,333355
290200,202008,274,222,52,233035,54340,287375
290205,202008,151,91,60,95095,62700,157795
290210,202008,1172,861,311,899745.5,324995,1224740.5
290220,202008,218,120,98,125400,102410,227810
290225,202008,291,116,175,121220,182875,304095
290230,202008,76,49,27,51205,28215,79420
290240,202008,355,132,223,137940,233035,370975
290250,202008,254,234,20,244530,20900,265430
290260,202008,321,264,57,275880.5,59565,335445.5
290265,202008,187,162,25,169290,26125,195415
290270,202008,1418,1180,238,1233100,248710.5,1481810.5
290280,202008,483,342,141,357390,147345,504735
290290,202008,1328,797,531,832866.03,555940.5,1388806.53
290300,202008,436,371,65,387695.5,67925,455620.5
290310,202008,301,137,164,143165,171380,314545
290320,202008,4011,2483,1528,2599960.3,1603030.1,4202990.4
290323,202008,191,164,27,171380,28215,199595
290327,202008,169,134,35,140030,36575,176605
290330,202008,105,54,51,56430,53295,109725
290340,202008,826,339,487,354255,509960,864215
290350,202008,627,382,245,399190.5,257070,656260.5
290360,202008,349,269,80,281106.64,83600,364706.64
290370,202008,916,389,527,406505.75,550715,957220.75
290380,202008,318,199,119,207955,124355,332310
290390,202008,2443,1523,920,1592686.25,961400,2554086.25
290395,202008,248,142,106,148390.25,110770,259160.25
290400,202008,271,202,69,211090.5,72105,283195.5
290405,202008,248,215,33,224675,34485,259160
290410,202008,628,525,103,548625.53,108680,657305.53
290420,202008,253,203,50,212135,52250,264385
290430,202008,479,312,167,326040,174515,500555
290440,202008,75,67,8,70015,8360,78375
290450,202008,203,154,49,160930,52250,213180
290460,202008,1962,1182,780,1236235,815100,2051335
290470,202008,1391,606,785,633270,822415,1455685
290475,202008,560,522,38,545490.2,39710,585200.2
290480,202008,287,163,124,170335,129580,299915
290485,202008,239,221,18,230945,18810,249755
290490,202008,1213,873,340,912285,355300,1267585
290500,202008,749,383,366,400235,382470,782705
290510,202008,227,178,49,186010,51205,237215
290515,202008,156,95,61,99275,63745,163020
290520,202008,1417,933,484,974985,507871.44,1482856.44
290530,202008,299,276,23,288420,24035,312455
290540,202008,104,55,49,57475,51205,108680
290550,202008,160,136,24,142120,25080,167200
290560,202008,3187,1377,1810,1440010,1899810,3339820
290570,202008,6216,3014,3202,3150676.9,3347137,6497813.9
290580,202008,1281,762,519,797335,542355,1339690
290590,202008,569,470,99,491150,103455,594605
290600,202008,1772,1221,551,1278035.63,577885,1855920.63
290610,202008,205,184,21,193325,21945,215270
290620,202008,355,319,36,333355,37620,370975
290630,202008,2012,851,1161,889295,1214290.5,2103585.5
290640,202008,152,123,29,128535,30305,158840
290650,202008,1801,832,969,870486.42,1014695,1885181.42
290660,202008,280,227,53,237215,55385,292600
290670,202008,940,485,455,507871.5,476520,984391.5
290680,202008,1231,990,241,1034550,253935,1288485
290682,202008,307,229,78,239305.8,81510,320815.8
290685,202008,239,157,82,164065,85690,249755
290687,202008,1042,676,366,706590.1,383515,1090105.1
290689,202008,146,78,68,82555,72105,154660
290690,202008,614,258,356,270655,375155,645810
290700,202008,246,121,125,127490,131670,259160
290710,202008,750,512,238,535040,248710,783750
290720,202008,1028,833,195,870485,203775,1074260
290730,202008,1162,667,495,697015.75,517275,1214290.75
290740,202008,17,14,3,14630,3135,17765
290750,202008,1423,635,788,663575,825551.54,1489126.54
290755,202008,72,65,7,67925,7315,75240
290760,202008,294,255,39,267520,40755,308275
290770,202008,188,177,11,184965,11495,196460
290780,202008,1105,847,258,885116,269610,1154726
290790,202008,363,255,108,266475,112860.5,379335.5
290800,202008,2486,1009,1477,1054405.5,1545555,2599960.5
290810,202008,461,318,143,332310,149435,481745
290820,202008,397,234,163,244530,170335,414865
290830,202008,422,300,122,313500,127490,440990
290840,202008,1748,1084,664,1133826.7,695970.5,1829797.2
290850,202008,834,444,390,463980,407550,871530
290860,202008,650,294,356,307230,374110.5,681340.5
290870,202008,635,451,184,471295.6,194370.6,665666.2
290880,202008,121,66,55,68970,57475,126445
290890,202008,385,262,123,274835,128535,403370
290900,202008,168,127,41,132715,42845,175560
290910,202008,386,295,91,308275,95095,403370
290920,202008,210,184,26,192280,27170,219450
290930,202008,820,624,196,653125.5,204820,857945.5
290940,202008,245,205,40,214225,41800,256025
290950,202008,155,94,61,98230,63745,161975
290960,202008,472,332,140,346940,146300,493240
290970,202008,248,216,32,225720,33440,259160
290980,202008,1630,1150,480,1201750.7,502646,1704396.7
290990,202008,392,330,62,344850,64790,409640
291000,202008,858,253,605,265430,632225,897655
291005,202008,2317,1011,1306,1056495,1368950.42,2425445.42
291010,202008,161,145,16,151525,16720,168245
291020,202008,102,81,21,84645,21945,106590
291030,202008,96,71,25,74195,26125,100320
291040,202008,611,342,269,357390,282150,639540
291050,202008,1430,790,640,826595,669845,1496440
291060,202008,1541,850,691,888250,723140,1611390
291070,202008,1962,1459,503,1525700.62,525635.12,2051335.74
291072,202008,7215,2688,4527,2810006.1,4733852.5,7543858.6
291075,202008,242,195,47,203775,49115,252890
291077,202008,58,40,18,41800,18810,60610
291080,202008,20292,8875,11417,9284827.46,11947486.27,21232313.73
291085,202008,297,244,53,254980,55385,310365
291090,202008,304,125,179,130625.5,188100,318725.5
291100,202008,662,203,459,212135,480700,692835
291110,202008,421,319,102,334400,108680,443080
291120,202008,2404,1200,1204,1256090.75,1258180,2514270.75
291125,202008,64,31,33,32395,34485,66880
291130,202008,201,178,23,186010,24035,210045
291140,202008,132,107,25,111815,26125.5,137940.5
291150,202008,392,150,242,156750,252890,409640
291160,202008,384,313,71,327085.25,74195,401280.25
291165,202008,41,33,8,34485,8360,42845
291170,202008,3164,1584,1580,1655281.67,1652145.5,3307427.17
291180,202008,1265,508,757,531905.31,794200,1326105.31
291185,202008,92,87,5,90915,5225,96140
291190,202008,1371,622,749,649990.25,782705,1432695.25
291200,202008,171,127,44,132715,45980,178695
291210,202008,2285,915,1370,957220.2,1432695.5,2389915.7
291220,202008,272,205,67,214225,70015,284240
291230,202008,988,339,649,354255.5,678205,1032460.5
291240,202008,428,400,28,418000.5,29260,447260.5
291250,202008,438,354,84,370975,87780,458755
291260,202008,57,47,10,49115,10450,59565
291270,202008,1158,482,676,503690,706420,1210110
291280,202008,358,168,190,175560,198550,374110
291290,202008,1733,899,834,941545.5,876755.5,1818301.0
291300,202008,232,185,47,193325,50160,243485
291310,202008,222,202,20,211090,20900,231990
291320,202008,1362,958,404,1003200,423225,1426425
291330,202008,133,114,19,119130,19855,138985
291340,202008,202,117,85,123310,88825,212135
291345,202008,131,91,40,95095,41800,136895
291350,202008,1653,581,1072,609235,1125465.75,1734700.75
291360,202008,8412,4058,4354,4247925.75,4560381.25,8808307.00
291370,202008,1125,647,478,677160.5,500555,1177715.5
291380,202008,270,212,58,221540,60610,282150
291390,202008,3898,1708,2190,1787996.4,2291685.5,4079681.9
291400,202008,2089,1488,601,1556005,628045.84,2184050.84
291410,202008,191,167,24,174515,25080,199595
291420,202008,119,87,32,90915,33440,124355
291430,202008,165,91,74,95095,77330.02,172425.02
291440,202008,520,427,93,446216,97185,543401
291450,202008,920,589,331,615505.25,345895,961400.25
291460,202008,1843,1505,338,1572725.5,354255.5,1926981.0
291465,202008,2177,1035,1142,1081575.5,1194435,2276010.5
291470,202008,2867,1448,1419,1513160.97,1483900.5,2997061.47
291480,202008,11840,5244,6596,5487300.51,6908498.25,12395798.76
291490,202008,616,247,369,258115,385605,643720
291500,202008,375,220,155,230945,161975,392920
291510,202008,1219,475,744,496375,777480,1273855
291520,202008,944,427,517,446215,540265,986480
291530,202008,935,252,683,263340,713735,977075
291535,202008,125,102,23,106590,24035,130625
291540,202008,348,107,241,111815.5,252890,364705.5
291550,202008,1232,583,649,610280,678205.5,1288485.5
291560,202008,5267,2648,2619,2768205,2742081,5510286
291570,202008,197,104,93,108680,97185,205865
291580,202008,1213,747,466,780615.55,488015,1268630.55
291590,202008,87,35,52,36575,54340.5,90915.5
291600,202008,1142,564,578,590425.25,606100,1196525.25
291610,202008,1446,703,743,735680,777480,1513160
291620,202008,563,261,302,273790,315590,589380
291630,202008,485,148,337,154660,353210,507870
291640,202008,3967,2024,1943,2119262.2,2035661.5,4154923.7
291650,202008,423,288,135,300961.12,141075,442036.12
291660,202008,392,160,232,167200.29,243485,410685.29
291670,202008,224,136,88,142120,91960,234080
291680,202008,657,393,264,410685,277970.5,688655.5
291685,202008,587,326,261,340670,272745,613415
291690,202008,533,320,213,334400,223630.27,558030.27
291700,202008,976,760,216,794200,225720,1019920
291710,202008,1640,789,851,826595,889295.5,1715890.5
291720,202008,427,288,139,300960,145255,446215
291730,202008,937,553,384,577885,401280,979165
291733,202008,289,196,93,204820,97185,302005
291735,202008,76,57,19,59565,19855,79420
291740,202008,359,275,84,287375,87780,375155
291750,202008,2154,1403,751,1466135.38,784795,2250930.38
291760,202008,2967,1640,1327,1716935,1389850,3106785
291770,202008,787,531,256,554896.05,269610,824506.05
291780,202008,58,36,22,37620,22990,60610
291790,202008,160,81,79,84645,84645,169290
291800,202008,10042,4141,5901,4330483.37,6170726.5,10501209.87
291810,202008,1108,824,284,862125.5,297825,1159950.5
291820,202008,282,201,81,210045,84645,294690
291830,202008,1049,418,631,437856.46,661485,1099341.46
291835,202008,569,528,41,551760,42845,594605
291840,202008,4874,2468,2406,2582195.25,2517405.5,5099600.75
291845,202008,271,88,183,91960,191235,283195
291850,202008,327,290,37,303050,38665,341715
291855,202008,265,105,160,109725,168245,277970
291860,202008,171,108,63,112860,65835,178695
291870,202008,84,36,48,37620,51205,88825
291875,202008,179,165,14,172425,14630,187055
291880,202008,456,362,94,378290,98230,476520
291890,202008,243,77,166,80465,173470.5,253935.5
291900,202008,58,33,25,34485,26125,60610
291905,202008,127,92,35,96140.5,36575,132715.5
291910,202008,162,132,30,137940,31350,169290
291915,202008,431,384,47,401280.25,49115,450395.25
291920,202008,5091,2552,2539,2671020,2654300.5,5325320.5
291930,202008,169,99,70,104500.55,73150,177650.55
291940,202008,362,206,156,215270.5,163020,378290.5
291950,202008,1154,932,222,973941,233035.84,1206976.84
291955,202008,1251,743,508,777480,530860,1308340
291960,202008,189,137,52,143165,54340,197505
291970,202008,762,580,182,606100,190190,796290
291980,202008,1503,1330,173,1389851.23,180785.5,1570636.73
291990,202008,134,125,9,130625,9405,140030
291992,202008,172,88,84,91960,87780,179740
291995,202008,180,119,61,124355,63745,188100
292000,202008,400,306,94,319770,98230,418000
292010,202008,316,220,96,229900,101365,331265
292020,202008,300,221,79,230945,82555,313500
292030,202008,147,114,33,119130,34485,153615
292040,202008,626,316,310,330220,323950,654170
292045,202008,108,97,11,101365,11495,112860
292050,202008,951,691,260,722095,271700.5,993795.5
292060,202008,908,747,161,781660.65,168245,949905.65
292070,202008,56,20,36,20900,37620,58520
292080,202008,142,97,45,101365,47025,148390
292090,202008,541,186,355,195415,372020,567435
292100,202008,1476,631,845,659395,885115,1544510
292105,202008,191,169,22,177650,22990,200640
292110,202008,2264,821,1443,858990,1510025,2369015
292120,202008,698,551,147,575795,153615,729410
292130,202008,441,249,192,260205,200640,460845
292140,202008,211,171,40,178695,41800,220495
292145,202008,162,86,76,89870,79420,169290
292150,202008,1477,1206,271,1260270,283195,1543465
292160,202008,170,139,31,145255,32395,177650
292170,202008,1207,1049,158,1096205,165110,1261315
292180,202008,219,161,58,169290,61655,230945
292190,202008,162,105,57,109725,59565,169290
292200,202008,1342,491,851,515185,890340.5,1405525.5
292205,202008,125,109,16,113905,16720,130625
292210,202008,367,256,111,267520,115995.25,383515.25
292220,202008,29,22,7,22990,7315,30305
292225,202008,41,35,6,36575,6270,42845
292230,202008,965,766,199,800470.75,207955,1008425.75
292240,202008,610,440,170,459800.75,178695,638495.75
292250,202008,1733,1140,593,1191300,621775,1813075
292260,202008,414,250,164,261250,171380,432630
292265,202008,251,180,71,188100,74195,262295
292270,202008,737,336,401,352165,420090,772255
292273,202008,208,114,94,119130,98230,217360
292275,202008,172,86,86,89870,89870,179740
292280,202008,143,99,44,103455,45980,149435
292285,202008,77,63,14,65835,14630,80465
292290,202008,575,389,186,406505,195415.5,601920.5
292300,202008,1686,634,1052,662530,1101430.3,1763960.3
292303,202008,112,73,39,76285,40755,117040
292305,202008,114,84,30,87780,31350,119130
292310,202008,929,606,323,633271.25,337535.9,970807.15
292320,202008,601,457,144,477565,150480,628045
292330,202008,177,101,76,105545,79420,184965
292335,202008,284,222,62,231990,64790,296780
292340,202008,579,404,175,423225,183920,607145
292350,202008,273,147,126,153615,131670,285285
292360,202008,707,540,167,564300.9,174515,738815.9
292370,202008,736,566,170,591470,178695,770165
292380,202008,640,518,122,542355.35,127490,669845.35
292390,202008,469,186,283,194370,295735,490105
292400,202008,3633,2236,1397,2338713.11,1463000,3801713.11
292405,202008,265,173,92,180785,96140,276925
292410,202008,138,85,53,88825,55385,144210
292420,202008,294,255,39,266475,40755,307230
292430,202008,540,407,133,426360,138985,565345
292440,202008,598,513,85,537130.16,88825,625955.16
292450,202008,248,192,56,200640,59565,260205
292460,202008,554,414,140,432630.95,146300,578930.95
292465,202008,211,176,35,183920,36575,220495
292467,202008,127,77,50,80465,53295,133760
292470,202008,288,195,93,203775,97185,300960
292480,202008,367,253,114,264385,119130.5,383515.5
292490,202008,234,164,70,171380,73150,244530
292500,202008,870,386,484,405460.15,506825,912285.15
292510,202008,3452,1592,1860,1665730.6,1945790,3611520.6
292520,202008,1086,511,575,533995,600875,1134870
292525,202008,397,282,115,294690,120175,414865
292530,202008,4387,1766,2621,1846515.96,2747306.5,4593822.46
292540,202008,478,266,212,277970,221540,499510
292550,202008,1099,582,517,608190,542355,1150545
292560,202008,332,310,22,323950,22990,346940
292570,202008,303,237,66,247665,70015,317680
292575,202008,490,324,166,338580.5,173470,512050.5
292580,202008,991,658,333,688655,347985.5,1036640.5
292590,202008,566,494,72,516230,75240,591470
292593,202008,142,113,29,118085,30305,148390
292595,202008,200,156,44,163020,45980,209000
292600,202008,1257,914,343,955130.29,358435,1313565.29
292610,202008,132,102,30,106590,31350,137940
292620,202008,527,442,85,461890,88825,550715
292630,202008,1430,803,627,839135.42,655215,1494350.42
292640,202008,824,572,252,597740,263340,861080
292650,202008,191,158,33,165110.5,35530,200640.5
292660,202008,2032,1457,575,1523610,600875.42,2124485.42
292665,202008,144,102,42,106590,43890,150480
292670,202008,391,316,75,330220,78375,408595
292680,202008,259,193,66,201685,68970.5,270655.5
292690,202008,195,144,51,150480,53295,203775
292700,202008,977,648,329,678205.55,343805,1022010.55
292710,202008,116,101,15,105545,15675,121220
292720,202008,930,530,400,554895,418000,972895
292730,202008,196,91,105,95095,109725,204820
292740,202008,68764,33587,35177,35129782.36,36826855.83,71956638.19
292750,202008,389,275,114,287375.95,119130,406505.95
292760,202008,335,279,56,291556.45,58520,350076.45
292770,202008,826,353,473,368885,494285,863170
292780,202008,415,164,251,171380,262295,433675
292790,202008,771,392,379,409640,397100,806740
292800,202008,1257,754,503,788975,525635,1314610
292805,202008,395,121,274,126445,286330,412775
292810,202008,1497,851,646,889296.5,675070,1564366.5
292820,202008,716,596,120,622821.25,126445,749266.25
292830,202008,112,90,22,94050,22990,117040
292840,202008,682,561,121,586245,126445,712690
292850,202008,143,95,48,99275,50160,149435
292860,202008,2161,1267,894,1324015.65,937365,2261380.65
292870,202008,3495,2340,1155,2445300.45,1209065,3654365.45
292880,202008,1500,985,515,1030370.05,539220,1569590.05
292890,202008,516,441,75,460845,78375,539220
292895,202008,141,94,47,98230,49115,147345
292900,202008,388,278,110,290510.4,114950,405460.4
292905,202008,479,241,238,251845,248710,500555
292910,202008,459,345,114,360525.75,119130,479655.75
292920,202008,525,228,297,238260,311410,549670
292925,202008,492,452,40,472340,41800,514140
292930,202008,614,374,240,390830,251845,642675
292935,202008,285,123,162,128535,169290,297825
292937,202008,227,158,69,165110,72105,237215
292940,202008,191,148,43,154660,44935,199595
292950,202008,1176,594,582,620730.75,609235.6,1229966.35
292960,202008,583,414,169,432630,176605,609235
292970,202008,245,173,72,181830,77330,259160
292975,202008,113,65,48,67925,50160,118085
292980,202008,287,194,93,202730.52,97185,299915.52
292990,202008,1335,991,344,1036641.55,360525,1397166.55
293000,202008,113,79,34,83600,35530,119130
293010,202008,2808,1672,1136,1748285.75,1188165.72,2936451.47
293015,202008,637,520,117,543400,122265,665665
293020,202008,329,272,57,284240,60610,344850
293030,202008,601,523,78,546535,81510,628045
293040,202008,357,281,76,293645,79420,373065
293050,202008,2881,1708,1173,1786950.5,1227875.5,3014826.0
293060,202008,261,209,52,218405.6,54340,272745.6
293070,202008,3488,1757,1731,1837112.72,1808896.75,3646009.47
293075,202008,91,61,30,63745,32395,96140
293076,202008,74,52,22,54340,22990,77330
293077,202008,508,295,213,308275.5,223630,531905.5
293080,202008,440,395,45,413820.85,47025,460845.85
293090,202008,128,115,13,120175,13585,133760
293100,202008,527,368,159,384560,166155,550715
293105,202008,345,251,94,262295,98230,360525
293110,202008,166,116,50,121220,52250,173470
293120,202008,311,212,99,221540,103455,324995
293130,202008,244,168,76,175560,79420,254980
293135,202008,8072,3173,4899,3315786.75,5128863.5,8444650.25
293140,202008,210,131,79,136895,82555,219450
293150,202008,328,284,44,296780,45980,342760
293160,202008,425,253,172,264385,179740,444125
293170,202008,177,121,56,126445,58520,184965
293180,202008,526,372,154,388740.5,160930,549670.5
293190,202008,1342,932,410,973940.61,429495,1403435.61
293200,202008,544,480,64,501600,66880,568480
293210,202008,395,299,96,312455,100320,412775
293220,202008,2489,1047,1442,1094115,1508980,2603095
293230,202008,1754,643,1111,672980.94,1162040,1835020.94
293240,202008,233,215,18,224675,18810,243485
293245,202008,126,107,19,111815,19855,131670
293250,202008,724,259,465,270655.9,488015,758670.9
293260,202008,304,253,51,264385,53295,317680
293270,202008,1159,539,620,564300.25,648945,1213245.25
293280,202008,275,152,123,158840,128535,287375
293290,202008,3043,1986,1057,2076415.56,1105610,3182025.56
293300,202008,740,527,213,550715.75,222585,773300.75
293305,202008,193,153,40,159885,41800,201685
293310,202008,151,114,37,119130,38665,157795
293315,202008,164,129,35,134805,36575,171380
293317,202008,90,65,25,67925.5,26125,94050.5
293320,202008,1058,586,472,612370.92,493240,1105610.92
293325,202008,182,67,115,70015,120175,190190
293330,202008,13721,6411,7310,6706814.05,7647312.75,14354126.80
293340,202008,271,193,78,201685,81510,283195
293345,202008,246,199,47,207955,49115,257070
293350,202008,616,354,262,370975,273790,644765
293360,202008,1530,1093,437,1142185,457710,1599895
310010,202008,138,75,63,78375,65835.5,144210.5
310020,202008,1038,576,462,602965,483835,1086800
310030,202008,329,264,65,275880,67925,343805
310040,202008,43,29,14,30305,14630,44935
310050,202008,179,113,66,118085.5,68970,187055.5
310060,202008,243,168,75,175560.5,78375,253935.5
310070,202008,15,10,5,10450,5225,15675
310080,202008,40,25,15,26125,15675,41800
310090,202008,1022,531,491,554897,514141,1069038
310100,202008,307,223,84,233035,87780,320815
310110,202008,706,389,317,406505,331265,737770
310120,202008,378,216,162,225720,169290,395010
310130,202008,33,19,14,19855,14630,34485
310140,202008,26,13,13,13585,13585,27170
310150,202008,1198,818,380,854810.5,398146,1252956.5
310160,202008,2065,1009,1056,1054407.15,1104565.5,2158972.65
310163,202008,86,49,37,51205,38665,89870
310170,202008,2560,1130,1430,1181895.85,1494352,2676247.85
310180,202008,150,55,95,58520,99275,157795
310190,202008,480,328,152,344850,158840,503690
310200,202008,489,312,177,326040,184965,511005
310205,202008,57,39,18,40755,18810,59565
310210,202008,283,228,55,238260,57475,295735
310220,202008,62,34,28,35530,29260,64790
310230,202008,277,192,85,200640,88825,289465
310240,202008,107,94,13,98230,13585,111815
310250,202008,98,79,19,82555,19855,102410
310260,202008,768,407,361,426361.17,377245,803606.17
310270,202008,272,177,95,184965.6,99275,284240.6
310280,202008,376,276,100,288420,104500,392920
310285,202008,209,152,57,158840,59565,218405
310290,202008,241,129,112,134805,117040,251845
310300,202008,157,128,29,133760,30305,164065
310310,202008,9,7,2,7315,2090,9405
310320,202008,29,11,18,11495,18810,30305
310330,202008,41,27,14,28215,14630,42845
310340,202008,1749,1149,600,1200707,628045.5,1828752.5
310350,202008,2785,1484,1301,1556005,1360590,2916595
310360,202008,40,34,6,35530,6270,41800
310370,202008,115,95,20,99275,20900,120175
310375,202008,102,38,64,39710,66880,106590
310380,202008,47,27,20,28215,20900,49115
310390,202008,95,63,32,65835,33440,99275
310400,202008,2344,1508,836,1581086,873620,2454706
310410,202008,128,70,58,74195,60610,134805
310420,202008,665,348,317,365750,331265,697015
310430,202008,309,195,114,204820,120175,324995
310440,202008,76,43,33,44935,34485,79420
310445,202008,80,65,15,67925,15675,83600
310450,202008,624,385,239,402325,249755,652080
310460,202008,261,183,78,192280,81510,273790
310470,202008,507,320,187,334400,195415,529815
310480,202008,77,53,24,55385,25080,80465
310490,202008,533,249,284,260205,296780,556985
310500,202008,136,54,82,56430,85690,142120
310510,202008,606,420,186,439945,194370,634315
310520,202008,134,93,41,97185,42845,140030
310530,202008,108,47,61,49115,63745,112860
310540,202008,474,274,200,287375,209000,496375
310550,202008,74,48,26,50160,28215,78375
310560,202008,2973,2044,929,2138070.25,970805,3108875.25
310570,202008,88,59,29,61655,30305,91960
310590,202008,369,235,134,245575.25,140030,385605.25
310600,202008,148,81,67,84645.5,70015,154660.5
310610,202008,59,24,35,25080,36575,61655
310620,202008,47013,22423,24590,23465411.83,25750895.9,49216307.73
310630,202008,645,397,248,415910,259160.5,675070.5
310640,202008,127,99,28,103455,29260,132715
310650,202008,159,142,17,149435,17765,167200
310660,202008,99,66,33,68970,34485,103455
310665,202008,62,47,15,49115,15675,64790
310670,202008,6716,2872,3844,3007512.5,4022206,7029718.5
310680,202008,58,37,21,38665,21945,60610
310690,202008,613,427,186,447260.25,194370,641630.25
310700,202008,58,38,20,39710,20900,60610
310710,202008,1329,906,423,947815.5,442035.5,1389851.0
310720,202008,134,36,98,37620,102410,140030
310730,202008,1459,1000,459,1046046.25,479655,1525701.25
310740,202008,968,538,430,564301,451440.25,1015741.25
310750,202008,240,145,95,151525.65,100320,251845.65
310760,202008,64,47,17,49115,17765.5,66880.5
310770,202008,91,46,45,49115,47025,96140
310780,202008,364,294,70,307230,73150,380380
310790,202008,101,82,19,85690,19855,105545
310800,202008,445,208,237,218405.25,248710,467115.25
310810,202008,171,122,49,127490.72,51205,178695.72
310820,202008,334,263,71,274835,74195,349030
310825,202008,193,163,30,170335,31350,201685
310830,202008,472,223,249,233035.5,261250,494285.5
310840,202008,370,215,155,224675,161975,386650
310850,202008,84,68,16,71060,16720,87780
310855,202008,394,314,80,328130,83600,411730
310860,202008,1585,1170,415,1222653,433676.25,1656329.25
310870,202008,53,43,10,44935,10450,55385
310880,202008,84,64,20,66880,20900,87780
310890,202008,306,175,131,182875,136895,319770
310900,202008,647,299,348,313509.14,363672.96,677182.10
310910,202008,242,162,80,169290.5,83600,252890.5
310920,202008,452,268,184,280061.45,192280.5,472341.95
310925,202008,35,29,6,31350,6270,37620
310930,202008,1301,823,478,860035,502645,1362680
310940,202008,704,350,354,365750,372020,737770
310945,202008,118,74,44,77330,45980,123310
310950,202008,230,184,46,192280,48070,240350
310960,202008,79,24,55,25080,57475,82555
310970,202008,164,103,61,107635,63745.5,171380.5
310980,202008,49,32,17,33440,17765,51205
310990,202008,162,82,80,85690,83600,169290
311000,202008,823,406,417,424271.49,435765.5,860036.99
311010,202008,43,38,5,39710,5225,44935
311020,202008,46,28,18,29260,18810,48070
311030,202008,389,225,164,235125.5,171380,406505.5
311040,202008,42,32,10,33440,10450,43890
311050,202008,486,187,299,195415,312455,507870
311060,202008,779,432,347,451440,363660.5,815100.5
311070,202008,338,151,187,157795,195415,353210
311080,202008,108,58,50,60610,52250,112860
311090,202008,338,156,182,163020,190190,353210
311100,202008,582,353,229,369930,240350,610280
311110,202008,691,483,208,506825,217360,724185
311115,202008,73,52,21,55385,21945,77330
311120,202008,1067,570,497,595650.5,521455,1117105.5
311130,202008,341,205,136,214225,143165,357390
311140,202008,168,89,79,93005,82555,175560
311150,202008,345,223,122,233035,127490,360525
311160,202008,713,509,204,532950.5,215270,748220.5
311170,202008,86,68,18,71060,18810,89870
311180,202008,329,221,108,230945,112860.5,343805.5
311190,202008,43,21,22,22990,22990,45980
311200,202008,326,229,97,239305,101365,340670
311205,202008,33,22,11,22990,11495,34485
311210,202008,47,41,6,42845.5,6270,49115.5
311220,202008,27,23,4,24035,4180,28215
311230,202008,1631,1072,559,1121285.5,587290,1708575.5
311240,202008,186,120,66,125400,68970,194370
311250,202008,57,22,35,22990,36575,59565
311260,202008,547,343,204,358435,213180,571615
311265,202008,123,83,40,86735,41800,128535
311270,202008,289,196,93,204820,97185,302005
311280,202008,214,98,116,102410,121220,223630
311290,202008,103,84,19,87780,19855,107635
311300,202008,586,366,220,383515,229900,613415
311310,202008,21,16,5,16720,5225,21945
311320,202008,660,489,171,512050,178695,690745
311330,202008,1082,798,284,833910,299915.5,1133825.5
311340,202008,2630,1864,766,1952061,802560,2754621
311350,202008,275,213,62,223630,64790,288420
311360,202008,176,108,68,112860,71060,183920
311370,202008,1219,498,721,520410.25,753445,1273855.25
311380,202008,7,6,1,6270,1045,7315
311390,202008,249,137,112,143165,117040,260205
311400,202008,137,87,50,90915,52250,143165
311410,202008,111,58,53,60610,55385,115995
311420,202008,302,164,138,171380,144210,315590
311430,202008,847,561,286,587290,298870.5,886160.5
311440,202008,462,324,138,338580,144210,482790
311450,202008,314,189,125,197505,131670,329175
311455,202008,278,191,87,199595,90915,290510
311460,202008,140,61,79,63745,82555,146300
311470,202008,24,13,11,13585,11495,25080
311480,202008,47,22,25,22990,26125,49115
311490,202008,13,9,4,9405,4180,13585
311500,202008,25,12,13,12540,13585,26125
311510,202008,633,436,197,455620,205865,661485
311520,202008,40,32,8,33440,8360,41800
311530,202008,1804,1324,480,1387761.7,502645,1890406.7
311535,202008,64,44,20,45980,20900,66880
311540,202008,34,30,4,31350,4180,35530
311545,202008,169,125,44,132715,45980,178695
311547,202008,35,29,6,30305,6270,36575
311550,202008,702,322,380,336490,397100,733590
311560,202008,42,28,14,29260,14630,43890
311570,202008,284,188,96,196460,101365,297825
311580,202008,334,195,139,203775,146300,350075
311590,202008,32,29,3,30305,3135,33440
311600,202008,107,83,24,86735,25080,111815
311610,202008,253,218,35,227810.25,36575,264385.25
311615,202008,83,67,16,70015,16720,86735
311620,202008,25,14,11,14630,11495,26125
311630,202008,88,74,14,77330,14630,91960
311640,202008,138,67,71,70015,74195,144210
311650,202008,117,78,39,81510,40755,122265
311660,202008,404,199,205,207955,214225,422180
311670,202008,151,101,50,105545,52250,157795
311680,202008,210,156,54,163020,56430,219450
311690,202008,15,11,4,11495,4180,15675
311700,202008,196,137,59,143165,61655,204820
311710,202008,200,132,68,137940,71060,209000
311720,202008,42,30,12,31350.5,12540,43890.5
311730,202008,575,389,186,407550,195415,602965
311740,202008,33,23,10,24035,10450,34485
311750,202008,726,490,236,512050.76,246620,758670.76
311760,202008,66,29,37,30305,38665,68970
311770,202008,389,196,193,204820.5,202730,407550.5
311780,202008,176,88,88,91960.5,91960,183920.5
311783,202008,86,77,9,80465,9405,89870
311787,202008,38,13,25,13585,26125,39710
311790,202008,259,115,144,120175,150480,270655
311800,202008,683,448,235,468160.95,246620,714780.95
311810,202008,48,39,9,40755,9405,50160
311820,202008,120,98,22,102410,22990,125400
311830,202008,1896,1167,729,1220561,762850,1983411
311840,202008,1013,562,451,591471,471295.25,1062766.25
311850,202008,12,8,4,8360,4180,12540
311860,202008,9577,4154,5423,4350337.25,5680620.5,10030957.75
311870,202008,126,66,60,68970,62700,131670
311880,202008,925,673,252,703285,263340,966625
311890,202008,205,99,106,104414,110770,215184
311900,202008,74,30,44,31350,45980,77330
311910,202008,1407,883,524,922735.75,547580.5,1470316.25
311920,202008,232,151,81,158840,84645,243485
311930,202008,902,511,391,533995.5,409640,943635.5
311940,202008,2489,1298,1191,1359545,1247730.15,2607275.15
311950,202008,55,40,15,41800,15675,57475
311960,202008,60,44,16,45980,16720,62700
311970,202008,23,14,9,14630,9405,24035
311980,202008,43,33,10,34485,10450,44935
311990,202008,38,29,9,30305,9405,39710
311995,202008,58,37,21,38665,21945,60610
312000,202008,29,21,8,21945,8360,30305
312010,202008,78,61,17,63745,17765,81510
312015,202008,75,57,18,59565,18810,78375
312020,202008,130,88,42,91960,43890,135850
312030,202008,59,44,15,45980,15675,61655
312040,202008,85,51,34,53295.5,35530,88825.5
312050,202008,204,113,91,118085,97185,215270
312060,202008,22,12,10,12540,10450,22990
312070,202008,73,47,26,50160,27170,77330
312080,202008,530,239,291,250800,305140,555940
312083,202008,57,36,21,37620,21945,59565
312087,202008,103,81,22,84645,22990,107635
312090,202008,3203,1906,1297,1993861.5,1355365.5,3349227.0
312100,202008,150,105,45,109484.74,47025,156509.74
312110,202008,119,69,50,72105,52250,124355
312120,202008,140,101,39,105545.29,40755,146300.29
312125,202008,91,51,40,53295,41800,95095
312130,202008,127,83,44,86735,45980,132715
312140,202008,136,106,30,110770.5,31350,142120.5
312150,202008,43,33,10,34485,10450,44935
312160,202008,1553,1021,532,1067041,558030.5,1625071.5
312170,202008,10,8,2,8360,2090,10450
312180,202008,115,70,45,73150,47025,120175
312190,202008,34,30,4,31350,4180,35530
312200,202008,751,639,112,669845.5,117040,786885.5
312210,202008,111,60,51,62700,53295,115995
312220,202008,133,102,31,106590.25,32395,138985.25
312230,202008,3639,1678,1961,1756645.4,2052381,3809026.4
312235,202008,158,105,53,109725,56430,166155
312240,202008,96,68,28,71060,29260,100320
312245,202008,192,129,63,134805,65835,200640
312247,202008,73,51,22,53295,22990,76285
312250,202008,176,83,93,86735,97185,183920
312260,202008,110,72,38,76285,39710,115995
312270,202008,132,77,55,80465,57475,137940
312280,202008,26,13,13,13585,13585,27170
312290,202008,145,103,42,107635,43890,151525
312300,202008,210,135,75,141075,78375,219450
312310,202008,61,54,7,56430,7315,63745
312320,202008,422,269,153,281105,159885.75,440990.75
312330,202008,90,79,11,82555,11495,94050
312340,202008,36,17,19,17765,19855,37620
312350,202008,18,11,7,11495,7315,18810
312352,202008,92,68,24,71060,25080,96140
312360,202008,583,247,336,259160,351120,610280
312370,202008,306,171,135,179740,141075,320815
312380,202008,141,93,48,97185,50160,147345
312385,202008,163,130,33,135850,34485,170335
312390,202008,300,188,112,196460,117040.5,313500.5
312400,202008,381,284,97,296780,102410.5,399190.5
312410,202008,995,314,681,330220,715825.5,1046045.5
312420,202008,624,475,149,496375.5,155705,652080.5
312430,202008,864,630,234,659396.11,244530,903926.11
312440,202008,41,30,11,31350,11495,42845
312450,202008,208,130,78,135850,81510,217360
312460,202008,31,16,15,16720,15675,32395
312470,202008,46,31,15,32395,15675,48070
312480,202008,189,117,72,123310,75240,198550
312490,202008,267,187,80,195415,83600,279015
312500,202008,35,20,15,20900,15675,36575
312510,202008,522,204,318,213214.83,336490,549704.83
312520,202008,30,9,21,9405,21945,31350
312530,202008,47,32,15,33440,15675,49115
312540,202008,94,82,12,85690,12540,98230
312550,202008,35,28,7,29260,7315,36575
312560,202008,215,163,52,170335.5,54340,224675.5
312570,202008,433,257,176,269610,184965,454575
312580,202008,86,47,39,49115,40755,89870
312590,202008,246,196,50,204820,52250,257070
312595,202008,133,119,14,124355,14630,138985
312600,202008,68,37,31,39710.25,32395,72105.25
312610,202008,1592,813,779,853767.5,817190.5,1670958.0
312620,202008,213,152,61,159885,63745,223630
312630,202008,68,58,10,60610,10450,71060
312640,202008,41,12,29,12540,30305,42845
312650,202008,147,121,26,126445.5,27170,153615.5
312660,202008,92,65,27,67925.76,29260,97185.76
312670,202008,921,593,328,619685,343805,963490
312675,202008,29,23,6,24035,6270,30305
312680,202008,75,45,30,47025,31350,78375
312690,202008,244,128,116,133760,121220,254980
312695,202008,28,24,4,25080,4180,29260
312700,202008,230,133,97,138985,101365,240350
312705,202008,81,65,16,67925,16720,84645
312707,202008,128,89,39,93005,40755,133760
312710,202008,1873,997,876,1042910.91,915420,1958330.91
312720,202008,58,31,27,32395,28215,60610
312730,202008,286,165,121,172425,126445,298870
312733,202008,47,38,9,39710,9405,49115
312735,202008,22,14,8,14630,8360,22990
312737,202008,64,36,28,37620,29260,66880
312738,202008,59,40,19,41800,19855,61655
312740,202008,83,54,29,56430,30305,86735
312750,202008,85,60,25,62700,26125,88825
312760,202008,288,207,81,216315,84645,300960
312770,202008,8028,3649,4379,3817389.25,4585460,8402849.25
312780,202008,441,337,104,352165,108680,460845
312790,202008,22,16,6,16720,6270,22990
312800,202008,1592,1104,488,1155770.75,509960,1665730.75
312810,202008,368,235,133,245575,141075,386650
312820,202008,188,144,44,150480,45980,196460
312825,202008,23,15,8,15675,8360,24035
312830,202008,230,130,100,136895,104500,241395
312840,202008,157,107,50,111815,53295,165110
312850,202008,44,39,5,40755,5225,45980
312860,202008,154,97,57,101365,59565,160930
312870,202008,1065,554,511,581020.75,536085,1117105.75
312880,202008,126,88,38,91960,39710,131670
312890,202008,153,109,44,113905,45980,159885
312900,202008,193,145,48,151525,50160,201685
312910,202008,177,93,84,97185,87780,184965
312920,202008,154,84,70,87780,74195,161975
312930,202008,324,226,98,236170,102410,338580
312940,202008,118,83,35,86735,36575,123310
312950,202008,702,480,222,501600,231990,733590
312960,202008,168,126,42,131670.9,43890,175560.9
312965,202008,76,64,12,66880,12540,79420
312970,202008,276,226,50,236170.25,52250,288420.25
312980,202008,2451,1234,1217,1291621,1272810,2564431
312990,202008,45,24,21,25080,21945,47025
313000,202008,53,28,25,29260,26125,55385
313005,202008,172,134,38,140030,39710.5,179740.5
313010,202008,918,358,560,374110.5,585200,959310.5
313020,202008,198,103,95,107635,99275,206910
313030,202008,193,131,62,136895.35,64790,201685.35
313040,202008,76,24,52,25080,54340,79420
313050,202008,181,132,49,137940,51205,189145
313055,202008,36,26,10,27170,10450,37620
313060,202008,130,89,41,93005,42845,135850
313065,202008,63,45,18,47025,18810.5,65835.5
313070,202008,137,70,67,73150,70015,143165
313080,202008,38,17,21,17765,21945,39710
313090,202008,656,438,218,458755,227810,686565
313100,202008,188,66,122,70015,127490,197505
313110,202008,134,69,65,72105,67925,140030
313115,202008,210,118,92,123310,98230,221540
313120,202008,828,471,357,492195,373065.5,865260.5
313130,202008,5703,3093,2610,3236367.2,2729541.75,5965908.95
313140,202008,141,75,66,78375,68970,147345
313150,202008,309,242,67,252890,70015,322905
313160,202008,186,138,48,144210.5,50160,194370.5
313170,202008,1402,944,458,987525.5,478610,1466135.5
313180,202008,299,178,121,186010.5,126445,312455.5
313190,202008,738,443,295,462936,311410,774346
313200,202008,26,21,5,21945,5225,27170
313210,202008,1006,848,158,887207.55,165110,1052317.55
313220,202008,274,169,105,176605,109725.5,286330.5
313230,202008,261,198,63,206910.87,65835,272745.87
313240,202008,2136,1096,1040,1146368,1087845,2234213
313250,202008,1262,962,300,1005290.5,313500.8,1318791.3
313260,202008,90,48,42,50160,43890,94050
313270,202008,979,566,413,591470.75,431586.5,1023057.25
313280,202008,52,44,8,45980,8360,54340
313290,202008,217,173,44,180785,45980,226765
313300,202008,346,180,166,188100,173470,361570
313310,202008,261,123,138,128535,144210,272745
313320,202008,379,282,97,294690,101365,396055
313330,202008,1402,857,545,895565,569525,1465090
313340,202008,324,232,92,242440,96140,338580
313350,202008,500,331,169,345895,177650,523545
313360,202008,135,70,65,73150,67925,141075
313370,202008,217,69,148,72105,154660,226765
313375,202008,291,175,116,182875,121220,304095
313380,202008,1349,704,645,735680.5,674025,1409705.5
313390,202008,52,47,5,49115,5225,54340
313400,202008,401,273,128,285285,133761,419046
313410,202008,23,14,9,14630,9405,24035
313420,202008,4592,2447,2145,2559415,2244661,4804076
313430,202008,145,69,76,72105,79420,151525
313440,202008,1421,971,450,1014696.81,472342,1487038.81
313450,202008,69,28,41,29260,42845,72105
313460,202008,385,171,214,178695.5,224675,403370.5
313470,202008,525,245,280,257070.5,293645.5,550716.0
313480,202008,147,108,39,112860.5,40755,153615.5
313490,202008,517,237,280,247665.5,295735.25,543400.75
313500,202008,26,14,12,14630,12540,27170
313505,202008,1024,806,218,842270,227810,1070080
313507,202008,103,61,42,63745,43890,107635
313510,202008,2831,1783,1048,1864281.54,1095160,2959441.54
313520,202008,3456,2691,765,2813142.57,799425,3612567.57
313530,202008,34,22,12,22990,12540,35530
313535,202008,60,46,14,48070,14630,62700
313540,202008,70,52,18,54340,18810.5,73150.5
313545,202008,111,94,17,99275,18810,118085
313550,202008,231,195,36,204820,37620.5,242440.5
313560,202008,344,166,178,173470,186010,359480
313570,202008,63,24,39,25080,40755,65835
313580,202008,1317,739,578,772255.5,604011.5,1376267.0
313590,202008,67,38,29,39710,30305,70015
313600,202008,677,407,270,426360,282150.5,708510.5
313610,202008,61,47,14,49115,14630,63745
313620,202008,1392,696,696,728366,727320,1455686
313630,202008,1619,1223,396,1279081,413820,1692901
313640,202008,119,73,46,76285,48070,124355
313650,202008,232,107,125,112860,130625,243485
313652,202008,18,18,0,18810,0,18810
313655,202008,66,44,22,45980,22990,68970
313657,202008,48,44,4,45980,4180,50160
313660,202008,134,92,42,97185,43908.81,141093.81
313665,202008,647,299,348,312455.75,363660,676115.75
313670,202008,10300,7019,3281,7345308.47,3432826.25,10778134.72
313680,202008,39,31,8,32395,8360,40755
313690,202008,145,110,35,114950,36575,151525
313695,202008,64,47,17,49115,17765,66880
313700,202008,313,253,60,264385.5,63745,328130.5
313710,202008,144,100,44,104500,45980,150480
313720,202008,1114,521,593,544445.5,621776.5,1166222.0
313730,202008,74,44,30,45980,31350,77330
313740,202008,151,122,29,127490,30305,157795
313750,202008,430,311,119,324995,124355,449350
313753,202008,234,173,61,180785,63745,244530
313760,202008,1302,475,827,497420,867351.63,1364771.63
313770,202008,373,272,101,284240.25,105545,389785.25
313780,202008,775,404,371,422180,387695,809875
313790,202008,28,27,1,28215,1045,29260
313800,202008,140,84,56,87780,58520,146300
313810,202008,78,43,35,44935,36575,81510
313820,202008,1309,621,688,648946,721050.5,1369996.5
313830,202008,56,41,15,42845,15675,58520
313835,202008,61,50,11,53295,11495,64790
313840,202008,1650,988,662,1033506.5,693880.5,1727387.0
313850,202008,205,74,131,78375,136895,215270
313860,202008,475,359,116,375155.5,121220,496375.5
313862,202008,162,108,54,113905,56430,170335
313865,202008,122,92,30,96140,31350,127490
313867,202008,48,38,10,39710,10450,50160
313868,202008,32,19,13,19855,13585,33440
313870,202008,118,62,56,64790,58520,123310
313880,202008,378,230,148,240350,154660,395010
313890,202008,334,173,161,180785,168245,349030
313900,202008,883,479,404,500555.66,422180.25,922735.91
313910,202008,151,107,44,111815,45980,157795
313920,202008,644,449,195,469205,203775.94,672980.94
313925,202008,31,28,3,29260,3135,32395
313930,202008,858,666,192,695970,201685,897655
313940,202008,1867,1161,706,1214290,737770,1952060
313950,202008,874,549,325,573705,339625,913330
313960,202008,1407,807,600,843315.9,627002,1470317.9
313970,202008,167,109,58,113905,60610,174515
313980,202008,205,131,74,136895.25,77330,214225.25
313990,202008,240,158,82,167200,85690,252890
314000,202008,900,597,303,624910.85,317680,942590.85
314010,202008,84,50,34,52250,35530,87780
314015,202008,63,16,47,16720,49115,65835
314020,202008,53,33,20,35530,20900,56430
314030,202008,75,35,40,36575,41800,78375
314040,202008,44,25,19,26125,19855,45980
314050,202008,283,169,114,176605,119130,295735
314053,202008,97,63,34,65835,35530,101365
314055,202008,301,186,115,194370,120175,314545
314060,202008,131,113,18,118085.04,18810,136895.04
314070,202008,1060,545,515,569525,538175,1107700
314080,202008,208,134,74,140030.75,78375.4,218406.15
314085,202008,138,93,45,98230,47025,145255
314090,202008,381,268,113,280060.25,118085,398145.25
314100,202008,503,405,98,423225.75,102410,525635.75
314110,202008,795,394,401,413820.5,419045,832865.5
314120,202008,79,48,31,50160,32395,82555
314130,202008,19,10,9,10450,9405,19855
314140,202008,1112,680,432,710600,451440,1162040
314150,202008,183,118,65,123310,67925,191235
314160,202008,331,251,80,262295,83600,345895
314170,202008,84,64,20,66880,20900,87780
314180,202008,734,648,86,678205.5,89870.25,768075.75
314190,202008,100,60,40,62700,41800,104500
314200,202008,493,336,157,351120,164065.5,515185.5
314210,202008,247,189,58,197505,60610.5,258115.5
314220,202008,308,226,82,236170.5,85690,321860.5
314225,202008,60,44,16,45980,16720,62700
314230,202008,118,53,65,55385,67925,123310
314240,202008,146,108,38,112860,39710,152570
314250,202008,53,29,24,30305,25080,55385
314260,202008,210,104,106,108680,110770,219450
314270,202008,368,285,83,297825,86735,384560
314280,202008,700,379,321,396055,336490,732545
314290,202008,544,436,108,455620,112860,568480
314300,202008,360,260,100,271700.25,104500.25,376200.50
314310,202008,1371,928,443,970022.57,462935,1432957.57
314315,202008,34,26,8,27170,8360,35530
314320,202008,590,390,200,407550.5,209000,616550.5
314330,202008,11127,5412,5715,5664946.75,5979491,11644437.75
314340,202008,600,273,327,286330,343806,630136
314345,202008,43,30,13,31350,13585,44935
314350,202008,181,114,67,119130,71060,190190
314360,202008,60,37,23,38665,24035,62700
314370,202008,64,43,21,44935,21945,66880
314380,202008,95,60,35,62700,36575,99275
314390,202008,3339,2132,1207,2232121.85,1261315,3493436.85
314400,202008,693,493,200,515186.3,209000,724186.3
314410,202008,480,316,164,330220,171380,501600
314420,202008,14,7,7,7315,7315,14630
314430,202008,2426,885,1541,924825.36,1613480.5,2538305.86
314435,202008,192,115,77,121220,80465,201685
314437,202008,28,21,7,21945,7315,29260
314440,202008,97,69,28,72105,29260,101365
314450,202008,158,109,49,113905,51205,165110
314460,202008,648,306,342,319770,357390,677160
314465,202008,97,60,37,62700,38665,101365
314467,202008,68,56,12,58520,12540,71060
314470,202008,416,208,208,217360.95,217360,434720.95
314480,202008,1064,500,564,523545,589380,1112925
314490,202008,47,32,15,33440,15675,49115
314500,202008,281,194,87,202730,90915,293645
314505,202008,109,69,40,72105,41800,113905
314510,202008,240,196,44,204820,47025,251845
314520,202008,1303,686,617,716875.92,645811.5,1362687.42
314530,202008,741,595,146,622821.01,152570,775391.01
314535,202008,180,107,73,111815,76285,188100
314537,202008,59,37,22,38665,22990,61655
314540,202008,16,10,6,10450,6270,16720
314545,202008,50,32,18,33440,18810,52250
314550,202008,80,41,39,42845,40755,83600
314560,202008,864,470,394,491150.5,413820,904970.5
314570,202008,21,16,5,16720,5225,21945
314580,202008,14,5,9,5225,9405,14630
314585,202008,25,17,8,17765,8360,26125
314587,202008,84,71,13,74195,13585,87780
314590,202008,555,396,159,415910.25,167200,583110.25
314600,202008,938,599,339,627001,354255.29,981256.29
314610,202008,955,492,463,515185.5,484880,1000065.5
314620,202008,134,100,34,104500,35530,140030
314625,202008,95,68,27,71060,28215,99275
314630,202008,1177,624,553,653125.4,581020,1234145.4
314640,202008,81,51,30,53295,31350.5,84645.5
314650,202008,181,102,79,106590,82555,189145
314655,202008,61,46,15,48070,15675,63745
314660,202008,16,13,3,13585,3135,16720
314670,202008,200,152,48,158840.5,50160,209000.5
314675,202008,209,121,88,126445,91960,218405
314690,202008,592,313,279,327085,291555,618640
314700,202008,2282,1224,1058,1281172,1107700,2388872
314710,202008,1695,973,722,1017831.75,756580.5,1774412.25
314720,202008,392,233,159,243485,167200,410685
314730,202008,515,267,248,279016,261250,540266
314740,202008,723,347,376,364705,397100,761805
314750,202008,17,14,3,14630,3135,17765
314760,202008,335,153,182,159885,190190,350075
314770,202008,108,74,34,77330,35530,112860
314780,202008,20,8,12,8360,12540,20900
314790,202008,2400,1511,889,1580040.5,932140,2512180.5
314795,202008,50,39,11,40755,11495,52250
314800,202008,2931,1710,1221,1789042.22,1280125,3069167.22
314810,202008,1511,853,658,892430,687610,1580040
314820,202008,104,56,48,58520,50160,108680
314830,202008,213,171,42,178695,43890,222585
314840,202008,86,53,33,55385,34485,89870
314850,202008,389,192,197,200640.5,205865,406505.5
314860,202008,671,512,159,535040,166155,701195
314870,202008,1528,793,735,828685.5,769120,1597805.5
314875,202008,55,49,6,51205,6270,57475
314880,202008,44,30,14,31350,14630,45980
314890,202008,54,32,22,33440,22990,56430
314900,202008,31,24,7,25080,7315,32395
314910,202008,244,158,86,165110,89870,254980
314915,202008,140,127,13,132715,13585,146300
314920,202008,104,65,39,67925,40755,108680
314930,202008,1063,516,547,540265.5,571615.5,1111881.0
314940,202008,48,38,10,39710,10450,50160
314950,202008,29,20,9,20900,9405,30305
314960,202008,31,24,7,25080,7315,32395
314970,202008,148,72,76,75240,79420,154660
314980,202008,309,196,113,204820,118085,322905
314990,202008,444,239,205,249755,215270,465025
314995,202008,176,68,108,71060,112860,183920
315000,202008,91,68,23,71060,24035,95095
315010,202008,42,27,15,28215,15675,43890
315015,202008,168,133,35,138985,36575,175560
315020,202008,68,56,12,58520,12540,71060
315030,202008,108,83,25,86735.5,26125,112860.5
315040,202008,71,49,22,51205,22990,74195
315050,202008,185,107,78,111815,81510,193325
315053,202008,45,36,9,37620,9405,47025
315057,202008,105,80,25,83600,26125,109725
315060,202008,74,63,11,66880.8,11495,78375.8
315070,202008,103,57,46,59565,48070,107635
315080,202008,378,304,74,317680,77330,395010
315090,202008,94,56,38,58520,39710,98230
315100,202008,80,40,40,41800,41800,83600
315110,202008,274,146,128,152570,133760,286330
315120,202008,1720,830,890,870485,931095.2,1801580.2
315130,202008,345,250,95,261250,99275,360525
315140,202008,530,302,228,315590.5,239306,554896.5
315150,202008,976,462,514,483835,537130,1020965
315160,202008,213,105,108,110770,112860,223630
315170,202008,316,209,107,219450.5,112860,332310.5
315180,202008,3251,1347,1904,1408661.5,1994906.25,3403567.75
315190,202008,319,190,129,198550,134805,333355
315200,202008,1231,729,502,761805,524590,1286395
315210,202008,1666,946,720,990695.58,753445,1744140.58
315213,202008,32,20,12,20900,12540,33440
315217,202008,210,162,48,169290,50160,219450
315220,202008,1579,1183,396,1238325.95,415910,1654235.95
315230,202008,172,124,48,129580.5,50160,179740.5
315240,202008,424,270,154,282150,160931,443081
315250,202008,2593,1261,1332,1319835,1397165.5,2717000.5
315260,202008,147,83,64,86735,66880,153615
315270,202008,131,91,40,95095,41800,136895
315280,202008,648,417,231,436810,241395,678205
315290,202008,188,118,70,123310,73150,196460
315300,202008,81,59,22,61655,22990,84645
315310,202008,75,67,8,70015,8360,78375
315320,202008,165,99,66,103455,68970,172425
315330,202008,56,46,10,48070,10450,58520
315340,202008,393,283,110,295735,115995,411730
315350,202008,154,92,62,96140,64790,160930
315360,202008,86,38,48,39710,50160,89870
315370,202008,54,34,20,35530,20900,56430
315380,202008,8,8,0,8360,0,8360
315390,202008,66,18,48,18810,50160.5,68970.5
315400,202008,837,622,215,651035.5,224675,875710.5
315410,202008,324,191,133,199595.5,138986.5,338582.0
315415,202008,56,42,14,43890,14630,58520
315420,202008,199,143,56,149435.5,58520,207955.5
315430,202008,652,372,280,389785.5,292600,682385.5
315440,202008,94,64,30,66880,31350,98230
315445,202008,233,193,40,201685,41800,243485
315450,202008,183,138,45,144210,47025,191235
315460,202008,4054,1956,2098,2047155,2194500,4241655
315470,202008,40,16,24,16720,26125,42845
315480,202008,68,20,48,20900,50160,71060
315490,202008,676,411,265,429495,276925,706420
315500,202008,18,12,6,12540,6270,18810
315510,202008,147,99,48,103455,50160,153615
315520,202008,71,62,9,64790,9405,74195
315530,202008,48,24,24,25080,25080,50160
315540,202008,246,168,78,175560,81510,257070
315550,202008,179,145,34,152570,35530,188100
315560,202008,740,593,147,619685.5,154660,774345.5
315570,202008,314,159,155,166157.19,161975,328132.19
315580,202008,712,479,233,500555,243485.5,744040.5
315590,202008,197,105,92,109725,96140,205865
315600,202008,303,228,75,238260,78375,316635
315610,202008,102,52,50,54340,52250,106590
315620,202008,36,28,8,29260,8360,37620
315630,202008,129,85,44,88825,45980,134805
315640,202008,75,45,30,47025,31350,78375
315645,202008,45,31,14,32395,14630.5,47025.5
315650,202008,174,124,50,129580.5,52250,181830.5
315660,202008,456,199,257,207955.5,268565,476520.5
315670,202008,2384,1137,1247,1188167,1306250,2494417
315680,202008,838,590,248,618640,261250,879890
315690,202008,672,464,208,485926.97,220495,706421.97
315700,202008,1894,989,905,1034551.21,947815,1982366.21
315710,202008,347,102,245,106590,257070,363660
315720,202008,453,280,173,293645.5,180785,474430.5
315725,202008,188,151,37,157795.5,38665,196460.5
315727,202008,53,22,31,22990,32395,55385
315730,202008,44,41,3,43890,3135,47025
315733,202008,89,58,31,60610,32395,93005
315737,202008,50,37,13,38665,13585,52250
315740,202008,34,26,8,27170,8360,35530
315750,202008,159,119,40,124355,41800.5,166155.5
315760,202008,40,30,10,31350,10450,41800
315765,202008,120,71,49,74195,51205,125400
315770,202008,225,140,85,146300,88825,235125
315780,202008,3516,1750,1766,1828750.75,1847560,3676310.75
315790,202008,233,180,53,188100,55385,243485
315800,202008,298,208,90,217360,95095,312455
315810,202008,95,57,38,59565,39710,99275
315820,202008,748,542,206,566390.5,215270,781660.5
315830,202008,129,80,49,83600,51205,134805
315840,202008,86,56,30,58520,31350,89870
315850,202008,259,182,77,190190.75,80465,270655.75
315860,202008,15,6,9,6270,9405,15675
315870,202008,38,29,9,30305,9405,39710
315880,202008,107,67,40,70015,41800,111815
315890,202008,88,67,21,70015,21945,91960
315895,202008,430,284,146,297825,152571,450396
315900,202008,67,31,36,32395,37620,70015
315910,202008,41,25,16,26125,16720,42845
315920,202008,160,107,53,111815,55385.75,167200.75
315930,202008,50,18,32,18810,33440,52250
315935,202008,132,102,30,106590.5,32395,138985.5
315940,202008,101,74,27,77330,28215,105545
315950,202008,40,31,9,32395,9405,41800
315960,202008,536,254,282,265430,294690.5,560120.5
315970,202008,34,27,7,28215,7315,35530
315980,202008,683,335,348,351120,364705,715825
315990,202008,252,148,104,155705,108680.5,264385.5
316000,202008,49,32,17,33440,18810,52250
316010,202008,79,68,11,71060,11495,82555
316020,202008,116,99,17,103455,17765,121220
316030,202008,383,212,171,221540.5,179740.75,401281.25
316040,202008,524,219,305,229900.5,319770.5,549671.0
316045,202008,57,50,7,52250,7315,59565
316050,202008,16,12,4,12540,4180,16720
316060,202008,96,63,33,65835,34485,100320
316070,202008,1091,697,394,728365.75,411730,1140095.75
316080,202008,99,67,32,70106.96,34485,104591.96
316090,202008,43,21,22,21945,22990,44935
316095,202008,94,76,18,80465,18810,99275
316100,202008,312,180,132,188100.25,137940,326040.25
316105,202008,40,27,13,28215,13585,41800
316110,202008,1869,1479,390,1548690.62,408595,1957285.62
316120,202008,80,57,23,59565,24035,83600
316130,202008,123,91,32,95095.5,33440,128535.5
316140,202008,31,20,11,20900,11495,32395
316150,202008,203,143,60,149435,62700,212135
316160,202008,81,44,37,45980,38665,84645
316165,202008,64,47,17,49115,17765,66880
316170,202008,183,121,62,126445,64790,191235
316180,202008,202,85,117,88825,123310.5,212135.5
316190,202008,135,97,38,101365,39710,141075
316200,202008,665,364,301,380380,314545,694925
316210,202008,780,518,262,542534.74,276925,819459.74
316220,202008,119,77,42,80465,43890,124355
316225,202008,26,15,11,15675,11495,27170
316230,202008,33,19,14,19855,14630,34485
316240,202008,644,517,127,540265,132715,672980
316245,202008,129,111,18,115995,18810,134805
316250,202008,1518,1031,487,1079486.5,509960,1589446.5
316255,202008,129,102,27,106590,28215,134805
316257,202008,181,94,87,98230,90915,189145
316260,202008,196,138,58,144210.25,60610,204820.25
316265,202008,27,18,9,18810,9405,28215
316270,202008,682,479,203,500555.5,212135.6,712691.1
316280,202008,548,339,209,354255.29,219450.5,573705.79
316290,202008,742,491,251,514140.65,263340,777480.65
316292,202008,510,199,311,207955,326040,533995
316294,202008,99,60,39,62700,40755,103455
316295,202008,310,133,177,138985.5,184965,323950.5
316300,202008,107,71,36,74195,37620,111815
316310,202008,29,15,14,15675,14630,30305
316320,202008,50,27,23,28215,24035,52250
316330,202008,161,109,52,113905.25,55385,169290.25
316340,202008,134,91,43,95095,44935,140030
316350,202008,194,137,57,143165.74,59565,202730.74
316360,202008,19,13,6,13585,6270,19855
316370,202008,1108,564,544,589381.25,569525,1158906.25
316380,202008,116,87,29,90915,30305,121220
316390,202008,115,83,32,86735,33440,120175
316400,202008,131,101,30,105545,31350,136895
316410,202008,301,218,83,227810,86735,314545
316420,202008,200,135,65,141075,67925,209000
316430,202008,154,81,73,84645,76285,160930
316440,202008,89,42,47,43890,49115,93005
316443,202008,40,38,2,39710,2090,41800
316447,202008,57,41,16,42845,16720,59565
316450,202008,225,172,53,179740,55385,235125
316460,202008,80,26,54,27170,56430,83600
316470,202008,1690,1232,458,1287433.01,480700,1768133.01
316480,202008,10,7,3,7315,3135,10450
316490,202008,18,6,12,6270,12540,18810
316500,202008,148,100,48,104500,50160,154660
316510,202008,152,116,36,121220,37620,158840
316520,202008,194,118,76,123310,79420,202730
316530,202008,163,106,57,110770,61655,172425
316540,202008,140,74,66,77330,68970,146300
316550,202008,135,89,46,93005,48070,141075
316553,202008,298,133,165,138985,173470.72,312455.72
316555,202008,42,36,6,37620,6270,43890
316556,202008,12,9,3,9405,3135,12540
316557,202008,23,19,4,19855,4180,24035
316560,202008,67,47,20,49115,20900,70015
316570,202008,218,198,20,206910,20900,227810
316580,202008,20,14,6,14630,6270,20900
316590,202008,103,86,17,89870,17765,107635
316600,202008,178,145,33,151525.5,34485,186010.5
316610,202008,66,50,16,52250,16720,68970
316620,202008,137,102,35,106590,36575,143165
316630,202008,43,34,9,35530,9405,44935
316640,202008,22,14,8,14630,8360,22990
316650,202008,72,59,13,61655,13585,75240
316660,202008,8,3,5,3135,5225,8360
316670,202008,439,153,286,159885,298870,458755
316680,202008,159,110,49,114950,51205,166155
316690,202008,186,116,70,121220,73150,194370
316695,202008,63,53,10,55385,10450,65835
316700,202008,18,12,6,12540,6270,18810
316710,202008,780,585,195,611325.25,203775,815100.25
316720,202008,5026,2448,2578,2565477.74,2697146,5262623.74
316730,202008,17,16,1,16720,1045,17765
316740,202008,139,89,50,94050,52250,146300
316750,202008,18,10,8,10450,8360,18810
316760,202008,328,260,68,271700,71060,342760
316770,202008,151,82,69,85690,72105,157795
316780,202008,69,42,27,44935,29260,74195
316790,202008,53,39,14,40755,14630,55385
316800,202008,1757,1095,662,1144275,691791.25,1836066.25
316805,202008,24,16,8,16720,8360,25080
316810,202008,68,42,26,43890,27170,71060
316820,202008,42,21,21,21945,21945,43890
316830,202008,97,43,54,44935,56430,101365
316840,202008,528,305,223,318725,233035,551760
316850,202008,329,220,109,229900,113905,343805
316860,202008,5916,2607,3309,2725363.4,3463130.75,6188494.15
316870,202008,1541,985,556,1033507.25,581020.5,1614527.75
316880,202008,127,61,66,63745,70015,133760
316890,202008,239,163,76,172425,79420,251845
316900,202008,418,294,124,307230.65,129580,436810.65
316905,202008,23,11,12,11495,12540,24035
316910,202008,70,28,42,29260,43890,73150
316920,202008,137,108,29,112860,30305,143165
316930,202008,1901,966,935,1010516.5,978120.75,1988637.25
316935,202008,914,552,362,577885.1,378290.5,956175.6
316940,202008,1101,624,477,652080.5,500555.5,1152636.0
316950,202008,180,87,93,90915,97185,188100
316960,202008,1105,619,486,646856,509960,1156816
316970,202008,655,516,139,541310.5,145255,686565.5
316980,202008,78,44,34,45980,35530,81510
316990,202008,2161,1441,720,1508980.85,754490.74,2263471.59
317000,202008,333,255,78,266475,81510,347985
317005,202008,239,167,72,174515,75240,249755
317010,202008,6370,3524,2846,3687810.23,2978250.5,6666060.73
317020,202008,16063,7013,9050,7343224.4,9476065,16819289.4
317030,202008,79,30,49,31350,51205,82555
317040,202008,3032,1887,1145,1975051,1198615,3173666
317043,202008,73,54,19,56430,19855,76285
317047,202008,30,16,14,16720,15675,32395
317050,202008,162,126,36,131670,37620,169290
317052,202008,135,102,33,107635,34485,142120
317057,202008,171,132,39,137940,40755,178695
317060,202008,63,39,24,40755,25080,65835
317065,202008,54,43,11,44935,11495,56430
317070,202008,1966,903,1063,945725.25,1113970.5,2059695.75
317075,202008,103,55,48,58520,50160,108680
317080,202008,913,468,445,489060.75,469205.7,958266.45
317090,202008,662,521,141,544445,147345,691790
317100,202008,423,318,105,332310,110770,443080
317103,202008,102,83,19,86735,19855,106590
317107,202008,45,39,6,40755,6270,47025
317110,202008,115,51,64,53295,66880,120175
317115,202008,41,36,5,37620,5225,42845
317120,202008,1935,930,1005,972896.5,1052315.5,2025212.0
317130,202008,1970,1307,663,1367906.5,692835,2060741.5
317140,202008,9,7,2,7315,2090,9405
317150,202008,259,152,107,158840.5,111815,270655.5
317160,202008,317,238,79,248710.79,82555,331265.79
317170,202008,219,148,71,155705,74195,229900
317180,202008,445,304,141,317680,147345,465025
317190,202008,264,185,79,193325,82555,275880
317200,202008,825,576,249,604012.9,260205,864217.9
317210,202008,185,101,84,105545,87780,193325
317220,202008,24,13,11,13585,11495,25080
320010,202008,604,437,167,457710.25,174515,632225.25
320013,202008,122,87,35,90915,36575,127490
320016,202008,272,173,99,180785,103455,284240
320020,202008,715,419,296,437857.37,312455,750312.37
320030,202008,152,107,45,111815.04,47025.08,158840.12
320035,202008,140,102,38,106590,39710,146300
320040,202008,485,247,238,258115,248710,506825
320050,202008,107,76,31,79420,32395,111815
320060,202008,1668,789,879,824505.25,918556.75,1743062.00
320070,202008,99,61,38,63745,39710,103455
320080,202008,796,461,335,482790.75,351120,833910.75
320090,202008,1249,837,412,876755,430540,1307295
320100,202008,331,188,143,196460,149435,345895
320110,202008,127,81,46,84646.25,48070,132716.25
320115,202008,111,91,20,96140,20900,117040
320120,202008,3470,1849,1621,1933252.65,1694990.5,3628243.15
320130,202008,7481,3386,4095,3545687.52,4288681.5,7834369.02
320140,202008,437,288,149,300960,155706.16,456666.16
320150,202008,2052,1159,893,1212200.75,937365.5,2149566.25
320160,202008,658,296,362,310365,378290.5,688655.5
320170,202008,110,89,21,93005.1,21945.02,114950.12
320180,202008,54,31,23,32395,24035,56430
320190,202008,237,152,85,158840,88825,247665
320200,202008,59,44,15,45980,16720,62700
320210,202008,900,492,408,514141,428450.5,942591.5
320220,202008,295,101,194,105545,202730,308275
320225,202008,85,67,18,70015,18810,88825
320230,202008,616,385,231,402325,242440,644765
320240,202008,3280,1576,1704,1647967.5,1784860.5,3432828.0
320245,202008,469,317,152,331265.5,158840,490105.5
320250,202008,225,114,111,119130,115995,235125
320255,202008,139,108,31,112860,32395,145255
320260,202008,217,141,76,148390.2,79420.12,227810.32
320265,202008,160,123,37,128535,38665,167200
320270,202008,153,121,32,127490,33440,160930
320280,202008,1095,623,472,654171.07,493240.02,1147411.09
320290,202008,56,48,8,52250,8360,60610
320300,202008,582,405,177,423226.35,184966.6,608192.95
320305,202008,677,362,315,380380,329175.5,709555.5
320310,202008,199,114,85,119130.9,88825,207955.9
320313,202008,332,161,171,169290.25,178695.5,347985.75
320316,202008,111,85,26,88825,27170,115995
320320,202008,3415,1536,1879,1607210.86,1965645,3572855.86
320330,202008,256,192,64,200731.96,66880,267611.96
320332,202008,775,469,306,490106.5,319770.25,809876.75
320334,202008,241,146,95,152570.52,100320,252890.52
320335,202008,148,100,48,104500,50160,154660
320340,202008,554,388,166,405460.75,173470.5,578931.25
320350,202008,975,419,556,438900.97,583110.5,1022011.47
320360,202008,166,90,76,94050,79420,173470
320370,202008,241,179,62,187055.9,64790.5,251846.4
320380,202008,282,196,86,204820.5,89870,294690.5
320390,202008,1155,689,466,721050,488015.5,1209065.5
320400,202008,311,227,84,237215,87780,324995
320405,202008,955,397,558,414865.25,583110.5,997975.75
320410,202008,990,505,485,527725,506825.25,1034550.25
320420,202008,509,242,267,253935.75,280060,533995.75
320425,202008,187,100,87,104500,90915,195415
320430,202008,386,209,177,218405.25,184965,403370.25
320435,202008,158,107,51,111815,53295,165110
320440,202008,196,113,83,118085.28,86735.22,204820.50
320450,202008,125,67,58,70015,60610,130625
320455,202008,252,204,48,214226.18,50160,264386.18
320460,202008,272,166,106,173470,110770,284240
320465,202008,115,77,38,80465,39710,120175
320470,202008,695,420,275,438900.5,288420,727320.5
320480,202008,197,127,70,132715,73150.25,205865.25
320490,202008,3087,1519,1568,1589446.26,1640652.3,3230098.56
320495,202008,109,68,41,71060,42845.5,113905.5
320500,202008,9650,4717,4933,4939721.3,5163350.95,10103072.25
320501,202008,550,282,268,295735,280060,575795
320503,202008,291,203,88,212135.1,91960.02,304095.12
320506,202008,261,183,78,191235,81510,272745
320510,202008,1026,452,574,473385,601920,1075305
320515,202008,87,68,19,71060,19855,90915
320517,202008,213,151,62,157795,64790,222585
320520,202008,6935,2974,3961,3114101.75,4148652.79,7262754.54
320530,202008,6132,3031,3101,3176248.22,3244725,6420973.22
330010,202008,3122,1577,1545,1650057.5,1616615,3266672.5
330015,202008,164,67,97,70015.9,101365,171380.9
330020,202008,3704,1558,2146,1631246.1,2245705,3876951.1
330022,202008,253,128,125,133760,131670,265430
330023,202008,609,193,416,201685,434720,636405
330025,202008,573,108,465,112860,486970,599830
330030,202008,1914,1210,704,1265495.12,735680.5,2001175.62
330040,202008,2435,1241,1194,1298935,1249820.5,2548755.5
330045,202008,8924,2705,6219,2828816,6512440,9341256
330050,202008,895,572,323,597740,337535,935275
330060,202008,1005,600,405,627000.5,424270,1051270.5
330070,202008,3685,1320,2365,1381490.4,2473515.5,3855005.9
330080,202008,1586,699,887,733590.75,929005,1662595.75
330090,202008,381,226,155,236170,161975,398145
330093,202008,262,116,146,121220,152570,273790
330095,202008,78,46,32,48070,33440,81510
330100,202008,9862,4925,4937,5154987.67,5164391.75,10319379.42
330110,202008,476,204,272,213180.75,284240,497420.75
330115,202008,530,278,252,290510,263340,553850
330120,202008,378,191,187,199595,195416.5,395011.5
330130,202008,1538,383,1155,400235,1208020,1608255
330140,202008,613,325,288,341715,302005,643720
330150,202008,514,296,218,309320,228855,538175
330160,202008,210,125,85,130625,88825,219450
330170,202008,27140,9125,18015,9546078.6,18858074.25,28404152.85
330180,202008,240,142,98,148390,102410,250800
330185,202008,956,339,617,354255,644765,999020
330187,202008,374,113,261,118085,272745,390830
330190,202008,5766,2201,3565,2302136.9,3729605.5,6031742.4
330200,202008,4705,1393,3312,1456731.81,3471490.5,4928222.31
330205,202008,439,253,186,265430,194370.5,459800.5
330210,202008,975,596,379,622820,397101,1019921
330220,202008,2668,1583,1085,1655280.2,1134870.5,2790150.7
330225,202008,575,292,283,305140,295735,600875
330227,202008,2426,732,1694,765985,1773365.25,2539350.25
330230,202008,253,143,110,149435,114950,264385
330240,202008,3841,1889,1952,1975050.75,2042977,4018027.75
330245,202008,148,66,82,68970.1,85690,154660.1
330250,202008,6669,3360,3309,3518071.25,3459997.02,6978068.27
330260,202008,602,158,444,166155,463980,630135
330270,202008,3592,1208,2384,1264450.5,2494416,3758866.5
330280,202008,453,289,164,302005.5,172425.45,474430.95
330285,202008,7033,2189,4844,2289595.75,5067207.25,7356803.00
330290,202008,653,235,418,245575.75,436810,682385.75
330300,202008,766,497,269,519487.22,281105,800592.22
330310,202008,444,246,198,257070.75,206910,463980.75
330320,202008,7868,2908,4960,3044086.49,5193652,8237738.49
330330,202008,8998,3392,5606,3547776.77,5865586,9413362.77
330340,202008,2674,1567,1107,1639605,1157860,2797465
330350,202008,18525,7032,11493,7355761.15,12027957.17,19383718.32
330360,202008,2244,1076,1168,1125466,1221605,2347071
330370,202008,1026,512,514,536087,538175,1074262
330380,202008,887,373,514,390830,537130.01,927960.01
330385,202008,633,323,310,337535.25,324995,662530.25
330390,202008,5597,2946,2651,3081706,2774475.5,5856181.5
330395,202008,316,189,127,197505,132715.75,330220.75
330400,202008,715,374,341,390830,356345,747175
330410,202008,509,367,142,384560.25,148390.5,532950.75
330411,202008,258,138,120,144210.55,125400,269610.55
330412,202008,242,96,146,101365.5,152570,253935.5
330414,202008,5391,2163,3228,2263472.7,3383710.5,5647183.2
330415,202008,604,262,342,274836.5,357390,632226.5
330420,202008,2227,1132,1095,1185031.55,1146365.5,2331397.05
330430,202008,1778,800,978,838091,1024102.5,1862193.5
330440,202008,291,138,153,144210,159885,304095
330450,202008,123,54,69,56430,72105,128535
330452,202008,2040,886,1154,926915,1208020.5,2134935.5
330455,202008,112678,39127,73551,40935957.72,76989351.47,117925309.19
330460,202008,260,111,149,115995,155705,271700
330470,202008,1232,671,561,701196.5,589381.75,1290578.25
330475,202008,1516,402,1114,420090,1165175,1585265
330480,202008,809,432,377,452485,395010,847495
330490,202008,14613,4667,9946,4883286.25,10409246.5,15292532.75
330500,202008,1419,608,811,635360,848540.14,1483900.14
330510,202008,10875,3725,7150,3898897.15,7484290.75,11383187.90
330513,202008,100,50,50,54340,52250,106590
330515,202008,815,336,479,351121.25,501600.5,852721.75
330520,202008,2484,874,1610,913330.35,1687675,2601005.35
330530,202008,204,116,88,121220.25,91960,213180.25
330540,202008,373,182,191,191235.5,200640.5,391876.0
330550,202008,2903,1004,1899,1049181.2,1985501,3034682.2
330555,202008,804,313,491,327085,513095,840180
330560,202008,696,224,472,235125,493240,728365
330570,202008,268,194,74,202730,77330,280060
330575,202008,786,284,502,296780,524591.25,821371.25
330580,202008,3396,1884,1512,1974007.66,1583175.5,3557183.16
330590,202008,283,146,137,152570.09,143165,295735.09
330600,202008,1190,742,448,775391,469205,1244596
330610,202008,1588,849,739,888252.75,774345,1662597.75
330615,202008,213,165,48,172425,50160,222585
330620,202008,1069,416,653,434720,683430,1118150
330630,202008,4118,2550,1568,2668930.96,1638560.75,4307491.71
350010,202008,585,386,199,404416.47,209000,613416.47
350020,202008,51,21,30,21945,31350,53295
350030,202008,511,318,193,332310.5,201685.5,533996.0
350040,202008,126,52,74,54340,77330,131670
350050,202008,307,159,148,167200,155705,322905
350055,202008,93,48,45,50160,48070,98230
350060,202008,86,31,55,32395,57475,89870
350070,202008,794,466,328,488015.49,342760.5,830775.99
350075,202008,73,49,24,51205,25080,76285
350080,202008,59,28,31,29260,32395,61655
350090,202008,80,48,32,50160,33440,83600
350100,202008,284,173,111,181830,115995,297825
350110,202008,60,42,18,43890,18810,62700
350115,202008,144,91,53,95095,55385,150480
350120,202008,108,67,41,71060,42845,113905
350130,202008,369,164,205,171380.03,214225,385605.03
350140,202008,43,27,16,28215,16720,44935
350150,202008,72,55,17,57475,17765,75240
350160,202008,2440,945,1495,987526,1565410,2552936
350170,202008,385,224,161,235126.85,168245.5,403372.35
350180,202008,164,96,68,101365,71060.5,172425.5
350190,202008,998,522,476,546535.29,499510.5,1046045.79
350200,202008,68,24,44,25080,45980,71060
350210,202008,1303,727,576,760761.5,601920.29,1362681.79
350220,202008,669,550,119,575795.29,125400,701195.29
350230,202008,72,48,24,50160,25080,75240
350240,202008,58,41,17,42845,17765,60610
350250,202008,1172,557,615,582066,642676.25,1224742.25
350260,202008,92,67,25,70015,27170,97185
350270,202008,880,585,295,612371,311410.5,923781.5
350275,202008,299,125,174,130625,181830,312455
350280,202008,4596,2326,2270,2434854.9,2376330,4811184.9
350290,202008,453,204,249,214225,260205.5,474430.5
350300,202008,53,27,26,28215,27170,55385
350310,202008,86,54,32,56430,33440,89870
350315,202008,53,27,26,28215,27170,55385
350320,202008,3319,1611,1708,1684540.5,1787995.5,3472536.0
350330,202008,1679,892,787,934232.12,824505,1758737.12
350335,202008,16,11,5,11495,5225,16720
350340,202008,124,53,71,56430,74195.75,130625.75
350350,202008,86,43,43,44935,44935,89870
350360,202008,114,74,40,78375,41800,120175
350370,202008,84,49,35,51205.29,36575,87780.29
350380,202008,777,327,450,343805,470251,814056
350390,202008,1588,602,986,629090.37,1031415.5,1660505.87
350395,202008,24,19,5,19855,5225,25080
350400,202008,1694,854,840,892432.12,880935.29,1773367.41
350410,202008,2705,1160,1545,1213245,1615589.29,2828834.29
350420,202008,255,153,102,161975.79,106590,268565.79
350430,202008,73,42,31,44935,32395,77330
350440,202008,156,112,44,117041,45980.5,163021.5
350450,202008,1650,966,684,1011560.56,715825.5,1727386.06
350460,202008,399,129,270,135850,282150,418000
350470,202008,19,10,9,10450,9405,19855
350480,202008,177,97,80,101365,83600,184965
350490,202008,232,112,120,118085,125400,243485
350500,202008,52,21,31,21945,32395,54340
350510,202008,167,109,58,114950,60610,175560
350520,202008,458,231,227,241395,237215,478610
350530,202008,438,202,236,211090,246620,457710
350535,202008,80,65,15,67925,15675,83600
350540,202008,373,188,185,196460,194370,390830
350550,202008,2696,1588,1108,1660505.83,1158906.08,2819411.91
350560,202008,623,425,198,446215,206910,653125
350570,202008,4179,1712,2467,1791131.29,2583241.35,4374372.64
350580,202008,367,179,188,187055,196460,383515
350590,202008,914,498,416,523545,434720,958265
350600,202008,6098,2910,3188,3046177.75,3339820.5,6385998.25
350610,202008,1513,781,732,817190.29,768075,1585265.29
350620,202008,29,19,10,19855,10450,30305
350630,202008,246,139,107,145255.29,111815.29,257070.58
350635,202008,970,379,591,396056.35,618640.5,1014696.85
350640,202008,117,89,28,93005,30305,123310
350650,202008,1887,1255,632,1315655.45,663575,1979230.45
350660,202008,750,314,436,329175,455620,784795
350670,202008,305,151,154,157795,160930,318725
350680,202008,175,91,84,96140,88826,184966
350690,202008,198,97,101,101365,105545,206910
350700,202008,790,377,413,396056,431585,827641
350710,202008,380,141,239,147345,249755,397100
350715,202008,56,46,10,48070,11495,59565
350720,202008,19,13,6,13585,6270,19855
350730,202008,45,28,17,29260,17765,47025
350740,202008,219,124,95,130625,99275,229900
350745,202008,24,11,13,11495,13585,25080
350750,202008,2219,1371,848,1434785.75,889295,2324080.75
350760,202008,3749,1598,2151,1674090.59,2251975,3926065.59
350770,202008,59,42,17,43890,17765,61655
350775,202008,42,31,11,32395,11495,43890
350780,202008,428,217,211,229900,220495,450395
350790,202008,370,152,218,158840,228855,387695
350800,202008,478,278,200,290510,210045,500555
350810,202008,518,413,105,431585.75,110770,542355.75
350820,202008,90,53,37,55385,38665,94050
350830,202008,79,40,39,41800,40755,82555
350840,202008,771,305,466,318725.5,488015,806740.5
350850,202008,1735,957,778,1001110.5,813010.5,1814121.0
350860,202008,599,334,265,349030.75,276925,625955.75
350870,202008,427,282,145,296780,151525,448305
350880,202008,286,160,126,167200.25,131670.5,298870.75
350890,202008,39,25,14,26125,14630,40755
350900,202008,1470,460,1010,481745.75,1055450.29,1537196.04
350910,202008,28,17,11,17765,11495,29260
350920,202008,699,366,333,382470,349030,731500
350925,202008,1208,642,566,672981.45,593562.39,1266543.84
350930,202008,102,60,42,62700,43890,106590
350940,202008,718,397,321,414865,335445,750310
350945,202008,108,78,30,81510,31350,112860
350950,202008,16404,7621,8783,7975446.15,9198092.75,17173538.90
350960,202008,1397,622,775,651035,811965,1463000
350970,202008,1094,568,526,594494.19,549670.5,1144164.69
350980,202008,97,65,32,67925,33440,101365
350990,202008,372,134,238,140030,248710,388740
350995,202008,37,17,20,17765,20900,38665
351000,202008,630,427,203,448305.58,213180,661485.58
351010,202008,53,32,21,33440,21945,55385
351015,202008,49,34,15,35530,15675,51205
351020,202008,1578,943,635,985435.5,665665,1651100.5
351030,202008,340,218,122,227810,128535,356345
351040,202008,902,462,440,482790.95,460846.49,943637.44
351050,202008,3322,1500,1822,1569593.3,1908170,3477763.3
351060,202008,5316,2046,3270,2141206.7,3421330.5,5562537.2
351070,202008,406,257,149,268566.64,155705,424271.64
351080,202008,715,521,194,545490.5,204820,750310.5
351090,202008,54,24,30,25080,32395,57475
351100,202008,437,248,189,259160.7,197505,456665.7
351110,202008,2043,967,1076,1014696.31,1130690.5,2145386.81
351120,202008,67,35,32,36575,33440,70015
351130,202008,193,59,134,61655,140030,201685
351140,202008,318,210,108,220495,112860,333355
351150,202008,431,225,206,236170.75,215270.5,451441.25
351160,202008,276,183,93,191235.5,98230,289465.5
351170,202008,189,99,90,103455,94050,197505
351190,202008,87,61,26,65835,28215,94050
351200,202008,363,242,121,252890.5,126445,379335.5
351210,202008,112,55,57,57475,59565,117040
351220,202008,542,320,222,334401.91,231990,566391.91
351230,202008,271,188,83,196460,86735,283195
351240,202008,240,116,124,121220,129580,250800
351250,202008,81,58,23,60610.57,24035,84645.57
351260,202008,152,112,40,117040,41800,158840
351270,202008,45,19,26,19855,27170,47025
351280,202008,1004,456,548,477565,574750.79,1052315.79
351290,202008,246,105,141,109725,147345,257070
351300,202008,3755,1642,2113,1719990.11,2213310.29,3933300.40
351310,202008,750,370,380,387695,398145,785840
351320,202008,115,68,47,71060.29,49115,120175.29
351330,202008,40,25,15,26125,15675,41800
351340,202008,1256,732,524,765985,547580,1313565
351350,202008,2394,1376,1018,1440010.75,1064855,2504865.75
351360,202008,781,373,408,390830,427405,818235
351370,202008,386,196,190,205865.5,200640,406505.5
351380,202008,9015,4034,4981,4220762.6,5213506.79,9434269.39
351385,202008,26,17,9,17765,9405,27170
351390,202008,275,206,69,215270.35,72105,287375.35
351400,202008,68,44,24,45980,25080,71060
351410,202008,437,277,160,289465.77,167200,456665.77
351420,202008,71,53,18,55385,18810,74195
351430,202008,72,40,32,41800,33440,75240
351440,202008,787,548,239,574752.33,249755,824507.33
351450,202008,266,130,136,135850,142120,277970
351460,202008,126,56,70,58520,73150,131670
351470,202008,142,79,63,82555,65835,148390
351480,202008,490,282,208,294690.5,217360,512050.5
351490,202008,289,107,182,112860,190190,303050
351492,202008,28,20,8,20900,8360,29260
351495,202008,25,18,7,18810,7315,26125
351500,202008,3532,1470,2062,1539286.35,2157926.9,3697213.25
351510,202008,1938,735,1203,769121,1258180.5,2027301.5
351512,202008,17,13,4,13585,4180,17765
351515,202008,186,106,80,110770,83600,194370
351518,202008,732,459,273,481745,285285,767030
351519,202008,78,46,32,48070,33440,81510
351520,202008,149,90,59,94050,61655,155705
351530,202008,25,14,11,14630,11495,26125
351535,202008,129,76,53,80465,56430,136895
351540,202008,458,328,130,342760.55,135850,478610.55
351550,202008,1414,840,574,880937.08,600875,1481812.08
351560,202008,72,40,32,41800,33440,75240
351565,202008,9,7,2,7315,2090,9405
351570,202008,2707,1308,1399,1371040.5,1465090,2836130.5
351580,202008,39,34,5,35530,5225,40755
351590,202008,59,38,21,39710,21945,61655
351600,202008,184,132,52,137940,54340,192280
351610,202008,46,21,25,21945,26125,48070
351620,202008,5880,3277,2603,3430737.96,2723270.75,6154008.71
351630,202008,2829,1394,1435,1458821,1502710,2961531
351640,202008,1990,917,1073,959310.02,1124421.29,2083731.31
351650,202008,27,23,4,24035,4180,28215
351660,202008,140,89,51,93005,53295,146300
351670,202008,707,443,264,463981.5,276925,740906.5
351680,202008,70,60,10,63745,11495,75240
351685,202008,18,13,5,13585,5225,18810
351690,202008,299,204,95,213180.37,99275,312455.37
351700,202008,157,108,49,112860.5,51205,164065.5
351710,202008,69,45,24,48070,25080,73150
351720,202008,134,77,57,80465,59565,140030
351730,202008,109,70,39,73150,40755.29,113905.29
351740,202008,721,462,259,482790.6,270655,753445.6
351750,202008,354,146,208,153615,217360,370975
351760,202008,760,577,183,604010,191235,795245
351770,202008,306,255,51,267520.29,53295,320815.29
351780,202008,160,97,63,101365,65835,167200
351790,202008,256,135,121,141075,126445.75,267520.75
351800,202008,39,24,15,25080,15675,40755
351810,202008,120,81,39,84645,40755,125400
351820,202008,809,588,221,617595.5,231990,849585.5
351830,202008,545,193,352,201685,368885,570570
351840,202008,1914,922,992,964536,1037685,2002221
351850,202008,235,167,68,174515,71060,245575
351860,202008,659,458,201,478610.45,211090,689700.45
351870,202008,5582,2587,2995,2706554.54,3139182.41,5845736.95
351880,202008,19496,7910,11586,8276403.5,12131407.6,20407811.1
351885,202008,82,51,31,53295,32395,85690
351890,202008,70,56,14,58520,14630,73150
351900,202008,229,131,98,136895,102410,239305
351905,202008,82,32,50,33440,52250,85690
351907,202008,3447,1412,2035,1478676.35,2130755.5,3609431.85
351910,202008,181,75,106,78375,110770,189145
351920,202008,117,64,53,66880,55385,122265
351925,202008,92,59,33,61655,34485,96140
351930,202008,398,255,143,267520,150480,418000
351940,202008,243,107,136,111815,142120,253935
351950,202008,135,72,63,75240,65835,141075
351960,202008,930,454,476,475802.37,497420.5,973222.87
351970,202008,1903,992,911,1036640.5,953040.5,1989681.0
351980,202008,161,75,86,78375,89870,168245
351990,202008,262,171,91,178696,95095,273791
352000,202008,341,219,122,229900.5,127490,357390.5
352010,202008,389,245,144,257070,150480,407550
352020,202008,184,69,115,72105,120175,192280
352030,202008,1099,553,546,577885,572660,1150545
352040,202008,574,243,331,253935,345895,599830
352042,202008,293,83,210,86735,219451,306186
352044,202008,360,223,137,233035.5,143165,376200.5
352050,202008,3200,1238,1962,1294756.69,2057605.5,3352362.19
352060,202008,106,63,43,65835,44935,110770
352070,202008,91,68,23,71060.58,24035,95095.58
352080,202008,67,43,24,44935,26125,71060
352090,202008,159,106,53,110770,55385,166155
352100,202008,287,137,150,143165.5,156750.5,299916.0
352110,202008,116,37,79,38665,82555,121220
352115,202008,61,20,41,20900,42845,63745
352120,202008,85,57,28,59565.29,29260,88825.29
352130,202008,222,185,37,193325,38665,231990
352140,202008,185,86,99,89870,103455,193325
352150,202008,116,61,55,63745,57475,121220
352160,202008,142,89,53,93005,55385,148390
352170,202008,391,264,127,275880,132715,408595
352180,202008,628,396,232,413820.29,242440,656260.29
352190,202008,244,99,145,103455,151525,254980
352200,202008,30,15,15,15675,15675,31350
352210,202008,4131,1691,2440,1768142.5,2555026,4323168.5
352215,202008,59,34,25,35530,26125,61655
352220,202008,6704,2515,4189,2629222,4381686.29,7010908.29
352230,202008,3332,2149,1183,2248841.66,1239371.62,3488213.28
352240,202008,2500,1430,1070,1494350.5,1122330.5,2616681.0
352250,202008,2764,1324,1440,1383581.58,1507935,2891516.58
352260,202008,989,519,470,544445.5,493240.5,1037686.0
352265,202008,56,28,28,29260,30305,59565
352270,202008,398,228,170,239305,177650.25,416955.25
352280,202008,451,277,174,289465.58,181830,471295.58
352290,202008,172,102,70,107635,73150,180785
352300,202008,95,66,29,68970,30305,99275
352310,202008,6408,2822,3586,2948991.69,3754685.3,6703676.99
352320,202008,1036,542,494,567435.5,516230,1083665.5
352330,202008,531,258,273,269610,287375,556985
352340,202008,1354,615,739,643722,773301.5,1417023.5
352350,202008,341,204,137,213180,143165.5,356345.5
352360,202008,219,98,121,102410,126445,228855
352370,202008,107,70,37,73150,38665,111815
352380,202008,116,75,41,78375,42845,121220
352390,202008,2459,1048,1411,1095161,1481811.3,2576972.3
352400,202008,495,217,278,226765,291555.5,518320.5
352410,202008,866,603,263,632225.79,274835,907060.79
352420,202008,97,67,30,70015,31350,101365
352430,202008,1745,798,947,834956.67,991705.58,1826662.25
352440,202008,3211,1582,1629,1655281.97,1706485,3361766.97
352450,202008,198,161,37,168245,38665,206910
352460,202008,620,317,303,332310,318725,651035
352470,202008,652,220,432,230945,451440,682385
352480,202008,1421,789,632,824505,661485.5,1485990.5
352490,202008,65,23,42,24035,43890,67925
352500,202008,1232,519,713,542355.85,745085.5,1287441.35
352510,202008,715,380,335,397100.58,351120,748220.58
352520,202008,676,322,354,337535,370975,708510
352530,202008,1764,915,849,957220,887205.5,1844425.5
352540,202008,74,47,27,49115,28215,77330
352550,202008,192,114,78,121220,81510,202730
352560,202008,47,38,9,40755,9405,50160
352570,202008,682,340,342,356345.29,358435,714780.29
352580,202008,55,42,13,43890,13585,57475
352585,202008,20,6,14,6270,14630,20900
352590,202008,4402,2180,2222,2286460.79,2326171,4612631.79
352600,202008,348,250,98,261250,102410,363660
352610,202008,943,434,509,453530.67,532950,986480.67
352620,202008,1039,399,640,416955,669845,1086800
352630,202008,176,63,113,65835,118085,183920
352640,202008,513,344,169,360525,176605,537130
352650,202008,84,62,22,64790,22990,87780
352660,202008,63,38,25,39710,26125,65835
352670,202008,1670,885,785,925871.32,820325,1746196.32
352680,202008,931,579,352,605055,368885,973940
352690,202008,4534,2038,2496,2131802.34,2615635.29,4747437.63
352700,202008,103,62,41,64790,42845,107635
352710,202008,1386,727,659,761805,689700,1451505
352720,202008,1372,625,747,654170,782705.5,1436875.5
352725,202008,22,17,5,17765,5225,22990
352730,202008,394,197,197,205865,206910,412775
352740,202008,416,266,150,279016.4,156750.11,435766.51
352750,202008,18,12,6,12540,6270,18810
352760,202008,184,119,65,124355,67925,192280
352770,202008,88,66,22,70015,22990,93005
352780,202008,80,41,39,42845,40755,83600
352790,202008,26,20,6,20900,6270,27170
352800,202008,235,175,60,182875,65835,248710
352810,202008,154,95,59,99275,61655,160930
352820,202008,56,43,13,44935,13585,58520
352830,202008,77,52,25,54340,26125,80465
352840,202008,661,322,339,336490.25,354255,690745.25
352850,202008,1556,506,1050,528770,1098295,1627065
352860,202008,116,75,41,78375,42845,121220
352870,202008,44,29,15,31350,15675,47025
352880,202008,179,120,59,125400,61655,187055
352885,202008,32,22,10,22990,10450,33440
352890,202008,54,36,18,37620,18810.5,56430.5
352900,202008,4774,2307,2467,2413951.61,2582195.79,4996147.40
352910,202008,38,31,7,32395,7315,39710
352920,202008,662,397,265,414865,276925,691790
352930,202008,1229,585,644,614460.5,675070.75,1289531.25
352940,202008,6147,2509,3638,2624045.07,3806935.5,6430980.57
352950,202008,112,41,71,42845,74195,117040
352960,202008,58,39,19,42845,19855,62700
352965,202008,18,9,9,9405,9405,18810
352970,202008,518,397,121,415910.23,126445,542355.23
352980,202008,155,86,69,89870,72105,161975
352990,202008,988,451,537,473385,561165,1034550
353000,202008,62,26,36,27170,37620,64790
353010,202008,545,337,208,353210,217360,570570
353020,202008,304,222,82,231990,85690,317680
353030,202008,1254,571,683,597740.85,714780,1312520.85
353040,202008,86,54,32,56430,33440,89870
353050,202008,1321,853,468,891386.19,489060,1380446.19
353060,202008,8412,3630,4782,3802759.71,5004505,8807264.71
353070,202008,1754,1072,682,1122331.33,713548.99,1835880.32
353080,202008,1280,683,597,715825.47,623865,1339690.47
353090,202008,60,32,28,33440,29260,62700
353100,202008,50,41,9,42845,9405,52250
353110,202008,2095,634,1461,662530.5,1527790.5,2190321.0
353120,202008,97,49,48,51205,50160,101365
353130,202008,858,421,437,440990.41,458755,899745.41
353140,202008,554,226,328,236170.29,342760,578930.29
353150,202008,332,189,143,197505.29,149435,346940.29
353160,202008,93,75,18,78375,18810,97185
353170,202008,220,70,150,73150,156750,229900
353180,202008,1077,486,591,507870.75,619686,1127556.75
353190,202008,497,365,132,382470,137940,520410
353200,202008,223,105,118,109725,123310,233035
353205,202008,19,12,7,12540,7315,19855
353210,202008,72,40,32,41800,33440,75240
353215,202008,45,25,20,26125,20900,47025
353220,202008,78,45,33,47025,34485,81510
353230,202008,156,61,95,63745,99275,163020
353240,202008,318,161,157,168245,164065,332310
353250,202008,209,103,106,107635,110770,218405
353260,202008,465,319,146,333355.8,152570,485925.8
353270,202008,71,52,19,55385,19855,75240
353280,202008,100,49,51,51205,53295,104500
353282,202008,133,95,38,99275,39710,138985
353284,202008,24,16,8,16720,8360,25080
353286,202008,2,0,2,0,2090,2090
353290,202008,78,43,35,44935,36575,81510
353300,202008,443,234,209,245576.33,218405,463981.33
353310,202008,49,42,7,43890,7315,51205
353320,202008,50,28,22,29260,24035,53295
353325,202008,51,30,21,31350,21945.5,53295.5
353330,202008,59,40,19,41800.75,19855,61655.75
353340,202008,644,228,416,238260,434720,672980
353350,202008,908,436,472,455620,493240.5,948860.5
353360,202008,105,84,21,88825,21945,110770
353370,202008,112,64,48,66880,50160,117040
353380,202008,32,18,14,18810,14630,33440
353390,202008,1122,533,589,558030,616550.5,1174580.5
353400,202008,45,25,20,26125,20900,47025
353410,202008,109,65,44,68970,45980.25,114950.25
353420,202008,59,23,36,24035,37620,61655
353430,202008,584,392,192,409641.41,200640,610281.41
353440,202008,11091,4802,6289,5028541.79,6589771,11618312.79
353450,202008,56,30,26,31350,27170,58520
353460,202008,597,323,274,338580.25,288420,627000.25
353470,202008,2155,1127,1028,1179805.37,1078440,2258245.37
353475,202008,249,164,85,171380.5,88825,260205.5
353480,202008,186,155,31,161975,32395,194370
353490,202008,242,145,97,151525,101365.5,252890.5
353500,202008,204,116,88,121220.29,91960,213180.29
353510,202008,105,72,33,75240,34485,109725
353520,202008,206,146,60,152570,62700,215270
353530,202008,460,249,211,262295,221540,483835
353540,202008,381,251,130,262295,135850,398145
353550,202008,713,463,250,484881.47,262295,747176.47
353560,202008,586,235,351,245575,368885,614460
353570,202008,67,37,30,38665.5,31350,70015.5
353580,202008,351,258,93,269611.35,97185,366796.35
353590,202008,87,63,24,65835,25080,90915
353600,202008,277,160,117,167200.29,122265,289465.29
353610,202008,126,70,56,73150,58520,131670
353620,202008,616,321,295,335445.5,309320,644765.5
353625,202008,50,27,23,28215,24035,52250
353630,202008,236,171,65,178695.45,67925,246620.45
353640,202008,130,84,46,87780,48070,135850
353650,202008,937,352,585,367840,611325,979165
353657,202008,23,17,6,17765,6270,24035
353660,202008,276,148,128,154660,133760,288420
353670,202008,763,451,312,472340.79,327085.5,799426.29
353680,202008,103,76,27,79420.25,29260,108680.25
353690,202008,41,29,12,30305,13585,43890
353700,202008,274,195,79,204820,82555,287375
353710,202008,474,219,255,228855,266475.5,495330.5
353715,202008,47,34,13,35530,13585,49115
353720,202008,344,156,188,163020.5,196460,359480.5
353730,202008,1092,672,420,703285.5,439945.5,1143231.0
353740,202008,614,339,275,355300.5,287375,642675.5
353750,202008,77,46,31,48070,32395,80465
353760,202008,2996,1124,1872,1175626.15,1958331.65,3133957.80
353770,202008,90,73,17,77330,17765,95095
353780,202008,1233,584,649,612370.29,679250,1291620.29
353790,202008,507,307,200,320815.9,209000,529815.9
353800,202008,3441,1661,1780,1735765.5,1865396.5,3601162.0
353810,202008,232,132,100,137940,104500,242440
353820,202008,210,93,117,97185,123310,220495
353830,202008,52,45,7,48070,7315,55385
353850,202008,174,82,92,85690,96140,181830
353860,202008,503,222,281,233035,294690,527725
353870,202008,5365,2699,2666,2824638.71,2792241.75,5616880.46
353880,202008,677,465,212,489060,221540,710600
353890,202008,553,319,234,333355.5,245575.61,578931.11
353900,202008,133,70,63,73150,66880,140030
353910,202008,173,75,98,78375,103455,181830
353920,202008,435,241,194,251845.75,203775,455620.75
353930,202008,1010,590,420,618640,438901.35,1057541.35
353940,202008,191,95,96,99275,100320,199595
353950,202008,505,309,196,322905,204820,527725
353960,202008,75,61,14,63745,14630,78375
353970,202008,53,30,23,31350,24035,55385
353980,202008,1692,780,912,816145.5,955130,1771275.5
353990,202008,71,43,28,44935,29260,74195
354000,202008,384,182,202,190190,211090,401280
354010,202008,90,50,40,52250,41800.5,94050.5
354020,202008,508,324,184,338580,193325,531905
354025,202008,43,37,6,38665,6270,44935
354030,202008,51,31,20,32395,20900,53295
354040,202008,98,75,23,78375,24035,102410
354050,202008,173,97,76,101365.79,79420,180785.79
354060,202008,758,363,395,379335,414865,794200
354070,202008,916,523,393,547581,410685,958266
354075,202008,185,85,100,88825,104500,193325
354080,202008,314,134,180,140030,188100,328130
354085,202008,20,13,7,13585,7315,20900
354090,202008,290,166,124,173382,129580,302962
354100,202008,5595,2265,3330,2367970.75,3486122.35,5854093.10
354105,202008,95,46,49,48070,51205,99275
354110,202008,46,22,24,22990,25080,48070
354120,202008,140,98,42,102410,43890,146300
354130,202008,720,453,267,475475,279015.5,754490.5
354140,202008,3172,1468,1704,1537196.02,1784860.5,3322056.52
354150,202008,642,380,262,397100.87,273790,670890.87
354160,202008,649,410,239,428450.5,249756.39,678206.89
354165,202008,16,14,2,14630,2090,16720
354170,202008,173,117,56,124355,58520,182875
354180,202008,60,35,25,36575.59,26125,62700.59
354190,202008,193,81,112,84645,117040,201685
354200,202008,114,61,53,63745,56430,120175
354210,202008,60,23,37,24035,38665,62700
354220,202008,660,414,246,432630.29,257070,689700.29
354230,202008,162,68,94,71060,98230,169290
354240,202008,337,215,122,224675.62,128535,353210.62
354250,202008,83,51,32,53295,33440,86735
354260,202008,2070,972,1098,1015741.82,1149501.6,2165243.42
354270,202008,91,65,26,67925,28215,96140
354280,202008,44,22,22,22990,24035,47025
354290,202008,144,99,45,104500,48070,152570
354300,202008,377,264,113,276925.29,119130,396055.29
354310,202008,90,68,22,71060.5,22990,94050.5
354320,202008,203,101,102,105545,106590,212135
354323,202008,10,9,1,9405,1045,10450
354325,202008,115,67,48,70015.83,50160,120175.83
354330,202008,2436,810,1626,848391.5,1704395.5,2552787.0
354340,202008,10354,4929,5425,5168352.63,5685848.25,10854200.88
354350,202008,136,89,47,93005,49115,142120
354360,202008,69,37,32,38665,33440,72105
354370,202008,242,127,115,133760,120175,253935
354380,202008,184,113,71,118085,74195,192280
354390,202008,2685,961,1724,1008425,1806805.45,2815230.45
354400,202008,304,167,137,174515,144210,318725
354410,202008,616,294,322,307231.6,336490.5,643722.1
354420,202008,271,173,98,180785,102410,283195
354425,202008,303,181,122,189194,127490,316684
354430,202008,185,105,80,109725,83600,193325
354440,202008,38,27,11,28215,11495,39710
354450,202008,51,33,18,34485,18810,53295
354460,202008,103,58,45,60610,47025,107635
354470,202008,34,18,16,18810,16720,35530
354480,202008,112,61,51,63745,53295,117040
354490,202008,143,89,54,93005,56430,149435
354500,202008,385,181,204,189145,213180,402325
354510,202008,94,65,29,67925,30305,98230
354515,202008,36,12,24,12540,25080,37620
354520,202008,1592,680,912,710451.9,956175.5,1666627.4
354530,202008,762,381,381,399190.5,400235,799425.5
354540,202008,268,144,124,151525,129580,281105
354550,202008,36,23,13,24035,13585,37620
354560,202008,150,79,71,82555,74195,156750
354570,202008,133,90,43,94050,44935,138985
354580,202008,1880,886,994,925871.5,1038730.5,1964602.0
354600,202008,256,139,117,145255,122265,267520
354610,202008,72,61,11,63745.15,11495,75240.15
354620,202008,65,20,45,20900,47025,67925
354625,202008,15,9,6,9405,6270,15675
354630,202008,301,194,107,203775,111815,315590
354640,202008,794,499,295,522500.75,309320,831820.75
354650,202008,69,41,28,42845,29260,72105
354660,202008,788,586,202,612370.25,211090,823460.25
354670,202008,240,89,151,93005,157795,250800
354680,202008,1269,468,801,490105,838090,1328195
354690,202008,83,57,26,59565.5,27170,86735.5
354700,202008,67,48,19,50160,19855,70015
354710,202008,46,33,13,34485,13585,48070
354720,202008,21,19,2,19855,2090,21945
354730,202008,1748,730,1018,763895.55,1064855.5,1828751.05
354740,202008,78,54,24,56430,25080,81510
354750,202008,425,244,181,254980,190190,445170
354760,202008,460,280,180,292601.25,189145.5,481746.75
354765,202008,10,5,5,5225,5225,10450
354770,202008,344,228,116,238260,121220,359480
354780,202008,8199,3225,4974,3377444.21,5215597.16,8593041.37
354790,202008,102,58,44,60610,45980,106590
354800,202008,453,246,207,258115,217360,475475
354805,202008,100,44,56,45980.5,58520,104500.5
354810,202008,102,60,42,62700,44935,107635
354820,202008,206,83,123,86735.9,129580,216315.9
354830,202008,42,22,20,22990,20900,43890
354840,202008,56,39,17,41800,17765,59565
354850,202008,4492,1983,2509,2075371.6,2625040.81,4700412.41
354860,202008,327,159,168,166155,175560.04,341715.04
354870,202008,12076,5380,6696,5633600.78,7004637.75,12638238.53
354880,202008,2770,1031,1739,1077395.88,1822480.75,2899876.63
354890,202008,2906,1552,1354,1626021.75,1415975,3041996.75
354900,202008,63,43,20,44935,20900,65835
354910,202008,1241,646,595,675071,622820,1297891
354920,202008,42,34,8,35530,8360,43890
354925,202008,13,6,7,6270,7315,13585
354930,202008,35,32,3,33440.78,3135,36575.78
354940,202008,799,580,219,611588.04,228855,840443.04
354950,202008,201,130,71,135850.25,74195,210045.25
354960,202008,147,56,91,58520,95095,153615
354970,202008,974,643,331,671936.64,346940.5,1018877.14
354980,202008,8765,3152,5613,3302202.92,5879171.02,9181373.94
354990,202008,9366,4273,5093,4471558.5,5343085,9814643.5
354995,202008,547,179,368,187055,385605,572660
355000,202008,467,160,307,167200,320815,488015
355010,202008,598,367,231,383515.5,242440.29,625955.79
355020,202008,775,486,289,508915,302005.5,810920.5
355030,202008,207941,79862,128079,83564883.16,134061033.41,217625916.57
355040,202008,765,355,410,372020.5,429495,801515.5
355050,202008,148,91,57,95095,60610,155705
355060,202008,1632,819,813,857946.5,850630,1708576.5
355070,202008,1448,682,766,712690.77,800470.29,1513161.06
355080,202008,197,122,75,127490,79420,206910
355090,202008,282,165,117,172425,122265.19,294690.19
355100,202008,5005,2364,2641,2479684.1,2767160.5,5246844.6
355110,202008,242,162,80,169290.5,83600,252890.5
355120,202008,65,43,22,44935,22990,67925
355130,202008,50,28,22,29260,22990,52250
355140,202008,186,113,73,118085,76285,194370
355150,202008,668,393,275,411730.67,287375,699105.67
355160,202008,471,226,245,236170.29,257070.5,493240.79
355170,202008,2049,1073,976,1122330,1023055,2145385
355180,202008,682,285,397,297825,414865,712690
355190,202008,215,144,71,150480,74195,224675
355200,202008,113,64,49,66880,51205,118085
355210,202008,696,394,302,411730,316635,728365
355220,202008,7174,3673,3501,3841423.5,3670042.5,7511466.0
355230,202008,101,59,42,61655,43890,105545
355240,202008,4467,1851,2616,1939522.66,2741035,4680557.66
355250,202008,5811,2598,3213,2718064.99,3368035.25,6086100.24
355255,202008,50,28,22,29260,22990,52250
355260,202008,182,110,72,115995.5,75240,191235.5
355270,202008,160,101,59,105545,61655,167200
355280,202008,6356,2496,3860,2612502,4042060.5,6654562.5
355290,202008,77,62,15,64790,16720,81510
355300,202008,195,118,77,123310,80465,203775
355310,202008,110,59,51,61655,53295,114950
355320,202008,90,47,43,49115,44935,94050
355330,202008,281,161,120,168245,125400,293645
355340,202008,1471,511,960,535041.27,1004245,1539286.27
355350,202008,137,67,70,70015,73150,143165
355360,202008,169,111,58,115995,60610,176605
355365,202008,21,17,4,17765,4180,21945
355370,202008,1042,612,430,640586.08,450395,1090981.08
355380,202008,822,519,303,543400.5,316635,860035.5
355385,202008,74,52,22,54340,22990,77330
355390,202008,113,63,50,65835,52250,118085
355395,202008,196,112,84,117040.92,87780,204820.92
355400,202008,1690,1003,687,1049096.75,717915.29,1767012.04
355410,202008,4891,2287,2604,2394097.5,2727450.25,5121547.75
355420,202008,49,33,16,34485,16720,51205
355430,202008,377,232,145,243485.5,151525,395010.5
355440,202008,82,47,35,49115,36575,85690
355450,202008,460,226,234,236171.2,244530,480701.2
355460,202008,64,48,16,50160.35,16720,66880.35
355465,202008,44,27,17,28215,17765,45980
355470,202008,174,72,102,75240.75,106590,181830.75
355475,202008,11,7,4,7315,4180,11495
355480,202008,521,218,303,227810,317680,545490
355490,202008,118,83,35,86735,36575,123310
355495,202008,65,25,40,26125,41800,67925
355500,202008,1575,875,700,915422.05,731500.5,1646922.55
355510,202008,268,198,70,206910,73150,280060
355520,202008,32,23,9,24035,9405,33440
355530,202008,20,12,8,12540,8360,20900
355535,202008,73,33,40,34485,42845,77330
355540,202008,2463,966,1497,1009617.84,1569590.79,2579208.63
355550,202008,58,36,22,37620,22990,60610
355560,202008,252,118,134,123310,140030,263340
355570,202008,23,15,8,15675,8360,24035
355580,202008,242,170,72,178695,75240.5,253935.5
355590,202008,16,10,6,10450,6270,16720
355600,202008,274,140,134,147345,140030,287375
355610,202008,227,152,75,158840,78375,237215
355620,202008,1326,598,728,625955.5,762850,1388805.5
355630,202008,436,320,116,335445,121220.29,456665.29
355635,202008,111,52,59,54340,61655,115995
355640,202008,565,318,247,334400,259160,593560
355645,202008,843,331,512,345895,535040.5,880935.5
355650,202008,1982,838,1144,877800.5,1199660,2077460.5
355660,202008,248,133,115,140030,120175,260205
355670,202008,569,234,335,244530,351120,595650
355680,202008,206,114,92,119130,96140,215270
355690,202008,94,43,51,44935,53295.66,98230.66
355695,202008,17,11,6,11495,6270,17765
355700,202008,1139,594,545,621775.65,571616,1193391.65
355710,202008,2218,1199,1019,1254349.32,1067990.5,2322339.82
355715,202008,16,14,2,14630,3135,17765
355720,202008,227,135,92,141075.6,96140,237215.6
355730,202008,98,57,41,59565,42845,102410
410010,202008,131,107,24,111815,25080,136895
410020,202008,113,87,26,90915,27170,118085
410030,202008,167,96,71,100320,74195,174515
410040,202008,1186,585,601,611325,629090,1240415
410045,202008,39,29,10,31350,10450,41800
410050,202008,471,265,206,276925,216315,493240
410060,202008,287,214,73,223630,76285,299915
410070,202008,295,245,50,256025,52250,308275
410080,202008,171,106,65,110770,67925,178695
410090,202008,81,70,11,73150.9,11495,84645.9
410100,202008,286,201,85,210045,88825,298870
410105,202008,49,30,19,31350,19855,51205
410110,202008,333,200,133,209000,138985,347985
410115,202008,34,25,9,26125,9405,35530
410120,202008,412,208,204,217360,214225,431585
410130,202008,46,29,17,30305,18810,49115
410140,202008,3129,1505,1624,1574817.67,1698129.84,3272947.51
410150,202008,2682,1042,1640,1088891.35,1716936,2805827.35
410160,202008,509,314,195,329175,203775,532950
410165,202008,68,43,25,44935,26125,71060
410170,202008,178,116,62,121220,64790,186010
410180,202008,2251,1258,993,1314610,1039775,2354385
410185,202008,38,33,5,34485,5225,39710
410190,202008,484,313,171,328130,180785,508915
410200,202008,944,683,261,714780,272745,987525
410210,202008,608,316,292,330220,305140,635360
410220,202008,47,22,25,22990,26125,49115
410230,202008,149,70,79,73150,82555,155705
410240,202008,751,489,262,511005.5,273790,784795.5
410250,202008,383,274,109,286330,113905,400235
410260,202008,296,165,131,172425,136895.5,309320.5
410270,202008,27,20,7,20900,7315,28215
410275,202008,56,44,12,45980,12540,58520
410280,202008,323,186,137,194370,143165,337535
410290,202008,248,151,97,157795,101365,259160
410300,202008,78,57,21,59565,21945,81510
410302,202008,19,12,7,12540,7315,19855
410304,202008,41,29,12,30305,12540,42845
410305,202008,215,111,104,117040,108680,225720
410310,202008,220,129,91,134805,95095,229900
410315,202008,48,35,13,36575,13585,50160
410320,202008,137,95,42,99275,43890,143165
410322,202008,34,23,11,24035,11495,35530
410330,202008,179,124,55,129580,57475,187055
410335,202008,100,57,43,59565,44935,104500
410337,202008,43,33,10,34485,10450,44935
410340,202008,37,31,6,32395,6270,38665
410345,202008,210,120,90,126445,95095,221540
410347,202008,46,35,11,36575,11495,48070
410350,202008,229,141,88,147345,91960,239305
410360,202008,468,295,173,308275.5,180786,489061.5
410370,202008,2343,991,1352,1038730.45,1414931.35,2453661.80
410380,202008,208,132,76,137940,79420,217360
410390,202008,391,268,123,280060,129580,409640
410395,202008,37,24,13,25080,13585,38665
410400,202008,850,387,463,404415.27,483835,888250.27
410405,202008,91,67,24,70015,25080,95095
410410,202008,31,22,9,22990,9405,32395
410420,202008,1664,785,879,821277.49,920645.85,1741923.34
410425,202008,175,69,106,72105,110770,182875
410430,202008,2294,1270,1024,1327150,1071126.4,2398276.4
410440,202008,380,277,103,289465,107635,397100
410442,202008,364,240,124,250904.5,129580,380484.5
410445,202008,425,303,122,316635,127490,444125
410450,202008,401,200,201,209000,211090,420090
410460,202008,507,261,246,272745,258115,530860
410465,202008,225,134,91,140030,95095,235125
410470,202008,242,145,97,151525,101365,252890
410480,202008,6186,2973,3213,3112014.2,3360721.75,6472735.95
410490,202008,1420,859,561,897655.51,587290.5,1484946.01
410500,202008,270,151,119,157795,125400,283195
410510,202008,167,123,44,128535,45980,174515
410520,202008,254,189,65,197505,67925,265430
410530,202008,290,103,187,107635,195415,303050
410540,202008,324,235,89,245575,93005,338580
410550,202008,1679,720,959,753445.2,1003200.5,1756645.7
410560,202008,147,103,44,107635,45980,153615
410570,202008,431,290,141,303051.3,148390,451441.3
410580,202008,3467,1495,1972,1562276.7,2063875.5,3626152.2
410590,202008,397,268,129,280042,134805,414847
410600,202008,193,165,28,172425,29260,201685
410610,202008,51,42,9,44935,9405,54340
410620,202008,249,167,82,174515.03,85690,260205.03
410630,202008,432,245,187,257070,195415,452485
410640,202008,1021,644,377,672980.75,398145,1071125.75
410645,202008,110,79,31,82555,32395,114950
410650,202008,358,230,128,240350,133760,374110
410655,202008,89,63,26,65835,27170,93005
410657,202008,24,8,16,8360,16720,25080
410660,202008,602,419,183,437855.52,191235,629090.52
410670,202008,73,61,12,65033.83,12540,77573.83
410680,202008,214,170,44,177650,45980,223630
410685,202008,18,11,7,11495,7315,18810
410690,202008,28477,12007,16470,12563945.65,17237280.75,29801226.40
410700,202008,330,242,88,253935,93005,346940
410710,202008,132,105,27,109725,28215,137940
410712,202008,36,26,10,27170,10450,37620
410715,202008,89,65,24,67925,25080,93005
410720,202008,700,399,301,416955,315590,732545
410725,202008,184,136,48,142120,50160,192280
410730,202008,94,48,46,50160,48070,98230
410740,202008,107,76,31,79420,32395,111815
410750,202008,262,175,87,182875,90915,273790
410752,202008,25,15,10,15675,10450,26125
410753,202008,56,23,33,24035,34485,58520
410754,202008,50,26,24,27170.5,25080,52250.5
410755,202008,84,50,34,52250,35530,87780
410760,202008,772,419,353,438900.5,369930,808830.5
410765,202008,1773,812,961,848540,1004246,1852786
410770,202008,109,85,24,88825,25080,113905
410773,202008,56,41,15,42845,15675,58520
410775,202008,184,138,46,144210,48070,192280
410780,202008,87,47,40,49115,41800,90915
410785,202008,59,46,13,48070,13585,61655
410790,202008,80,36,44,37620,45980,83600
410800,202008,291,175,116,182875,121220.5,304095.5
410810,202008,23,16,7,16720,7315.5,24035.5
410820,202008,171,125,46,130625,48070,178695
410830,202008,8563,3707,4856,3874861.78,5086015.5,8960877.28
410832,202008,109,74,35,77330,36575,113905
410840,202008,1461,789,672,824506.44,702240.25,1526746.69
410845,202008,72,44,28,45980,29260,75240
410850,202008,189,133,56,138985,58520,197505
410855,202008,61,48,13,50160,13585,63745
410860,202008,734,399,335,416955.5,350075,767030.5
410865,202008,103,76,27,79420,28215,107635
410870,202008,155,133,22,138985,22990,161975
410880,202008,1114,562,552,588335.5,577885,1166220.5
410890,202008,89,64,25,66880,26125,93005
410895,202008,70,54,16,56430,16720,73150
410900,202008,25,19,6,19855,6270,26125
410910,202008,16,13,3,13585,3135,16720
410920,202008,37,25,12,26125,12540,38665
410930,202008,530,328,202,342760,212135,554895
410940,202008,4388,2454,1934,2569064.86,2026673.5,4595738.36
410950,202008,106,77,29,80465,30305,110770
410960,202008,827,341,486,357390,507870,865260
410965,202008,63,47,16,49115,16720,65835
410970,202008,632,449,183,471295,192280,663575
410975,202008,123,76,47,79420.91,49115,128535.91
410980,202008,1628,728,900,760760.5,942590,1703350.5
410990,202008,268,187,81,195415,84645,280060
411000,202008,66,41,25,42845,26125.5,68970.5
411005,202008,28,23,5,24035,5225,29260
411007,202008,259,153,106,159885,110770,270655
411010,202008,614,410,204,429495,213180,642675
411020,202008,287,196,91,206388.35,95095,301483.35
411030,202008,19,11,8,11495,8360,19855
411040,202008,56,38,18,39710,18810,58520
411050,202008,205,157,48,164065,50160,214225
411060,202008,513,344,169,360525,176605,537130
411065,202008,53,46,7,48070,8360,56430
411070,202008,1251,754,497,788975,520410,1309385
411080,202008,245,173,72,181830,75240,257070
411090,202008,97,75,22,78375,22990,101365
411095,202008,281,108,173,112860,181830,294690
411100,202008,119,97,22,101365,22990,124355
411110,202008,129,83,46,86735,48070,134805
411120,202008,209,142,67,148390,70015,218405
411125,202008,242,104,138,109725,144210,253935
411130,202008,131,112,19,117040,19855,136895
411140,202008,211,139,72,145255,75240,220495
411150,202008,1223,799,424,836000,443080.54,1279080.54
411155,202008,119,80,39,83600,41800,125400
411160,202008,27,13,14,13585,14630,28215
411170,202008,52,47,5,49115,5225,54340
411180,202008,971,638,333,666710,347985,1014695
411190,202008,328,190,138,198550,144210,342760
411200,202008,666,407,259,425315,270655,695970
411210,202008,692,363,329,381425,343805.5,725230.5
411220,202008,156,112,44,117040,45980,163020
411230,202008,40,34,6,35530,6270,41800
411240,202008,121,77,44,80465,45980,126445
411250,202008,435,317,118,331265,123310,454575
411260,202008,17,12,5,12540,5225,17765
411270,202008,277,151,126,157795,131670,289465
411275,202008,184,161,23,168245,24035,192280
411280,202008,212,150,62,156750.29,64790,221540.29
411290,202008,61,47,14,49115,14630,63745
411295,202008,139,108,31,112860,32395,145255
411300,202008,78,36,42,37620,43890,81510
411310,202008,89,69,20,72105,20900,93005
411320,202008,784,525,259,548625,271700,820325
411325,202008,61,41,20,42845,20900,63745
411330,202008,911,579,332,606518.5,346940.99,953459.49
411340,202008,28,18,10,18810,10450,29260
411342,202008,66,49,17,51205,17765,68970
411345,202008,116,57,59,59565,61655,121220
411350,202008,482,367,115,384560.45,120175.5,504735.95
411360,202008,54,35,19,36575,19855,56430
411370,202008,14223,5771,8452,6039060.24,8843837.63,14882897.87
411373,202008,176,126,50,131670,53295,184965
411375,202008,76,61,15,63745,15675,79420
411380,202008,84,62,22,64790,22990,87780
411390,202008,124,78,46,81510,48070,129580
411400,202008,377,275,102,288420,106590,395010
411410,202008,442,222,220,231990,231990.5,463980.5
411420,202008,994,432,562,453530,588335,1041865
411430,202008,470,269,201,281105,210045,491150
411435,202008,33,20,13,20900,13585,34485
411440,202008,449,355,94,370975,100320,471295
411450,202008,424,359,65,375155,67925,443080
411460,202008,774,292,482,305140,503690.57,808830.57
411470,202008,88,64,24,66880,25080,91960
411480,202008,667,371,296,388740.5,309320,698060.5
411490,202008,293,187,106,195415,111815,307230
411500,202008,100,82,18,85690,18810,104500
411510,202008,226,180,46,188100,48070,236170
411520,202008,6043,2277,3766,2383646,3938607.26,6322253.26
411530,202008,124,84,40,87780,41800,129580
411535,202008,51,20,31,20900,32395,53295
411540,202008,351,243,108,253935,112860,366795
411545,202008,54,40,14,41800,14630,56430
411550,202008,81,63,18,65835,18810,84645
411560,202008,399,171,228,178695,239305,418000
411570,202008,844,301,543,314545.2,567435,881980.2
411573,202008,24,15,9,15675,9405,25080
411575,202008,299,191,108,199595,112860,312455
411580,202008,1267,457,810,478052.66,846450,1324502.66
411585,202008,77,37,40,38665,41800,80465
411590,202008,23,16,7,16720,7315,24035
411600,202008,26,12,14,12540,14630,27170
411605,202008,237,96,141,100320,148390,248710
411610,202008,211,137,74,143165,77330,220495
411620,202008,376,199,177,207955,184965,392920
411630,202008,59,39,20,40755,20900,61655
411640,202008,33,24,9,25080,9405,34485
411650,202008,12,7,5,7315,5225,12540
411660,202008,36,24,12,25080,12540,37620
411670,202008,242,175,67,182875,70015,252890
411680,202008,166,136,30,142120,31350,173470
411690,202008,586,310,276,323950,288420,612370
411695,202008,60,44,16,45980,16720,62700
411700,202008,142,115,27,120175,28215,148390
411705,202008,104,69,35,72105,36575,108680
411710,202008,300,202,98,211090,102410,313500
411720,202008,130,88,42,94050,43890,137940
411721,202008,68,58,10,60610,10450,71060
411722,202008,104,45,59,47025,62700,109725
411725,202008,155,116,39,121220.5,40755,161975.5
411727,202008,87,67,20,70015,20900,90915
411729,202008,38,31,7,32395,7315,39710
411730,202008,553,348,205,363660,214225,577885
411740,202008,40,25,15,26125,15675,41800
411745,202008,70,49,21,51205,21945,73150
411750,202008,861,385,476,402325.5,498465,900790.5
411760,202008,1180,876,304,915420.6,318725,1234145.6
411770,202008,460,302,158,315590,165110,480700
411780,202008,348,228,120,238260,125400,363660
411790,202008,518,288,230,300960.22,240350,541310.22
411800,202008,156,119,37,124355.96,38665,163020.96
411810,202008,182,137,45,143165,47025,190190
411820,202008,2213,970,1243,1013652.11,1302070,2315722.11
411830,202008,11,10,1,10450,1045,11495
411840,202008,2020,1234,786,1290575,825551,2116126
411845,202008,53,19,34,19855,35530,55385
411850,202008,1217,674,543,706420.5,567435.75,1273856.25
411860,202008,50,32,18,33440.5,18810,52250.5
411870,202008,70,47,23,49115,24035,73150
411880,202008,422,266,156,279015,163020,442035
411885,202008,105,68,37,71060,38665,109725
411890,202008,311,201,110,210046.49,114950,324996.49
411900,202008,78,61,17,63745.5,17765,81510.5
411910,202008,182,143,39,151525,40755,192280
411915,202008,2184,888,1296,927960,1355365.05,2283325.05
411920,202008,118,96,22,100320,22990,123310
411925,202008,12,8,4,8360,4180,12540
411930,202008,809,584,225,611778.68,236170,847948.68
411940,202008,584,397,187,414865.85,195415,610280.85
411950,202008,1009,483,526,506233.59,550715,1056948.59
411960,202008,1044,698,346,730455.75,361570,1092025.75
411965,202008,20,14,6,14630,6270,20900
411970,202008,82,73,9,76285,9405,85690
411980,202008,165,108,57,112860,59565,172425
411990,202008,5176,2928,2248,3061857.14,2353410.25,5415267.39
411995,202008,503,169,334,176605,349030,525635
412000,202008,315,203,112,212135,117040,329175
412010,202008,45,28,17,29260,17765,47025
412015,202008,42,30,12,31350,12540,43890
412020,202008,31,25,6,26125,6270,32395
412030,202008,47,45,2,47025,2090,49115
412033,202008,49,29,20,30305,20900,51205
412035,202008,70,44,26,45980,27170,73150
412040,202008,43,25,18,26125.5,18810,44935.5
412050,202008,199,153,46,159885,48070,207955
412060,202008,786,582,204,609478.83,213180,822658.83
412065,202008,48,31,17,32395,17765,50160
412070,202008,164,110,54,115995,56430,172425
412080,202008,289,146,143,152570,150480,303050
412085,202008,37,16,21,16720,21945,38665
412090,202008,810,510,300,533995.25,313500,847495.25
412100,202008,245,205,40,214225,41800,256025
412110,202008,70,54,16,56430.5,16720,73150.5
412120,202008,326,195,131,203775,136895,340670
412125,202008,82,50,32,52250,33440,85690
412130,202008,36,22,14,22990.4,14630,37620.4
412135,202008,29,17,12,17765,12540,30305
412140,202008,345,226,119,237215,124355,361570
412150,202008,250,165,85,173470,88825,262295
412160,202008,90,51,39,53295,41800,95095
412170,202008,692,474,218,495330.5,227810,723140.5
412175,202008,38,28,10,29260,10450,39710
412180,202008,197,148,49,155705,51205,206910
412190,202008,329,261,68,273790,71060,344850
412200,202008,183,119,64,124355,66880,191235
412210,202008,75,57,18,59565,18810,78375
412215,202008,230,162,68,169597.23,71060,240657.23
412217,202008,65,52,13,54340,13585,67925
412220,202008,837,590,247,618640,258115,876755
412230,202008,325,198,127,209000,132715,341715
412240,202008,1352,666,686,697015,720005,1417020
412250,202008,407,252,155,263340,161975,425315
412260,202008,111,79,32,82555,33440,115995
412265,202008,177,138,39,144210,40755,184965
412270,202008,88,59,29,61655,30305,91960
412280,202008,90,72,18,75240,18810,94050
412290,202008,94,64,30,66880,31350,98230
412300,202008,209,138,71,144210,75240,219450
412310,202008,48,41,7,42845,7315,50160
412320,202008,99,81,18,84645,18810,103455
412330,202008,185,157,28,164065,29260,193325
412340,202008,157,110,47,114950,49115.5,164065.5
412350,202008,621,304,317,317680,331265,648945
412360,202008,26,22,4,22990,4180,27170
412370,202008,160,140,20,146300.3,20900,167200.3
412380,202008,259,195,64,203775,66880,270655
412382,202008,63,34,29,35530,30305,65835
412385,202008,151,107,44,111815,45980,157795
412390,202008,282,215,67,224675,70015,294690
412395,202008,70,58,12,60610,12540,73150
412400,202008,93,62,31,64790,32395,97185
412402,202008,230,114,116,119130.5,121220,240350.5
412405,202008,857,308,549,323950,573705,897655
412410,202008,965,595,370,622820.5,388740,1011560.5
412420,202008,13,12,1,12540,1045,13585
412430,202008,20,16,4,16720,4180,20900
412440,202008,614,332,282,347985,295735,643720
412450,202008,74,64,10,66880,10450,77330
412460,202008,93,72,21,75240,21945,97185
412470,202008,220,175,45,182875,47025,229900
412480,202008,145,107,38,111815.75,39710,151525.75
412490,202008,158,140,18,146300,18810,165110
412500,202008,434,353,81,368885.5,84645,453530.5
412510,202008,176,145,31,151525,32395,183920
412520,202008,93,61,32,63745,33440,97185
412530,202008,104,55,49,57475,51205,108680
412535,202008,91,68,23,71060,24035,95095
412540,202008,84,40,44,41800,45980,87780
412545,202008,88,60,28,62700,29260,91960
412550,202008,3830,1623,2207,1698125.5,2309451.33,4007576.83
412555,202008,13,9,4,9405,4180,13585
412560,202008,617,433,184,452486.5,193325.75,645812.25
412570,202008,766,390,376,407550,392920,800470
412575,202008,91,62,29,64790,30305,95095
412580,202008,178,117,61,122265,63745,186010
412590,202008,36,32,4,33440,4180,37620
412600,202008,168,123,45,128535.85,47025,175560.85
412610,202008,34,17,17,17765,17765,35530
412620,202008,149,124,25,129580,26125,155705
412625,202008,2143,1118,1025,1170401.04,1071126.85,2241527.89
412627,202008,68,52,16,54340,16720,71060
412630,202008,410,270,140,283195,146300,429495
412635,202008,67,18,49,18810,52250,71060
412640,202008,103,72,31,75240,33440,108680
412650,202008,337,220,117,229900,122265,352165
412660,202008,473,282,191,294690,199595,494285
412665,202008,46,41,5,42845,5225,48070
412667,202008,297,201,96,210045,100320,310365
412670,202008,64,52,12,54340,12540,66880
412680,202008,296,231,65,241395,67925.7,309320.7
412690,202008,104,67,37,70015,38665.5,108680.5
412700,202008,162,109,53,113905,55385,169290
412710,202008,1378,827,551,865261.25,576840,1442101.25
412720,202008,228,141,87,147345,90915,238260
412730,202008,189,159,30,166155,31350,197505
412740,202008,430,226,204,236170,213180,449350
412750,202008,434,246,188,257070,196460,453530
412760,202008,283,143,140,150480,146300,296780
412770,202008,2145,1185,960,1241460.29,1005291,2246751.29
412780,202008,139,107,32,112860,33440,146300
412785,202008,281,135,146,143165,152570,295735
412788,202008,37,21,16,21945,16720,38665
412790,202008,123,104,19,108680,19855,128535
412795,202008,149,105,44,109725,45980,155705
412796,202008,317,206,111,215757.66,115995,331752.66
412800,202008,621,375,246,391875.25,257070,648945.25
412810,202008,2949,1594,1355,1666777.75,1419110,3085887.75
412820,202008,940,585,355,613416.75,370975,984391.75
412830,202008,14,11,3,11495,3135,14630
412840,202008,232,166,66,173470,68970,242440
412850,202008,755,489,266,511005,277970,788975
412853,202008,170,85,85,89870,88825,178695
412855,202008,180,97,83,102410.09,86735,189145.09
412860,202008,94,63,31,65835,32395,98230
412862,202008,57,38,19,39710,19855,59565
412863,202008,6,5,1,5225,1045,6270
412865,202008,46,32,14,33440,14630,48070
412870,202008,109,67,42,70015,43890,113905
412880,202008,92,66,26,68970.5,27170,96140.5
420005,202008,42,38,4,39710,4180,43890
420010,202008,364,234,130,244530,135850,380380
420020,202008,81,68,13,71060,13585,84645
420030,202008,23,21,2,21945,2090,24035
420040,202008,105,81,24,84645,25080,109725
420050,202008,59,36,23,37620,24035,61655
420055,202008,18,18,0,18810,0,18810
420060,202008,29,23,6,24035,6270,30305
420070,202008,104,86,18,89870,18810,108680
420075,202008,11,11,0,11495,0,11495
420080,202008,42,37,5,39710,5225,44935
420090,202008,34,30,4,31350,4180,35530
420100,202008,150,127,23,132715.5,24035,156750.5
420110,202008,19,19,0,19855,0,19855
420120,202008,57,40,17,43890,17765,61655
420125,202008,79,61,18,63745,18810,82555
420127,202008,32,26,6,27170,6270,33440
420130,202008,428,256,172,267520,180785,448305
420140,202008,1297,723,574,756580.75,600875,1357455.75
420150,202008,44,37,7,38665,7315,45980
420160,202008,32,30,2,31350,2090,33440
420165,202008,16,11,5,11495,5225,16720
420170,202008,76,49,27,51205,28215,79420
420180,202008,22,19,3,19855,3135,22990
420190,202008,25,22,3,22990,3135,26125
420195,202008,132,63,69,65835,72105,137940
420200,202008,1267,560,707,585200.5,740905,1326105.5
420205,202008,81,46,35,48070,36575,84645
420207,202008,121,67,54,70015,56430,126445
420208,202008,19,15,4,15675,4180,19855
420209,202008,18,15,3,15675,3135,18810
420210,202008,517,238,279,248710,291555,540265
420213,202008,43,35,8,36575,8360,44935
420215,202008,27,24,3,25080,3135,28215
420220,202008,63,41,22,42845,22990,65835
420230,202008,834,469,365,490105,381425.5,871530.5
420240,202008,2249,1459,790,1526745.9,827640,2354385.9
420243,202008,41,31,10,32395,10450,42845
420245,202008,157,83,74,86735,77330,164065
420250,202008,62,41,21,42845,21945,64790
420253,202008,30,24,6,25080,6270,31350
420257,202008,13,10,3,10450,3135,13585
420260,202008,101,84,17,87780,17765,105545
420270,202008,29,24,5,25080,5225,30305
420280,202008,294,223,71,233035.75,74195.75,307231.50
420285,202008,23,13,10,13585,10450,24035
420287,202008,50,33,17,34485,17765,52250
420290,202008,979,677,302,709555.5,315590,1025145.5
420300,202008,1431,1128,303,1180853.1,316635.65,1497488.75
420310,202008,53,36,17,37620,17765,55385
420315,202008,35,28,7,29260.5,7315,36575.5
420320,202008,921,452,469,474221.1,491150,965371.1
420325,202008,0,,,,,0.0
420330,202008,118,78,40,81510,41800,123310
420340,202008,160,106,54,111606,56430,168036
420350,202008,257,183,74,191235,77330,268565
420360,202008,725,550,175,576840.83,183920,760760.83
420370,202008,118,70,48,73150,50160.5,123310.5
420380,202008,1173,814,359,851675.75,376200,1227875.75
420390,202008,249,177,72,184965,75240,260205
420395,202008,198,143,55,149435,57475,206910
420400,202008,238,182,56,191235.65,58520,249755.65
420410,202008,59,45,14,47025,14630,61655
420415,202008,34,29,5,30305,5225,35530
420417,202008,49,38,11,39710,11495,51205
420419,202008,11,11,0,11495,0,11495
420420,202008,2852,1752,1100,1830843.24,1150545.5,2981388.74
420425,202008,67,55,12,57475,12540,70015
420430,202008,1164,835,329,872575.45,343805,1216380.45
420435,202008,15,13,2,13585,2090,15675
420440,202008,101,72,29,75240.5,30305,105545.5
420445,202008,27,26,1,27170,1045,28215
420450,202008,76,38,38,39710,39710,79420
420455,202008,214,161,53,168245,55385,223630
420460,202008,2336,1507,829,1576907.31,868395,2445302.31
420470,202008,104,75,29,78375,30305,108680
420475,202008,7,7,0,7315,0,7315
420480,202008,850,642,208,671936,218405.5,890341.5
420490,202008,103,76,27,79420,28215,107635
420500,202008,450,237,213,247666.09,222585,470251.09
420510,202008,17,15,2,15675,2090,17765
420515,202008,24,16,8,16720,8360,25080
420517,202008,9,9,0,9405,0,9405
420519,202008,0,,,,,0.0
420520,202008,66,50,16,52250,16720,68970
420530,202008,158,105,53,110770.75,55385,166155.75
420535,202008,19,17,2,17765,2090,19855
420540,202008,5508,3294,2214,3445631.15,2320945.5,5766576.65
420543,202008,28,26,2,27170,2090,29260
420545,202008,209,149,60,155705,62700,218405
420550,202008,854,703,151,735680.66,157795,893475.66
420555,202008,35,26,9,27170,9405,36575
420560,202008,62,52,10,54340,10450,64790
420570,202008,161,91,70,95095,73150,168245
420580,202008,276,129,147,134805,155705,290510
420590,202008,514,347,167,363660,175560,539220
420600,202008,116,62,54,64790,56430,121220
420610,202008,38,34,4,35530,4180,39710
420620,202008,87,68,19,71060,19855,90915
420630,202008,153,104,49,109725,52250,161975
420640,202008,83,74,9,77330,9405,86735
420650,202008,245,124,121,129580,127490,257070
420660,202008,49,39,10,40755.5,10450,51205.5
420665,202008,37,28,9,29260,9405,38665
420670,202008,298,229,69,239305,72105,311410
420675,202008,12,11,1,11495,1045,12540
420680,202008,38,27,11,29260,11495,40755
420690,202008,180,141,39,147345,40755,188100
420700,202008,684,463,221,485925.46,230945,716870.46
420710,202008,149,81,68,84645,71060,155705
420720,202008,109,88,21,91960,21945,113905
420730,202008,612,381,231,398145.4,241395.5,639540.9
420740,202008,52,51,1,53295,1045,54340
420750,202008,499,340,159,355300,168245,523545
420757,202008,16,14,2,14630,2090,16720
420760,202008,37,29,8,30305,8360,38665
420765,202008,79,60,19,62700,19855,82555
420768,202008,49,43,6,44935,6270,51205
420770,202008,73,63,10,65835,10450,76285
420775,202008,40,37,3,38665,3135,41800
420780,202008,220,172,48,179740,50160,229900
420785,202008,12,9,3,9405,3135,12540
420790,202008,165,137,28,143165,29260,172425
420800,202008,66,50,16,52250,16720,68970
420810,202008,249,208,41,217360,42845,260205
420820,202008,2374,1351,1023,1411795.5,1073216.22,2485011.72
420830,202008,617,328,289,343805.5,302005,645810.5
420840,202008,150,108,42,112860,43890,156750
420845,202008,407,177,230,184965,242440.5,427405.5
420850,202008,257,190,67,198550,70015,268565
420860,202008,58,49,9,51205,9405,60610
420870,202008,125,86,39,90915,40755,131670
420880,202008,183,119,64,124355,66880,191235
420890,202008,932,465,467,485925.25,488015,973940.25
420895,202008,9,9,0,9405,0,9405
420900,202008,404,321,83,335445,86735,422180
420910,202008,5878,3256,2622,3408794.83,2745215,6154009.83
420915,202008,61,57,4,59565,4180,63745
420917,202008,22,15,7,15675,7315,22990
420920,202008,22,15,7,15675,7315,22990
420930,202008,2798,1741,1057,1822825.4,1106657.94,2929483.34
420940,202008,595,439,156,458756,163020.9,621776.9
420945,202008,9,7,2,7315,2090,9405
420950,202008,56,49,7,51205,7315,58520
420960,202008,110,86,24,89870,25080,114950
420970,202008,294,236,58,246621,60610,307231
420980,202008,24,23,1,24035,1045,25080
420985,202008,55,49,6,52250,6270,58520
420990,202008,81,58,23,60610,24035,84645
421000,202008,42,25,17,26125,17765,43890
421003,202008,51,35,16,36575,16720,53295
421005,202008,6,3,3,3135,3135,6270
421010,202008,778,523,255,546535,266475,813010
421020,202008,25,20,5,20900,5225,26125
421030,202008,119,99,20,103455.75,20900,124355.75
421040,202008,73,54,19,56430,19855,76285
421050,202008,350,247,103,258116,107635,365751
421055,202008,21,17,4,17765,4180,21945
421060,202008,92,53,39,56430,41800,98230
421070,202008,49,43,6,44935.5,6270,51205.5
421080,202008,35,31,4,32395,4180,36575
421085,202008,21,15,6,15675,6270,21945
421090,202008,36,28,8,29260,8360,37620
421100,202008,126,92,34,96140,35530,131670
421105,202008,198,161,37,168245,38665,206910
421110,202008,111,87,24,91960,25080,117040
421120,202008,166,121,45,126445.42,48070,174515.42
421125,202008,17,12,5,12540,5225,17765
421130,202008,822,515,307,539220,320815.5,860035.5
421140,202008,30,21,9,21945,9405,31350
421145,202008,41,33,8,34485,8360,42845
421150,202008,101,72,29,75240,30305,105545
421160,202008,67,46,21,48070,21945,70015
421165,202008,16,15,1,15675,1045,16720
421170,202008,182,154,28,161056,29260,190316
421175,202008,164,112,52,117040,54340,171380
421180,202008,46,32,14,33440.1,14630,48070.1
421185,202008,18,14,4,14630,4180,18810
421187,202008,1,0,1,0,1045,1045
421189,202008,45,30,15,31350,15675,47025
421190,202008,1698,1060,638,1109790,667755,1777545
421200,202008,94,70,24,73150,25080,98230
421205,202008,27,18,9,18810,9405,28215
421210,202008,173,118,55,123310,57475,180785
421220,202008,274,213,61,222585,63745,286330
421223,202008,49,39,10,40755,10450,51205
421225,202008,70,44,26,45980,27170,73150
421227,202008,87,67,20,70015,20900,90915
421230,202008,56,40,16,41800,16720,58520
421240,202008,17,17,0,17765,0,17765
421250,202008,372,217,155,226765.5,161975,388740.5
421260,202008,24,20,4,20900,4180,25080
421265,202008,2,2,0,2090,0,2090
421270,202008,47,42,5,43890,5225,49115
421280,202008,351,188,163,196460,170335,366795
421290,202008,333,220,113,229900,118085.5,347985.5
421300,202008,23,19,4,19855,4180,24035
421310,202008,47,33,14,34485,14630,49115
421315,202008,30,18,12,18810,12540,31350
421320,202008,128,81,47,84645,49115,133760
421330,202008,106,76,30,79420,31350,110770
421335,202008,39,27,12,28215,12540,40755
421340,202008,241,158,83,165110.25,86735,251845.25
421350,202008,191,109,82,113905.82,85690,199595.82
421360,202008,647,475,172,499510.25,179740,679250.25
421370,202008,200,151,49,157795,51205,209000
421380,202008,131,102,29,106590,30305,136895
421390,202008,19,13,6,13585,6270,19855
421400,202008,125,110,15,114950,15675,130625
421410,202008,17,15,2,15675,2090,17765
421415,202008,20,19,1,20900,1045,21945
421420,202008,131,109,22,113905,22990,136895
421430,202008,17,13,4,13585,4180,17765
421440,202008,59,50,9,52250,9405,61655
421450,202008,92,76,16,79420,16720,96140
421460,202008,62,50,12,52250,12540,64790
421470,202008,68,42,26,43890.25,27170,71060.25
421480,202008,727,554,173,578930,181830,760760
421490,202008,23,22,1,22990,1045,24035
421500,202008,491,313,178,329175.5,186010.25,515185.75
421505,202008,24,17,7,17765,7315,25080
421507,202008,33,25,8,26125,8360,34485
421510,202008,71,46,25,48070,26125,74195
421520,202008,56,47,9,49115,9405,58520
421530,202008,50,42,8,43890,8360,52250
421535,202008,25,23,2,24035,2090,26125
421540,202008,52,44,8,45980,8360,54340
421545,202008,103,75,28,78375,29260,107635
421550,202008,286,203,83,212135,86735,298870
421555,202008,21,18,3,18810,3135.5,21945.5
421560,202008,9,8,1,8360,1045,9405
421565,202008,121,81,40,85690,41800,127490
421567,202008,30,23,7,24035,7315,31350
421568,202008,32,28,4,29260,4180,33440
421569,202008,10,10,0,10450,0,10450
421570,202008,203,137,66,143165,68970,212135
421575,202008,27,22,5,22990,5225,28215
421580,202008,714,423,291,442103,304095,746198
421590,202008,20,19,1,19855,1045,20900
421600,202008,153,99,54,103455.5,56430.5,159886.0
421605,202008,109,76,33,79420.75,34485,113905.75
421610,202008,178,135,43,141075,44935,186010
421620,202008,1027,597,430,624910,449350,1074260
421625,202008,20,18,2,18810,2090,20900
421630,202008,303,189,114,197505.25,119131.5,316636.75
421635,202008,19,9,10,9405,10450,19855
421640,202008,101,83,18,86735,18810,105545
421650,202008,301,179,122,187055,127490,314545
421660,202008,2242,1341,901,1402391.5,944681,2347072.5
421670,202008,183,131,52,136895,54340,191235
421680,202008,178,161,17,168245,17765,186010
421690,202008,347,243,104,256026.2,108680.6,364706.8
421700,202008,52,36,16,37620,16720,54340
421710,202008,24,23,1,24035,1045,25080
421715,202008,6,5,1,5225,1045,6270
421720,202008,633,441,192,462936.21,201685,664621.21
421725,202008,16,6,10,6270,10450,16720
421730,202008,33,24,9,25080,9405,34485
421740,202008,89,33,56,34485,58520,93005
421750,202008,210,156,54,164065,56430,220495
421755,202008,23,21,2,21945,2090,24035
421760,202008,100,68,32,71060,33440,104500
421770,202008,656,412,244,431586.75,256025,687611.75
421775,202008,27,16,11,16720,11495,28215
421780,202008,192,151,41,157795.5,42845,200640.5
421790,202008,149,127,22,132715,22990,155705
421795,202008,17,14,3,14630,3135,17765
421800,202008,516,330,186,344850,194370,539220
421810,202008,67,54,13,56430,13585,70015
421820,202008,314,202,112,212135.5,117040,329175.5
421825,202008,140,119,21,125400,21945,147345
421830,202008,140,90,50,94050,52250,146300
421835,202008,6,4,2,4180,2090,6270
421840,202008,49,43,6,44935,6270,51205
421850,202008,80,68,12,71060,12540,83600
421860,202008,35,29,6,30305,7315,37620
421870,202008,1025,763,262,797336.25,273790,1071126.25
421875,202008,54,44,10,45980,10450,56430
421880,202008,170,118,52,124355,54340.5,178695.5
421885,202008,22,17,5,17765,5225,22990
421890,202008,135,95,40,99275,41800,141075
421895,202008,45,40,5,41800,5225,47025
421900,202008,150,118,32,125400,33440,158840
421910,202008,69,41,28,42845,29260,72105
421915,202008,30,25,5,26125,5225,31350
421917,202008,38,29,9,30305,9405,39710
421920,202008,40,36,4,37620,4180,41800
421930,202008,670,537,133,563255,138985,702240
421935,202008,52,45,7,47025,7315,54340
421940,202008,44,38,6,39710,6270,45980
421950,202008,875,586,289,613416.44,303050,916466.44
421960,202008,45,40,5,41800,5225,47025
421970,202008,354,227,127,238260.5,132715,370975.5
421985,202008,23,13,10,13585,10450,24035
422000,202008,0,,,,,0.0
430003,202008,187,55,132,58450.33,137940,196390.33
430005,202008,38,25,13,27170,13585,40755
430010,202008,266,194,72,202730,75240,277970
430020,202008,144,96,48,100320.5,50160,150480.5
430030,202008,122,98,24,102410,25080,127490
430040,202008,2919,1717,1202,1796357,1258180.5,3054537.5
430045,202008,67,56,11,58520,11495,70015
430047,202008,6,6,0,6270,0,6270
430050,202008,78,64,14,66880,14630,81510
430055,202008,12,11,1,11495,1045,12540
430057,202008,5,4,1,4180,1045,5225
430060,202008,3710,2150,1560,2247796.25,1634380,3882176.25
430063,202008,53,49,4,51205,4180,55385
430064,202008,151,120,31,125400,32395,157795
430066,202008,5,2,3,2090,3135,5225
430070,202008,43,29,14,30305,14630,44935
430080,202008,69,47,22,49115,22990,72105
430085,202008,29,10,19,10450,19855,30305
430087,202008,26,19,7,19855.75,7315,27170.75
430090,202008,72,65,7,67925,7315,75240
430100,202008,124,83,41,86735,42845,129580
430105,202008,151,83,68,86735,71060,157795
430107,202008,18,12,6,12540,6270,18810
430110,202008,449,260,189,271700,197505,469205
430120,202008,155,144,11,150480,11495,161975
430130,202008,794,487,307,508915.5,321860,830775.5
430140,202008,123,115,8,120175,9405,129580
430150,202008,111,72,39,75240,40755,115995
430155,202008,36,31,5,32395,5225,37620
430160,202008,3631,2129,1502,2228987.75,1569590.5,3798578.25
430163,202008,364,158,206,165110,215270,380380
430165,202008,29,20,9,20900,9405,30305
430170,202008,89,74,15,77330,15675,93005
430175,202008,76,58,18,60610,18810,79420
430180,202008,105,86,19,89870,19855,109725
430185,202008,31,21,10,21945,10450,32395
430187,202008,83,38,45,39710,47025,86735
430190,202008,219,120,99,125400,103455,228855
430192,202008,13,11,2,11495,2090,13585
430195,202008,15,10,5,11495,5225,16720
430200,202008,164,140,24,146300,25080,171380
430205,202008,21,20,1,20900,1045,21945
430210,202008,678,522,156,546535,164065.5,710600.5
430215,202008,13,11,2,11495,2090,13585
430220,202008,72,49,23,52250,24035,76285
430222,202008,12,6,6,6270,6270,12540
430223,202008,15,8,7,8360,7315,15675
430225,202008,2,1,1,1045,1045,2090
430230,202008,315,185,130,194370,135850.5,330220.5
430235,202008,55,43,12,44935,12540,57475
430237,202008,28,21,7,21945,7315,29260
430240,202008,125,83,42,86735,43890,130625
430245,202008,70,56,14,58520,14630,73150
430250,202008,185,111,74,115995,78375,194370
430258,202008,9,8,1,8360,1045,9405
430260,202008,31,27,4,28215,4180,32395
430265,202008,36,30,6,31350,6270,37620
430270,202008,521,390,131,407551.25,136895,544446.25
430280,202008,1037,625,412,653125,430540,1083665
430290,202008,400,217,183,226765,191235,418000
430300,202008,2085,1149,936,1201750.75,979165.5,2180916.25
430310,202008,2006,1011,995,1056495.5,1040821.21,2097316.71
430320,202008,57,47,10,49115,10450,59565
430330,202008,99,87,12,91960,12540,104500
430340,202008,72,58,14,60610,14630,75240
430350,202008,1654,1114,540,1168310.5,566390,1734700.5
430355,202008,19,17,2,17765,2090,19855
430360,202008,85,43,42,44935,43890,88825
430367,202008,35,26,9,27170,9405,36575
430370,202008,52,47,5,49115,5225,54340
430380,202008,132,101,31,105545,32395,137940
430390,202008,587,364,223,380380,233035,613415
430400,202008,260,183,77,191235.5,80465,271700.5
430410,202008,54,43,11,44935,11495,56430
430420,202008,508,332,176,346940.85,183920,530860.85
430430,202008,55,54,1,55735,1045,56780
430435,202008,153,113,40,118085,41800,159885
430440,202008,487,319,168,334400,175560,509960
430450,202008,1149,948,201,990660,211090,1201750
430460,202008,5275,2760,2515,2888382.37,2640715,5529097.37
430461,202008,16,15,1,15675,1045,16720
430462,202008,10,6,4,6270,4180,10450
430463,202008,1096,594,502,621775,524590,1146365
430465,202008,24,13,11,13585,11495,25080
430466,202008,652,458,194,480700.5,202730,683430.5
430467,202008,105,57,48,59565,50160,109725
430468,202008,121,71,50,74195,52250,126445
430469,202008,23,18,5,18810,5225,24035
430470,202008,1160,642,518,673291.62,541310,1214601.62
430471,202008,53,35,18,36575,18810,55385
430480,202008,101,65,36,68970,37620,106590
430485,202008,6,6,0,6270.5,0,6270.5
430490,202008,76,61,15,63745,15675,79420
430495,202008,34,26,8,27170,8360,35530
430500,202008,188,127,61,132715,63745,196460
430510,202008,3451,2223,1228,2325125.63,1286395.5,3611521.13
430511,202008,16,16,0,16720,0,16720
430512,202008,153,106,47,110770,49115,159885
430513,202008,53,43,10,44935,10450,55385
430515,202008,29,27,2,28215,2090,30305
430517,202008,167,146,21,152570,21945,174515
430520,202008,340,237,103,247665,107635,355300
430530,202008,84,49,35,51205,37620,88825
430535,202008,445,304,141,319770,148390,468160
430537,202008,10,10,0,10450,0,10450
430540,202008,83,57,26,59565,27170,86735
430543,202008,349,114,235,119130,246620,365750
430544,202008,43,40,3,41800,3135,44935
430545,202008,379,190,189,198550,197505,396055
430550,202008,41,33,8,34485,8360,42845
430558,202008,2,2,0,2090,0,2090
430560,202008,55,29,26,30305,27170,57475
430570,202008,106,41,65,42845,67925,110770
430580,202008,131,106,25,110770,26125,136895
430583,202008,13,13,0,13585,0,13585
430585,202008,12,5,7,5225,7315,12540
430587,202008,14,7,7,7315,7315,14630
430590,202008,143,116,27,122265,28215,150480
430593,202008,2,2,0,2090,0,2090
430595,202008,17,14,3,14630,3135,17765
430597,202008,43,21,22,21945,22990,44935
430600,202008,219,161,58,168245,60610,228855
430605,202008,159,100,59,104500,61655,166155
430607,202008,24,20,4,20900,4180,25080
430610,202008,1624,761,863,795245,903925.5,1699170.5
430613,202008,2,2,0,2090,0,2090
430620,202008,108,78,30,81510,32395,113905
430630,202008,47,41,6,42845,6270,49115
430632,202008,30,25,5,26125,5225,31350
430635,202008,33,30,3,31350,3135,34485
430637,202008,60,30,30,31350,31350,62700
430640,202008,180,97,83,101365,86735,188100
430642,202008,21,17,4,17765,4180,21945
430645,202008,33,27,6,28215,6270,34485
430650,202008,248,202,46,211090.5,48070,259160.5
430655,202008,2,2,0,2090,0,2090
430660,202008,974,482,492,504735,514140.5,1018875.5
430670,202008,76,50,26,52250,27170,79420
430673,202008,68,41,27,42845,28215,71060
430675,202008,11,9,2,9405,2090,11495
430676,202008,518,304,214,317680,225720,543400
430680,202008,237,162,75,169291,78375,247666
430690,202008,529,326,203,340670,212135.29,552805.29
430692,202008,8,6,2,6270,2090,8360
430693,202008,137,88,49,91960,51205,143165
430695,202008,67,55,12,57475,12540,70015
430697,202008,56,35,21,36575,21945,58520
430700,202008,1482,1028,454,1077395.9,474430,1551825.9
430705,202008,22,20,2,20900,2090,22990
430710,202008,255,161,94,169290,98230,267520
430720,202008,107,92,15,96140,15675,111815
430730,202008,138,119,19,124355,19855,144210
430740,202008,71,49,22,51205,22990,74195
430745,202008,29,23,6,24035,6270,30305
430750,202008,326,218,108,227810,112860,340670
430755,202008,85,45,40,47025,41800,88825
430760,202008,384,215,169,225720.6,177699,403419.6
430770,202008,1492,778,714,815100.5,750310.5,1565411.0
430780,202008,296,186,110,194370,114950,309320
430781,202008,26,22,4,22990,4180,27170
430783,202008,61,49,12,51205,12540,63745
430786,202008,5,3,2,3135,2090,5225
430790,202008,515,341,174,356345,181830.5,538175.5
430800,202008,150,122,28,127490.76,29260,156750.76
430805,202008,41,36,5,37620,5225,42845
430807,202008,46,24,22,25080,22990,48070
430810,202008,73,44,29,45980,30305,76285
430820,202008,146,86,60,89870,62700,152570
430825,202008,10,8,2,8360,2090,10450
430830,202008,238,219,19,228855.5,19855,248710.5
430840,202008,126,85,41,88825,42845,131670
430843,202008,5,3,2,3135,2090,5225
430845,202008,73,41,32,42845,33440,76285
430850,202008,581,412,169,430540,177650,608190
430860,202008,161,103,58,107635,61655,169290
430865,202008,76,43,33,44935,34485,79420
430870,202008,81,66,15,68970,15675,84645
430880,202008,150,110,40,114950,41800,156750
430885,202008,8,6,2,6270,2090,8360
430890,202008,346,209,137,219450,144210,363660
430900,202008,509,352,157,367840,164065,531905
430905,202008,120,52,68,54340,71060,125400
430910,202008,279,154,125,160930,131670,292600
430912,202008,5,5,0,5225,0,5225
430915,202008,34,30,4,31350,4180,35530
430920,202008,4315,2294,2021,2398275,2117170,4515445
430925,202008,4,3,1,3135,1045,4180
430930,202008,2089,1205,884,1259227.25,923780.5,2183007.75
430940,202008,256,166,90,174515,94050,268565
430950,202008,154,125,29,130625,31350,161975
430955,202008,22,11,11,11495,11495,22990
430957,202008,17,15,2,15675,2090,17765
430960,202008,246,166,80,173470,83600,257070
430965,202008,112,71,41,74195,42845,117040
430970,202008,82,69,13,72105,13585,85690
430975,202008,43,39,4,40755,4180,44935
430980,202008,45,28,17,29260,17765,47025
430990,202008,110,85,25,88825,26125,114950
430995,202008,115,109,6,113905,6270,120175
431000,202008,295,141,154,147346.1,160930,308276.1
431010,202008,356,201,155,210045,161975,372020
431020,202008,1845,1065,780,1112925.5,816145,1929070.5
431030,202008,40,32,8,33440,8360,41800
431033,202008,404,193,211,201685,220495,422180
431036,202008,11,6,5,6270,5225,11495
431040,202008,138,86,52,89870,55385,145255
431041,202008,40,27,13,28215.5,13585,41800.5
431043,202008,43,26,17,27170,17765,44935
431046,202008,10,6,4,6270,4180,10450
431050,202008,200,126,74,131670,77330,209000
431053,202008,67,39,28,40755,29260,70015
431055,202008,63,43,20,44935,20900,65835
431057,202008,18,18,0,18810,0,18810
431060,202008,1610,1046,564,1094116.34,592515.75,1686632.09
431065,202008,18,12,6,12540,6270,18810
431070,202008,66,61,5,63745,5225,68970
431075,202008,8,7,1,7315,1045,8360
431080,202008,136,81,55,84645,57475,142120
431085,202008,34,31,3,32395,3135,35530
431087,202008,15,13,2,13585,2090,15675
431090,202008,56,44,12,45980,12540,58520
431100,202008,1225,737,488,770166.1,511005,1281171.1
431110,202008,227,137,90,143165,94050.5,237215.5
431112,202008,27,16,11,16720,11495,28215
431113,202008,35,25,10,26125,10450,36575
431115,202008,157,110,47,114950,49115,164065
431120,202008,607,360,247,376200,259160,635360
431123,202008,3,2,1,2090,1045,3135
431125,202008,94,85,9,88825,9405,98230
431127,202008,10,5,5,5225,5225,10450
431130,202008,688,454,234,474430,245575,720005
431140,202008,751,515,236,540265.5,246620,786885.5
431142,202008,26,22,4,22990.67,4180,27170.67
431150,202008,192,145,47,152570,49115,201685
431160,202008,48,44,4,45980,5225,51205
431162,202008,5,4,1,4180,1045,5225
431164,202008,6,6,0,6270,0,6270
431170,202008,106,84,22,87780,22990,110770
431171,202008,69,41,28,42845,29260,72105
431173,202008,1,1,0,1045,0,1045
431175,202008,196,100,96,104500.5,100320,204820.5
431177,202008,82,58,24,60610,25080,85690
431179,202008,12,10,2,10450,2090,12540
431180,202008,430,261,169,273790,176605,450395
431190,202008,78,60,18,62700,18810,81510
431198,202008,73,53,20,55385,20900,76285
431200,202008,20,16,4,16720,4180,20900
431205,202008,20,19,1,19855,1045,20900
431210,202008,96,60,36,62700,37620,100320
431213,202008,31,26,5,27170,5225,32395
431215,202008,22,19,3,19855,3135,22990
431217,202008,5,4,1,4180,1045,5225
431220,202008,67,58,9,60610.87,9405,70015.87
431225,202008,150,95,55,99275,57475,156750
431230,202008,98,85,13,88825,13585,102410
431235,202008,7,7,0,7315,0,7315
431237,202008,20,14,6,14630,6270,20900
431238,202008,10,6,4,6270,4180,10450
431240,202008,1013,637,376,666710,392920.56,1059630.56
431242,202008,39,38,1,39710,1045,40755
431244,202008,14,9,5,9405,5225,14630
431245,202008,50,38,12,39710,12540,52250
431247,202008,10,6,4,6270,4180,10450
431250,202008,277,144,133,150480,140030,290510
431260,202008,57,45,12,47025,12540,59565
431261,202008,18,11,7,11495,7315,18810
431262,202008,16,15,1,16720,1045,17765
431265,202008,150,80,70,83600,73150,156750
431267,202008,19,15,4,15675,4180,19855
431270,202008,324,263,61,274835,63745,338580
431275,202008,37,34,3,35530,3135,38665
431280,202008,20,16,4,16720,4180,20900
431290,202008,24,21,3,21945,3135,25080
431295,202008,2,2,0,2090,0,2090
431300,202008,21,18,3,18810,3135,21945
431301,202008,5,5,0,5225,0,5225
431303,202008,60,39,21,40755,21945,62700
431306,202008,244,130,114,136708.99,119130,255838.99
431308,202008,7,5,2,5225,2090,7315
431310,202008,65,54,11,56430,11495,67925
431320,202008,148,90,58,94050,60610,154660
431330,202008,174,112,62,117040,64790,181830
431333,202008,24,19,5,19855,5225,25080
431335,202008,9,5,4,5225,4180,9405
431337,202008,348,154,194,160930,203775,364705
431339,202008,19,17,2,17765,2090,19855
431340,202008,3015,1649,1366,1727302.44,1428516.25,3155818.69
431342,202008,37,24,13,25080,13585,38665
431344,202008,19,19,0,19855,0,19855
431346,202008,5,5,0,5225,0,5225
431349,202008,36,32,4,33440,4180,37620
431350,202008,936,541,395,565345.25,412775,978120.25
431360,202008,47,40,7,41800,7315,49115
431365,202008,339,155,184,163020,192280,355300
431370,202008,1205,689,516,721050.5,539220,1260270.5
431380,202008,97,84,13,87780,13585,101365
431390,202008,498,264,234,275880,245575,521455
431395,202008,297,126,171,131670,178695,310365
431400,202008,42,29,13,30305,13585,43890
431402,202008,106,75,31,78375,32395,110770
431403,202008,23,14,9,14630,9405,24035
431405,202008,672,371,301,387695.25,314545,702240.25
431406,202008,29,25,4,26125,4180,30305
431407,202008,53,41,12,43890,12540,56430
431410,202008,3385,2065,1320,2161060.5,1385670.75,3546731.25
431413,202008,15,12,3,12540,3135,15675
431415,202008,68,51,17,53295,17765,71060
431417,202008,23,11,12,11495,12540,24035
431420,202008,321,217,104,226765,108680,335445
431430,202008,54,23,31,24035,32395,56430
431440,202008,8896,6167,2729,6451837.9,2853896.76,9305734.66
431442,202008,28,13,15,13585,15675,29260
431445,202008,25,23,2,24035,2090,26125
431446,202008,4,4,0,4180,0,4180
431447,202008,84,58,26,60610,27170,87780
431449,202008,53,45,8,47025,8360,55385
431450,202008,415,274,141,287375,147345,434720
431454,202008,0,,,,,0.0
431455,202008,53,41,12,42845,12540,55385
431460,202008,512,353,159,368885,166155,535040
431470,202008,117,88,29,93005,30305,123310
431475,202008,10,8,2,8360,2090,10450
431477,202008,35,24,11,25080,11495,36575
431478,202008,9,8,1,8360,1045,9405
431480,202008,515,307,208,320815,217360,538175
431490,202008,28536,15961,12575,16702245.72,13172228.25,29874473.97
431500,202008,79,63,16,65835,16720,82555
431505,202008,25,15,10,15675,10450,26125
431507,202008,10,8,2,8360,2090,10450
431510,202008,254,180,74,188100.25,77330,265430.25
431513,202008,24,21,3,21945,3135,25080
431514,202008,5,4,1,4180,1045,5225
431515,202008,81,67,14,70015,14630,84645
431517,202008,6,4,2,4180,2090,6270
431520,202008,39,35,4,37620,4180,41800
431530,202008,1447,657,790,687610,825550,1513160
431531,202008,24,23,1,24035,1045,25080
431532,202008,34,25,9,26125,9405,35530
431535,202008,27,15,12,15675,12540,28215
431540,202008,141,119,22,124355,22990,147345
431545,202008,14,12,2,12540,2090,14630
431550,202008,348,189,159,199595,166155,365750
431555,202008,12,12,0,12540,0,12540
431560,202008,4518,3092,1426,3233232.85,1492260,4725492.85
431570,202008,816,426,390,445171,407550,852721
431575,202008,39,22,17,22990,17765,40755
431580,202008,96,63,33,65835,34485,100320
431590,202008,138,117,21,122265,21945,144210
431595,202008,19,15,4,15675,4180,19855
431600,202008,243,143,100,149435,105545,254980
431610,202008,113,82,31,85690,32395,118085
431620,202008,43,36,7,37620,7315,44935
431630,202008,130,108,22,113905,22990,136895
431640,202008,1338,848,490,886160.5,512050.5,1398211.0
431642,202008,35,33,2,34485,2090,36575
431643,202008,45,21,24,21945,25080,47025
431645,202008,313,185,128,193325,133760,327085
431647,202008,8,8,0,8360,0,8360
431650,202008,36,24,12,25080,12540,37620
431660,202008,315,202,113,211090,119130,330220
431670,202008,226,102,124,107635,129580,237215
431673,202008,3,3,0,3135,0,3135
431675,202008,25,20,5,20900,5225,26125
431680,202008,1119,821,298,860035,313500,1173535
431690,202008,4734,2841,1893,2973029.92,1983411,4956440.92
431695,202008,23,16,7,16720,7315,24035
431697,202008,2,0,2,0,2090,2090
431700,202008,178,137,41,143165,42845,186010
431710,202008,3982,1741,2241,1820390.5,2342890,4163280.5
431720,202008,1327,819,508,856378,530860,1387238
431725,202008,1,1,0,1045,0,1045
431730,202008,1157,785,372,820327.9,388740,1209067.9
431740,202008,1346,660,686,689700,716870.5,1406570.5
431750,202008,1831,1191,640,1245640.55,669845,1915485.55
431755,202008,5,4,1,4180,1045,5225
431760,202008,1029,654,375,683432,395010,1078442
431770,202008,413,297,116,310365,122265,432630
431775,202008,28,20,8,20900,8360,29260
431780,202008,545,330,215,344850.25,224675,569525.25
431790,202008,164,127,37,133760,39710,173470
431795,202008,12,10,2,10450,2090,12540
431800,202008,3195,1677,1518,1753512.7,1586311,3339823.7
431805,202008,17,15,2,15675,2090,17765
431810,202008,599,394,205,411730,216315,628045
431820,202008,325,195,130,203775,136895,340670
431830,202008,2304,1386,918,1450460.5,961400,2411860.5
431840,202008,482,321,161,335445,168245,503690
431842,202008,32,25,7,27170,7315,34485
431843,202008,11,8,3,8360,3135,11495
431844,202008,19,14,5,14630,5225,19855
431845,202008,27,25,2,26125,2090,28215
431846,202008,26,22,4,22990,4180,27170
431848,202008,11,9,2,9405,2090,11495
431849,202008,7,6,1,6270,1045,7315
431850,202008,786,635,151,663575,157795,821370
431860,202008,114,77,37,80465,38665,119130
431861,202008,7,2,5,2090,5225,7315
431862,202008,56,38,18,39710,18810,58520
431870,202008,3483,2006,1477,2097315.75,1544510,3641825.75
431880,202008,918,672,246,702240,257070,959310
431890,202008,1310,785,525,821370.5,548625,1369995.5
431900,202008,181,128,53,133760,55385,189145
431910,202008,54,39,15,40755,15675,56430
431912,202008,42,24,18,25080,18810,43890
431915,202008,121,94,27,98230,28215,126445
431920,202008,156,113,43,118085,44935,163020
431930,202008,80,66,14,68970,15675,84645
431935,202008,3,3,0,3135,0,3135
431936,202008,12,11,1,11495,1045,12540
431937,202008,19,15,4,15675,4180,19855
431940,202008,455,304,151,317680,158840.25,476520.25
431950,202008,494,310,184,323950.5,192280,516230.5
431960,202008,731,399,332,416955.5,347985,764940.5
431970,202008,70,63,7,65835,7315,73150
431971,202008,3,3,0,3135,0,3135
431973,202008,21,17,4,17765,4180,21945
431975,202008,9,8,1,8360,1045,9405
431980,202008,210,130,80,135850,83600,219450
431990,202008,1137,612,525,639472.52,548625,1188097.52
432000,202008,1732,912,820,953041.75,858991,1812032.75
432010,202008,277,187,90,195415,95095,290510
432020,202008,170,140,30,146300,31350,177650
432023,202008,15,13,2,13585,2090,15675
432026,202008,68,62,6,64790,6270,71060
432030,202008,67,34,33,35530,34485,70015
432032,202008,19,15,4,15675,4180,19855
432035,202008,55,44,11,45980,11495,57475
432040,202008,98,67,31,70015,32395,102410
432045,202008,5,4,1,4180,1045,5225
432050,202008,83,49,34,51205,35530,86735
432055,202008,122,89,33,93005,34485,127490
432057,202008,8,6,2,6270.5,2090,8360.5
432060,202008,34,31,3,32395,3135,35530
432065,202008,32,28,4,29260,4180,33440
432067,202008,91,82,9,85690,9405,95095
432070,202008,395,303,92,316897.5,96140,413037.5
432080,202008,818,567,251,592515,263340,855855
432085,202008,9,7,2,7315,2090,9405
432090,202008,264,176,88,183920,91960,275880
432100,202008,170,112,58,117040,60610,177650
432110,202008,558,376,182,395010,190190,585200
432120,202008,949,548,401,573705.5,420090.5,993796.0
432130,202008,479,346,133,361570,140030,501600
432132,202008,22,19,3,19855,3135,22990
432135,202008,81,67,14,70015,14630,84645
432140,202008,271,212,59,221540,61655,283195
432143,202008,210,131,79,136895,82555,219450
432145,202008,278,190,88,198550,91960,290510
432146,202008,13,12,1,12540,1045,13585
432147,202008,108,59,49,61655,51205,112860
432149,202008,16,10,6,10450,6270,16720
432150,202008,881,536,345,562210.44,361570,923780.44
432160,202008,1492,770,722,804650.22,755535,1560185.22
432162,202008,4,3,1,3135,1045,4180
432163,202008,19,14,5,14630,5225,19855
432166,202008,122,89,33,93267.5,34485,127752.5
432170,202008,227,115,112,120175,117040,237215
432180,202008,546,335,211,350075,220495.5,570570.5
432183,202008,7,7,0,7315,0,7315
432185,202008,77,67,10,70015,10450,80465
432190,202008,476,281,195,293645,203775,497420
432195,202008,87,72,15,75240,15675,90915
432200,202008,407,256,151,267520,157795,425315
432210,202008,117,74,43,77330,44935,122265
432215,202008,41,37,4,38665,4180,42845
432218,202008,20,19,1,19855,1045,20900
432220,202008,660,343,317,358435,331265.29,689700.29
432225,202008,14,8,6,8360,6270,14630
432230,202008,135,92,43,96140,44935,141075
432232,202008,12,11,1,11495,1045,12540
432234,202008,3,2,1,2090,1045,3135
432235,202008,2,2,0,2090,0,2090
432237,202008,28,17,11,17765,11495,29260
432240,202008,4300,2398,1902,2505911,1989716.33,4495627.33
432250,202008,1104,722,382,755535,405460,1160995
432252,202008,46,43,3,44935,3135,48070
432253,202008,61,49,12,51205,12540,63745
432254,202008,25,11,14,11495,14630,26125
432255,202008,15,12,3,12540,3135,15675
432260,202008,814,638,176,666710.5,183920,850630.5
432270,202008,239,181,58,189145,60610,249755
432280,202008,138,105,33,109725,34485,144210
432285,202008,2,2,0,2090,0,2090
432290,202008,66,57,9,59565,9405,68970
432300,202008,4687,2553,2134,2676177.07,2240480.5,4916657.57
432310,202008,129,105,24,109725,25080,134805
432320,202008,22,17,5,17765,5225,22990
432330,202008,19,13,6,13585,6270,19855
432335,202008,8,6,2,6270,2090,8360
432340,202008,39,33,6,34485,6270,40755
432345,202008,102,70,32,73150,33440,106590
432350,202008,20,19,1,19855,1045,20900
432360,202008,6,5,1,5225,1045,6270
432370,202008,24,23,1,24035,1045,25080
432375,202008,30,27,3,28215,3135,31350
432377,202008,8,8,0,8360,0,8360
432380,202008,170,75,95,78375,99275,177650
500020,202008,240,130,110,135850,114950,250800
500025,202008,138,69,69,72105,72105,144210
500060,202008,1443,905,538,946770.5,564300.5,1511071.0
500070,202008,793,375,418,391875.29,436810.78,828686.07
500080,202008,130,103,27,107635,29260,136895
500085,202008,135,111,24,115995.5,25080,141075.5
500090,202008,350,158,192,165110,200640,365750
500100,202008,721,376,345,392920,360526,753446
500110,202008,2261,1055,1206,1102475.5,1261315.75,2363791.25
500124,202008,262,144,118,150480,123310,273790
500150,202008,342,137,205,143165,214225,357390
500190,202008,515,352,163,367840,170335.5,538175.5
500200,202008,188,161,27,168245.2,28215,196460.2
500210,202008,1556,539,1017,565345,1063810.25,1629155.25
500215,202008,245,138,107,144210,111815,256025
500220,202008,742,481,261,503690.77,273790,777480.77
500230,202008,244,150,94,156750,98230,254980
500240,202008,668,459,209,480700.4,218405.5,699105.9
500260,202008,594,230,364,240350,380380,620730
500270,202008,30048,12792,17256,13386859.79,18055516.13,31442375.92
500280,202008,202,70,132,73150,137940,211090
500290,202008,1171,708,463,739860.5,484880,1224740.5
500295,202008,435,281,154,293645.5,161975,455620.5
500310,202008,77,25,52,26125,54340,80465
500315,202008,744,430,314,449350,328130,777480
500320,202008,3582,1773,1809,1856966.04,1898765,3755731.04
500325,202008,935,502,433,525636,454575.5,980211.5
500330,202008,1498,707,791,738815.5,827640,1566455.5
500345,202008,308,234,74,244530.5,77330,321860.5
500348,202008,254,148,106,154660,110770,265430
500350,202008,117,55,62,57475,64790,122265
500370,202008,5583,2490,3093,2605186,3237411,5842597
500375,202008,346,246,100,257070,105545,362615
500380,202008,587,333,254,347985,266475,614460
500390,202008,76,37,39,38665,41800,80465
500400,202008,217,140,77,146300,80465,226765
500410,202008,543,223,320,233035,334400,567435
500430,202008,516,366,150,383515,156750,540265
500440,202008,194,101,93,105545,98230,203775
500450,202008,398,171,227,178695,237215,415910
500460,202008,269,144,125,150480,130625,281105
500470,202008,434,343,91,360525.5,96140,456665.5
500480,202008,101,61,40,63745,41800,105545
500490,202008,105,45,60,47025,62700,109725
500500,202008,1437,521,916,544445,959310,1503755
500510,202008,43,35,8,36575,8360,44935
500515,202008,101,70,31,73150,32395,105545
500520,202008,314,168,146,175560,154660.5,330220.5
500525,202008,89,49,40,51205,41800,93005
500540,202008,888,385,503,402325,529815.5,932140.5
500560,202008,937,524,413,548625,432631,981256
500568,202008,982,558,424,584155,443080.5,1027235.5
500570,202008,1191,695,496,727321,520410,1247731
500580,202008,337,172,165,179740,173470,353210
500600,202008,339,164,175,171380,183920,355300
500620,202008,894,628,266,657305.42,277970,935275.42
500625,202008,77,61,16,63745,16720,80465
500627,202008,21,10,11,10450,11495,21945
500630,202008,1568,874,694,914377.45,728365.12,1642742.57
500635,202008,517,311,206,324995,216315,541310
500640,202008,382,202,180,212135,188100,400235
500660,202008,5500,2013,3487,2105676.18,3646006,5751682.18
500690,202008,602,207,395,216315,412775,629090
500710,202008,402,207,195,217360,204820,422180
500720,202008,944,545,399,569526.23,418000,987526.23
500730,202008,191,116,75,121220,79420,200640
500740,202008,890,374,516,390830,542355,933185
500750,202008,141,45,96,47025,100320,147345
500755,202008,122,89,33,94050.5,34485,128535.5
500769,202008,749,409,340,427405.5,357390,784795.5
500770,202008,411,217,194,226765,202730,429495
500780,202008,153,100,53,104500,55385,159885
500790,202008,1069,541,528,566390,553850,1120240
500793,202008,279,149,130,155705,135850.5,291555.5
500795,202008,175,120,55,125400,58520,183920
500797,202008,51,36,15,37620,15675,53295
500800,202008,437,192,245,200640,257070,457710
500830,202008,2233,1248,985,1305205,1030370,2335575
500840,202008,135,101,34,105545,35530,141075
510010,202008,171,90,81,94050,84645,178695
510020,202008,505,223,282,233035,295735,528770
510025,202008,1686,963,723,1006335,757625.5,1763960.5
510030,202008,667,346,321,362615,336490.5,699105.5
510035,202008,125,62,63,64790,65835,130625
510040,202008,401,185,216,193325,225720.3,419045.3
510050,202008,406,217,189,226765,197505.73,424270.73
510060,202008,119,59,60,61655,62700,124355
510080,202008,231,88,143,91960,149435,241395
510100,202008,64,27,37,28215,38665,66880
510120,202008,38,23,15,24035,15675,39710
510125,202008,386,239,147,249755,153615,403370
510130,202008,549,318,231,334400,244530.5,578930.5
510140,202008,427,124,303,129580,316635,446215
510160,202008,112,37,75,38665,78375,117040
510170,202008,796,481,315,503690.03,329175,832865.03
510180,202008,2934,1381,1553,1445236,1630201.25,3075437.25
510185,202008,19,8,11,8360,11495,19855
510190,202008,228,81,147,84645,153615,238260
510250,202008,2592,1530,1062,1599896,1112926,2712822
510260,202008,175,128,47,133760,49115,182875
510263,202008,467,263,204,275880.5,215270,491150.5
510267,202008,675,378,297,395010.5,310365,705375.5
510268,202008,62,28,34,29260,35530,64790
510269,202008,74,34,40,35530,41800,77330
510270,202008,384,194,190,202730,199595,402325
510279,202008,217,162,55,169290,57475,226765
510285,202008,181,73,108,76285,112860,189145
510300,202008,515,270,245,282150,257070,539220
510305,202008,207,99,108,103455,112860,216315
510310,202008,106,54,52,56430,54340,110770
510320,202008,852,537,315,561165,329175,890340
510325,202008,409,170,239,177650,249755,427405
510330,202008,429,238,191,248710,199595,448305
510335,202008,641,365,276,382470,288420,670890
510336,202008,56,39,17,40755,17765,58520
510337,202008,106,46,60,49115,62700,111815
510340,202008,17265,7815,9450,8184441.29,9895107.46,18079548.75
510343,202008,64,45,19,47025,19855,66880
510345,202008,161,105,56,109725,58520.5,168245.5
510350,202008,645,357,288,373065,300960.5,674025.5
510360,202008,201,123,78,128535,81510,210045
510370,202008,148,71,77,75240,80465,155705
510380,202008,86,64,22,66880,22990,89870
510385,202008,61,27,34,28215,35530,63745
510390,202008,108,47,61,49115,63745,112860
510395,202008,46,34,12,35530,13585,49115
510410,202008,710,466,244,488015,254980,742995
510420,202008,570,275,295,287375,309320,596695
510450,202008,49,24,25,25080,26125,51205
510452,202008,51,24,27,25080,28215,53295
510454,202008,52,24,28,25080,29260,54340
510455,202008,136,80,56,83600,58520,142120
510460,202008,177,83,94,86735,98230,184965
510480,202008,722,423,299,442035.2,312455,754490.2
510490,202008,352,178,174,186010,181830,367840
510500,202008,238,179,59,187055,61655,248710
510510,202008,784,462,322,484880.5,337535.5,822416.0
510515,202008,1219,634,585,662530,612370,1274900
510517,202008,258,111,147,115995,153615,269610
510520,202008,233,149,84,155705,87780,243485
510523,202008,99,76,23,79420,24035,103455
510525,202008,806,481,325,503690,340670,844360
510530,202008,20,14,6,14630,6270,20900
510550,202008,246,110,136,114950,142120,257070
510558,202008,288,142,146,148390,153615,302005
510560,202008,415,243,172,254980.5,179740,434720.5
510562,202008,648,469,179,490105,187055,677160
510590,202008,757,392,365,409640,381425,791065
510600,202008,237,124,113,129580,118085,247665
510610,202008,203,84,119,87780,124355,212135
510615,202008,183,83,100,86735,104500,191235
510617,202008,18,9,9,9405,9405,18810
510618,202008,119,57,62,59565,64790,124355
510619,202008,96,67,29,70015,30305,100320
510620,202008,171,95,76,99275,79420,178695
510621,202008,178,114,64,119130,66880,186010
510622,202008,499,304,195,317680,203775,521455
510623,202008,323,223,100,234080,106590,340670
510624,202008,92,45,47,48070,49115,97185
510625,202008,529,327,202,341715,211090.29,552805.29
510626,202008,113,69,44,72105,45980,118085
510627,202008,72,51,21,53295,21945,75240
510628,202008,149,89,60,93005,62700,155705
510629,202008,262,160,102,167200,106609,273809
510630,202008,436,225,211,236170,222585,458755
510631,202008,12,3,9,3135,9405,12540
510637,202008,347,198,149,207955,155705,363660
510642,202008,995,531,464,554895,485925,1040820
510645,202008,2,0,2,0,2090,2090
510650,202008,1411,924,487,966625.5,511005,1477630.5
510665,202008,81,36,45,37620,47025,84645
510670,202008,58,33,25,34485,26125,60610
510675,202008,1147,724,423,757625.5,442035,1199660.5
510677,202008,345,176,169,183920,176605,360525
510680,202008,107,60,47,62700,49115,111815
510682,202008,200,103,97,108680,101365,210045
510685,202008,55,41,14,42845,14630,57475
510700,202008,580,333,247,349030,259160,608190
510704,202008,1160,609,551,636405,578930,1215335
510706,202008,136,67,69,70015,72105,142120
510710,202008,380,266,114,279015,119130,398145
510715,202008,59,41,18,42845,18810,61655
510718,202008,208,104,104,109725,108680,218405
510719,202008,39,17,22,17765,22990,40755
510720,202008,189,129,60,134805,63745,198550
510724,202008,85,33,52,34485,54340,88825
510726,202008,50,26,24,27170,25080,52250
510729,202008,66,30,36,31350,37620,68970
510730,202008,477,264,213,275880,222585,498465
510735,202008,117,48,69,50160,72105,122265
510740,202008,20,11,9,11495,10450,21945
510757,202008,24,19,5,19855,5225,25080
510760,202008,7164,3676,3488,3847691.5,3651232.04,7498923.54
510770,202008,685,323,362,338580,379335,717915
510774,202008,18,7,11,7315,11495,18810
510775,202008,104,80,24,83600,25080,108680
510776,202008,27,10,17,10450,17765,28215
510777,202008,194,83,111,86735,115995,202730
510779,202008,51,23,28,24035,29260,53295
510780,202008,284,158,126,165110,131670,296780
510785,202008,390,212,178,221540,186010,407550
510787,202008,196,94,102,98230,106590,204820
510788,202008,4,0,4,0,4180,4180
510790,202008,2489,1304,1185,1363774.75,1239370,2603144.75
510792,202008,1151,643,508,672980,535040.66,1208020.66
510794,202008,113,61,52,63745,54340,118085
510795,202008,2341,1362,979,1425380.5,1026191,2451571.5
510800,202008,174,104,70,108680,74195,182875
510805,202008,181,118,63,123310,65835,189145
510810,202008,96,43,53,44935,56430,101365
510820,202008,237,119,118,124355.45,123310.12,247665.57
510830,202008,72,42,30,43890,31350,75240
510835,202008,14,9,5,9405,5225,14630
510840,202008,9113,4335,4778,4535303.5,5003460.5,9538764.0
510850,202008,221,90,131,94050,136895,230945
510860,202008,378,169,209,176605,218405.5,395010.5
510880,202008,67,50,17,52250,17765,70015
510885,202008,71,40,31,41800,32395,74195
510890,202008,67,38,29,39710,30305,70015
510895,202008,174,104,70,108680,73150.5,181830.5
520005,202008,119,50,69,52250,72105,124355
520010,202008,283,129,154,134805,160930.5,295735.5
520013,202008,716,459,257,481466.32,268565,750031.32
520015,202008,53,39,14,40755,14630,55385
520017,202008,86,48,38,50160.5,39710,89870.5
520020,202008,19,10,9,10450,9405,19855
520025,202008,2252,1164,1088,1217425.5,1142185,2359610.5
520030,202008,803,422,381,440990.5,398145,839135.5
520050,202008,69,48,21,50160,21945,72105
520055,202008,53,34,19,35530,19855,55385
520060,202008,175,115,60,120175,62700,182875
520080,202008,587,421,166,439945,173470,613415
520082,202008,18,12,6,12540,6270,18810
520085,202008,91,68,23,71060,24035,95095
520090,202008,94,63,31,65835,32395,98230
520110,202008,9249,3960,5289,4141336,5533277.5,9674613.5
520120,202008,13,8,5,8360,5225,13585
520130,202008,804,561,243,586245,253935.5,840180.5
520140,202008,12000,6649,5351,6959703,5605380.8,12565083.8
520145,202008,54,32,22,33440,22990,56430
520150,202008,163,129,34,134805,35530,170335
520160,202008,39,28,11,29260,11495,40755
520170,202008,255,149,106,155705,111815,267520
520180,202008,164,78,86,81510,89870,171380
520215,202008,203,136,67,142120,70015,212135
520235,202008,81,62,19,64790,19855,84645
520250,202008,132,77,55,80465,57475,137940
520260,202008,115,72,43,76285,44935,121220
520280,202008,47,32,15,33440,15675,49115
520310,202008,40,27,13,28215,13585,41800
520320,202008,181,114,67,119130,70015,189145
520330,202008,783,419,364,438900,382470,821370
520340,202008,365,216,149,225720,156750,382470
520350,202008,508,236,272,246620,284240,530860
520355,202008,86,51,35,53295,37620,90915
520357,202008,25,18,7,18810,7315,26125
520360,202008,1,1,0,1045,0,1045
520380,202008,134,72,62,75240,64790,140030
520390,202008,258,107,151,112860.5,157795,270655.5
520393,202008,16,12,4,12540,4180,16720
520396,202008,75,48,27,50160,28215,78375
520400,202008,203,118,85,123310,88825,212135
520410,202008,196,96,100,102410,104500,206910
520420,202008,21,14,7,14630,7315,21945
520425,202008,286,140,146,146300,152570,298870
520430,202008,479,240,239,250896.14,251845.75,502741.89
520440,202008,695,502,193,525077.66,201685,726762.66
520450,202008,1967,851,1116,889295,1167265,2056560
520455,202008,54,31,23,32395,24035,56430
520460,202008,36,22,14,22990,15675,38665
520465,202008,32,27,5,28215,5225,33440
520470,202008,430,276,154,289465,160930,450395
520480,202008,78,47,31,49115,32395,81510
520485,202008,117,41,76,42845,79420,122265
520490,202008,411,306,105,319770,109725,429495
520495,202008,162,97,65,101365,67925,169290
520500,202008,184,144,40,150480,41800,192280
520505,202008,188,108,80,112860,83600,196460
520510,202008,1798,852,946,891386,990662.25,1882048.25
520520,202008,45,33,12,34485,12540,47025
520530,202008,226,172,54,179740,56430,236170
520540,202008,578,396,182,414865,190190,605055
520545,202008,136,82,54,85690,56430,142120
520547,202008,57,33,24,34485,25080,59565
520549,202008,1220,567,653,592515.3,684475,1276990.3
520551,202008,301,161,140,168245,148390.5,316635.5
520552,202008,41,26,15,27170,15675,42845
520570,202008,14,8,6,8360,6270,14630
520580,202008,281,173,108,180785,113905,294690
520590,202008,149,92,57,96140,59565,155705
520620,202008,1137,528,609,552805.5,638495.25,1191300.75
520630,202008,37,21,16,21945,16720,38665
520640,202008,389,225,164,235125,171380,406505
520650,202008,64,36,28,37620,29260,66880
520660,202008,44,23,21,24035,21945,45980
520670,202008,37,31,6,32395,6270,38665
520680,202008,51,34,17,35530,17765,53295
520690,202008,42,11,31,11495,32395,43890
520710,202008,33,30,3,31350,3135,34485
520725,202008,203,148,55,154660,57475,212135
520735,202008,55,37,18,38665,18810,57475
520740,202008,418,199,219,207955,228855.5,436810.5
520750,202008,34,25,9,26125,9405,35530
520753,202008,66,46,20,48070,20900,68970
520760,202008,102,68,34,71060,35530,106590
520780,202008,290,213,77,222585,80465,303050
520790,202008,162,90,72,94050,75240,169290
520800,202008,3398,1834,1564,1917575.5,1638560,3556135.5
520810,202008,158,120,38,125400,39710,165110
520815,202008,5,4,1,4180,1045,5225
520830,202008,147,100,47,105545,49115,154660
520840,202008,346,231,115,241395,120175,361570
520850,202008,102,62,40,64790,41800,106590
520860,202008,1748,1130,618,1180850.5,646855.5,1827706.0
520870,202008,31795,14977,16818,15672917.97,17611393,33284310.97
520880,202008,1162,619,543,647900.5,568480.5,1216381.0
520890,202008,791,483,308,504735,321860,826595
520910,202008,965,513,452,538175.93,472340,1010515.93
520915,202008,100,76,24,79420,25080,104500
520920,202008,415,199,216,207955,225720,433675
520929,202008,18,16,2,16720,2090,18810
520940,202008,69,46,23,48070,24035,72105
520945,202008,18,12,6,12540,6270,18810
520960,202008,45,30,15,31350,15675,47025
520970,202008,340,207,133,216315,138985,355300
520980,202008,95,69,26,72105,27170,99275
520990,202008,451,307,144,320815,151525,472340
520993,202008,126,59,67,61655,70015,131670
520995,202008,245,141,104,147345.65,108680.5,256026.15
521000,202008,1559,910,649,951995,678205.5,1630200.5
521010,202008,680,333,347,347985,362615,710600
521015,202008,14,9,5,9405,5225,14630
521020,202008,1424,1010,414,1058585,436810.5,1495395.5
521030,202008,52,36,16,37620,16720,54340
521040,202008,946,600,346,627000.25,362615.5,989615.75
521056,202008,48,33,15,34485,15675,50160
521060,202008,131,86,45,89870,47025,136895
521080,202008,418,321,97,336490,101365,437855
521090,202008,555,361,194,377245,202730,579975
521100,202008,274,206,68,215270,71060,286330
521120,202008,1068,752,316,785840.5,331265,1117105.5
521130,202008,353,252,101,263340,105545.5,368885.5
521140,202008,180,98,82,102410,85690,188100
521150,202008,2646,1148,1498,1199660,1568545,2768205
521160,202008,32,16,16,16720,16720,33440
521170,202008,210,117,93,122265,97185,219450
521180,202008,1182,758,424,794200,445170.25,1239370.25
521190,202008,2535,1071,1464,1120240,1537195.5,2657435.5
521200,202008,54,41,13,42845,13585,56430
521205,202008,11,8,3,8360,3135,11495
521210,202008,123,72,51,75240,53295,128535
521220,202008,778,540,238,565345,248710.25,814055.25
521225,202008,31,21,10,22990,10450,33440
521230,202008,106,71,35,74195,36575,110770
521250,202008,6176,3499,2677,3656459.8,2800603,6457062.8
521260,202008,28,14,14,14630,14630,29260
521270,202008,142,110,32,114950,33440,148390
521280,202008,431,263,168,274835,175560,450395
521290,202008,27,13,14,13585,14630,28215
521295,202008,97,63,34,65835,35530,101365
521300,202008,220,123,97,128535,102410.5,230945.5
521305,202008,37,26,11,27170,11495,38665
521308,202008,1073,821,252,858223.66,264385,1122608.66
521310,202008,1332,768,564,806740,590425,1397165
521340,202008,19,15,4,15675,4180,19855
521350,202008,125,94,31,98230,32395,130625
521370,202008,177,126,51,131670,53295,184965
521375,202008,176,93,83,97185,86735,183920
521377,202008,48,37,11,38665,11495,50160
521380,202008,1067,679,388,710601.05,406505,1117106.05
521385,202008,14,9,5,9405,5225,14630
521390,202008,102,84,18,87780,18810,106590
521400,202008,343,227,116,238260,121220,359480
521405,202008,147,80,67,83600,70015,153615
521410,202008,66,46,20,49115,20900,70015
521440,202008,197,142,55,148390,57475,205865
521450,202008,733,415,318,433675,332310,765985
521460,202008,1154,743,411,779570,430540,1210110
521470,202008,13,9,4,9405,4180,13585
521480,202008,42,29,13,30305,13585.25,43890.25
521483,202008,312,184,128,192280.5,133760,326040.5
521486,202008,275,179,96,187055,100320,287375
521487,202008,23,11,12,11495,12540,24035
521490,202008,24,13,11,13585,11495,25080
521500,202008,124,78,46,81510,48070,129580
521520,202008,46,33,13,34485,13585,48070
521523,202008,716,429,287,448305,302005,750310
521525,202008,47,30,17,31350,17765,49115
521530,202008,246,133,113,138985,118085,257070
521540,202008,30,16,14,16720,14630,31350
521550,202008,87,37,50,38665,52250,90915
521560,202008,818,555,263,579975.5,274835.96,854811.46
521565,202008,61,41,20,42845,21945,64790
521570,202008,524,345,179,360525.5,187055.25,547580.75
521580,202008,55,31,24,32395,25080,57475
521590,202008,35,17,18,17765,18810,36575
521600,202008,22,12,10,12540,10450,22990
521630,202008,244,132,112,137940,118085.25,256025.25
521640,202008,309,166,143,173470,149435,322905
521645,202008,31,16,15,16720,15675,32395
521680,202008,241,148,93,154660,97185,251845
521690,202008,3,3,0,3135,0,3135
521710,202008,1145,551,594,575795,622820,1198615
521720,202008,566,395,171,412775,178695.85,591470.85
521730,202008,645,310,335,323951.09,351120,675071.09
521740,202008,905,390,515,408595,538175.5,946770.5
521760,202008,1916,994,922,1038730.95,963490.5,2002221.45
521770,202008,820,520,300,543400,313500,856900
521800,202008,2010,1299,711,1357456.5,744040,2101496.5
521805,202008,33,18,15,18810,15675,34485
521810,202008,82,53,29,56430,30305,86735
521830,202008,951,681,270,711645.09,282150,993795.09
521839,202008,89,54,35,56430,36575,93005
521850,202008,1111,580,531,607145.36,554895.5,1162040.86
521860,202008,342,212,130,221540,135850,357390
521870,202008,74,44,30,45980,31350,77330
521878,202008,33,16,17,16720,17765,34485
521880,202008,4742,2120,2622,2219581.5,2746610.33,4966191.83
521890,202008,601,426,175,445170.3,182875,628045.3
521900,202008,284,233,51,243485,53295,296780
521910,202008,162,115,47,120175,49115,169290
521920,202008,46,22,24,22990,25080,48070
521925,202008,53,31,22,32395,22990,55385
521930,202008,1164,639,525,667755.5,548625,1216380.5
521935,202008,34,25,9,26125,9405,35530
521940,202008,205,98,107,102410,111815,214225
521945,202008,15,13,2,13585,2090,15675
521950,202008,8,4,4,4180,4180,8360
521960,202008,69,52,17,54340,17765,72105
521970,202008,400,256,144,268565,150480,419045
521971,202008,100,53,47,55385,49115,104500
521973,202008,34,17,17,17765,17765,35530
521975,202008,1445,723,722,757625.41,755536.47,1513161.88
521980,202008,246,167,79,174515.5,82555,257070.5
521990,202008,79,56,23,58520,24035,82555
522000,202008,290,183,107,190870.29,111815,302685.29
522005,202008,19,10,9,10450,9405,19855
522010,202008,1128,628,500,659395,522500.5,1181895.5
522015,202008,62,37,25,38665,26125,64790
522020,202008,895,519,376,542355,392920.5,935275.5
522026,202008,23,14,9,14630,9405,24035
522028,202008,15,11,4,11495,4180,15675
522040,202008,776,317,459,331265.25,481745,813010.25
522045,202008,2326,1423,903,1487037.23,945726.25,2432763.48
522050,202008,155,75,80,78375,83600,161975
522060,202008,542,341,201,359480,210045,569525
522068,202008,113,79,34,82555,35530,118085
522070,202008,10,10,0,10450,0,10450
522100,202008,37,21,16,21945,16720,38665
522108,202008,40,31,9,32395,10450,42845
522119,202008,56,31,25,32395,26125,58520
522130,202008,79,33,46,34485,48070,82555
522140,202008,4103,2128,1975,2224805.6,2068055.5,4292861.1
522145,202008,48,33,15,34485,15675,50160
522150,202008,90,67,23,70015,24035,94050
522155,202008,53,36,17,37620,17765,55385
522157,202008,5,3,2,3135,2090,5225
522160,202008,1702,1008,694,1053743.16,726275,1780018.16
522170,202008,396,267,129,279015,134805,413820
522180,202008,38,18,20,18810,20900,39710
522185,202008,2068,825,1243,862126,1302070,2164196
522190,202008,50,26,24,27170,25080,52250
522200,202008,299,178,121,186010,126445,312455
522205,202008,143,97,46,101365,48070,149435
522220,202008,149,110,39,114950,40755,155705
522230,202008,31,25,6,26125,6270,32395
530010,202008,54137,27378,26759,28660460.48,28033186.55,56693647.03
110001,202009,501,402,99,421135,104500,525635
110002,202009,2836,1757,1079,1840245.5,1129645.5,2969891.0
110003,202009,82,68,14,71060,14630,85690
110004,202009,2034,1330,704,1391941.5,736725,2128666.5
110005,202009,437,347,90,362615.5,94050,456665.5
110006,202009,447,345,102,360525.5,106590,467115.5
110007,202009,69,57,12,59565,12540,72105
110008,202009,235,134,101,141075,106590,247665
110009,202009,885,642,243,671935,253935,925870
110010,202009,1707,1051,656,1103520.25,686565,1790085.25
110011,202009,1769,1371,398,1433740,416955,1850695
110012,202009,4099,2379,1720,2493370,1798445.5,4291815.5
110013,202009,771,617,154,645810,161975,807785
110014,202009,376,327,49,341715.5,51205,392920.5
110015,202009,1380,1111,269,1164131.55,282150,1446281.55
110018,202009,1101,687,414,717915,434720,1152635
110020,202009,15520,8888,6632,9310957.56,6959702.1,16270659.66
110025,202009,629,463,166,484880.5,173470,658350.5
110026,202009,38,27,11,28215,11495,39710
110028,202009,1630,1179,451,1234145.85,471296.5,1705442.35
110029,202009,139,125,14,130625,14630,145255
110030,202009,2422,1615,807,1694823.22,846451.35,2541274.57
110032,202009,313,241,72,251845.17,75240,327085.17
110033,202009,661,483,178,504735,187055,691790
110034,202009,351,259,92,270655.67,96140,366795.67
110037,202009,98,85,13,88825,13585,102410
110040,202009,374,254,120,265430,125400,390830
110045,202009,935,641,294,670891,307230.6,978121.6
110050,202009,92,80,12,83600.5,12540,96140.5
110060,202009,67,40,27,41800,28215,70015
110070,202009,110,73,37,76285,38665,114950
110080,202009,483,265,218,277970,228855,506825
110090,202009,30,26,4,27170,4180,31350
110092,202009,100,55,45,57475,47025,104500
110094,202009,200,144,56,150480,58520,209000
110100,202009,37,28,9,29260,9405,38665
110110,202009,90,51,39,53295,40755,94050
110120,202009,66,56,10,58520,10450,68970
110130,202009,290,238,52,248710,54340,303050
110140,202009,235,164,71,171380,74195,245575
110143,202009,45,37,8,38665,8360,47025
110145,202009,26,20,6,20900,6270,27170
110146,202009,22,12,10,12540,10450,22990
110147,202009,38,27,11,28215,11495,39710
110148,202009,33,23,10,24035,10450,34485
110149,202009,315,222,93,231990,97185,329175
110150,202009,130,100,30,104500,32395,136895
110155,202009,8,7,1,7315,1045,8360
110160,202009,68,54,14,56430,14630,71060
110170,202009,222,171,51,178695,53295,231990
110175,202009,69,52,17,54340,17765,72105
110180,202009,88,73,15,76285,15675,91960
120001,202009,214,159,55,166155,57475,223630
120005,202009,197,115,82,120175,85690,205865
120010,202009,1110,694,416,725230.72,434720,1159950.72
120013,202009,142,97,45,102410.56,47025,149435.56
120017,202009,107,60,47,62700,49115,111815
120020,202009,3553,2871,682,3002286.18,714780.5,3717066.68
120025,202009,544,307,237,320815.77,247665,568480.77
120030,202009,1074,921,153,963491.36,160930,1124421.36
120032,202009,36,33,3,34485,3135,37620
120033,202009,214,188,26,196460,27170,223630
120034,202009,172,126,46,131670.5,48070,179740.5
120035,202009,39,32,7,33440,7315,40755
120038,202009,401,264,137,275880,145255,421135
120039,202009,29,28,1,29260,1045,30305
120040,202009,14087,9636,4451,10080701.36,4662790.5,14743491.86
120042,202009,43,38,5,39710,5225,44935
120043,202009,11,3,8,3135,8360,11495
120045,202009,544,347,197,362615,206910,569525
120050,202009,1280,978,302,1022010.69,315590,1337600.69
120060,202009,1474,1209,265,1263405,276925,1540330
120070,202009,430,308,122,321860.82,127490,449350.82
120080,202009,176,109,67,113905,70015,183920
130002,202009,162,117,45,122265,47025,169290
130006,202009,103,66,37,68970,38665,107635
130008,202009,133,72,61,75240,63745,138985
130010,202009,148,83,65,86735,67925,154660
130014,202009,277,201,76,210045,79420,289465
130020,202009,103,63,40,65835,42845,108680
130030,202009,960,569,391,594605,409640,1004245
130040,202009,344,173,171,180785,179740,360525
130050,202009,566,292,274,305140,287375,592515
130060,202009,850,580,270,608190,285285,893475
130063,202009,597,341,256,356345,267520,623865
130068,202009,191,121,70,126445,73150,199595
130070,202009,1324,903,421,944680.5,440990,1385670.5
130080,202009,700,460,240,480700,251845,732545
130083,202009,71,39,32,40755,33440,74195
130090,202009,331,165,166,173470,173470,346940
130100,202009,1108,473,635,494285,665665,1159950
130110,202009,736,307,429,320815,448305,769120
130115,202009,161,67,94,70015,98230,168245
130120,202009,1631,1037,594,1085755,622820,1708575
130130,202009,621,426,195,445170,204820,649990
130140,202009,1572,1234,338,1289530,354255,1643785
130150,202009,418,366,52,383515,54340,437855
130160,202009,462,265,197,276925,207955,484880
130165,202009,42,33,9,34485,9405,43890
130170,202009,974,667,307,697993.12,328130,1026123.12
130180,202009,233,176,57,183920,60610,244530
130185,202009,2317,1072,1245,1122330,1304161,2426491
130190,202009,3419,2161,1258,2260335.5,1325060,3585395.5
130195,202009,278,222,56,231990,58520,290510
130200,202009,175,78,97,81510,103455,184965
130210,202009,76,38,38,39710,40755,80465
130220,202009,179,122,57,127490,59565,187055
130230,202009,379,246,133,257070,141075,398145
130240,202009,1326,835,491,874665,514140,1388805
130250,202009,4696,3002,1694,3145450,1777545,4922995
130255,202009,422,198,224,206910,235125,442035
130260,202009,57118,26863,30255,28127144.83,31687541.5,59814686.33
130270,202009,1542,1045,497,1097344.05,522500,1619844.05
130280,202009,122,69,53,72105,55385,127490
130290,202009,2118,1473,645,1541375,674025,2215400
130300,202009,433,304,129,317680,134805,452485
130310,202009,925,488,437,509960,457710,967670
130320,202009,521,277,244,290510,256025,546535
130330,202009,757,470,287,493240,300960,794200
130340,202009,3518,2014,1504,2104631,1576905.5,3681536.5
130350,202009,485,324,161,339625,172425,512050
130353,202009,938,402,536,420090,561165,981255
130356,202009,814,364,450,382470,470250,852720
130360,202009,89,66,23,68970,24035,93005
130370,202009,709,548,161,574750,169290,744040
130380,202009,687,526,161,549670,170335,720005
130390,202009,487,393,94,411730,99275,511005
130395,202009,162,38,124,39710,129580,169290
130400,202009,66,44,22,45980,22990,68970
130406,202009,2089,1261,828,1318790.5,866305,2185095.5
130410,202009,443,208,235,217360,246620,463980
130420,202009,2932,2386,546,2495460.75,577885,3073345.75
130423,202009,154,80,74,83600,77330,160930
130426,202009,161,83,78,86735,81510,168245
130430,202009,410,256,154,267520,160930,428450
130440,202009,196,62,134,64790,140030,204820
140002,202009,34,10,24,10450,25080,35530
140005,202009,201,122,79,129580,82555,212135
140010,202009,10365,6597,3768,6900140.2,3945922.15,10846062.35
140015,202009,125,55,70,57475,73150,130625
140017,202009,124,77,47,80465,49115,129580
140020,202009,471,308,163,322905,171380,494285
140023,202009,51,22,29,22990.35,30305,53295.35
140028,202009,22,12,10,12540,10450,22990
140030,202009,346,241,105,254980,110770,365750
140040,202009,65,42,23,43890,24035,67925
140045,202009,252,97,155,101365,161975,263340
140047,202009,634,407,227,425315.5,238260,663575.5
140050,202009,156,95,61,99275,63745,163020
140060,202009,49,34,15,35530,15675,51205
140070,202009,32,29,3,30305,3135,33440
150010,202009,4679,2851,1828,2983475.5,1929070.5,4912546.0
150013,202009,159,110,49,114950,52250,167200
150020,202009,1090,583,507,610280,530860,1141140
150030,202009,666,277,389,291555,407550,699105
150034,202009,199,124,75,130625,78375,209000
150040,202009,1473,843,630,880935,661485,1542420
150050,202009,665,374,291,391875,306185,698060
150060,202009,4837,3064,1773,3204927,1864712.63,5069639.63
150070,202009,349,162,187,170335,197505,367840
150080,202009,15063,7084,7979,7413233.2,8357914.5,15771147.7
150085,202009,429,267,162,281105,169290,450395
150090,202009,726,612,114,641630,120175,761805
150095,202009,362,226,136,236170,142120,378290
150100,202009,61,39,22,40755,22990,63745
150110,202009,203,105,98,109725,103455,213180
150120,202009,407,293,114,306185,119130,425315
150125,202009,46,17,29,17765,30305,48070
150130,202009,1999,1059,940,1111880,989615,2101495
150140,202009,54660,24695,29965,25861809.03,31403302.21,57265111.24
150145,202009,202,107,95,111815,99275,211090
150150,202009,2948,1280,1668,1338645,1744106,3082751
150157,202009,388,273,115,286330.5,120175,406505.5
150160,202009,129,99,30,104500,31350,135850
150170,202009,3633,2699,934,2823590,979165,3802755
150172,202009,337,232,105,244530,111815,356345
150175,202009,79,48,31,50160,32395,82555
150178,202009,764,502,262,526680,274835,801515
150180,202009,3161,1547,1614,1616615.25,1690810.5,3307425.75
150190,202009,343,216,127,225720.5,132715,358435.5
150195,202009,109,57,52,59565,54340,113905
150200,202009,195,92,103,96140,107635,203775
150210,202009,3121,2510,611,2626085,642675,3268760
150215,202009,553,356,197,372020.5,207955,579975.5
150220,202009,3623,2415,1208,2526811.32,1266540.6,3793351.92
150230,202009,1184,952,232,995885.37,244530,1240415.37
150240,202009,6305,3579,2726,3743190.6,2854940,6598130.6
150250,202009,43,19,24,19855,26125,45980
150260,202009,88,57,31,59565.43,32395,91960.43
150270,202009,2220,1441,779,1507935,819280.5,2327215.5
150275,202009,523,328,195,343805,204820,548625
150276,202009,107,42,65,43890,67925,111815
150277,202009,780,335,445,350075,466070,816145
150280,202009,355,231,124,241395,129580,370975
150285,202009,102,52,50,54340,52250,106590
150290,202009,981,582,399,608190,418000.5,1026190.5
150293,202009,669,312,357,327085,374110,701195
150295,202009,500,225,275,235125,288420,523545
150300,202009,79,37,42,38665,44935,83600
150304,202009,174,104,70,108680,73150,181830
150307,202009,393,323,70,337535,73150,410685
150309,202009,572,409,163,427405,171380,598785
150310,202009,239,157,82,165110,86735,251845
150320,202009,1904,1324,580,1383580.27,606100,1989680.27
150330,202009,2023,1171,852,1226830,895565,2122395
150340,202009,197,130,67,135850,70015,205865
150345,202009,629,345,284,361570,298870,660440
150350,202009,405,315,90,332310,94050,426360
150360,202009,4649,2870,1779,3011690.75,1864280,4875970.75
150370,202009,816,554,262,581020.5,276925,857945.5
150375,202009,197,91,106,95095,110770,205865
150380,202009,1475,977,498,1022010,523545,1545555
150390,202009,795,461,334,482790,350075,832865
150400,202009,107,89,18,93005,18810,111815
150405,202009,1234,784,450,819280.3,471295,1290575.3
150410,202009,121,78,43,81510,44935,126445
150420,202009,7307,3938,3369,4118516.5,3535235.5,7653752.0
150430,202009,604,384,220,401280,230945,632225
150440,202009,589,365,224,381425,235125,616550
150442,202009,2306,1221,1085,1280126,1138005,2418131
150445,202009,537,346,191,361570,202730,564300
150450,202009,226,119,107,124355,111815,236170
150460,202009,736,547,189,572660,198550,771210
150470,202009,1302,780,522,816145,550715,1366860
150475,202009,228,174,54,181830,56430,238260
150480,202009,1300,899,401,940500,421135,1361635
150490,202009,670,397,273,414865,288420,703285
150495,202009,332,246,86,257070,91960,349030
150497,202009,276,190,86,198550,90915,289465
150500,202009,221,137,84,143165,87780,230945
150503,202009,1020,503,517,525635.5,542355,1067990.5
150506,202009,922,614,308,641630,322905,964535
150510,202009,1247,689,558,720005.5,586245,1306250.5
150520,202009,281,183,98,191235,102410,293645
150530,202009,1710,938,772,981255.25,811965.5,1793220.75
150540,202009,223,162,61,170335,64790,235125
150543,202009,828,426,402,445170,421135.5,866305.5
150548,202009,468,333,135,349030,142120,491150
150549,202009,60,42,18,43890,18810,62700
150550,202009,2922,1473,1449,1541375.75,1517340,3058715.75
150553,202009,3328,1881,1447,1977142,1516295,3493437
150555,202009,145,77,68,80465,72105,152570
150560,202009,32,14,18,14630,18810,33440
150563,202009,93,47,46,49115,48070,97185
150565,202009,188,112,76,117040,79420,196460
150570,202009,426,284,142,296780,149435,446215
150580,202009,1663,797,866,832865,909150,1742015
150590,202009,804,534,270,558030,288420,846450
150600,202009,469,281,188,294690,198550,493240
150610,202009,144,119,25,124355,26125,150480
150611,202009,120,82,38,85690,39710,125400
150613,202009,3222,1913,1309,2001175,1375220.5,3376395.5
150616,202009,526,302,224,315590,234080,549670
150618,202009,1323,698,625,731500,654170,1385670
150619,202009,389,294,95,308275,99275,407550
150620,202009,1254,728,526,761805,554895,1316700
150630,202009,310,200,110,209000,114950,323950
150635,202009,457,190,267,198550,279015,477565
150640,202009,52,27,25,28215,27170,55385
150650,202009,2370,1370,1000,1432695.5,1046045.5,2478741.0
150655,202009,239,179,60,187055,62700,249755
150658,202009,85,48,37,50160,38665,88825
150660,202009,537,351,186,366795,194370,561165
150670,202009,1064,370,694,389785,727320,1117105
150680,202009,10047,5237,4810,5478936.19,5031675,10510611.19
150690,202009,19,10,9,10450,9405,19855
150700,202009,478,313,165,328130,172425,500555
150710,202009,282,151,131,158840,136895,295735
150715,202009,813,504,309,527725,324995,852720
150720,202009,411,317,94,332310.5,98230,430540.5
150730,202009,1021,513,508,536085,531905,1067990
150740,202009,231,152,79,158840,82555,241395
150745,202009,784,430,354,451440,370975,822415
150746,202009,62,35,27,36575,28215,64790
150747,202009,227,172,55,179740,57475,237215
150750,202009,135,76,59,79420,61655,141075
150760,202009,1823,1185,638,1241460.62,669845,1911305.62
150770,202009,393,216,177,225720,184965,410685
150775,202009,101,47,54,49115,56430,105545
150780,202009,196,110,86,114950,89870,204820
150790,202009,868,488,380,511005,399190,910195
150795,202009,1508,895,613,936320,644765,1581085
150796,202009,353,202,151,211090,160930,372020
150797,202009,333,163,170,170335,178695,349030
150800,202009,1484,843,641,883025,676115,1559140
150803,202009,548,443,105,462935,110770,573705
150805,202009,201,119,82,124355,85690,210045
150808,202009,986,532,454,556985.5,476520,1033505.5
150810,202009,3249,2214,1035,2320945.97,1087845.5,3408791.47
150812,202009,435,222,213,233035,224675,457710
150815,202009,1038,647,391,678205,409640,1087845
150820,202009,1532,911,621,954085,656260,1610345
150830,202009,737,541,196,567435,205865,773300
150835,202009,203,118,85,123310,89870,213180
150840,202009,1377,839,538,879890,564300,1444190
160005,202009,62,43,19,44935,19855,64790
160010,202009,194,126,68,131670,71060,202730
160015,202009,129,76,53,79420,55385,134805
160020,202009,135,76,59,79420,62700,142120
160021,202009,59,25,34,26125,35530,61655
160023,202009,69,45,24,47025,25080,72105
160025,202009,23,11,12,11495,12540,24035
160027,202009,1484,840,644,879890.25,674025,1553915.25
160030,202009,15868,8123,7745,8510483.1,8132190.5,16642673.6
160040,202009,295,170,125,177650,131670,309320
160050,202009,713,362,351,378290,368885,747175
160053,202009,281,167,114,174515,119130,293645
160055,202009,27,18,9,18810,9405,28215
160060,202009,6523,3436,3087,3601071.25,3238455.5,6839526.75
160070,202009,177,103,74,107635,77330,184965
160080,202009,107,51,56,53295,59565,112860
170025,202009,29,15,14,15675,14630,30305
170030,202009,211,171,40,178695.62,41800,220495.62
170035,202009,222,106,116,111815,123310,235125
170040,202009,179,133,46,140030,48070,188100
170070,202009,322,199,123,207955,129580,337535
170100,202009,352,258,94,269610,99275,368885
170105,202009,57,45,12,47025,12540,59565
170110,202009,117,71,46,74195,48070,122265
170130,202009,69,33,36,34485,37620,72105
170190,202009,99,59,40,61655,41800,103455
170200,202009,376,257,119,268565,124355,392920
170210,202009,6128,3228,2900,3379279.63,3045132.43,6424412.06
170215,202009,114,48,66,51205,72105,123310
170220,202009,1386,1015,371,1061720,388740.12,1450460.12
170230,202009,151,100,51,104500,54340,158840
170240,202009,520,348,172,364705,181830,546535
170255,202009,1087,883,204,922735,213180,1135915
170270,202009,46,33,13,34485,13585,48070
170290,202009,114,77,37,80465,38665,119130
170300,202009,96,62,34,64790,35530,100320
170305,202009,48,37,11,38665,11495,50160
170307,202009,63,49,14,51205,14630,65835
170310,202009,118,66,52,68970,54340,123310
170320,202009,27,17,10,17765,10450,28215
170330,202009,27,24,3,25080,3135,28215
170360,202009,31,18,13,18810,13585,32395
170370,202009,102,50,52,52250,55385,107635
170380,202009,74,56,18,58520,18810,77330
170382,202009,43,36,7,37620,7315,44935
170384,202009,140,109,31,113905,32395,146300
170386,202009,68,26,42,27170,43890,71060
170388,202009,48,19,29,19855,30305,50160
170389,202009,26,21,5,21945,5225,27170
170390,202009,70,40,30,41800,31350,73150
170410,202009,33,26,7,27170,7315,34485
170460,202009,16,10,6,10450,6270,16720
170510,202009,38,29,9,30305,9405,39710
170550,202009,1556,905,651,946770,684475,1631245
170555,202009,109,79,30,82555,31350,113905
170560,202009,108,75,33,79420,34485,113905
170600,202009,38,16,22,16720,22990,39710
170610,202009,196,102,94,106590,98230.5,204820.5
170625,202009,35,20,15,20900,15675,36575
170650,202009,79,57,22,59565,22990,82555
170700,202009,585,439,146,458755.25,152570,611325.25
170710,202009,159,100,59,104500,62700,167200
170720,202009,90,72,18,75240,18810,94050
170730,202009,85,50,35,52250,37620,89870
170740,202009,86,60,26,62700,27170,89870
170755,202009,61,33,28,34485,30305,64790
170765,202009,141,76,65,79420,67925,147345
170770,202009,207,130,77,135850.5,80465,216315.5
170820,202009,609,406,203,424270,215270.5,639540.5
170825,202009,37,20,17,20900,17765,38665
170830,202009,83,68,15,71060,15675,86735
170900,202009,183,141,42,147345,43890,191235
170930,202009,905,485,420,506825.8,439945.5,946771.3
170950,202009,3126,1423,1703,1491215,1785905.88,3277120.88
170980,202009,15,10,5,10450,5225,15675
171050,202009,146,113,33,119130,34485,153615
171070,202009,38,31,7,32395,7315,39710
171090,202009,46,34,12,35530,12540,48070
171110,202009,23,16,7,16720,7315,24035
171150,202009,41,22,19,22990,19855,42845
171180,202009,27,14,13,14630,13585,28215
171190,202009,153,87,66,90915,70015,160930
171195,202009,65,56,9,58520,9405,67925
171200,202009,50,25,25,26125,26125,52250
171215,202009,4,3,1,3135,1045,4180
171240,202009,60,42,18,43890,18810,62700
171245,202009,57,48,9,50160,9405,59565
171250,202009,75,43,32,44935,33440,78375
171270,202009,16,11,5,11495,5225,16720
171280,202009,41,36,5,37620,5225,42845
171320,202009,990,569,421,596381.5,443080,1039461.5
171330,202009,427,212,215,222585,225720,448305
171360,202009,87,62,25,64790,26125,90915
171370,202009,36,18,18,18810,18810,37620
171380,202009,130,112,18,117040,19855,136895
171395,202009,53,33,20,34485,20900,55385
171420,202009,281,182,99,190190,104500,294690
171430,202009,72,58,14,61655,14630,76285
171488,202009,178,99,79,103455,82555,186010
171500,202009,57,34,23,35530,24035,59565
171510,202009,71,45,26,47025,27170,74195
171515,202009,44,35,9,36575,9405,45980
171525,202009,30,28,2,29260,2090,31350
171550,202009,13,9,4,9405,4180,13585
171570,202009,52,27,25,28215,26125,54340
171575,202009,308,201,107,210045,113905,323950
171610,202009,1751,886,865,929005,907060,1836065
171620,202009,138,95,43,100320,44935,145255
171630,202009,54,27,27,28215,28215,56430
171650,202009,300,206,94,215270,100320,315590
171660,202009,267,151,116,157795,121220.5,279015.5
171665,202009,62,42,20,43890,20900,64790
171670,202009,431,259,172,270655.25,180785,451440.25
171700,202009,64,58,6,60610,6270,66880
171720,202009,28,10,18,10450,18810,29260
171750,202009,101,52,49,54340,51205,105545
171780,202009,71,56,15,58520,15675,74195
171790,202009,81,68,13,71060,13585,84645
171800,202009,32,23,9,24035,9405,33440
171820,202009,2095,1194,901,1249820.46,942590.5,2192410.96
171830,202009,33,26,7,27170,7315,34485
171840,202009,65,42,23,43890,24035,67925
171845,202009,31,19,12,19855,12540,32395
171850,202009,40,30,10,31350,10450,41800
171855,202009,78,60,18,62700,18810,81510
171865,202009,7,6,1,6270,1045,7315
171870,202009,34,24,10,25080,10450,35530
171875,202009,79,56,23,58520,24035,82555
171880,202009,35,22,13,22990,13585,36575
171884,202009,50,27,23,28215,24035,52250
171886,202009,135,54,81,56430,85690,142120
171888,202009,31,25,6,26125,6270,32395
171889,202009,18,12,6,12540,6270,18810
171890,202009,56,48,8,50160,8360,58520
171900,202009,34,25,9,26125,9405,35530
172000,202009,40,31,9,32395,9405,41800
172010,202009,51,41,10,42845,10450,53295
172015,202009,27,17,10,17765.45,10450,28215.45
172020,202009,139,87,52,90915,54340,145255
172025,202009,39,26,13,27170,14630,41800
172030,202009,42,24,18,25080,18810,43890
172049,202009,84,55,29,57475,30305,87780
172065,202009,138,90,48,95095,51205,146300
172080,202009,107,70,37,73150,38665,111815
172085,202009,27,14,13,14630,13585,28215
172090,202009,428,326,102,340670.03,108680,449350.03
172093,202009,14,12,2,12540,2090,14630
172097,202009,19,12,7,12540,7315,19855
172100,202009,5078,2869,2209,3008555.75,2313630.7,5322186.45
172110,202009,78,48,30,50160,31350,81510
172120,202009,1650,1385,265,1450462.45,276925,1727387.45
172125,202009,11,10,1,10450,1045,11495
172130,202009,22,13,9,13585,9405,22990
172208,202009,203,123,80,128535,83600,212135
172210,202009,384,185,199,193325,210045,403370
210005,202009,2983,1868,1115,1954150.15,1170404,3124554.15
210010,202009,160,91,69,95095,73150,168245
210015,202009,40,29,11,30305,11495,41800
210020,202009,359,198,161,206910,169290,376200
210030,202009,329,215,114,224675,120175,344850
210040,202009,140,111,29,115995,30305,146300
210043,202009,252,191,61,199595,64790,264385
210047,202009,523,315,208,330220,220495,550715
210050,202009,286,210,76,219450,79420,298870
210055,202009,49,39,10,40755,10450,51205
210060,202009,542,434,108,454575,113905,568480
210070,202009,418,319,99,333355,103455,436810
210080,202009,124,111,13,115995,13585,129580
210083,202009,298,146,152,152570,159885,312455
210087,202009,3,2,1,2090,1045,3135
210090,202009,445,319,126,334400,131670,466070
210095,202009,436,331,105,345895,109725,455620
210100,202009,706,548,158,573705,166155,739860
210110,202009,122,78,44,81510,47025,128535
210120,202009,5063,3952,1111,4135067.35,1172490.12,5307557.47
210125,202009,195,119,76,125400,81510,206910
210130,202009,475,270,205,283195,217360,500555
210135,202009,26,19,7,19855,7315,27170
210140,202009,4370,3410,960,3567630,1003200,4570830
210150,202009,376,238,138,248710,144210,392920
210160,202009,3282,2787,495,2914506.36,519365,3433871.36
210170,202009,1157,929,228,971850,238260,1210110
210173,202009,126,110,16,114950,17765,132715
210177,202009,360,203,157,213180,164065,377245
210180,202009,31,17,14,17765,14630,32395
210190,202009,437,289,148,302005,154660,456665
210193,202009,2,2,0,2090,0,2090
210197,202009,73,53,20,55385,20900,76285
210200,202009,613,511,102,535040,109725,644765
210203,202009,228,155,73,161975,78375,240350
210207,202009,366,301,65,314545,67925,382470
210210,202009,748,691,57,722095,59565,781660
210215,202009,74,67,7,70015,7315,77330
210220,202009,388,328,60,342760,62700,405460
210230,202009,310,247,63,258115,65835,323950
210232,202009,1385,941,444,983345,469205,1452550
210235,202009,169,128,41,133760,42845,176605
210237,202009,37,23,14,24035,14630,38665
210240,202009,88,76,12,79420,12540,91960
210250,202009,181,154,27,160930,28215,189145
210255,202009,354,265,89,277970,93005,370975
210260,202009,398,273,125,286330,130625,416955
210270,202009,654,437,217,456665,227810,684475
210275,202009,76,60,16,62700,16720,79420
210280,202009,1048,699,349,730455.7,366795,1097250.7
210290,202009,534,358,176,374110,184965,559075
210300,202009,5335,3365,1970,3523741.46,2070145.2,5593886.66
210310,202009,113,78,35,81510,36575,118085
210312,202009,117,79,38,82555,40755,123310
210315,202009,110,91,19,95095,20900,115995
210317,202009,133,99,34,103455,35530,138985
210320,202009,2323,1976,347,2067010,364705,2431715
210325,202009,139,89,50,94050.5,52250.5,146301.0
210330,202009,4574,2618,1956,2736855.75,2051335,4788190.75
210340,202009,1255,935,320,978120,334400.5,1312520.5
210350,202009,632,526,106,550715,111815,662530
210355,202009,146,120,26,125400,27170,152570
210360,202009,2243,1541,702,1610345,734635,2344980
210370,202009,1226,599,627,625955,661485,1287440
210375,202009,187,96,91,100320,95095,195415
210380,202009,710,544,166,568480,173470,741950
210390,202009,194,166,28,173470,30305,203775
210400,202009,394,343,51,358435,54340,412775
210405,202009,984,692,292,723140,309320,1032460
210407,202009,53,42,11,43890,11495,55385
210408,202009,60,53,7,55385,7315,62700
210409,202009,323,281,42,293645,43890,337535
210410,202009,440,343,97,359480,101365,460845
210420,202009,202,167,35,175560,36575,212135
210430,202009,50,35,15,36575,16720,53295
210440,202009,336,227,109,237215,113905,351120
210450,202009,142,114,28,119130,29260,148390
210455,202009,231,123,108,129580.5,112860,242440.5
210460,202009,300,202,98,211090,102410,313500
210462,202009,65,54,11,56430,11495,67925
210465,202009,143,111,32,115995,33440,149435
210467,202009,519,383,136,400235,142120,542355
210470,202009,51,44,7,45980,7315,53295
210480,202009,1263,909,354,949905,372020,1321925
210490,202009,205,134,71,140030,74195,214225
210500,202009,510,311,199,324995,210045,535040
210510,202009,553,441,112,460845,119130,579975
210515,202009,367,232,135,242440,141075,383515
210520,202009,401,361,40,378290,41800,420090
210530,202009,9349,4924,4425,5147674.8,4637713.54,9785388.34
210535,202009,130,97,33,101365,34485,135850
210540,202009,1509,1003,506,1050225,529815,1580040
210542,202009,1183,609,574,636405,602966,1239371
210545,202009,20,18,2,18810,2090,20900
210547,202009,128,112,16,117040,16720,133760
210550,202009,685,498,187,520410.6,195415,715825.6
210560,202009,158,138,20,145255,20900,166155
210565,202009,21,16,5,16720,5225,21945
210570,202009,1304,1061,243,1109790.11,256025,1365815.11
210580,202009,120,103,17,107635,17765,125400
210590,202009,734,605,129,632225,135850,768075
210592,202009,36,34,2,35530,2090,37620
210594,202009,112,94,18,98230,18810,117040
210596,202009,99,85,14,88825,15675,104500
210598,202009,134,101,33,105545,34485,140030
210600,202009,317,273,44,285285,45980,331265
210610,202009,255,240,15,250800,15675,266475
210620,202009,43,27,16,28215,16720,44935
210630,202009,75,73,2,76285,2090,78375
210632,202009,1032,730,302,762850,316635,1079485
210635,202009,22,19,3,19855,3135,22990
210637,202009,121,87,34,90915,35530,126445
210640,202009,597,521,76,546535,79420,625955
210650,202009,402,333,69,347985,72105,420090
210660,202009,377,298,79,312455,82555,395010
210663,202009,35,26,9,27170,9405,36575
210667,202009,101,41,60,42845,62700,105545
210670,202009,243,216,27,228855,28215,257070
210675,202009,536,295,241,308275,253935,562210
210680,202009,220,144,76,150480,81510,231990
210690,202009,624,513,111,536085,115995,652080
210700,202009,157,120,37,125400,38665,164065
210710,202009,249,157,92,164065,96140,260205
210720,202009,129,115,14,120175,14630,134805
210725,202009,66,58,8,60610,8360,68970
210730,202009,24,18,6,18810,6270,25080
210735,202009,291,207,84,216315,87780.5,304095.5
210740,202009,523,452,71,472340,75240,547580
210745,202009,154,115,39,120175,40755,160930
210750,202009,2389,1212,1177,1268630.25,1231011,2499641.25
210760,202009,261,199,62,209000,64790,273790
210770,202009,377,296,81,309320,84645,393965
210780,202009,441,330,111,344850,118085,462935
210790,202009,185,152,33,158840,34485,193325
210800,202009,173,132,41,137940,43890,181830
210805,202009,54,49,5,51205,5225,56430
210810,202009,469,382,87,399190,90915,490105
210820,202009,2132,1765,367,1848605.9,384560,2233165.9
210825,202009,158,91,67,95095,70015,165110
210830,202009,741,487,254,509960,265430,775390
210840,202009,195,139,56,145255,58520,203775
210845,202009,231,163,68,171380,72105,243485
210850,202009,755,518,237,543400,249755,793155
210860,202009,3735,2095,1640,2189275.25,1723205,3912480.25
210870,202009,429,342,87,357390,90915,448305
210880,202009,73,56,17,58520,17765,76285
210890,202009,322,278,44,290510,45980,336490
210900,202009,629,409,220,427405,229900,657305
210905,202009,64,35,29,36575,30305,66880
210910,202009,1945,1468,477,1536151.06,499510,2035661.06
210920,202009,170,64,106,66880,110770,177650
210923,202009,82,65,17,67925,17765,85690
210927,202009,412,192,220,200640,230945,431585
210930,202009,73,59,14,61655,14630,76285
210940,202009,86,67,19,70015,19855,89870
210945,202009,193,103,90,107635,94050,201685
210950,202009,531,385,146,402325,152570,554895
210955,202009,82,52,30,55385,32395,87780
210960,202009,2188,1088,1100,1138005,1154725,2292730
210970,202009,116,102,14,106590,14630,121220
210975,202009,82,76,6,79420,6270,85690
210980,202009,1084,528,556,552805,584155.5,1136960.5
210990,202009,4020,2655,1365,2779700,1433740,4213440
211000,202009,1320,1065,255,1113970.5,266475,1380445.5
211003,202009,987,707,280,738815,293645,1032460
211010,202009,505,448,57,470250,59565,529815
211020,202009,1445,615,830,644765,868395,1513160
211023,202009,34,30,4,31350,4180,35530
211027,202009,72,52,20,54340,20900,75240
211030,202009,370,265,105,276925,111815,388740
211040,202009,297,245,52,257070.5,54340,311410.5
211050,202009,1167,776,391,811965,408595.5,1220560.5
211060,202009,634,552,82,576841,85690.46,662531.46
211065,202009,20,17,3,17765,4180,21945
211070,202009,894,738,156,774346.15,164065,938411.15
211080,202009,86,83,3,86735,3135,89870
211085,202009,55,28,27,30305,28215,58520
211090,202009,80,67,13,70015,13585,83600
211100,202009,490,404,86,422180,89870.5,512050.5
211102,202009,253,179,74,187055,77330,264385
211105,202009,222,156,66,163020,68970,231990
211107,202009,128,81,47,85690,49115,134805
211110,202009,808,528,280,553850,294690,848540
211120,202009,5283,2625,2658,2747306.05,2780745.4,5528051.45
211125,202009,35,26,9,27170,9405,36575
211130,202009,41615,19095,22520,19979361.8,23591922.75,43571284.55
211140,202009,405,353,52,368885,55385,424270
211150,202009,1210,818,392,854810,415910.5,1270720.5
211153,202009,170,105,65,109725,67925,177650
211157,202009,65,51,14,53295,14630,67925
211160,202009,702,601,101,628045,105545,733590
211163,202009,1,1,0,1045,0,1045
211167,202009,10,9,1,9405,1045,10450
211170,202009,425,314,111,328130,115995,444125
211172,202009,118,81,37,84645,38665,123310
211174,202009,253,156,97,163020,102410,265430
211176,202009,484,361,123,380380.5,128535,508915.5
211178,202009,94,63,31,65835,32395,98230
211180,202009,208,165,43,172425,44935,217360
211190,202009,72,66,6,68970,6270,75240
211195,202009,35,24,11,25080,11495,36575
211200,202009,151,131,20,136895,20900,157795
211210,202009,436,322,114,337535,119130,456665
211220,202009,4098,2397,1701,2505912.57,1781726,4287638.57
211223,202009,93,90,3,94050,3135,97185
211227,202009,68,53,15,55385,15675,71060
211230,202009,736,608,128,635360,133760,769120
211240,202009,404,316,88,330220,91960,422180
211245,202009,185,92,93,96140,97185,193325
211250,202009,1548,1336,212,1398210,222585,1620795
211260,202009,811,665,146,694925,153615,848540
211270,202009,1956,1600,356,1674090.5,374110.5,2048201.0
211280,202009,1753,1126,627,1178760,657305,1836065
211285,202009,206,125,81,130625,84645,215270
211290,202009,697,486,211,507870,220495,728365
211300,202009,762,604,158,631180,165110,796290
211400,202009,1526,941,585,987525,617595,1605120
220005,202009,15,14,1,14630,1045,15675
220010,202009,88,68,20,71060,20900,91960
220020,202009,704,558,146,585200,153615,738815
220025,202009,110,108,2,112860,2090,114950
220027,202009,44,35,9,36575,9405,45980
220030,202009,112,90,22,94050,22990,117040
220040,202009,1249,950,299,992750,312455,1305205
220045,202009,33,22,11,22990,11495,34485
220050,202009,689,574,115,599830.61,120175,720005.61
220060,202009,169,149,20,155705,20900,176605
220070,202009,110,100,10,104500,10450,114950
220080,202009,15,13,2,13585,2090,15675
220090,202009,33,27,6,28215,6270,34485
220095,202009,2,1,1,1045,1045,2090
220100,202009,21,17,4,17765,4180,21945
220105,202009,25,23,2,24035.5,2090,26125.5
220110,202009,225,205,20,214225,20900,235125
220115,202009,36,35,1,36575,1045,37620
220117,202009,21,20,1,20900,1045,21945
220120,202009,1478,1128,350,1180850,366795,1547645
220130,202009,31,30,1,31350,1045,32395
220140,202009,106,84,22,87780,24035,111815
220150,202009,499,369,130,385605,135850,521455
220155,202009,6,6,0,6270,0,6270
220157,202009,19,15,4,15675,4180,19855
220160,202009,89,80,9,83600,9405,93005
220170,202009,33,32,1,33440,1045,34485
220173,202009,7,7,0,7315,0,7315
220177,202009,9,9,0,9405,0,9405
220180,202009,68,66,2,68970,2090,71060
220190,202009,1070,949,121,991705,126445,1118150
220191,202009,46,39,7,40755,7315,48070
220192,202009,80,77,3,80465,3135,83600
220194,202009,56,52,4,54340,4180,58520
220196,202009,101,85,16,88825,16720,105545
220198,202009,3,2,1,2090,1045,3135
220200,202009,412,343,69,358435.25,72105,430540.25
220202,202009,42,35,7,36575,7315,43890
220205,202009,53,47,6,49115,6270,55385
220207,202009,12,12,0,12540,0,12540
220208,202009,79,42,37,43890,38665,82555
220209,202009,32,29,3,30305,3135,33440
220210,202009,22,14,8,14630,8360,22990
220211,202009,28,26,2,27170,2090,29260
220213,202009,41,36,5,37620,5225.5,42845.5
220217,202009,41,31,10,32395,10450,42845
220220,202009,2182,1434,748,1500620,782705.5,2283325.5
220225,202009,8,3,5,3135,5225,8360
220230,202009,960,748,212,783750,221540,1005290
220240,202009,162,147,15,154660,15675,170335
220245,202009,32,29,3,30305.97,3135,33440.97
220250,202009,121,108,13,112860,13585,126445
220253,202009,46,39,7,40755,7315,48070
220255,202009,31,28,3,29260,3135,32395
220260,202009,707,527,180,551760,189145,740905
220265,202009,7,5,2,5225,2090,7315
220270,202009,759,684,75,714780,78375,793155
220271,202009,42,34,8,35530,8360,43890
220272,202009,22,22,0,22990,0,22990
220273,202009,19,15,4,15675,4180,19855
220275,202009,56,46,10,48070,10450,58520
220277,202009,17,14,3,14630,3135,17765
220280,202009,17,12,5,12540,5225,17765
220285,202009,45,41,4,42845,4180,47025
220290,202009,1475,1267,208,1326106,217360.25,1543466.25
220300,202009,35,34,1,35530,1045,36575
220310,202009,327,279,48,291555,50160,341715
220320,202009,439,407,32,425315.5,33440,458755.5
220323,202009,1,0,1,0,1045,1045
220325,202009,12,10,2,10450,2090,12540
220327,202009,11,11,0,11495,0,11495
220330,202009,230,167,63,174515,65835,240350
220335,202009,142,124,18,129580,18810,148390
220340,202009,39,27,12,28215,12540,40755
220342,202009,58,50,8,52250,8360,60610
220345,202009,79,72,7,75240,7315,82555
220350,202009,443,381,62,398145,64790,462935
220360,202009,43,31,12,32395,12540,44935
220370,202009,1242,1028,214,1074260,223630,1297890
220375,202009,19,17,2,17765,2090,19855
220380,202009,22,17,5,17765,5225,22990
220385,202009,14,13,1,13585,1045,14630
220390,202009,2312,1319,993,1382535.6,1043955.75,2426491.35
220400,202009,34,30,4,31350,4180,35530
220410,202009,21,18,3,18810,3135,21945
220415,202009,13,11,2,11495,2090,13585
220420,202009,125,105,20,109725,20900,130625
220430,202009,128,114,14,119130,14630,133760
220435,202009,24,17,7,17765,7315,25080
220440,202009,291,247,44,258115,45980,304095
220450,202009,332,170,162,177650,169290,346940
220455,202009,53,52,1,54340,1045,55385
220460,202009,19,18,1,18810,1045,19855
220465,202009,99,65,34,67925,35530,103455
220470,202009,243,211,32,220495,33440,253935
220480,202009,72,64,8,66880,8360,75240
220490,202009,89,76,13,79420,13585,93005
220500,202009,107,91,16,95095,16720,111815
220510,202009,415,324,91,338580,95095,433675
220515,202009,21,19,2,19855,2090,21945
220520,202009,368,330,38,345895.85,39710,385605.85
220525,202009,10,7,3,7315,3135,10450
220527,202009,19,14,5,14630,5225,19855
220530,202009,35,14,21,14630,21945,36575
220535,202009,4,4,0,4180,0,4180
220540,202009,67,55,12,57475,12540,70015
220545,202009,40,27,13,28215,13585,41800
220550,202009,714,564,150,590425,156750,747175
220551,202009,14,11,3,11495,3135,14630
220552,202009,15,15,0,15675,0,15675
220553,202009,53,48,5,50160,5225,55385
220554,202009,9,7,2,7315,2090,9405
220555,202009,34,31,3,32395,3135,35530
220556,202009,46,44,2,45980,2090,48070
220557,202009,56,53,3,55385,3135,58520
220558,202009,9,4,5,4180,5225,9405
220559,202009,2,2,0,2090,0,2090
220560,202009,71,47,24,49115,25080,74195
220570,202009,744,461,283,481745,296780,778525
220580,202009,554,510,44,535040,45980,581020
220585,202009,10,9,1,9405,1045,10450
220590,202009,15,15,0,15675,0,15675
220595,202009,64,48,16,50160,16720,66880
220600,202009,19,11,8,11495,8360,19855
220605,202009,25,23,2,24035,2090,26125
220610,202009,77,66,11,68970,11495,80465
220620,202009,562,465,97,488015,101365,589380
220630,202009,5,4,1,4180,1045,5225
220635,202009,37,32,5,33440,5225,38665
220640,202009,104,86,18,89870,18810,108680
220650,202009,113,106,7,110770,7315,118085
220660,202009,57,45,12,47025,12540,59565
220665,202009,5,5,0,5225,0,5225
220667,202009,21,19,2,19855,2090,21945
220669,202009,28,25,3,26125,3135,29260
220670,202009,67,53,14,55385,14630,70015
220672,202009,76,53,23,55385,24035,79420
220675,202009,36,28,8,29260,8360,37620
220680,202009,42,37,5,38665,5225,43890
220690,202009,47,44,3,45980,3135,49115
220695,202009,36,19,17,19855,17765,37620
220700,202009,1688,1304,384,1363725.5,403370,1767095.5
220710,202009,6,4,2,4180,2090,6270
220720,202009,105,89,16,93005,16720,109725
220730,202009,16,16,0,16720,0,16720
220735,202009,5,1,4,1045,4180,5225
220740,202009,49,45,4,47025,4180,51205
220750,202009,110,95,15,99275,15675,114950
220755,202009,15,14,1,14630,1045,15675
220760,202009,68,62,6,64790,6270,71060
220770,202009,5631,3078,2553,3219647.01,2683560.5,5903207.51
220775,202009,18,11,7,11495,7315,18810
220777,202009,18,17,1,17765,1045,18810
220779,202009,1,0,1,0,1045,1045
220780,202009,899,766,133,801515,138985.5,940500.5
220785,202009,5,1,4,1045,4180,5225
220790,202009,1091,861,230,899745.05,241395,1141140.05
220793,202009,6,6,0,6270,0,6270
220795,202009,15,14,1,14630,1045,15675
220800,202009,3997,3079,918,3220690.81,961400,4182090.81
220810,202009,64,57,7,59565.5,7315,66880.5
220820,202009,240,219,21,228855,21945,250800
220830,202009,1245,1076,169,1125465,179740,1305205
220840,202009,2428,1687,741,1765007.59,776435.95,2541443.54
220850,202009,55,46,9,48070,9405,57475
220855,202009,8,5,3,5225,3135,8360
220860,202009,13,11,2,11495,2090,13585
220865,202009,31,29,2,30305,2090,32395
220870,202009,73,65,8,68970,8360,77330
220880,202009,322,258,64,269610,66880,336490
220885,202009,34,31,3,33440,3135,36575
220887,202009,13,12,1,12540,1045,13585
220890,202009,95,84,11,87780,11495,99275
220900,202009,23,14,9,14630,9405,24035
220910,202009,52,43,9,44935,9405,54340
220915,202009,11,10,1,10450,1045,11495
220920,202009,52,47,5,49115,5225,54340
220930,202009,43,42,1,43890,1045,44935
220935,202009,15,15,0,15675,0,15675
220937,202009,36,35,1,36575,1045,37620
220940,202009,54,50,4,52250,4180,56430
220945,202009,2,2,0,2090,0,2090
220950,202009,44,36,8,37620,8360,45980
220955,202009,23,21,2,21945,2090,24035
220960,202009,11,10,1,10450,1045,11495
220965,202009,37,33,4,34485,4180,38665
220970,202009,61,51,10,53295,10450,63745
220975,202009,16,14,2,14630,2090,16720
220980,202009,32,29,3,30305,3135,33440
220985,202009,64,57,7,59565,7315,66880
220987,202009,29,28,1,29260,1045,30305
220990,202009,23,22,1,22990,1045,24035
220995,202009,18,14,4,14630,4180,18810
220997,202009,66,54,12,56430,12540,68970
221000,202009,1175,1060,115,1107700,120175,1227875
221005,202009,51,46,5,48070,5225,53295
221010,202009,16,12,4,12540,4180,16720
221020,202009,39,38,1,39710,1045,40755
221030,202009,40,32,8,33440,8360,41800
221035,202009,23,23,0,24035,0,24035
221037,202009,12,8,4,8360,4180,12540
221038,202009,26,23,3,24035,3135,27170
221039,202009,22,22,0,22990,0,22990
221040,202009,252,215,37,224675,38665,263340
221050,202009,236,200,36,209000,37620,246620
221060,202009,1853,1615,238,1688720,248710,1937430
221062,202009,33,33,0,34485,0,34485
221063,202009,12,8,4,8360,4180,12540
221065,202009,60,48,12,50160,12540,62700
221070,202009,138,120,18,125400,19855,145255
221080,202009,369,320,49,335445,51205,386650
221090,202009,28,25,3,26125,3135,29260
221093,202009,47,33,14,34485,14630,49115
221095,202009,6,6,0,6270,0,6270
221097,202009,13,10,3,10450,3135,13585
221100,202009,25361,15065,10296,15779503.94,10808435.95,26587939.89
221110,202009,1099,833,266,871530,277970,1149500
221120,202009,539,396,143,413820.5,150480,564300.5
221130,202009,974,786,188,822415,196460,1018875
221135,202009,35,31,4,32395,4180,36575
221140,202009,45,39,6,40755,6270,47025
221150,202009,11,9,2,9405,2090,11495
221160,202009,14,14,0,14630,0,14630
221170,202009,15,15,0,15675,0,15675
230010,202009,167,153,14,159885,14630,174515
230015,202009,127,102,25,106590,27170,133760
230020,202009,1630,1380,250,1442100.5,264385,1706485.5
230030,202009,1676,1205,471,1260271,494285,1754556
230040,202009,221,187,34,195415,35530,230945
230050,202009,230,169,61,176605,63745,240350
230060,202009,165,131,34,136895,35530,172425
230070,202009,308,266,42,279015,43890,322905
230075,202009,853,733,120,767032,127490,894522
230080,202009,195,167,28,174515,29260,203775
230090,202009,126,90,36,94050,37620,131670
230100,202009,2161,1229,932,1286396.5,977075,2263471.5
230110,202009,2906,1880,1026,1967735.5,1073215.5,3040951.0
230120,202009,1016,798,218,833910,228855,1062765
230125,202009,154,127,27,132715,28215,160930
230130,202009,478,426,52,446215,54340,500555
230140,202009,225,187,38,195415,39710,235125
230150,202009,147,114,33,119130,35530,154660
230160,202009,938,794,144,830775.5,151525,982300.5
230170,202009,611,550,61,575795.5,63745,639540.5
230180,202009,73,67,6,70015,6270,76285
230185,202009,401,345,56,360525.5,58520,419045.5
230190,202009,2330,1839,491,1923845,517275,2441120
230195,202009,493,428,65,448305,67925,516230
230200,202009,407,339,68,354255,71060,425315
230205,202009,388,257,131,268565,137940,406505
230210,202009,1369,1062,307,1111880.38,321860,1433740.38
230220,202009,1582,1074,508,1127555,531905,1659460
230230,202009,904,773,131,807785,136895,944680
230240,202009,1744,1501,243,1569853.45,256025,1825878.45
230250,202009,1784,1470,314,1539285,329175.71,1868460.71
230260,202009,3256,2028,1228,2119260,1285350,3404610
230270,202009,1366,1098,268,1148456.88,280060.5,1428517.38
230280,202009,2755,2066,689,2161060,721050.5,2882110.5
230290,202009,402,359,43,375155.72,44935,420090.72
230300,202009,535,385,150,402325,157795,560120
230310,202009,415,314,101,330220,107635,437855
230320,202009,929,792,137,827641,143165,970806
230330,202009,305,246,59,257070,62700,319770
230340,202009,453,364,89,381425,93005,474430
230350,202009,3161,1995,1166,2086865,1218470,3305335
230360,202009,278,224,54,234080,56430,290510
230365,202009,135,114,21,120175,21945,142120
230370,202009,10104,4921,5183,5149763.42,5430866.5,10580629.92
230380,202009,479,408,71,427405.5,74195,501600.5
230390,202009,548,306,242,319770,252890.5,572660.5
230393,202009,247,204,43,213180,44935,258115
230395,202009,352,284,68,296781.2,71060,367841.2
230400,202009,621,491,130,513095,135850,648945
230410,202009,2696,1682,1014,1761870.97,1062765.5,2824636.47
230420,202009,6264,4137,2127,4327348.04,2227940.2,6555288.24
230423,202009,335,291,44,304095,45980,350075
230425,202009,428,352,76,368885.85,79420,448305.85
230426,202009,122,100,22,104500,22990,127490
230427,202009,75,71,4,74195,4180,78375
230428,202009,1518,753,765,787930.5,801515,1589445.5
230430,202009,455,370,85,386650,88825,475475
230435,202009,892,646,246,679250,262295.77,941545.77
230440,202009,88817,39477,49340,41304688.22,51675265.54,92979953.76
230445,202009,316,220,96,229900,100320,330220
230450,202009,565,447,118,468160,124355,592515
230460,202009,68,53,15,55385,15675,71060
230465,202009,310,252,58,263340,60610,323950
230470,202009,2016,1591,425,1662595.5,446215.25,2108810.75
230480,202009,157,148,9,154660,9405,164065
230490,202009,303,243,60,253935,63745,317680
230495,202009,449,331,118,345895,123310,469205
230500,202009,1021,754,267,788975,279015,1067990
230510,202009,59,46,13,48070,13585,61655
230520,202009,384,301,83,314545.53,86735,401280.53
230523,202009,2366,1477,889,1545555.75,930050.5,2475606.25
230526,202009,271,233,38,243485,39710,283195
230530,202009,692,517,175,540265,184965,725230
230533,202009,206,192,14,200640,14630,215270
230535,202009,370,275,95,288420,99275,387695
230540,202009,1804,1591,213,1662595,222585,1885180
230550,202009,3826,2457,1369,2571748.16,1431650,4003398.16
230560,202009,582,441,141,460845.5,147345,608190.5
230565,202009,224,162,62,170335,64790,235125
230570,202009,289,256,33,267520,34485,302005
230580,202009,1178,857,321,898700,336490,1235190
230590,202009,1006,782,224,818235.25,236170,1054405.25
230600,202009,241,219,22,228855,22990,251845
230610,202009,380,292,88,305140,91960,397100
230620,202009,206,173,33,181830.5,34485,216315.5
230625,202009,761,535,226,561165.25,237215,798380.25
230630,202009,1333,1040,293,1087845,306185,1394030
230640,202009,3777,3202,575,3349225.5,601921.25,3951146.75
230650,202009,457,393,64,411730,66880,478610
230655,202009,690,585,105,611325,111815,723140
230660,202009,368,306,62,319770,64790,384560
230670,202009,449,382,67,400235,70015,470250
230680,202009,206,187,19,196460,19855,216315
230690,202009,917,774,143,808830,149435,958265
230700,202009,851,714,137,746130,143165.5,889295.5
230710,202009,691,657,34,686565,35530,722095
230720,202009,155,134,21,140030,21945,161975
230725,202009,265,209,56,218405,58520,276925
230730,202009,12182,6636,5546,6941872.05,5810203.37,12752075.42
230740,202009,669,538,131,562210.5,136895,699105.5
230750,202009,834,702,132,735680,137940,873620
230760,202009,1470,1271,199,1329240,207955,1537195
230763,202009,326,270,56,282150,58520,340670
230765,202009,7557,3477,4080,3639735.51,4273006.25,7912741.76
230770,202009,5066,2581,2485,2701327.4,2601005.5,5302332.9
230780,202009,729,640,89,669845.5,93005,762850.5
230790,202009,287,241,46,251845,48070,299915
230800,202009,1135,817,318,855855,333355,1189210
230810,202009,1347,1187,160,1240415,167200,1407615
230820,202009,366,253,113,265430.5,118085,383515.5
230830,202009,951,813,138,850630,145255,995885
230835,202009,277,240,37,250800,38665,289465
230837,202009,167,142,25,148390,26125,174515
230840,202009,927,730,197,763895.5,205865.5,969761.0
230850,202009,1471,1270,201,1329240,210045,1539285
230860,202009,301,226,75,236170,79420,315590
230870,202009,1836,1566,270,1638560,283195,1921755
230880,202009,68,52,16,54340,16720,71060
230890,202009,536,491,45,513095,47025,560120
230900,202009,283,205,78,215270,81510.31,296780.31
230910,202009,218,172,46,179740,49115,228855
230920,202009,421,337,84,354255,89870,444125
230930,202009,983,693,290,724185,304095,1028280
230940,202009,855,665,190,694925,198550,893475
230945,202009,518,420,98,439945.5,103455,543400.5
230950,202009,413,356,57,372020,59565,431585
230960,202009,2674,1794,880,1878911,922735.5,2801646.5
230970,202009,1709,955,754,997975,787930,1785905
230980,202009,201,165,36,172425,37620,210045
230990,202009,135,111,24,115995,26125,142120
231000,202009,191,176,15,183920,15675,199595
231010,202009,153,112,41,117040,42845,159885
231020,202009,1348,937,411,980210.25,430540,1410750.25
231025,202009,1067,789,278,824505,290510.5,1115015.5
231030,202009,1097,914,183,956175,191235,1147410
231040,202009,134,92,42,96140,43890,140030
231050,202009,948,839,109,876755,113905,990660
231060,202009,156,130,26,135850,28215,164065
231070,202009,1493,1038,455,1085755,477565,1563320
231080,202009,265,243,22,253935,22990,276925
231085,202009,608,370,238,386650,249755,636405
231090,202009,246,201,45,210045,47025,257070
231095,202009,168,133,35,138985,36575,175560
231100,202009,148,123,25,128535,26125,154660
231110,202009,372,314,58,329175,60610,389785
231120,202009,269,230,39,240350,41800,282150
231123,202009,156,147,9,153615,9405,163020
231126,202009,332,259,73,272745.5,76285,349030.5
231130,202009,4712,3678,1034,3844556,1086800.5,4931356.5
231135,202009,212,184,28,192280,29260,221540
231140,202009,3078,2265,813,2373195.5,849585,3222780.5
231150,202009,370,350,20,365750,20900,386650
231160,202009,1211,958,253,1001110.75,265430,1266540.75
231170,202009,519,358,161,374110,169290,543400
231180,202009,1713,1468,245,1535105,258115,1793220
231190,202009,209,175,34,182875,35530,218405
231195,202009,215,181,34,189145,35530,224675
231200,202009,803,657,146,686565,152570,839135
231210,202009,583,491,92,513095,96140,609235
231220,202009,1047,765,282,800471.7,294690,1095161.7
231230,202009,1474,1170,304,1223695,317680,1541375
231240,202009,1470,1043,427,1089935,447260.5,1537195.5
231250,202009,113,104,9,108680,9405,118085
231260,202009,279,182,97,190190,101365,291555
231270,202009,998,812,186,849586.15,195415,1045001.15
231280,202009,75,59,16,62700,16720,79420
231290,202009,7652,4312,3340,4514400,3514335.94,8028735.94
231300,202009,605,563,42,588335,43890,632225
231310,202009,749,694,55,725230.56,57475,782705.56
231320,202009,589,445,144,466071.5,150480,616551.5
231325,202009,99,86,13,89870,13585,103455
231330,202009,1989,1542,447,1611654.4,469205.5,2080859.9
231335,202009,255,226,29,236170,30305,266475
231340,202009,1718,1256,462,1314610,482790,1797400
231350,202009,1306,1057,249,1104565,260206.5,1364771.5
231355,202009,433,370,63,388740,65835,454575
231360,202009,516,376,140,393965.86,146300,540265.86
231370,202009,87,76,11,79420,11495,90915
231375,202009,293,212,81,221540,85690,307230
231380,202009,491,398,93,416955,97185,514140
231390,202009,208,163,45,170335,48070,218405
231395,202009,738,463,275,483835,287375,771210
231400,202009,1126,936,190,978120.25,198550.5,1176670.75
231410,202009,1330,1090,240,1139050,251845,1390895
240010,202009,395,174,221,182875,231990,414865
240020,202009,2271,1840,431,1922801.68,450395,2373196.68
240030,202009,119,100,19,104500,19855,124355
240040,202009,33,33,0,34485,0,34485
240050,202009,533,455,78,475475,81510,556985
240060,202009,67,63,4,65835,4180,70015
240070,202009,217,171,46,179740,48070,227810
240080,202009,525,357,168,373065,175560.01,548625.01
240090,202009,103,92,11,97185,11495,108680
240100,202009,1501,1419,82,1482855.37,85690,1568545.37
240110,202009,1050,690,360,722096,376200.75,1098296.75
240120,202009,141,112,29,117040,30305,147345
240130,202009,280,258,22,270655,22990,293645
240140,202009,78,57,21,59565,21945,81510
240145,202009,743,662,81,692835,84645,777480
240150,202009,21,16,5,16720,5225,21945
240160,202009,41,35,6,36575,6270,42845
240165,202009,35,27,8,29260.25,8360,37620.25
240170,202009,112,81,31,84645,32395,117040
240180,202009,90,70,20,73150,20900,94050
240185,202009,42,39,3,40755,3135,43890
240190,202009,16,14,2,14630,2090,16720
240200,202009,3087,1735,1352,1815167,1415976,3231143
240210,202009,173,133,40,138985,41800,180785
240220,202009,1096,799,297,838090.75,312455,1150545.75
240230,202009,853,781,72,816145.75,76285,892430.75
240240,202009,73,54,19,56430,19855,76285
240250,202009,90,78,12,81510,12540,94050
240260,202009,1808,1334,474,1395075.5,500555,1895630.5
240270,202009,185,163,22,170335,22990,193325
240280,202009,46,35,11,36575,11495,48070
240290,202009,48,46,2,48070,2090,50160
240300,202009,177,94,83,98230,86735,184965
240310,202009,2328,1276,1052,1335511.48,1100385.85,2435897.33
240320,202009,194,182,12,190190,12540,202730
240325,202009,4552,2702,1850,2825682.49,1941610.7,4767293.19
240330,202009,74,69,5,72105,5225,77330
240340,202009,69,45,24,47025,25080,72105
240350,202009,94,82,12,85690,12540,98230
240360,202009,558,347,211,362615,221540,584155
240370,202009,52,48,4,50160,4180,54340
240375,202009,68,40,28,41800,29260,71060
240380,202009,231,188,43,196460,44935.5,241395.5
240390,202009,12,11,1,11495,1045,12540
240400,202009,83,75,8,78375,8360,86735
240410,202009,14,8,6,8360,6270,14630
240420,202009,1008,733,275,769120,287375,1056495
240430,202009,264,248,16,259160,16720,275880
240440,202009,125,70,55,74195,57475,131670
240450,202009,228,153,75,159885.5,79420,239305.5
240460,202009,72,54,18,56430,18810,75240
240470,202009,237,212,25,221540,26125,247665
240480,202009,16,14,2,14630,2090,16720
240485,202009,82,68,14,71060,14630,85690
240490,202009,46,44,2,45980,2090,48070
240500,202009,86,64,22,66880,22990,89870
240510,202009,43,32,11,33440,11495,44935
240520,202009,115,110,5,114950,5225,120175
240530,202009,56,49,7,51205,7315,58520
240540,202009,78,66,12,70015,12540,82555
240550,202009,13,12,1,12540,1045,13585
240560,202009,380,278,102,290510.5,106590,397100.5
240570,202009,447,288,159,300960.5,166155.5,467116.0
240580,202009,1300,1023,277,1070080.25,290510,1360590.25
240590,202009,30,28,2,29260,2090,31350
240600,202009,106,101,5,105545,5225,110770
240610,202009,521,436,85,455620.5,88825,544445.5
240615,202009,19,18,1,18810,1045,19855
240620,202009,87,83,4,86735,4180,90915
240630,202009,38,33,5,34485,5225,39710
240640,202009,26,20,6,20900,6270,27170
240650,202009,241,199,42,207955,43890,251845
240660,202009,111,95,16,99275,17765,117040
240670,202009,310,178,132,187055.75,137940,324995.75
240680,202009,50,37,13,38665,13585,52250
240690,202009,47,44,3,45980,3135,49115
240700,202009,184,152,32,158840,33440,192280
240710,202009,2021,1251,770,1308341.25,805695,2114036.25
240720,202009,1064,789,275,824505,287375,1111880
240725,202009,66,61,5,63745,5225,68970
240730,202009,149,127,22,132715,22990,155705
240740,202009,230,196,34,205865,35530.85,241395.85
240750,202009,54,28,26,29260,27170,56430
240760,202009,46,41,5,42845,5225,48070
240770,202009,145,114,31,119130,32395,151525
240780,202009,673,558,115,583110,120175,703285
240790,202009,42,40,2,41800,2090,43890
240800,202009,9277,6312,2965,6606498.8,3101562.75,9708061.55
240810,202009,20433,11035,9398,11547260.72,9853308.47,21400569.19
240820,202009,237,143,94,150480.09,99275,249755.09
240830,202009,1622,1334,288,1394030.75,300960,1694990.75
240840,202009,77,67,10,70015,10450,80465
240850,202009,87,77,10,80465,10450,90915
240860,202009,107,103,4,107635,4180,111815
240870,202009,59,51,8,53295,8360,61655
240880,202009,30,27,3,28215,3135,31350
240890,202009,1119,641,478,669845.4,500555,1170400.4
240895,202009,61,41,20,42845,20900,63745
240910,202009,156,140,16,146300,17765,164065
240920,202009,13,10,3,10450,3135,13585
240930,202009,413,370,43,387695,45980,433675
240933,202009,48,32,16,33440,16720,50160
240940,202009,2382,2108,274,2203905.45,286330,2490235.45
240950,202009,48,43,5,44935,5225,50160
240960,202009,26,22,4,22990,4180,27170
240970,202009,112,82,30,85690,31350,117040
240980,202009,199,158,41,165110,42845,207955
240990,202009,130,87,43,90915,44935,135850
241000,202009,61,57,4,59565,4180,63745
241010,202009,68,52,16,54340,16720,71060
241020,202009,112,103,9,108680,9405,118085
241025,202009,12,5,7,5225,7315,12540
241030,202009,114,91,23,95095,24035,119130
241040,202009,44,31,13,33440,13585,47025
241050,202009,82,75,7,78375,7315,85690
241060,202009,29,24,5,25080,5225,30305
241070,202009,15,15,0,15675,0,15675
241080,202009,61,54,7,56430,7315,63745
241090,202009,60,47,13,49115,13585,62700
241100,202009,72,61,11,63745,11495,75240
241105,202009,9,3,6,3135,6270,9405
241110,202009,49,45,4,47025,4180,51205
241120,202009,1482,1122,360,1174580.5,377245,1551825.5
241140,202009,221,183,38,191235.5,39710,230945.5
241142,202009,40,34,6,36575,6270,42845
241150,202009,1182,1037,145,1085755,151525,1237280
241160,202009,17,16,1,16720,1045,17765
241170,202009,44,38,6,39710,6270,45980
241180,202009,43,36,7,37620,7315,44935
241190,202009,38,37,1,38665,1045,39710
241200,202009,3984,2059,1925,2156881.42,2015805,4172686.42
241210,202009,68,59,9,61655,9405,71060
241220,202009,1428,957,471,1001111.1,493240,1494351.1
241230,202009,244,204,40,213180,41800,254980
241240,202009,55,44,11,45980,11495,57475
241250,202009,1140,1048,92,1095160.5,96140,1191300.5
241255,202009,54,41,13,42845,13585,56430
241260,202009,681,527,154,550715,161975,712690
241270,202009,62,44,18,45980,18810,64790
241280,202009,95,83,12,86735,12540,99275
241290,202009,123,86,37,89870,38665,128535
241300,202009,80,56,24,58520,25080,83600
241310,202009,51,37,14,38665.75,14630,53295.75
241320,202009,30,18,12,18810,12540,31350
241330,202009,63,55,8,57475,8360,65835
241335,202009,75,67,8,70015,8360,78375
241340,202009,182,133,49,138985,51205,190190
241350,202009,61,52,9,54340,9405,63745
241355,202009,50,43,7,44935,7315,52250
241360,202009,50,49,1,52250,1045,53295
241370,202009,53,42,11,43890,11495,55385
241380,202009,37,33,4,34485,4180,38665
241390,202009,86,66,20,68970,20900,89870
241400,202009,223,176,47,183920,49115,233035
241410,202009,184,165,19,172425,19855,192280
241415,202009,100,81,19,84645,19855,104500
241420,202009,102,75,27,78375,28215.1,106590.1
241430,202009,27,24,3,25080,3135,28215
241440,202009,537,432,105,451440,111815,563255
241445,202009,38,33,5,34485,5225,39710
241450,202009,276,226,50,237215,52250,289465
241460,202009,144,131,13,136895.25,13585,150480.25
241470,202009,34,29,5,30305,5225,35530
241475,202009,55,52,3,54340,3135,57475
241480,202009,96,67,29,70015,30305,100320
241490,202009,11,10,1,10450,1045,11495
241500,202009,47,36,11,37620,11495,49115
250010,202009,103,88,15,91960,15675,107635
250020,202009,32,29,3,30305,3135,33440
250030,202009,870,652,218,681340,227810,909150
250040,202009,373,307,66,320815,68970,389785
250050,202009,258,210,48,219450,50160,269610
250053,202009,54,40,14,42845,14630,57475
250057,202009,1,1,0,1045,0,1045
250060,202009,578,411,167,429495,174515,604010
250070,202009,714,571,143,596695.1,149435,746130.1
250073,202009,7,7,0,7315,0,7315
250077,202009,178,134,44,140030,45980,186010
250080,202009,431,337,94,352165.3,98230,450395.3
250090,202009,223,146,77,152570,80465,233035
250100,202009,519,431,88,451440,93005,544445
250110,202009,619,469,150,490105,156750,646855
250115,202009,20,7,13,7315,13585,20900
250120,202009,122,87,35,90915,37620,128535
250130,202009,581,470,111,491150,115995,607145
250135,202009,16,9,7,9405,7315,16720
250140,202009,87,77,10,80465,10450,90915
250150,202009,593,427,166,446215,173470,619685
250153,202009,10,7,3,7315,3135,10450
250157,202009,32,26,6,27170,6270,33440
250160,202009,232,182,50,190190,53295,243485
250170,202009,62,40,22,41800,22990,64790
250180,202009,4299,2923,1376,3057670.3,1440010,4497680.3
250190,202009,841,550,291,574750,304095.25,878845.25
250200,202009,51,42,9,43890,9405,53295
250205,202009,24,20,4,20900,4180,25080
250210,202009,85,75,10,78375,10450,88825
250215,202009,70,55,15,57475,15675,73150
250220,202009,25,18,7,18810,7315,26125
250230,202009,78,71,7,74195,7315,81510
250240,202009,235,195,40,203775,41800,245575
250250,202009,389,333,56,347985,58520,406505
250260,202009,45,38,7,39710,7315,47025
250270,202009,75,54,21,56430,21945,78375
250280,202009,384,316,68,330220,73150,403370
250290,202009,94,86,8,89870,8360,98230
250300,202009,551,371,180,387695,190190,577885
250310,202009,50,43,7,44935,7315,52250
250320,202009,1968,1324,644,1387760.85,676115.9,2063876.75
250330,202009,104,86,18,89870,18810,108680
250340,202009,25,23,2,24035,2090,26125
250350,202009,166,108,58,112860,60610,173470
250355,202009,32,25,7,26125,7315,33440
250360,202009,199,165,34,172425,35530,207955
250370,202009,2415,1604,811,1676180,851675,2527855
250375,202009,11,7,4,7315,4180,11495
250380,202009,55,42,13,43890,13585,57475
250390,202009,46,35,11,36575,11495,48070
250400,202009,16424,8324,8100,8714240.56,8484358.13,17198598.69
250403,202009,329,264,65,275880,67925,343805
250407,202009,62,50,12,52250,12540,64790
250410,202009,30,26,4,27170,4180,31350
250415,202009,45,31,14,32395,14630,47025
250420,202009,43,37,6,38665,6270,44935
250430,202009,1449,1246,203,1302331.25,213180,1515511.25
250435,202009,17,13,4,13585,4180,17765
250440,202009,675,564,111,589380,115995,705375
250450,202009,86,66,20,68970,20900,89870
250460,202009,457,303,154,316635,161975,478610
250470,202009,94,64,30,66880,31350,98230
250480,202009,331,265,66,276925,68970,345895
250485,202009,2,2,0,2090,0,2090
250490,202009,227,181,46,189145,48070,237215
250500,202009,93,68,25,71060,26125,97185
250510,202009,769,604,165,633270,172425,805695
250520,202009,182,123,59,128535,61655,190190
250523,202009,119,95,24,99275,25080,124355
250527,202009,106,83,23,86735,24035,110770
250530,202009,10,6,4,6270,4180,10450
250535,202009,36,26,10,27170,10450,37620
250540,202009,135,105,30,109725,31350,141075
250550,202009,72,69,3,72105,3135,75240
250560,202009,52,38,14,39710,14630,54340
250570,202009,165,135,30,142120,31350,173470
250580,202009,109,84,25,87847,26125,113972
250590,202009,24,14,10,14630,10450,25080
250600,202009,1397,915,482,956176.46,505780,1461956.46
250610,202009,159,130,29,135850,30305,166155
250620,202009,22,17,5,17765,5225,22990
250625,202009,71,52,19,55385,19855,75240
250630,202009,3052,1951,1101,2044022.43,1154725,3198747.43
250640,202009,220,174,46,181830,48070,229900
250650,202009,30,20,10,20900,10450,31350
250660,202009,50,39,11,40755,11495,52250
250670,202009,66,45,21,47025,21945,68970
250680,202009,410,329,81,343805,84645,428450
250690,202009,2064,1429,635,1495395.96,665665,2161060.96
250700,202009,940,812,128,848540.25,133760,982300.25
250710,202009,431,338,93,355300,97185,452485
250720,202009,117,86,31,89870,32395,122265
250730,202009,385,322,63,336490,65835,402325
250740,202009,54,51,3,53295,3135,56430
250750,202009,22304,13370,8934,13996625.28,9366337.5,23362962.78
250760,202009,101,79,22,82555,22990,105545
250770,202009,366,239,127,249755.6,132715,382470.6
250780,202009,64,43,21,44935,21945,66880
250790,202009,460,300,160,313500,168245,481745
250800,202009,151,137,14,143165,14630,157795
250810,202009,77,61,16,63745,16720,80465
250820,202009,153,127,26,133760,27170,160930
250830,202009,433,292,141,306185.5,148390,454575.5
250840,202009,54,48,6,50160,6270,56430
250850,202009,57,47,10,49115,10450,59565
250855,202009,13,11,2,11495,2090,13585
250860,202009,217,149,68,155705,71060,226765
250870,202009,30,26,4,27170,4180,31350
250880,202009,86,64,22,66880,22990,89870
250890,202009,2833,2119,714,2218535,747175.5,2965710.5
250900,202009,49,40,9,41800,9405,51205
250905,202009,116,88,28,91960,29260,121220
250910,202009,1127,822,305,858990,319770,1178760
250915,202009,108,74,34,77330,35530,112860
250920,202009,140,101,39,105545,40755,146300
250930,202009,172,101,71,105545,74195,179740
250933,202009,5,3,2,3135,2090,5225
250937,202009,10,10,0,10450,0,10450
250939,202009,35,25,10,26125,10450,36575
250940,202009,104,77,27,80465,28215,108680
250950,202009,73,50,23,52250,24035,76285
250960,202009,90,50,40,52250,41800,94050
250970,202009,1213,858,355,898700,373065,1271765
250980,202009,103,68,35,72105,36575,108680
250990,202009,163,128,35,133760,36575,170335
251000,202009,74,66,8,68970,8360,77330
251010,202009,112,83,29,86735,30305,117040
251020,202009,74,61,13,63745,13585,77330
251030,202009,47,35,12,36575,12540,49115
251040,202009,57,39,18,41800,18810,60610
251050,202009,24,21,3,21945,3135,25080
251060,202009,51,40,11,41800,11495,53295
251065,202009,4,4,0,4180,0,4180
251070,202009,21,17,4,17765,4180,21945
251080,202009,5038,2406,2632,2515315.75,2752532.14,5267847.89
251090,202009,184,157,27,164065,28215,192280
251100,202009,17,17,0,17765,0,17765
251110,202009,46,37,9,38665,9405,48070
251120,202009,1848,1133,715,1185032.75,748220.2,1933252.95
251130,202009,406,330,76,344850,79420,424270
251140,202009,559,361,198,377245,206910,584155
251150,202009,340,288,52,300960,54340,355300
251160,202009,89,72,17,75240,17765,93005
251170,202009,101,81,20,84645,20900,105545
251180,202009,292,177,115,184965,120175,305140
251190,202009,201,131,70,136895,73150,210045
251200,202009,275,223,52,233035,55385,288420
251203,202009,36,34,2,35530,2090,37620
251207,202009,88,72,16,75240,16720,91960
251210,202009,1483,1083,400,1133825,419045,1552870
251220,202009,48,36,12,37620,12540,50160
251230,202009,591,497,94,520410,98230,618640
251240,202009,95,65,30,67925,31350,99275
251250,202009,1408,1008,400,1054405.75,420090.75,1474496.50
251260,202009,11,7,4,7315,4180,11495
251270,202009,320,244,76,254980,79420,334400
251272,202009,64,58,6,61655,6270,67925
251274,202009,30,23,7,24035,7315,31350
251275,202009,34,20,14,20900,14630,35530
251276,202009,15,11,4,11495,4180,15675
251278,202009,9,7,2,7315,2090,9405
251280,202009,101,96,5,100320,5225,105545
251290,202009,801,576,225,604010,235125,839135
251300,202009,15,12,3,12540,3135,15675
251310,202009,330,240,90,250800,94050,344850
251315,202009,31,27,4,28215,4180,32395
251320,202009,64,50,14,52250,14630,66880
251330,202009,79,70,9,73150,9405,82555
251335,202009,15,10,5,10450,5225,15675
251340,202009,739,437,302,456665,316635,773300
251350,202009,34,33,1,34485,1045,35530
251360,202009,83,73,10,76285,10450,86735
251365,202009,15,15,0,15675,0,15675
251370,202009,5563,3723,1840,3893670.65,1925935,5819605.65
251380,202009,44,36,8,37620,8360,45980
251385,202009,3,3,0,3135,0,3135
251390,202009,818,617,201,644765,211090.5,855855.5
251392,202009,19,11,8,11495,8360,19855
251394,202009,10,10,0,10450,0,10450
251396,202009,12,8,4,8360,4180,12540
251398,202009,18,16,2,16720,2090,18810
251400,202009,39,32,7,33440,7315,40755
251410,202009,37,31,6,32395,6270,38665
251420,202009,101,71,30,74195,31350,105545
251430,202009,44,40,4,41800,4180,45980
251440,202009,43,26,17,27170,17765,44935
251445,202009,51,46,5,48070.25,5225,53295.25
251450,202009,405,353,52,368885,54340,423225
251455,202009,3,2,1,2090,1045,3135
251460,202009,14,12,2,13585,2090,15675
251465,202009,7,4,3,4180,3135,7315
251470,202009,49,39,10,40755,10450,51205
251480,202009,26,21,5,21945,5225,27170
251490,202009,127,82,45,85690,47025.5,132715.5
251500,202009,128,106,22,110770,22990,133760
251510,202009,51,31,20,32395,20900,53295
251520,202009,29,28,1,29260,1045,30305
251530,202009,4485,3158,1327,3302200.5,1391940,4694140.5
251540,202009,76,64,12,66880,12540,79420
251550,202009,416,316,100,330220,104500.25,434720.25
251560,202009,24,16,8,16720,8360,25080
251570,202009,19,18,1,18810,1045,19855
251580,202009,133,105,28,109725,29260,138985
251590,202009,116,85,31,89022.5,32395,121417.5
251593,202009,25,15,10,15675,10450,26125
251597,202009,105,83,22,86735,24035,110770
251600,202009,1112,786,326,821370.5,341715,1163085.5
251610,202009,239,180,59,188100,61655,249755
251615,202009,9,8,1,8360,1045,9405
251620,202009,4260,2777,1483,2907192.1,1554961.5,4462153.6
251630,202009,459,336,123,352165,128535,480700
251640,202009,142,101,41,105545,42845,148390
251650,202009,277,200,77,209000.75,80465,289465.75
251660,202009,189,169,20,176605,20900,197505
251670,202009,372,292,80,305140,83600,388740
251675,202009,8,6,2,6270,2090,8360
251680,202009,99,89,10,93005,10450,103455
251690,202009,326,268,58,280060,60610,340670
251700,202009,286,246,40,257070.9,41800,298870.9
251710,202009,21,14,7,14630,8360,22990
251720,202009,22,15,7,15675,7315.5,22990.5
251740,202009,12,9,3,9405,3135,12540
260005,202009,3275,1782,1493,1863239.99,1564365.5,3427605.49
260010,202009,1643,1185,458,1242505.14,478610.1,1721115.24
260020,202009,417,362,55,379335,57475,436810
260030,202009,605,420,185,438900,193325,632225
260040,202009,814,506,308,528770,321860,850630
260050,202009,1161,832,329,871530,346941,1218471
260060,202009,380,347,33,363660,34485,398145
260070,202009,1362,843,519,881980.5,543400.3,1425380.8
260080,202009,729,561,168,587290,175560,762850
260090,202009,492,323,169,337535,176605,514140
260100,202009,214,150,64,156750,67925,224675
260105,202009,239,131,108,136895,113905,250800
260110,202009,2871,2098,773,2194501,808830.5,3003331.5
260120,202009,2841,1445,1396,1513439.3,1465090.75,2978530.05
260130,202009,168,113,55,118085,58520,176605
260140,202009,2124,1377,747,1442102.3,781660.5,2223762.8
260150,202009,207,133,74,138985,77330,216315
260160,202009,323,269,54,282150,57475,339625
260170,202009,3380,2034,1346,2127621.45,1412840.5,3540461.95
260180,202009,160,128,32,133760,33440,167200
260190,202009,2338,1583,755,1654235,792110,2446345
260200,202009,973,783,190,818235.29,198550.5,1016785.79
260210,202009,1437,1018,419,1063810,437855,1501665
260220,202009,689,618,71,647900.5,74195,722095.5
260230,202009,1203,907,296,948860,310365,1259225
260240,202009,232,163,69,170335,72105,242440
260250,202009,92,67,25,70015,26125,96140
260260,202009,1043,732,311,764940,324995,1089935
260270,202009,412,323,89,338580,93005,431585
260280,202009,1299,917,382,959310,400235.5,1359545.5
260290,202009,6540,3535,3005,3700347.15,3147542.46,6847889.61
260300,202009,951,818,133,856900.5,138985,995885.5
260310,202009,515,411,104,429495,110770,540265
260320,202009,858,632,226,660440,237215,897655
260330,202009,64,43,21,44935,21945,66880
260340,202009,78,56,22,58520,22990,81510
260345,202009,5513,2998,2515,3143361.93,2638625.5,5781987.43
260350,202009,493,348,145,363660.5,151525,515185.5
260360,202009,246,135,111,141075,117040,258115
260370,202009,773,471,302,493240.25,315590,808830.25
260380,202009,584,430,154,450395,160930.47,611325.47
260390,202009,293,246,47,257070,49115,306185
260392,202009,113,97,16,101365,16720,118085
260400,202009,4196,2390,1806,2498596.22,1894585.5,4393181.72
260410,202009,14833,7727,7106,8083077.27,7441447.13,15524524.40
260415,202009,139,121,18,126445,18810,145255
260420,202009,1725,1058,667,1106656.77,700150,1806806.77
260430,202009,188,173,15,180785.35,15675,196460.35
260440,202009,197,141,56,148390,58520,206910
260450,202009,429,318,111,332310.96,115995,448305.96
260460,202009,816,429,387,448305,405460,853765
260470,202009,344,212,132,221540,137940.5,359480.5
260480,202009,242,155,87,161975,90915,252890
260490,202009,215,177,38,184965,40755,225720
260500,202009,1114,751,363,784795,381425,1166220
260510,202009,778,618,160,646855,167200,814055
260515,202009,239,215,24,224675,26125,250800
260520,202009,3270,2018,1252,2110900,1311475.95,3422375.95
260530,202009,791,651,140,680295,146300,826595
260540,202009,552,432,120,452485,125400,577885
260545,202009,15,11,4,11495,4180,15675
260550,202009,328,203,125,212135,130625,342760
260560,202009,518,391,127,409640.5,132715,542355.5
260570,202009,972,788,184,824505,192280,1016785
260580,202009,249,216,33,225720,34485,260205
260590,202009,638,367,271,384560,284240,668800
260600,202009,8113,4337,3776,4537392.84,3958460.5,8495853.34
260610,202009,486,325,161,339625,168245,507870
260620,202009,3662,1901,1761,1990726.65,1847560.58,3838287.23
260630,202009,82,77,5,80465,5225,85690
260640,202009,3529,1963,1566,2054470.8,1638560,3693030.8
260650,202009,332,237,95,248710,99275,347985
260660,202009,558,362,196,378290,205865,584155
260670,202009,104,77,27,80465,28215,108680
260680,202009,3737,2069,1668,2165240.22,1746195.5,3911435.72
260690,202009,130,93,37,97185,38665,135850
260700,202009,308,208,100,217360,106590,323950
260710,202009,43,35,8,36575,8360,44935
260720,202009,2458,1459,999,1525701,1045000,2570701
260730,202009,703,529,174,552805,181830,734635
260740,202009,64,58,6,60610,6270,66880
260750,202009,603,420,183,438900,191235,630135
260760,202009,657,340,317,355300.23,333355,688655.23
260765,202009,981,506,475,528770,497420,1026190
260770,202009,221,163,58,171362,60610.5,231972.5
260775,202009,778,441,337,460846.25,355300,816146.25
260780,202009,248,158,90,165110,95095,260205
260790,202009,14164,7268,6896,7609695.47,7217816.67,14827512.14
260795,202009,168,109,59,113905,61655,175560
260800,202009,288,239,49,249755.5,51205,300960.5
260805,202009,175,117,58,122265,60610,182875
260810,202009,761,655,106,684475,110770,795245
260820,202009,286,184,102,192280.85,106590,298870.85
260825,202009,213,148,65,154660,67925,222585
260830,202009,303,184,119,195415,125400,320815
260840,202009,242,176,66,183920,68970,252890
260845,202009,175,119,56,124355,58520,182875
260850,202009,440,323,117,337535,122265,459800
260860,202009,251,189,62,197505,65835,263340
260870,202009,366,275,91,287375.29,95095,382470.29
260875,202009,730,518,212,542355,221540,763895
260880,202009,1599,1013,586,1059630,614460,1674090
260890,202009,2359,1665,694,1743061,727320,2470381
260900,202009,975,695,280,726275,292600,1018875
260910,202009,257,203,54,212135,56430,268565
260915,202009,291,214,77,223630,80465,304095
260920,202009,184,98,86,102410,91960,194370
260930,202009,393,334,59,349030,61655,410685
260940,202009,2701,1463,1238,1528836.4,1296846,2825682.4
260950,202009,2011,1151,860,1208020.75,899745,2107765.75
260960,202009,13702,6916,6786,7234543.08,7107048.76,14341591.84
260970,202009,422,353,69,368885,73150,442035
260980,202009,190,170,20,177650,20900,198550
260990,202009,2623,2117,506,2215401.35,528770,2744171.35
261000,202009,4270,2563,1707,2682515.75,1791130,4473645.75
261010,202009,165,119,46,124355,49115,173470
261020,202009,603,452,151,473385.99,157795,631180.99
261030,202009,263,177,86,184965,90915,275880
261040,202009,375,327,48,341715,50160,391875
261050,202009,507,436,71,456665,74195,530860
261060,202009,1394,891,503,934230.25,530860,1465090.25
261070,202009,8811,4322,4489,4520673.15,4698323.37,9218996.52
261080,202009,375,289,86,303050,89870,392920
261090,202009,2196,1683,513,1758738.95,536085.83,2294824.78
261100,202009,1158,812,346,850630.75,361570,1212200.75
261110,202009,8629,5267,3362,5511330.8,3523741,9035071.8
261120,202009,261,223,38,233035,39710,272745
261130,202009,568,340,228,355300,238260.55,593560.55
261140,202009,201,125,76,130625,79420,210045
261150,202009,683,424,259,443080.03,270655,713735.03
261153,202009,69,64,5,66880,5225,72105
261160,202009,74809,37047,37762,38775884.54,39539673.11,78315557.65
261170,202009,462,347,115,362615,120175,482790
261180,202009,1793,1119,674,1173535,706420,1879955
261190,202009,632,439,193,459800.9,201685,661485.9
261200,202009,214,183,31,191235,32395,223630
261210,202009,32,27,5,28215,5225,33440
261220,202009,2695,1898,797,1986546.12,834955,2821501.12
261230,202009,338,251,87,262295,90915,353210
261240,202009,455,398,57,415910,59565,475475
261245,202009,235,194,41,202730,42845,245575
261247,202009,172,134,38,140030,39710,179740
261250,202009,3156,1548,1608,1617660.5,1683495,3301155.5
261255,202009,245,221,24,230945,25080,256025
261260,202009,849,738,111,774345.06,115995,890340.06
261270,202009,200,143,57,150480,60610,211090
261280,202009,176,145,31,151525,33440,184965
261290,202009,115,83,32,86735,33440,120175
261300,202009,1280,938,342,981255,359480,1340735
261310,202009,810,544,266,568480,277970,846450
261320,202009,548,372,176,388740.7,183920,572660.7
261330,202009,962,737,225,770165,235125.29,1005290.29
261340,202009,298,165,133,172425,138985,311410
261350,202009,854,606,248,633270.5,260205,893475.5
261360,202009,1296,843,453,883025,475475,1358500
261370,202009,4833,2887,1946,3024231.5,2046111,5070342.5
261380,202009,551,418,133,436810.69,138985.5,575796.19
261390,202009,3603,2425,1178,2536216,1235190.75,3771406.75
261400,202009,294,266,28,279015,29260,308275
261410,202009,1090,721,369,755535,386650,1142185
261420,202009,882,546,336,571615.55,352165,923780.55
261430,202009,330,298,32,311410,33440,344850
261440,202009,117,108,9,112860,9405,122265
261450,202009,2538,2040,498,2134936.25,521455.5,2656391.75
261460,202009,727,578,149,604010.85,155705,759715.85
261470,202009,246,197,49,205865.5,51205,257070.5
261480,202009,443,345,98,361570,103407.97,464977.97
261485,202009,348,207,141,216315,147345,363660
261500,202009,610,415,195,433675.86,203775,637450.86
261510,202009,50,32,18,33440,18810,52250
261520,202009,101,89,12,93005,12540,105545
261530,202009,4132,2624,1508,2748351.98,1584220.75,4332572.73
261540,202009,1348,790,558,825550,585200,1410750
261550,202009,264,128,136,133760.5,142120,275880.5
261560,202009,848,561,287,587291.75,300960.5,888252.25
261570,202009,399,311,88,324995,91960,416955
261580,202009,379,295,84,308275,87780,396055
261590,202009,192,154,38,160930,39710,200640
261600,202009,290,231,59,241395,61655.5,303050.5
261610,202009,88,75,13,78375,13585,91960
261618,202009,73,58,15,60610,15675,76285
261620,202009,199,124,75,129580,78375,207955
261630,202009,553,433,120,452485,127490,579975
261640,202009,6404,3375,3029,3528968.09,3167395.75,6696363.84
261650,202009,481,304,177,318725,184965,503690
270010,202009,518,459,59,480734.83,62700,543434.83
270020,202009,286,233,53,244530,55385,299915
270030,202009,8840,5713,3127,5976358.28,3276075.5,9252433.78
270040,202009,2007,1265,742,1325060,778525,2103585
270050,202009,150,116,34,121220,35530,156750
270060,202009,112,61,51,63745,53295,117040
270070,202009,865,634,231,663575,242440,906015
270080,202009,37,31,6,32395,6270,38665
270090,202009,22,16,6,16720,6270,22990
270100,202009,1240,831,409,870485,430540,1301025
270110,202009,123,95,28,100320,29260,129580
270120,202009,229,188,41,196460,42845,239305
270130,202009,259,183,76,192280,79420,271700
270135,202009,117,73,44,76285,45980,122265
270140,202009,1370,866,504,906266.5,528770,1435036.5
270150,202009,256,203,53,212135,55385,267520
270160,202009,502,397,105,414865,109725,524590
270170,202009,797,518,279,541762.83,291555,833317.83
270180,202009,73,56,17,58520,17765,76285
270190,202009,90,77,13,80465,13585,94050
270200,202009,107,93,14,97185,14630,111815
270210,202009,516,291,225,306185,236170,542355
270220,202009,180,141,39,147345,40755.5,188100.5
270230,202009,2101,1284,817,1343871.6,854810,2198681.6
270235,202009,696,545,151,570570,157795,728365
270240,202009,3024,2398,626,2512843.25,657305.85,3170149.10
270250,202009,157,115,42,120175,43890,164065
270255,202009,216,187,29,195415,31350,226765
270260,202009,367,297,70,310365,74195,384560
270270,202009,99,43,56,44935,58520,103455
270280,202009,240,135,105,141075,109725,250800
270290,202009,1151,884,267,925870,281105,1206975
270300,202009,318,223,95,234080,100320,334400
270310,202009,855,698,157,731500,164065,895565
270320,202009,823,707,116,739860.79,122265,862125.79
270330,202009,299,252,47,263340,49115,312455
270340,202009,60,47,13,49115,13585,62700
270350,202009,90,49,41,51205,42845,94050
270360,202009,67,38,29,39710,30305,70015
270370,202009,57,46,11,48070,11495,59565
270375,202009,72,44,28,45980,29260,75240
270380,202009,1010,644,366,675070.5,385605,1060675.5
270390,202009,190,114,76,119130,80465,199595
270400,202009,710,528,182,554895.79,191235,746130.79
270410,202009,659,485,174,506825,181830,688655
270420,202009,404,281,123,293645,128535,422180
270430,202009,32884,23656,9228,24764283.6,9671004.07,34435287.67
270440,202009,487,385,102,402325,106590,508915
270450,202009,790,448,342,468160,357390,825550
270460,202009,189,151,38,158840,39710,198550
270470,202009,1474,1021,453,1066945,476520,1543465
270480,202009,545,452,93,472340.5,98230.5,570571.0
270490,202009,24,19,5,19855,5225,25080
270500,202009,489,411,78,429495,81510,511005
270510,202009,804,500,304,522500,317680,840180
270520,202009,293,189,104,197505,108680,306185
270530,202009,70,62,8,64790,8360,73150
270540,202009,109,85,24,88825,25080,113905
270550,202009,1738,1335,403,1396120,423225,1819345
270560,202009,268,145,123,153615,128535,282150
270570,202009,520,363,157,380380,165110,545490
270580,202009,97,72,25,75240,26125,101365
270590,202009,68,55,13,57475,13585,71060
270600,202009,177,147,30,153615,31350,184965
270610,202009,229,178,51,186010,55385,241395
270620,202009,28,27,1,28215,1045,29260
270630,202009,3758,2850,908,2982465.83,949905.5,3932371.33
270640,202009,873,649,224,678205,234080,912285
270642,202009,219,185,34,195415,35530,230945
270644,202009,252,161,91,169290,95095,264385
270650,202009,328,196,132,204820.5,137940,342760.5
270660,202009,243,203,40,212135,42845,254980
270670,202009,3062,2326,736,2434853.55,769120,3203973.55
270680,202009,434,260,174,271700,181830,453530
270690,202009,1180,775,405,810920.95,424270,1235190.95
270700,202009,28,23,5,24035,5225,29260
270710,202009,874,682,192,714780,202730,917510
270720,202009,243,192,51,200640,53295,253935
270730,202009,1856,1114,742,1164130.5,775390.25,1939520.75
270740,202009,43,30,13,31350,13585,44935
270750,202009,645,486,159,508949.83,167200,676149.83
270760,202009,289,210,79,219450,82555,302005
270770,202009,2761,1836,925,1925936.55,968715,2894651.55
270780,202009,79,51,28,53295,30305,83600
270790,202009,275,178,97,186010,101365,287375
270800,202009,1970,1585,385,1658415,405460,2063875
270810,202009,279,222,57,233035,59565,292600
270820,202009,139,95,44,99275,47025.5,146300.5
270830,202009,798,598,200,627000,209000,836000
270840,202009,1391,1052,339,1100385,356345.85,1456730.85
270850,202009,1502,938,564,980210.5,590425,1570635.5
270860,202009,2525,1672,853,1751455.29,894520,2645975.29
270870,202009,119,63,56,65835,58520,124355
270880,202009,896,701,195,733590,203775,937365
270890,202009,295,221,74,231990.5,78375,310365.5
270895,202009,63,54,9,56430,9405,65835
270900,202009,90,70,20,73150,20900,94050
270910,202009,305,248,57,259160,59565,318725
270915,202009,1900,1211,689,1265495.75,722096.1,1987591.85
270920,202009,475,399,76,416955,79420,496375
270930,202009,5914,4435,1479,4642935.5,1551825.03,6194760.53
270940,202009,2307,1803,504,1885180,526680,2411860
280010,202009,40,34,6,35530,6270,41800
280020,202009,478,413,65,431585.45,67925,499510.45
280030,202009,20587,13336,7251,13966452.73,7609695.97,21576148.70
280040,202009,331,217,114,226765,119130,345895
280050,202009,408,312,96,326040,100320,426360
280060,202009,353,226,127,236170.7,133760,369930.7
280067,202009,1071,769,302,803605,316635.62,1120240.62
280070,202009,123,99,24,103455,25080,128535
280100,202009,626,487,139,509960.65,145255,655215.65
280110,202009,75,70,5,73150,5225,78375
280120,202009,661,540,121,564300,126445,690745
280130,202009,1730,1136,594,1190255,622820.5,1813075.5
280140,202009,480,392,88,409640.5,91960,501600.5
280150,202009,392,282,110,295735,115995,411730
280160,202009,107,90,17,95095,17765,112860
280170,202009,396,275,121,288420.25,126445,414865.25
280190,202009,26,22,4,22990,4180,27170
280200,202009,29,25,4,26125,4180,30305
280210,202009,2933,2098,835,2193332.36,873621,3066953.36
280220,202009,39,31,8,32395,8360,40755
280230,202009,327,269,58,281105,60610,341715
280240,202009,120,114,6,119130,6270,125400
280250,202009,16,10,6,10450,6270,16720
280260,202009,81,73,8,76285,8360,84645
280270,202009,149,117,32,122265,34485,156750
280280,202009,192,122,70,127490.37,74195,201685.37
280290,202009,3331,2413,918,2522119.66,961400.1,3483519.76
280300,202009,1599,1245,354,1307296,372020,1679316
280310,202009,101,95,6,99275.5,6270,105545.5
280320,202009,648,460,188,483835,197505,681340
280330,202009,327,237,90,247665,94050,341715
280340,202009,406,331,75,345895,78375,424270
280350,202009,3678,2863,815,2993927.16,852721.52,3846648.68
280360,202009,475,314,161,328130.13,168245,496375.13
280370,202009,97,85,12,88825.65,12540,101365.65
280380,202009,54,43,11,44935,11495,56430
280390,202009,170,147,23,153615,24035,177650
280400,202009,353,244,109,254980.5,113905,368885.5
280410,202009,287,235,52,245575,54340,299915
280420,202009,171,142,29,150480,30305,180785
280430,202009,42,32,10,33440,10450,43890
280440,202009,698,549,149,573705.65,157795,731500.65
280445,202009,117,107,10,111815,10450,122265
280450,202009,1192,1031,161,1081575,168245,1249820
280460,202009,621,455,166,475476.63,173470,648946.63
280470,202009,183,171,12,179740,12540.75,192280.75
280480,202009,2692,1878,814,1964602.09,854810.82,2819412.91
280490,202009,263,249,14,262295.66,14630,276925.66
280500,202009,42,38,4,39710,4180,43890
280510,202009,139,113,26,118085,27170.5,145255.5
280520,202009,54,39,15,40755,15675,56430
280530,202009,76,48,28,51205,29260,80465
280540,202009,538,452,86,472340,89870,562210
280550,202009,731,677,54,708511.71,56430,764941.71
280560,202009,495,438,57,457710,59565,517275
280570,202009,2207,1727,480,1805760.7,502645,2308405.7
280580,202009,590,457,133,478610,140030.5,618640.5
280590,202009,211,133,78,140030,82555,222585
280600,202009,388,325,63,339625,66880,406505
280610,202009,112,86,26,89870,27170,117040
280620,202009,557,455,102,476520,106590,583110
280630,202009,153,127,26,132715,28215,160930
280640,202009,196,155,41,163020,42845,205865
280650,202009,91,60,31,62700,32395,95095
280660,202009,148,109,39,113905,40755,154660
280670,202009,1862,1168,694,1226832.78,726276.05,1953108.83
280680,202009,184,161,23,168245,24035,192280
280690,202009,79,70,9,73150,9405,82555
280700,202009,22,22,0,22990,0,22990
280710,202009,1469,1128,341,1179805,356345,1536150
280720,202009,113,72,41,75240,42845,118085
280730,202009,26,21,5,21945,5225,27170
280740,202009,2520,1879,641,1967108.5,669845,2636953.5
280750,202009,233,204,29,214225,30305,244530
280760,202009,786,543,243,567435,253935,821370
290010,202009,205,142,63,149435,65835,215270
290020,202009,184,166,18,173470,18810,192280
290030,202009,616,397,219,414865,228855,643720
290035,202009,132,107,25,111815,26125,137940
290040,202009,305,204,101,213180,105545,318725
290050,202009,86,66,20,68970,20900,89870
290060,202009,268,119,149,124355,156750,281105
290070,202009,5723,2761,2962,2888381.6,3100515.75,5988897.35
290080,202009,453,207,246,216315,258115,474430
290090,202009,388,177,211,184965,221540,406505
290100,202009,1643,1065,578,1112925,604011,1716936
290110,202009,831,481,350,502645.75,366795,869440.75
290115,202009,194,179,15,187055,15675,202730
290120,202009,763,504,259,526680,270655,797335
290130,202009,424,263,161,274835,168245,443080
290135,202009,303,229,74,239305,77330,316635
290140,202009,316,261,55,273790,57475,331265
290150,202009,137,97,40,102410,41800,144210
290160,202009,243,187,56,196460,58520,254980
290170,202009,93,67,26,70015,27170,97185
290180,202009,178,131,47,136895,49115,186010
290190,202009,438,361,77,377245,81510,458755
290195,202009,317,204,113,213180,120175,333355
290200,202009,272,222,50,231990,52250,284240
290205,202009,151,91,60,95095,62700,157795
290210,202009,1173,863,310,901835.5,323950,1225785.5
290220,202009,219,120,99,125400,103455,228855
290225,202009,286,116,170,121220,183920,305140
290230,202009,76,49,27,51205,28215,79420
290240,202009,359,132,227,137940,238260,376200
290250,202009,254,234,20,244530,20900,265430
290260,202009,325,267,58,279015.5,60610,339625.5
290265,202009,186,161,25,169290,26125,195415
290270,202009,1414,1180,234,1233100,246620.5,1479720.5
290280,202009,481,341,140,356345,146300,502645
290290,202009,1330,799,531,837045.97,555940.5,1392986.47
290300,202009,437,372,65,389785.5,67925,457710.5
290310,202009,299,136,163,142120,170335,312455
290320,202009,4008,2478,1530,2596825.3,1606165.1,4202990.4
290323,202009,192,165,27,172425,28215,200640
290327,202009,170,135,35,141075,36575,177650
290330,202009,108,56,52,58520,54340,112860
290340,202009,826,338,488,353210,512050,865260
290350,202009,631,385,246,402325.5,258115,660440.5
290360,202009,348,269,79,282151.64,83600,365751.64
290370,202009,916,389,527,406505.75,554895,961400.75
290380,202009,318,200,118,209000,123310,332310
290390,202009,2451,1524,927,1595716.75,971850,2567566.75
290395,202009,248,143,105,150480.25,109725,260205.25
290400,202009,270,202,68,211090.5,71060,282150.5
290405,202009,249,215,34,224675,35530,260205
290410,202009,624,523,101,547580.53,105545,653125.53
290420,202009,253,203,50,212135,52250,264385
290430,202009,478,313,165,327085,174515,501600
290440,202009,74,66,8,68970,8360,77330
290450,202009,203,154,49,160930,51205,212135
290460,202009,1960,1179,781,1235190,819280,2054470
290470,202009,1396,610,786,637450.5,821370,1458820.5
290475,202009,560,523,37,546535.2,39710,586245.2
290480,202009,287,163,124,170335,129580,299915
290485,202009,239,221,18,230945,18810,249755
290490,202009,1218,875,343,917510,358435,1275945
290500,202009,745,382,363,400235,380380,780615
290510,202009,227,178,49,186010,51205,237215
290515,202009,156,95,61,99275,63745,163020
290520,202009,1413,931,482,972895,504736.44,1477631.44
290530,202009,301,278,23,290510,24035,314545
290540,202009,104,55,49,57475,51205,108680
290550,202009,158,135,23,142120,25080,167200
290560,202009,3176,1380,1796,1444190,1888315,3332505
290570,202009,6225,3024,3201,3164261.9,3354452,6518713.9
290580,202009,1278,757,521,793155,545490,1338645
290590,202009,573,473,100,495330,104500,599830
290600,202009,1767,1216,551,1272810.63,575795,1848605.63
290610,202009,206,185,21,193325,21945,215270
290620,202009,358,322,36,336490,37620,374110
290630,202009,2003,850,1153,889295,1206975.5,2096270.5
290640,202009,151,122,29,127490,30305,157795
290650,202009,1813,840,973,878846.42,1018875,1897721.42
290660,202009,280,227,53,237215,55385,292600
290670,202009,937,484,453,506826,473385,980211
290680,202009,1229,989,240,1034550,252890,1287440
290682,202009,306,228,78,239305.8,81510,320815.8
290685,202009,239,157,82,164065,85690,249755
290687,202009,1047,680,367,710770.1,384560,1095330.1
290689,202009,146,78,68,81510,71060,152570
290690,202009,610,258,352,269610,369930,639540
290700,202009,245,121,124,126445,130625,257070
290710,202009,750,510,240,535040,251845,786885
290720,202009,1024,828,196,870485,204820,1075305
290730,202009,1163,670,493,700150.75,518320,1218470.75
290740,202009,18,15,3,15675,3135,18810
290750,202009,1423,637,786,665665,822416.54,1488081.54
290755,202009,72,65,7,67925,7315,75240
290760,202009,295,255,40,266475,41800,308275
290770,202009,185,174,11,181830,11495,193325
290780,202009,1110,852,258,890341,270655,1160996
290790,202009,364,254,110,265430,114950.5,380380.5
290800,202009,2479,1010,1469,1056495.5,1540330,2596825.5
290810,202009,465,321,144,335445,150480,485925
290820,202009,395,233,162,243485,169290,412775
290830,202009,424,303,121,316635,127490,444125
290840,202009,1754,1088,666,1136961.7,697015.5,1833977.2
290850,202009,834,441,393,462935,412775,875710
290860,202009,641,291,350,304095,369930.07,674025.07
290870,202009,629,448,181,468160.6,189145.6,657306.2
290880,202009,122,66,56,68970,58520,127490
290890,202009,387,263,124,274835,130625,405460
290900,202009,168,127,41,132715,42845,175560
290910,202009,388,296,92,309320,96140,405460
290920,202009,210,183,27,191235,28215,219450
290930,202009,822,624,198,654170.5,206910,861080.5
290940,202009,243,204,39,213180,41800,254980
290950,202009,156,94,62,98230,64790,163020
290960,202009,473,334,139,349030,145255,494285
290970,202009,247,215,32,224675,33440,258115
290980,202009,1626,1147,479,1199660.7,502646,1702306.7
290990,202009,388,327,61,343805,63745,407550
291000,202009,860,254,606,266475,636405,902880
291005,202009,2322,1012,1310,1058585,1368950.42,2427535.42
291010,202009,159,144,15,150480,15675,166155
291020,202009,101,81,20,84645,20900,105545
291030,202009,96,70,26,74195,27170,101365
291040,202009,615,344,271,359480,283195,642675
291050,202009,1432,793,639,829730,669845,1499575
291060,202009,1534,845,689,884070,723140,1607210
291070,202009,1968,1466,502,1531970.62,525635.62,2057606.24
291072,202009,7183,2676,4507,2804781.1,4722357.5,7527138.6
291075,202009,241,195,46,203775,48070,251845
291077,202009,57,39,18,40755,18810,59565
291080,202009,20287,8846,11441,9254522.46,11973611.27,21228133.73
291085,202009,296,243,53,253935,56430,310365
291090,202009,302,124,178,129580.5,187055,316635.5
291100,202009,659,202,457,211090,477565,688655
291110,202009,417,318,99,332310,104500,436810
291120,202009,2394,1198,1196,1252955.75,1261315,2514270.75
291125,202009,64,31,33,32395,34485,66880
291130,202009,200,177,23,186010,24035,210045
291140,202009,131,106,25,111815,26125.5,137940.5
291150,202009,391,148,243,154660,254980,409640
291160,202009,386,314,72,328130.25,75240,403370.25
291165,202009,43,35,8,36575,8360,44935
291170,202009,3166,1581,1585,1655281.67,1659460.5,3314742.17
291180,202009,1263,509,754,533995,790020,1324015
291185,202009,92,87,5,90915,5225,96140
291190,202009,1374,626,748,654170.25,782705,1436875.25
291200,202009,172,127,45,132715,47025,179740
291210,202009,2284,916,1368,960355.2,1432695.5,2393050.7
291220,202009,274,206,68,215270,71060,286330
291230,202009,982,340,642,355300.5,674025,1029325.5
291240,202009,429,400,29,419045.5,30305,449350.5
291250,202009,438,354,84,370975,87780,458755
291260,202009,59,49,10,51205,10450,61655
291270,202009,1157,480,677,501600,709555,1211155
291280,202009,356,169,187,176605,197505,374110
291290,202009,1729,896,833,938410.5,871530.5,1809941.0
291300,202009,232,185,47,193325,49115,242440
291310,202009,223,201,22,210045,22990,233035
291320,202009,1364,958,406,1002155,425315,1427470
291330,202009,133,114,19,119130,19855,138985
291340,202009,207,122,85,127490,88825,216315
291345,202009,131,91,40,95095,41800,136895
291350,202009,1643,580,1063,606100,1113970.75,1720070.75
291360,202009,8387,4050,4337,4234340.75,4548886.75,8783227.50
291370,202009,1123,649,474,680296,496375,1176671
291380,202009,270,212,58,221540,60610,282150
291390,202009,3907,1712,2195,1793221.4,2302135.5,4095356.9
291400,202009,2081,1485,596,1551825,624910.84,2176735.84
291410,202009,192,168,24,175560,25080,200640
291420,202009,119,87,32,90915,33440,124355
291430,202009,167,90,77,95095,80465.02,175560.02
291440,202009,518,426,92,446215.95,97185,543400.95
291450,202009,925,594,331,621775.25,346940,968715.25
291460,202009,1857,1514,343,1584220.5,358435.5,1942656.0
291465,202009,2178,1039,1139,1086800.5,1194435,2281235.5
291470,202009,2870,1450,1420,1516295.97,1489125.5,3005421.47
291480,202009,11825,5237,6588,5484164.88,6906407.75,12390572.63
291490,202009,613,245,368,257070,386650,643720
291500,202009,377,222,155,231990,161975,393965
291510,202009,1219,474,745,495330,780615,1275945
291520,202009,946,430,516,449350,540265,989615
291530,202009,936,252,684,263340,715825,979165
291535,202009,124,102,22,106590,22990,129580
291540,202009,351,108,243,112860.5,253935,366795.5
291550,202009,1228,582,646,608190,675070.5,1283260.5
291560,202009,5271,2650,2621,2773430,2744171,5517601
291570,202009,199,105,94,109725,98230,207955
291580,202009,1199,740,459,773300.55,480700,1254000.55
291590,202009,88,36,52,37620,55385.5,93005.5
291600,202009,1140,566,574,591470.25,604010,1195480.25
291610,202009,1454,704,750,736725,784795,1521520
291620,202009,562,260,302,271700,317680,589380
291630,202009,483,149,334,155705,350075,505780
291640,202009,3964,2020,1944,2115082.2,2034616.5,4149698.7
291650,202009,427,290,137,303051.12,143165,446216.12
291660,202009,391,158,233,165110.29,243485,408595.29
291670,202009,226,137,89,143165,93005,236170
291680,202009,654,392,262,410685,275880.5,686565.5
291685,202009,586,327,259,341715,270655,612370
291690,202009,527,317,210,332310,220495.27,552805.27
291700,202009,979,763,216,797335,226765,1024100
291710,202009,1634,789,845,825550,887205.5,1712755.5
291720,202009,428,289,139,302005,145255,447260
291730,202009,935,549,386,578930,405460,984390
291733,202009,290,197,93,205865,97185,303050
291735,202009,75,57,18,59565,19855,79420
291740,202009,357,274,83,287375,86735,374110
291750,202009,2151,1403,748,1467180.38,785840,2253020.38
291760,202009,2957,1639,1318,1715890,1382535,3098425
291770,202009,783,526,257,551761.05,268565,820326.05
291780,202009,59,37,22,38665,22990,61655
291790,202009,160,81,79,84645,82555,167200
291800,202009,10037,4145,5892,4335708.09,6169681.5,10505389.59
291810,202009,1110,828,282,865260.5,296780,1162040.5
291820,202009,281,200,81,209000,84645,293645
291830,202009,1050,420,630,438901.46,659395,1098296.46
291835,202009,566,525,41,549670,42845,592515
291840,202009,4850,2454,2396,2573835.75,2517405.5,5091241.25
291845,202009,272,88,184,93005,192280,285285
291850,202009,327,290,37,303050,38665,341715
291855,202009,265,106,159,110770,166155,276925
291860,202009,171,108,63,112860,65835,178695
291870,202009,84,35,49,36575,51205,87780
291875,202009,178,165,13,172425,13585,186010
291880,202009,456,363,93,379335,97185,476520
291890,202009,244,78,166,81510,173470.5,254980.5
291900,202009,59,34,25,35530,26125,61655
291905,202009,127,92,35,96140.5,36575,132715.5
291910,202009,162,132,30,137940,31350,169290
291915,202009,434,386,48,403370.25,50160,453530.25
291920,202009,5106,2556,2550,2674155.5,2667885.5,5342041.0
291930,202009,171,101,70,105545.55,73150,178695.55
291940,202009,359,206,153,215270.5,161975,377245.5
291950,202009,1149,928,221,970806,234080,1204886
291955,202009,1248,744,504,777480,527725.44,1305205.44
291960,202009,191,137,54,143165,56430,199595
291970,202009,761,578,183,605055,191235,796290
291980,202009,1504,1331,173,1391941.23,180785.5,1572726.73
291990,202009,134,124,10,129580,10450,140030
291992,202009,174,90,84,94050,87780,181830
291995,202009,185,121,64,126445,66880,193325
292000,202009,399,304,95,318725,99275,418000
292010,202009,315,219,96,229900,100320,330220
292020,202009,301,221,80,230945,83600,314545
292030,202009,146,113,33,118085,34485,152570
292040,202009,631,320,311,334400,324995,659395
292045,202009,108,97,11,101365,11495,112860
292050,202009,949,691,258,722095,271700.5,993795.5
292060,202009,908,746,162,780615.65,169290,949905.65
292070,202009,57,19,38,19855,39710,59565
292080,202009,139,95,44,100320,45980,146300
292090,202009,543,188,355,197505,373065,570570
292100,202009,1473,628,845,658350,884070,1542420
292105,202009,192,170,22,177650,22990,200640
292110,202009,2274,820,1454,856900,1523610,2380510
292120,202009,698,551,147,575795,153615,729410
292130,202009,441,248,193,259160,201685,460845
292140,202009,210,170,40,178695,41800,220495
292145,202009,162,86,76,89870,79420,169290
292150,202009,1478,1206,272,1260270,284240,1544510
292160,202009,171,139,32,145255,33440,178695
292170,202009,1207,1050,157,1098295.5,166155,1264450.5
292180,202009,219,161,58,168245,60610,228855
292190,202009,162,105,57,109725,59565,169290
292200,202009,1344,490,854,513095,895565.5,1408660.5
292205,202009,125,109,16,113905,16720,130625
292210,202009,366,255,111,267520,115995.25,383515.25
292220,202009,29,22,7,22990,7315,30305
292225,202009,41,35,6,36575,6270,42845
292230,202009,963,763,200,800470.75,209000,1009470.75
292240,202009,612,440,172,459800.75,179740,639540.75
292250,202009,1727,1134,593,1186075,620730,1806805
292260,202009,412,248,164,259160,171380,430540
292265,202009,251,180,71,188100,74195,262295
292270,202009,739,336,403,351120,422180,773300
292273,202009,209,114,95,119130,99275,218405
292275,202009,173,86,87,89870,90915,180785
292280,202009,143,99,44,103455,45980,149435
292285,202009,77,63,14,65835,14630,80465
292290,202009,578,391,187,408595,195415.5,604010.5
292300,202009,1685,632,1053,660440,1101430.3,1761870.3
292303,202009,112,73,39,76285,40755,117040
292305,202009,114,85,29,88825,30305,119130
292310,202009,929,603,326,632226.25,340670.9,972897.15
292320,202009,598,456,142,477565,148390,625955
292330,202009,177,101,76,106590,79420,186010
292335,202009,280,220,60,231990,63745,295735
292340,202009,579,403,176,422180,183920,606100
292350,202009,273,147,126,153615,131670,285285
292360,202009,709,540,169,564300.9,176605,740905.9
292370,202009,738,567,171,593560,178695,772255
292380,202009,638,518,120,541310.35,127490,668800.35
292390,202009,463,189,274,197505,292600,490105
292400,202009,3619,2231,1388,2337668.11,1457775.5,3795443.61
292405,202009,266,175,91,182875,95095,277970
292410,202009,136,84,52,88825,55385,144210
292420,202009,294,255,39,266475,40755,307230
292430,202009,540,406,134,424270,140030,564300
292440,202009,598,512,86,535040.16,89870,624910.16
292450,202009,246,192,54,200640,56430,257070
292460,202009,553,414,139,433675.95,147345,581020.95
292465,202009,210,176,34,184965,35530,220495
292467,202009,132,80,52,83600,54340,137940
292470,202009,289,198,91,206910,95095,302005
292480,202009,365,251,114,263340,119130.5,382470.5
292490,202009,236,165,71,172425,74195,246620
292500,202009,870,385,485,403370.15,507870,911240.15
292510,202009,3452,1597,1855,1669910.6,1944745,3614655.6
292520,202009,1088,512,576,536085,602965,1139050
292525,202009,397,283,114,295735,120175,415910
292530,202009,4404,1771,2633,1853830.96,2758801.5,4612632.46
292540,202009,481,268,213,280060,223630,503690
292550,202009,1098,583,515,611325,540265,1151590
292560,202009,332,310,22,323950,22990,346940
292570,202009,306,239,67,249755,70015,319770
292575,202009,489,326,163,340670.76,172425,513095.76
292580,202009,994,657,337,687610,354255.5,1041865.5
292590,202009,565,492,73,516230,76285,592515
292593,202009,141,112,29,117040,30305,147345
292595,202009,202,156,46,163020,48070,211090
292600,202009,1256,911,345,953040.29,360525,1313565.29
292610,202009,133,102,31,106590,32395,138985
292620,202009,525,442,83,461890,87780,549670
292630,202009,1434,804,630,840180.42,658350,1498530.42
292640,202009,832,575,257,600875,268565,869440
292650,202009,191,159,32,166155.5,33440,199595.5
292660,202009,2026,1454,572,1521520,598785.42,2120305.42
292665,202009,147,104,43,108680,44935,153615
292670,202009,391,316,75,330220,78375,408595
292680,202009,260,194,66,202730,68970.5,271700.5
292690,202009,194,143,51,150480,53295,203775
292700,202009,980,649,331,679250.55,346940,1026190.55
292710,202009,116,101,15,105545,15675,121220
292720,202009,929,527,402,550715,422180,972895
292730,202009,196,92,104,96140,108680,204820
292740,202009,68702,33516,35186,35086937.61,36862386.33,71949323.94
292750,202009,388,273,115,285285.95,120175,405460.95
292760,202009,339,280,59,293646.45,61655,355301.45
292770,202009,837,355,482,370975,504735,875710
292780,202009,413,162,251,170335,263340,433675
292790,202009,777,393,384,410685,401280,811965
292800,202009,1264,755,509,788975,531905,1320880
292805,202009,397,121,276,126445,291555,418000
292810,202009,1498,849,649,890341.5,678205,1568546.5
292820,202009,718,600,118,627001.25,123310,750311.25
292830,202009,109,89,20,93005,20900,113905
292840,202009,686,562,124,588335,129580,717915
292850,202009,143,95,48,99275,50160,149435
292860,202009,2153,1263,890,1322970.5,933185,2256155.5
292870,202009,3497,2334,1163,2446345.45,1216380,3662725.45
292880,202009,1497,985,512,1029325.05,535040,1564365.05
292890,202009,517,440,77,460845,80465,541310
292895,202009,139,94,45,98230,47025,145255
292900,202009,385,275,110,287375.4,114950,402325.4
292905,202009,480,241,239,251845,249755,501600
292910,202009,460,345,115,360525.75,120175,480700.75
292920,202009,519,228,291,238260,306185,544445
292925,202009,496,456,40,476520,41800,518320
292930,202009,622,378,244,395010,257070,652080
292935,202009,284,123,161,128535,168245,296780
292937,202009,227,158,69,165110,73150,238260
292940,202009,190,147,43,153615,44935,198550
292950,202009,1174,590,584,616550.75,610280.6,1226831.35
292960,202009,580,411,169,429495,177650,607145
292970,202009,245,173,72,180785,76285,257070
292975,202009,113,65,48,67925,50160,118085
292980,202009,285,194,91,202730.52,95095,297825.52
292990,202009,1331,990,341,1034551.55,357390,1391941.55
293000,202009,114,79,35,82555,36575,119130
293010,202009,2805,1669,1136,1745151.25,1187120.72,2932271.97
293015,202009,639,520,119,543400,125400,668800
293020,202009,330,271,59,283195,61655,344850
293030,202009,601,523,78,546535,81510,628045
293040,202009,357,282,75,294690,79420,374110
293050,202009,2881,1705,1176,1784860.5,1233100.5,3017961.0
293060,202009,260,209,51,218405.6,54340,272745.6
293070,202009,3487,1759,1728,1840247.72,1809941.75,3650189.47
293075,202009,91,61,30,63745,31350,95095
293076,202009,74,53,21,55385,21945,77330
293077,202009,509,295,214,309320.5,224675,533995.5
293080,202009,441,397,44,415910.85,45980,461890.85
293090,202009,130,117,13,122265,13585,135850
293100,202009,524,365,159,383515,166155,549670
293105,202009,344,250,94,262295,98230,360525
293110,202009,165,116,49,121220,51205,172425
293120,202009,310,211,99,220495,103455,323950
293130,202009,245,169,76,176605,79420,256025
293135,202009,8073,3173,4900,3318921.75,5131998.5,8450920.25
293140,202009,212,132,80,137940,83600,221540
293150,202009,329,284,45,296780,47025,343805
293160,202009,424,254,170,266475,180785,447260
293170,202009,177,121,56,126445,58520,184965
293180,202009,525,371,154,387695.5,160930,548625.5
293190,202009,1342,933,409,977075.61,429495,1406570.61
293200,202009,547,481,66,503690,68970,572660
293210,202009,392,296,96,310365,100320,410685
293220,202009,2481,1050,1431,1099340,1499575,2598915
293230,202009,1744,641,1103,670890.94,1159950,1830840.94
293240,202009,234,215,19,225720,19855,245575
293245,202009,126,107,19,111815,19855,131670
293250,202009,723,259,464,270655.9,485925,756580.9
293260,202009,305,254,51,265430,53295,318725
293270,202009,1158,536,622,560120.25,651035,1211155.25
293280,202009,277,154,123,160930,128535,289465
293290,202009,3044,1985,1059,2076415,1111880,3188295
293300,202009,739,528,211,552805.75,221540,774345.75
293305,202009,195,153,42,159885,43890,203775
293310,202009,151,114,37,119130,39710,158840
293315,202009,163,128,35,133760,36575,170335
293317,202009,89,64,25,66880,26125,93005
293320,202009,1059,582,477,608190.92,498465,1106655.92
293325,202009,181,67,114,70015,119130,189145
293330,202009,13722,6402,7320,6695318.41,7674483.25,14369801.66
293340,202009,273,195,78,203775,81510,285285
293345,202009,247,201,46,210045,49115,259160
293350,202009,612,352,260,369930,274835,644765
293360,202009,1528,1092,436,1142185,456665,1598850
310010,202009,137,75,62,78375,64790.5,143165.5
310020,202009,1036,570,466,595650,486970,1082620
310030,202009,326,261,65,273790,67925,341715
310040,202009,43,29,14,30305,14630,44935
310050,202009,178,111,67,115995.5,70015,186010.5
310060,202009,249,171,78,178695.5,81510,260205.5
310070,202009,15,10,5,10450,5225,15675
310080,202009,40,25,15,26125,15675,41800
310090,202009,1023,532,491,556987,513096,1070083
310100,202009,306,223,83,234080,86735,320815
310110,202009,706,387,319,406505,334400,740905
310120,202009,380,218,162,227810,169290,397100
310130,202009,33,19,14,19855,14630,34485
310140,202009,26,13,13,13585,13585,27170
310150,202009,1195,814,381,851675.5,400236,1251911.5
310160,202009,2061,1007,1054,1052317.15,1106655.5,2158972.65
310163,202009,84,47,37,49115,38665,87780
310170,202009,2549,1121,1428,1177715.85,1501667,2679382.85
310180,202009,149,54,95,56430,99275,155705
310190,202009,483,330,153,344850,159885,504735
310200,202009,488,310,178,324995,186010,511005
310205,202009,58,40,18,41800,18810,60610
310210,202009,285,229,56,239305,58520,297825
310220,202009,60,33,27,34485,28215,62700
310230,202009,278,192,86,200640,89870,290510
310240,202009,107,94,13,98230,13585,111815
310250,202009,98,80,18,83600,18810,102410
310260,202009,769,405,364,423226.17,381425,804651.17
310270,202009,270,175,95,184965.6,99275,284240.6
310280,202009,378,276,102,289465,106590,396055
310285,202009,207,151,56,158840,59565,218405
310290,202009,240,128,112,133760,117040,250800
310300,202009,157,128,29,133760,30305,164065
310310,202009,9,7,2,7315,2090,9405
310320,202009,27,10,17,10450,17765,28215
310330,202009,41,27,14,28215,14630,42845
310340,202009,1747,1149,598,1201543,625955.5,1827498.5
310350,202009,2783,1481,1302,1551825,1362680,2914505
310360,202009,41,34,7,35530,7315,42845
310370,202009,115,95,20,99275,20900,120175
310375,202009,102,38,64,40755,66880,107635
310380,202009,46,26,20,27170,20900,48070
310390,202009,96,63,33,65835,34485,100320
310400,202009,2347,1509,838,1581086,876859.5,2457945.5
310410,202009,126,69,57,72105,59565,131670
310420,202009,664,349,315,364705,329175,693880
310430,202009,307,192,115,200640,120175,320815
310440,202009,75,42,33,43890,34485,78375
310445,202009,80,65,15,67925,15675,83600
310450,202009,622,383,239,400235,249755,649990
310460,202009,258,181,77,189145,80465,269610
310470,202009,507,321,186,335445,196460,531905
310480,202009,79,53,26,55385,27170,82555
310490,202009,534,247,287,259160,299915,559075
310500,202009,137,54,83,56430,86735,143165
310510,202009,601,418,183,436810,191235,628045
310520,202009,135,94,41,98230,42845,141075
310530,202009,109,46,63,48070,65835,113905
310540,202009,475,274,201,287375,210045,497420
310550,202009,73,48,25,50160,26125,76285
310560,202009,2969,2043,926,2139115.25,969760,3108875.25
310570,202009,87,59,28,61655,29260,90915
310590,202009,370,236,134,246620.25,141075,387695.25
310600,202009,149,82,67,85690.5,70015,155705.5
310610,202009,57,22,35,22990,36575,59565
310620,202009,46969,22339,24630,23393307.33,25798965.9,49192273.23
310630,202009,649,399,250,418000,261250.5,679250.5
310640,202009,127,99,28,103455,29260,132715
310650,202009,162,144,18,150480,18810,169290
310660,202009,97,65,32,67925,33440,101365
310665,202009,61,46,15,48070,15675,63745
310670,202009,6705,2863,3842,2993927.5,4026385.5,7020313.0
310680,202009,56,35,21,36575,21945,58520
310690,202009,615,426,189,446215.25,197505,643720.25
310700,202009,58,38,20,39710,20900,60610
310710,202009,1326,904,422,946770.5,444125.5,1390896.0
310720,202009,136,35,101,36575,105545,142120
310730,202009,1464,1001,463,1047091.25,483835,1530926.25
310740,202009,966,537,429,561166,448305.25,1009471.25
310750,202009,242,147,95,153615.65,100320,253935.65
310760,202009,64,47,17,49115,17765.5,66880.5
310770,202009,88,45,43,47025,44935,91960
310780,202009,364,294,70,307230,74195,381425
310790,202009,102,83,19,86735,19855,106590
310800,202009,445,209,236,218405.25,248710,467115.25
310810,202009,170,121,49,126445.72,51205,177650.72
310820,202009,335,264,71,275880,75240,351120
310825,202009,192,163,29,170335,30305,200640
310830,202009,473,224,249,234080.5,261250,495330.5
310840,202009,367,214,153,223630,160930,384560
310850,202009,79,64,15,66880,15675,82555
310855,202009,394,313,81,327085,84645,411730
310860,202009,1585,1166,419,1219517.5,437856.25,1657373.75
310870,202009,53,43,10,44935,10450,55385
310880,202009,83,64,19,66880,19855,86735
310890,202009,309,174,135,181830,141075,322905
310900,202009,658,301,357,314554.86,373077.96,687632.82
310910,202009,240,162,78,169290.5,81510,250800.5
310920,202009,453,267,186,280061.45,194370.5,474431.95
310925,202009,34,28,6,29260,6270,35530
310930,202009,1294,820,474,860035,496375,1356410
310940,202009,703,350,353,365750,368885,734635
310945,202009,119,74,45,78375,47025,125400
310950,202009,229,183,46,191235,48070,239305
310960,202009,77,24,53,25080,55385,80465
310970,202009,166,102,64,106590,66880.5,173470.5
310980,202009,48,30,18,31350,18810,50160
310990,202009,164,83,81,86735,84645,171380
311000,202009,817,402,415,423226.49,435765.5,858991.99
311010,202009,49,43,6,44935,6270,51205
311020,202009,46,28,18,29260,18810,48070
311030,202009,389,226,163,236170.5,170335,406505.5
311040,202009,41,31,10,32395,10450,42845
311050,202009,484,188,296,197505,311410,508915
311060,202009,778,431,347,450395,362615.5,813010.5
311070,202009,338,151,187,157795,196460,354255
311080,202009,108,58,50,61655,52250,113905
311090,202009,339,157,182,164065,190190,354255
311100,202009,581,350,231,366795,241395,608190
311110,202009,693,485,208,506825,217360,724185
311115,202009,71,50,21,52250,21945,74195
311120,202009,1068,571,497,596695.5,521455,1118150.5
311130,202009,337,203,134,212135,141075,353210
311140,202009,168,90,78,94050,82555,176605
311150,202009,346,223,123,233035,128535,361570
311160,202009,716,511,205,533995.5,214225,748220.5
311170,202009,86,68,18,71060,18810,89870
311180,202009,332,219,113,229900,118085.5,347985.5
311190,202009,43,21,22,21945,22990,44935
311200,202009,329,230,99,240350,103455,343805
311205,202009,33,23,10,24035,10450,34485
311210,202009,44,38,6,40755.5,6270,47025.5
311220,202009,29,24,5,25080,5225,30305
311230,202009,1634,1076,558,1126510.5,585200,1711710.5
311240,202009,187,120,67,125400,70015,195415
311250,202009,53,20,33,20900,34485,55385
311260,202009,551,347,204,362615,213180,575795
311265,202009,122,83,39,86735,40755,127490
311270,202009,288,195,93,204820,97185,302005
311280,202009,211,96,115,101365,120175,221540
311290,202009,103,84,19,87780,19855,107635
311300,202009,582,365,217,382470,226765,609235
311310,202009,21,16,5,16720,5225,21945
311320,202009,655,485,170,506825,178695,685520
311330,202009,1077,793,284,829730,297825.5,1127555.5
311340,202009,2630,1858,772,1945791,808830,2754621
311350,202009,275,213,62,222585,64790,287375
311360,202009,176,106,70,111815,73150,184965
311370,202009,1222,497,725,519365.25,758670,1278035.25
311380,202009,7,6,1,6270,1045,7315
311390,202009,250,136,114,142120,119130,261250
311400,202009,137,86,51,89870,53295,143165
311410,202009,115,59,56,61655,58520,120175
311420,202009,301,164,137,171380,143165,314545
311430,202009,846,561,285,586245,299915.5,886160.5
311440,202009,460,324,136,338580,142120,480700
311450,202009,314,189,125,197505,131670,329175
311455,202009,280,192,88,200640,91960,292600
311460,202009,138,61,77,63745,81510,145255
311470,202009,24,13,11,13585,11495,25080
311480,202009,49,23,26,24035,27170,51205
311490,202009,13,9,4,9405,4180,13585
311500,202009,24,11,13,11495,13585,25080
311510,202009,636,436,200,456665,210045,666710
311520,202009,39,31,8,33440,8360,41800
311530,202009,1806,1323,483,1385671.7,506825,1892496.7
311535,202009,64,44,20,45980,20900,66880
311540,202009,34,30,4,31350,4180,35530
311545,202009,170,125,45,130625,47025,177650
311547,202009,36,30,6,31350,6270,37620
311550,202009,702,321,381,335445,399190,734635
311560,202009,42,28,14,29260,14630,43890
311570,202009,284,188,96,196460,100320,296780
311580,202009,335,195,140,203775,146300,350075
311590,202009,32,29,3,30305,3135,33440
311600,202009,107,83,24,86735,25080,111815
311610,202009,253,216,37,225720.25,38665,264385.25
311615,202009,83,67,16,70015,16720,86735
311620,202009,25,14,11,14630,11495,26125
311630,202009,88,74,14,77330,14630,91960
311640,202009,137,65,72,68970,75240,144210
311650,202009,117,78,39,81510,40755,122265
311660,202009,406,197,209,205865,218405,424270
311670,202009,152,101,51,105545,53295,158840
311680,202009,207,153,54,159885,56430,216315
311690,202009,16,12,4,12540,4180,16720
311700,202009,195,137,58,143165,61655,204820
311710,202009,197,132,65,137940,70015,207955
311720,202009,43,31,12,32395.5,12540,44935.5
311730,202009,568,385,183,403370,192280,595650
311740,202009,33,23,10,24035,10450,34485
311750,202009,722,484,238,507870.76,251845,759715.76
311760,202009,66,29,37,30305,38665,68970
311770,202009,389,197,192,205865.5,200640,406505.5
311780,202009,177,88,89,91960.5,93005,184965.5
311783,202009,86,77,9,80465,9405,89870
311787,202009,35,12,23,12540,24035,36575
311790,202009,259,114,145,119130,151525,270655
311800,202009,683,446,237,466070.95,249755,715825.95
311810,202009,48,39,9,40755,9405,50160
311820,202009,118,96,22,101365,22990,124355
311830,202009,1888,1162,726,1216381,762850,1979231
311840,202009,1006,561,445,589381,467115.25,1056496.25
311850,202009,12,8,4,8360,4180,12540
311860,202009,9561,4141,5420,4337797.25,5684800.5,10022597.75
311870,202009,124,66,58,68970,60610,129580
311880,202009,928,673,255,703285,266475,969760
311890,202009,202,99,103,103369,107635,211004
311900,202009,74,30,44,31350,45980,77330
311910,202009,1401,878,523,917510.75,546535.5,1464046.25
311920,202009,234,152,82,158840,85690,244530
311930,202009,900,512,388,536085.5,406505,942590.5
311940,202009,2490,1298,1192,1356410,1247730.15,2604140.15
311950,202009,55,40,15,41800,15675,57475
311960,202009,60,44,16,45980,16720,62700
311970,202009,24,15,9,15675,9405,25080
311980,202009,44,34,10,35530,10450,45980
311990,202009,38,29,9,30305,9405,39710
311995,202009,57,36,21,37620,21945,59565
312000,202009,31,21,10,21945,10450,32395
312010,202009,78,61,17,63745,18810,82555
312015,202009,76,57,19,59565,19855,79420
312020,202009,128,86,42,90915,43890,134805
312030,202009,59,44,15,45980,15675,61655
312040,202009,85,51,34,53295.5,35530,88825.5
312050,202009,203,113,90,118085,95095,213180
312060,202009,22,12,10,12540,10450,22990
312070,202009,74,48,26,50160,27170,77330
312080,202009,525,237,288,247665,304095,551760
312083,202009,57,36,21,38665,21945,60610
312087,202009,103,80,23,83600,24035,107635
312090,202009,3196,1896,1300,1987591.5,1360590.5,3348182.0
312100,202009,149,105,44,109484.65,47025,156509.65
312110,202009,121,69,52,72105,54340,126445
312120,202009,137,100,37,105545.29,38665,144210.29
312125,202009,90,50,40,52250,41800,94050
312130,202009,129,84,45,87780,47025,134805
312140,202009,136,106,30,110770.5,31350,142120.5
312150,202009,42,32,10,33440,10450,43890
312160,202009,1554,1021,533,1071221,556985.5,1628206.5
312170,202009,10,8,2,8360,2090,10450
312180,202009,113,70,43,73150,44935,118085
312190,202009,34,30,4,31350,4180,35530
312200,202009,754,642,112,674025.5,117040,791065.5
312210,202009,111,60,51,62700,53295,115995
312220,202009,134,103,31,107635.25,32395,140030.25
312230,202009,3641,1680,1961,1757690.4,2055516,3813206.4
312235,202009,156,105,51,110770,53295,164065
312240,202009,96,68,28,71060,29260,100320
312245,202009,192,130,62,135850,64790,200640
312247,202009,72,50,22,52250,22990,75240
312250,202009,176,83,93,86735,97185,183920
312260,202009,109,71,38,74195,39710,113905
312270,202009,132,77,55,80465,57475,137940
312280,202009,27,14,13,14630,13585,28215
312290,202009,146,104,42,108680,43890,152570
312300,202009,208,135,73,142120,76285,218405
312310,202009,62,55,7,57475,7315,64790
312320,202009,424,268,156,280060,164065.75,444125.75
312330,202009,90,79,11,83600,11495,95095
312340,202009,36,17,19,17765,19855,37620
312350,202009,16,9,7,9405,7315,16720
312352,202009,91,68,23,71060,24035,95095
312360,202009,581,245,336,256025,351120,607145
312370,202009,312,173,139,181830,145255,327085
312380,202009,137,91,46,95095,48070,143165
312385,202009,162,129,33,134805,34485,169290
312390,202009,297,186,111,194370,115995.5,310365.5
312400,202009,380,284,96,297825,101365.5,399190.5
312410,202009,994,315,679,330220.5,710600.5,1040821.0
312420,202009,623,476,147,497420.5,154660,652080.5
312430,202009,863,629,234,657306.11,246620,903926.11
312440,202009,41,30,11,31350,11495,42845
312450,202009,207,131,76,136895,80465,217360
312460,202009,31,16,15,16720,15675,32395
312470,202009,45,31,14,32395,14630,47025
312480,202009,190,117,73,122265,76285,198550
312490,202009,268,187,81,195415,84645,280060
312500,202009,35,20,15,20900,15675,36575
312510,202009,519,204,315,214225,329175,543400
312520,202009,30,9,21,9405,21945,31350
312530,202009,46,31,15,32395,15675,48070
312540,202009,94,82,12,85690,12540,98230
312550,202009,35,28,7,29260,7315,36575
312560,202009,214,161,53,168245.5,55385,223630.5
312570,202009,426,251,175,263340,182875,446215
312580,202009,87,47,40,49115,41800,90915
312590,202009,245,195,50,205865,52250,258115
312595,202009,133,119,14,124355,14630,138985
312600,202009,66,36,30,37620.25,31350,68970.25
312610,202009,1599,814,785,852722.5,821370.5,1674093.0
312620,202009,212,151,61,157795,63745,221540
312630,202009,69,58,11,60610,11495,72105
312640,202009,40,11,29,11495,30305,41800
312650,202009,148,122,26,127490.5,27170,154660.5
312660,202009,92,65,27,67925.76,28215,96140.76
312670,202009,920,592,328,618640,343805,962445
312675,202009,28,23,5,24035,5225,29260
312680,202009,75,45,30,47025,31350,78375
312690,202009,242,125,117,131670,122265,253935
312695,202009,28,24,4,25080,4180,29260
312700,202009,227,131,96,136895,101365,238260
312705,202009,81,65,16,67925,16720,84645
312707,202009,128,88,40,93005,41800,134805
312710,202009,1866,994,872,1041865.91,913330,1955195.91
312720,202009,58,31,27,32395,28215,60610
312730,202009,288,167,121,174515,126445,300960
312733,202009,47,38,9,39710,9405,49115
312735,202009,22,14,8,14630,8360,22990
312737,202009,63,35,28,36575,29260,65835
312738,202009,59,40,19,41800,19855,61655
312740,202009,83,54,29,56430,30305,86735
312750,202009,90,62,28,64790,29260,94050
312760,202009,289,207,82,216315,85690,302005
312770,202009,8080,3671,4409,3843514.75,4619945,8463459.75
312780,202009,446,340,106,356345,110770,467115
312790,202009,22,16,6,16720,6270,22990
312800,202009,1589,1103,486,1157860.75,509960.65,1667821.40
312810,202009,368,235,133,245575,138985,384560
312820,202009,187,144,43,150480,45980,196460
312825,202009,24,16,8,16720,8360,25080
312830,202009,230,131,99,136895,103455,240350
312840,202009,158,107,51,111815,54340,166155
312850,202009,45,39,6,40755,6270,47025
312860,202009,156,98,58,102410,60610,163020
312870,202009,1064,553,511,579976.25,536085,1116061.25
312880,202009,125,87,38,91960,39710,131670
312890,202009,154,110,44,114950,45980,160930
312900,202009,195,146,49,152570,51205,203775
312910,202009,179,94,85,98230,88825,187055
312920,202009,153,84,69,87780,72105,159885
312930,202009,324,225,99,235125,104500,339625
312940,202009,120,83,37,86735,38665,125400
312950,202009,696,475,221,496375.69,230945,727320.69
312960,202009,166,124,42,129580.9,43890,173470.9
312965,202009,76,64,12,66880,12540,79420
312970,202009,275,226,49,236170.25,51205,287375.25
312980,202009,2453,1232,1221,1288486,1278035,2566521
312990,202009,45,24,21,25080,21945,47025
313000,202009,53,28,25,29260,26125,55385
313005,202009,172,134,38,140030,39710.5,179740.5
313010,202009,920,361,559,378290.5,587290,965580.5
313020,202009,198,102,96,106590,100320,206910
313030,202009,193,131,62,136895.35,64790,201685.35
313040,202009,76,24,52,25080,54340,79420
313050,202009,181,132,49,137940,51205,189145
313055,202009,36,26,10,27170,10450,37620
313060,202009,130,89,41,93005,42845,135850
313065,202009,62,44,18,45980,18810.5,64790.5
313070,202009,136,69,67,72105,70015,142120
313080,202009,38,17,21,17765,21945,39710
313090,202009,658,437,221,456665,230945,687610
313100,202009,187,64,123,66880,128535,195415
313110,202009,134,68,66,71060,68970,140030
313115,202009,208,115,93,121220,98230,219450
313120,202009,828,472,356,493240,372020.5,865260.5
313130,202009,5725,3104,2621,3246817.2,2742081.75,5988898.95
313140,202009,141,75,66,78375,70015,148390
313150,202009,310,243,67,253935,70015,323950
313160,202009,186,138,48,144210.5,50160,194370.5
313170,202009,1400,942,458,985436,479655,1465091
313180,202009,300,179,121,187055.5,126445,313500.5
313190,202009,740,441,299,460846,312455,773301
313200,202009,26,21,5,21945,5225,27170
313210,202009,1004,847,157,885117.55,165110.5,1050228.05
313220,202009,280,174,106,181830,110770.5,292600.5
313230,202009,259,197,62,205865.87,65835,271700.87
313240,202009,2136,1094,1042,1145323,1095160,2240483
313250,202009,1260,960,300,1004245.5,314545.8,1318791.3
313260,202009,90,48,42,50160,43890,94050
313270,202009,987,571,416,597740.75,436811.5,1034552.25
313280,202009,51,43,8,44935,8360,53295
313290,202009,212,170,42,178695,45980,224675
313300,202009,345,182,163,190190,172425,362615
313310,202009,263,123,140,128535,146300,274835
313320,202009,384,284,100,296780,104500,401280
313330,202009,1403,857,546,896610,572660.87,1469270.87
313340,202009,324,232,92,242440,98230,340670
313350,202009,501,332,169,347985,176605,524590
313360,202009,137,70,67,73150,71060,144210
313370,202009,219,69,150,72105,156750,228855
313375,202009,289,172,117,180785,122265,303050
313380,202009,1344,703,641,734635.5,669845,1404480.5
313390,202009,52,47,5,49115,5225,54340
313400,202009,398,270,128,282150,133761,415911
313410,202009,22,13,9,13585,9405,22990
313420,202009,4570,2431,2139,2550846,2243616,4794462
313430,202009,145,69,76,72105,79420,151525
313440,202009,1411,965,446,1009471.81,467117,1476588.81
313450,202009,70,29,41,30305,42845,73150
313460,202009,387,171,216,179740.5,225720,405460.5
313470,202009,524,243,281,254980.5,294690.5,549671.0
313480,202009,146,107,39,111815.5,41800,153615.5
313490,202009,517,236,281,246620.5,293645.25,540265.75
313500,202009,26,14,12,14630,12540,27170
313505,202009,1020,801,219,840180,228855,1069035
313507,202009,103,61,42,63745,43890,107635
313510,202009,2827,1775,1052,1857058.54,1101430,2958488.54
313520,202009,3452,2690,762,2815232.66,797335,3612567.66
313530,202009,33,21,12,22990,12540,35530
313535,202009,59,46,13,48070,13585,61655
313540,202009,71,53,18,55385,18810.77,74195.77
313545,202009,111,94,17,98230,17765,115995
313550,202009,230,194,36,202730,37620.5,240350.5
313560,202009,343,167,176,174515,183920,358435
313570,202009,63,24,39,25080,40755,65835
313580,202009,1322,737,585,770165.5,611326.5,1381492.0
313590,202009,68,38,30,39710,31350,71060
313600,202009,674,405,269,425315,281105.5,706420.5
313610,202009,62,47,15,49115,15675,64790
313620,202009,1393,695,698,728366,731500,1459866
313630,202009,1620,1222,398,1278036,418000,1696036
313640,202009,119,73,46,76285,48070,124355
313650,202009,232,107,125,111815,131670,243485
313652,202009,17,17,0,17765,0,17765
313655,202009,68,45,23,47025,24035,71060
313657,202009,48,44,4,45980,4180,50160
313660,202009,134,91,43,95095,44953.81,140048.81
313665,202009,640,294,346,308275.75,362615,670890.75
313670,202009,10297,7000,3297,7330678.47,3449546.25,10780224.72
313680,202009,39,31,8,32395,8360,40755
313690,202009,142,108,34,113905,35530,149435
313695,202009,64,47,17,49115,17765,66880
313700,202009,311,252,59,263340.5,62700,326040.5
313710,202009,143,100,43,104500,44935,149435
313720,202009,1113,519,594,543400.5,621776.5,1165177.0
313730,202009,73,44,29,45980,30305,76285
313740,202009,150,121,29,126445,30305,156750
313750,202009,433,311,122,324995,127490,452485
313753,202009,232,172,60,180785,63745,244530
313760,202009,1309,480,829,501600.5,866306.5,1367907.0
313770,202009,380,273,107,285285.25,111815,397100.25
313780,202009,775,403,372,422180,389785,811965
313790,202009,28,27,1,28215,1045,29260
313800,202009,137,83,54,87780,56430,144210
313810,202009,77,43,34,44935,37620,82555
313820,202009,1306,616,690,645811,722095.5,1367906.5
313830,202009,56,41,15,42845,15675,58520
313835,202009,61,50,11,52250,11495,63745
313840,202009,1649,986,663,1031416.5,692835.5,1724252.0
313850,202009,206,75,131,78375,136895,215270
313860,202009,474,357,117,374110.5,122265,496375.5
313862,202009,163,109,54,113905,57475,171380
313865,202009,120,91,29,95095,30305,125400
313867,202009,51,40,11,41800,11495,53295
313868,202009,32,19,13,19855,13585,33440
313870,202009,114,60,54,62700,57475,120175
313880,202009,377,230,147,241395,153615,395010
313890,202009,332,172,160,179740,167200,346940
313900,202009,876,475,401,496375.66,421135.25,917510.91
313910,202009,147,104,43,108680,45980,154660
313920,202009,642,449,193,469205,203775.94,672980.94
313925,202009,31,28,3,29260,3135,32395
313930,202009,853,664,189,693880,197505,891385
313940,202009,1862,1154,708,1208020,741950,1949970
313950,202009,866,544,322,572660,340670,913330
313960,202009,1412,809,603,845405.9,630137,1475542.9
313970,202009,167,107,60,111815,62700,174515
313980,202009,207,133,74,138985.25,78375,217360.25
313990,202009,240,158,82,165110,85690,250800
314000,202009,897,595,302,623865.85,315590,939455.85
314010,202009,82,49,33,51205,36575,87780
314015,202009,63,16,47,16720,49115,65835
314020,202009,52,32,20,33440,20900,54340
314030,202009,76,35,41,36575,42845,79420
314040,202009,45,26,19,27170,19855,47025
314050,202009,283,168,115,176605,121220,297825
314053,202009,97,63,34,65835,35530,101365
314055,202009,299,185,114,194370,119130,313500
314060,202009,131,113,18,118085.04,18810,136895.04
314070,202009,1057,547,510,571615,533995,1105610
314080,202009,206,132,74,140030.17,77330.4,217360.57
314085,202009,140,95,45,99275,47025,146300
314090,202009,379,269,110,281105.25,114950,396055.25
314100,202009,504,406,98,425315.75,102410,527725.75
314110,202009,793,395,398,412775.5,415910,828685.5
314120,202009,72,44,28,47025,29260,76285
314130,202009,19,10,9,10450,9405,19855
314140,202009,1114,682,432,713735,451440,1165175
314150,202009,184,119,65,124355,67925,192280
314160,202009,331,251,80,262295,84645,346940
314170,202009,81,62,19,64790,19855,84645
314180,202009,735,647,88,676115.5,91960.25,768075.75
314190,202009,99,59,40,62700,41800,104500
314200,202009,491,335,156,350075,163020.5,513095.5
314210,202009,248,190,58,198550,60610.5,259160.5
314220,202009,308,225,83,235125.5,86735,321860.5
314225,202009,58,42,16,43890,16720,60610
314230,202009,118,53,65,55385,67925,123310
314240,202009,147,108,39,112860,40755,153615
314250,202009,53,29,24,30305,25080,55385
314260,202009,211,105,106,109725,110770,220495
314270,202009,368,284,84,297825,87780,385605
314280,202009,703,380,323,397100,339625,736725
314290,202009,543,434,109,453530,113905,567435
314300,202009,359,259,100,270656.1,104500.25,375156.35
314310,202009,1373,932,441,975248.32,460845,1436093.32
314315,202009,34,26,8,27170,8360,35530
314320,202009,591,392,199,409640.5,209000,618640.5
314330,202009,11098,5392,5706,5645092.75,5978446,11623538.75
314340,202009,604,273,331,285285,345896,631181
314345,202009,45,31,14,32395,14630,47025
314350,202009,182,114,68,119130,71060,190190
314360,202009,59,36,23,38665,24035,62700
314370,202009,64,43,21,44935,21945,66880
314380,202009,95,60,35,62700,36575,99275
314390,202009,3334,2127,1207,2226896.85,1264450,3491346.85
314400,202009,692,489,203,513096.3,212135,725231.3
314410,202009,483,317,166,332310,173470,505780
314420,202009,15,8,7,8360,7315,15675
314430,202009,2424,886,1538,926915.36,1610345.5,2537260.86
314435,202009,186,112,74,117040,77330,194370
314437,202009,27,21,6,21945,6270,28215
314440,202009,96,68,28,71060,29260,100320
314450,202009,158,109,49,113905,51205,165110
314460,202009,645,307,338,320815,354255,675070
314465,202009,95,59,36,61655,37620,99275
314467,202009,68,56,12,58520,12540,71060
314470,202009,416,208,208,217360.95,217360,434720.95
314480,202009,1059,498,561,520410,587290,1107700
314490,202009,46,31,15,32395,15675,48070
314500,202009,280,194,86,202730,89870,292600
314505,202009,111,70,41,73150,42845,115995
314510,202009,240,197,43,205865,45980,251845
314520,202009,1298,683,615,713740.5,643721.5,1357462.0
314530,202009,741,595,146,621776.01,152570,774346.01
314535,202009,171,102,69,107635,72105,179740
314537,202009,61,37,24,38665,25080,63745
314540,202009,16,10,6,10450,6270,16720
314545,202009,50,32,18,33440,18810,52250
314550,202009,79,41,38,42845,39710,82555
314560,202009,858,464,394,486970.5,411730,898700.5
314570,202009,21,16,5,16720,5225,21945
314580,202009,14,5,9,5225,9405,14630
314585,202009,25,17,8,17765,8360,26125
314587,202009,83,70,13,73150,13585,86735
314590,202009,557,396,161,413820.25,168245,582065.25
314600,202009,941,602,339,629091,354255.29,983346.29
314610,202009,948,491,457,514140.5,477565,991705.5
314620,202009,134,101,33,105545,34485,140030
314625,202009,96,69,27,72105,28215,100320
314630,202009,1175,624,551,653125.25,581020,1234145.25
314640,202009,83,53,30,55385,31350.5,86735.5
314650,202009,179,101,78,105545,81510,187055
314655,202009,61,46,15,48070,15675,63745
314660,202009,16,13,3,13585,3135,16720
314670,202009,198,151,47,157795.5,49115,206910.5
314675,202009,210,122,88,127490,91960,219450
314690,202009,594,314,280,328130,293645,621775
314700,202009,2278,1222,1056,1281172,1103520,2384692
314710,202009,1698,973,725,1020966.75,758670.5,1779637.25
314720,202009,391,232,159,243485,166155,409640
314730,202009,513,266,247,279016,259160,538176
314740,202009,722,347,375,363660,395010,758670
314750,202009,17,14,3,14630,3135,17765
314760,202009,339,154,185,161975,193325,355300
314770,202009,108,74,34,77330,35530,112860
314780,202009,20,8,12,8360,12540,20900
314790,202009,2400,1510,890,1581086,932140,2513226
314795,202009,49,38,11,39710,11495,51205
314800,202009,2933,1714,1219,1793222.22,1275945,3069167.22
314810,202009,1506,851,655,890340,685520,1575860
314820,202009,106,57,49,59565,51205,110770
314830,202009,213,171,42,178695,43890,222585
314840,202009,87,54,33,56430,34485,90915
314850,202009,397,197,200,205865.5,209000,414865.5
314860,202009,667,510,157,532950,166155,699105
314870,202009,1527,794,733,830775.5,770165,1600940.5
314875,202009,54,48,6,50160,6270,56430
314880,202009,44,30,14,31350,14630,45980
314890,202009,54,32,22,33440,22990,56430
314900,202009,30,23,7,24035,7315,31350
314910,202009,244,158,86,165110,89870,254980
314915,202009,139,125,14,130625,14630,145255
314920,202009,103,64,39,66880,40755,107635
314930,202009,1064,514,550,537130.5,575795.5,1112926.0
314940,202009,48,38,10,39710,10450,50160
314950,202009,29,20,9,20900,9405,30305
314960,202009,32,23,9,24035,9405,33440
314970,202009,148,72,76,75240,79420,154660
314980,202009,307,196,111,204820,118085,322905
314990,202009,443,237,206,247665,216315,463980
314995,202009,169,69,100,72105,104500,176605
315000,202009,83,63,20,65835,20900,86735
315010,202009,42,27,15,28215,15675,43890
315015,202009,166,132,34,138985,35530,174515
315020,202009,70,56,14,58520,14630,73150
315030,202009,108,83,25,86735.5,26125,112860.5
315040,202009,70,48,22,51205,22990,74195
315050,202009,186,108,78,112860,81510,194370
315053,202009,45,34,11,35530,11495,47025
315057,202009,105,80,25,83600,26125,109725
315060,202009,75,63,12,65835.8,12540,78375.8
315070,202009,105,59,46,61655,48070,109725
315080,202009,378,304,74,317680,77330,395010
315090,202009,93,55,38,57475,40755,98230
315100,202009,79,39,40,40755,41800,82555
315110,202009,272,144,128,150480,133760,284240
315120,202009,1722,834,888,873620,931095.2,1804715.2
315130,202009,344,250,94,261250,98230,359480
315140,202009,527,297,230,310365,241396,551761
315150,202009,977,462,515,484880,538175,1023055
315160,202009,213,105,108,110770,114950,225720
315170,202009,317,210,107,219450.5,112860,332310.5
315180,202009,3252,1349,1903,1410751.5,1994906.25,3405657.75
315190,202009,316,188,128,196460,133760,330220
315200,202009,1220,717,503,750310,525635,1275945
315210,202009,1660,944,716,986480.53,749265,1735745.53
315213,202009,31,19,12,19855,12540,32395
315217,202009,203,157,46,164065,48070,212135
315220,202009,1580,1183,397,1238325.95,415910,1654235.95
315230,202009,170,123,47,128535.5,49115,177650.5
315240,202009,426,272,154,284240,160931,445171
315250,202009,2592,1259,1333,1316700,1399255.5,2715955.5
315260,202009,145,82,63,86735,65835,152570
315270,202009,130,91,39,95095,40755,135850
315280,202009,646,415,231,433675,243485,677160
315290,202009,190,120,70,125400,73150,198550
315300,202009,80,58,22,60610,22990,83600
315310,202009,74,66,8,70015,8360,78375
315320,202009,160,95,65,100320,67925,168245
315330,202009,55,45,10,47025,10450,57475
315340,202009,392,282,110,294690,114950,409640
315350,202009,154,92,62,96140,64790,160930
315360,202009,89,40,49,41800,51205,93005
315370,202009,54,34,20,35530,20900,56430
315380,202009,8,8,0,8360,0,8360
315390,202009,65,18,47,18810,49115.5,67925.5
315400,202009,837,622,215,652081.25,225720,877801.25
315410,202009,327,193,134,201685.5,141076.5,342762.0
315415,202009,56,42,14,43890,14630,58520
315420,202009,198,144,54,150480.5,58520,209000.5
315430,202009,651,372,279,388740.5,293645,682385.5
315440,202009,93,64,29,66880,30305,97185
315445,202009,233,192,41,201685,42845,244530
315450,202009,182,137,45,143165,47025,190190
315460,202009,4037,1947,2090,2041930,2185095,4227025
315470,202009,40,16,24,16720,25080,41800
315480,202009,66,20,46,20900,48070,68970
315490,202009,675,409,266,428450,277970,706420
315500,202009,17,11,6,11495,7315,18810
315510,202009,148,100,48,104500,50160,154660
315520,202009,71,62,9,64790,9405,74195
315530,202009,47,24,23,25080,24035,49115
315540,202009,245,167,78,174515,81510,256025
315550,202009,181,145,36,151525,37620,189145
315560,202009,740,593,147,619685.5,153615,773300.5
315570,202009,312,156,156,165112.19,163020,328132.19
315580,202009,711,479,232,500555,243485.5,744040.5
315590,202009,198,102,96,108680,100320,209000
315600,202009,301,228,73,238260,76285,314545
315610,202009,102,52,50,54340,52250,106590
315620,202009,36,28,8,29260,8360,37620
315630,202009,129,85,44,88825,45980,134805
315640,202009,76,45,31,47025,32395,79420
315645,202009,45,31,14,32395,14630.5,47025.5
315650,202009,172,123,49,129580.5,51205,180785.5
315660,202009,455,199,256,207955.5,268565,476520.5
315670,202009,2390,1140,1250,1192347,1308340,2500687
315680,202009,836,589,247,616550,259160,875710
315690,202009,670,461,209,484881.97,219450,704331.97
315700,202009,1896,989,907,1033506.21,948860,1982366.21
315710,202009,347,103,244,107635,254980,362615
315720,202009,455,279,176,292600.5,183920,476520.5
315725,202009,187,150,37,156750.5,38665,195415.5
315727,202009,52,22,30,22990,31350,54340
315730,202009,44,41,3,42845,3135,45980
315733,202009,89,58,31,60610,32395,93005
315737,202009,50,37,13,38665,13585,52250
315740,202009,32,25,7,26125,7315,33440
315750,202009,159,119,40,124355,41800.5,166155.5
315760,202009,39,29,10,31350,10450,41800
315765,202009,120,70,50,73150,52250,125400
315770,202009,222,139,83,145255,87780,233035
315780,202009,3512,1746,1766,1829796.18,1850695,3680491.18
315790,202009,233,181,52,189145,55385,244530
315800,202009,298,206,92,216315,96140,312455
315810,202009,93,57,36,59565,37620,97185
315820,202009,750,542,208,567435.5,218405,785840.5
315830,202009,128,80,48,83600,50160,133760
315840,202009,86,56,30,58520,31350,89870
315850,202009,260,182,78,190190.75,81510,271700.75
315860,202009,15,6,9,6270,9405,15675
315870,202009,38,29,9,30305,9405,39710
315880,202009,108,68,40,71060,41800,112860
315890,202009,87,66,21,68970,21945,90915
315895,202009,422,277,145,290510.75,151526,442036.75
315900,202009,66,30,36,31350,37620,68970
315910,202009,40,24,16,25080,16720,41800
315920,202009,160,106,54,110770,56430.75,167200.75
315930,202009,53,19,34,19855,35530,55385
315935,202009,131,102,29,106590.5,31350,137940.5
315940,202009,101,74,27,77330,28215,105545
315950,202009,38,29,9,30305,9405,39710
315960,202009,536,254,282,265430,295735.5,561165.5
315970,202009,35,28,7,29260,7315,36575
315980,202009,678,336,342,351120,360525,711645
315990,202009,252,148,104,154660,108680.5,263340.5
316000,202009,48,31,17,32395,17765,50160
316010,202009,79,68,11,71060,11495,82555
316020,202009,116,99,17,103455,17765,121220
316030,202009,379,210,169,220495.5,177650.75,398146.25
316040,202009,524,217,307,227810.5,320815.5,548626.0
316045,202009,52,46,6,48070,6270,54340
316050,202009,16,12,4,12540,4180,16720
316060,202009,96,63,33,65835,34485,100320
316070,202009,1083,692,391,723140.75,412775,1135915.75
316080,202009,98,66,32,70106.96,33440,103546.96
316090,202009,42,21,21,21945,21945,43890
316095,202009,96,76,20,79420,20900,100320
316100,202009,312,180,132,188100.25,137940,326040.25
316105,202009,38,25,13,26125,13585,39710
316110,202009,1867,1477,390,1544510.62,408595,1953105.62
316120,202009,80,57,23,59565,24035,83600
316130,202009,123,91,32,95095.5,33440,128535.5
316140,202009,31,20,11,20900,11495,32395
316150,202009,205,143,62,149435,64790,214225
316160,202009,80,45,35,47025,36575,83600
316165,202009,64,46,18,48070,18810,66880
316170,202009,184,121,63,127490,65835,193325
316180,202009,201,85,116,88825,121220.5,210045.5
316190,202009,135,97,38,101365,39710,141075
316200,202009,664,363,301,379335,316635,695970
316210,202009,784,518,266,543579.74,279015,822594.74
316220,202009,119,77,42,80465,43890,124355
316225,202009,26,15,11,15675,11495,27170
316230,202009,34,20,14,20900,14630,35530
316240,202009,644,515,129,539220,134805,674025
316245,202009,128,110,18,114950,18810,133760
316250,202009,1519,1030,489,1078441.5,512050,1590491.5
316255,202009,129,101,28,105545,29260,134805
316257,202009,181,94,87,98230,90915,189145
316260,202009,198,138,60,145255.25,62700,207955.25
316265,202009,27,18,9,18810,9405,28215
316270,202009,684,480,204,502645.5,213180.6,715826.1
316280,202009,546,337,209,352165.29,218405.5,570570.79
316290,202009,742,491,251,514140.65,264385,778525.65
316292,202009,510,201,309,211090,323950,535040
316294,202009,99,60,39,62700,40755,103455
316295,202009,311,133,178,140030.5,186010,326040.5
316300,202009,109,71,38,74195,39710,113905
316310,202009,28,14,14,14630,14630,29260
316320,202009,50,27,23,28215,24035,52250
316330,202009,163,110,53,114950.25,55385,170335.25
316340,202009,134,91,43,95095,44935,140030
316350,202009,193,137,56,143165.74,58520,201685.74
316360,202009,22,15,7,15675,7315,22990
316370,202009,1116,567,549,592516.25,574750,1167266.25
316380,202009,117,87,30,90915,31350,122265
316390,202009,113,81,32,85690,33440,119130
316400,202009,132,102,30,106590,31350,137940
316410,202009,303,220,83,229900,86735,316635
316420,202009,201,135,66,141075,68970,210045
316430,202009,155,82,73,85690,76285,161975
316440,202009,89,42,47,43890,49115,93005
316443,202009,39,37,2,38665,2090,40755
316447,202009,55,41,14,42845,14630,57475
316450,202009,223,171,52,178695,54340,233035
316460,202009,79,25,54,26125,56430,82555
316470,202009,1685,1226,459,1283253.01,482790,1766043.01
316480,202009,11,8,3,8360,3135,11495
316490,202009,18,6,12,6270,12540,18810
316500,202009,149,101,48,105545,50160,155705
316510,202009,152,116,36,121220,37620,158840
316520,202009,194,118,76,123310,79420,202730
316530,202009,164,107,57,111815,59565,171380
316540,202009,141,75,66,78375,68970,147345
316550,202009,140,90,50,94050,52250,146300
316553,202009,298,133,165,138985,173470.72,312455.72
316555,202009,43,37,6,38665,6270,44935
316556,202009,12,9,3,9405,3135,12540
316557,202009,23,19,4,19855,4180,24035
316560,202009,68,48,20,50160,21945,72105
316570,202009,218,198,20,206910.5,20900,227810.5
316580,202009,20,14,6,14630,6270,20900
316590,202009,102,85,17,88825,17765,106590
316600,202009,175,143,32,149435.5,34485,183920.5
316610,202009,66,50,16,52250,16720,68970
316620,202009,137,102,35,106590,36575,143165
316630,202009,43,34,9,35530,9405,44935
316640,202009,22,14,8,14630,8360,22990
316650,202009,72,59,13,61655,13585,75240
316660,202009,8,3,5,3135,5225,8360
316670,202009,437,151,286,157795,298870,456665
316680,202009,157,110,47,114950,49115,164065
316690,202009,184,114,70,120175,73150,193325
316695,202009,63,53,10,55385,10450,65835
316700,202009,18,12,6,12540,6270,18810
316710,202009,776,581,195,609235.25,203775,813010.25
316720,202009,5013,2438,2575,2555027.96,2698191,5253218.96
316730,202009,17,16,1,16720,1045,17765
316740,202009,139,89,50,93005,52250,145255
316750,202009,17,10,7,10450,7315,17765
316760,202009,324,259,65,270655,68970,339625
316770,202009,151,83,68,86735,71060,157795
316780,202009,68,41,27,42845,28215,71060
316790,202009,54,39,15,40755,15675,56430
316800,202009,1758,1095,663,1144275,692836.25,1837111.25
316805,202009,25,17,8,17765,8360,26125
316810,202009,66,41,25,42845,26125,68970
316820,202009,42,21,21,21945,21945,43890
316830,202009,98,43,55,44935,57475,102410
316840,202009,525,303,222,317680,233035,550715
316850,202009,328,220,108,229900,112860,342760
316860,202009,5910,2603,3307,2726408.4,3462085.75,6188494.15
316870,202009,1529,978,551,1023057.25,576840.5,1599897.75
316880,202009,127,61,66,63745,68970,132715
316890,202009,239,163,76,171380,79420,250800
316900,202009,420,294,126,309320.65,131670,440990.65
316905,202009,22,10,12,10450,12540,22990
316910,202009,69,29,40,30305,42845,73150
316920,202009,138,108,30,112860,31350,144210
316930,202009,1887,966,921,1011561.5,966625.75,1978187.25
316935,202009,911,549,362,573705.1,378290.5,951995.6
316940,202009,1099,619,480,647900.5,505780.5,1153681.0
316950,202009,179,87,92,90915,97185,188100
316960,202009,1099,613,486,640586,508915,1149501
316970,202009,654,514,140,537130,146300,683430
316980,202009,77,43,34,44935,35530,80465
316990,202009,2154,1433,721,1501665.85,754490.74,2256156.59
317000,202009,335,256,79,267520,82555,350075
317005,202009,237,167,70,174515,73150,247665
317010,202009,6357,3511,2846,3674224.73,2985565.5,6659790.23
317020,202009,16016,6997,9019,7327549.4,9450985,16778534.4
317030,202009,80,31,49,32395,51205,83600
317040,202009,3034,1892,1142,1979231,1194435,3173666
317043,202009,74,54,20,56430,20900,77330
317047,202009,31,17,14,17765,14630,32395
317050,202009,162,126,36,133760,37620,171380
317052,202009,136,102,34,106590,35530,142120
317057,202009,170,132,38,137940,39710,177650
317060,202009,62,38,24,39710,25080,64790
317065,202009,54,43,11,44935,11495,56430
317070,202009,1957,904,1053,946770.25,1104565.5,2051335.75
317075,202009,103,55,48,57475,50160,107635
317080,202009,908,465,443,488015.25,465025,953040.25
317090,202009,664,522,142,545490,149435,694925
317100,202009,422,317,105,331265,109725,440990
317103,202009,102,83,19,86735,19855,106590
317107,202009,45,39,6,40755,6270,47025
317110,202009,115,50,65,53295,67925,121220
317115,202009,41,36,5,37620,5225,42845
317120,202009,1932,926,1006,967671.5,1053360.5,2021032.0
317130,202009,1962,1305,657,1364771.5,690745,2055516.5
317140,202009,10,8,2,8360,2090,10450
317150,202009,261,155,106,161975.5,110770,272745.5
317160,202009,315,237,78,248711.29,82555,331266.29
317170,202009,219,148,71,154660,75240,229900
317180,202009,443,303,140,317680,147345,465025
317190,202009,263,185,78,193325,81510,274835
317200,202009,821,573,248,598787.9,259160,857947.9
317210,202009,184,101,83,105545,86735,192280
317220,202009,24,13,11,13585,11495,25080
320010,202009,604,436,168,456665.25,175560,632225.25
320013,202009,122,87,35,90915,36575,127490
320016,202009,270,171,99,178695,103455,282150
320020,202009,710,415,295,434722.37,309320,744042.37
320030,202009,152,107,45,111815.04,47025.08,158840.12
320035,202009,141,103,38,107635,39710,147345
320040,202009,483,246,237,257070,248710,505780
320050,202009,107,76,31,79420,32395,111815
320060,202009,1677,790,887,828685.25,930051.75,1758737.00
320070,202009,100,61,39,64790,40755,105545
320080,202009,800,463,337,484880.75,352165,837045.75
320090,202009,1250,834,416,872575,435765,1308340
320100,202009,329,187,142,195415,148390,343805
320110,202009,126,80,46,83601.25,48070,131671.25
320115,202009,110,90,20,94050,20900,114950
320120,202009,3483,1846,1637,1932207.65,1712755.5,3644963.15
320130,202009,7464,3376,4088,3537328.01,4283457,7820785.01
320140,202009,440,290,150,303050,156751.16,459801.16
320150,202009,2055,1159,896,1213245.75,937365.5,2150611.25
320160,202009,653,294,359,308275,378290.5,686565.5
320170,202009,111,89,22,93005.1,22990.02,115995.12
320180,202009,54,32,22,33440,22990,56430
320190,202009,239,153,86,159885,89870,249755
320200,202009,59,44,15,45980,15675,61655
320210,202009,897,489,408,512051,427405.5,939456.5
320220,202009,295,101,194,105545,202730,308275
320225,202009,85,67,18,70015,18810,88825
320230,202009,618,387,231,404415,242440,646855
320240,202009,3292,1581,1711,1654237.5,1792175.5,3446413.0
320245,202009,474,319,155,334400.5,161975,496375.5
320250,202009,225,114,111,119130,115995,235125
320255,202009,138,107,31,111815,32395,144210
320260,202009,217,140,77,146300.2,80465.12,226765.32
320265,202009,158,121,37,126445,38665,165110
320270,202009,153,121,32,126445,33440,159885
320280,202009,1101,627,474,655216.07,497420.02,1152636.09
320290,202009,57,49,8,51205,8360,59565
320300,202009,581,402,179,420091.37,187056.6,607147.97
320305,202009,674,358,316,375155,330220.5,705375.5
320310,202009,199,114,85,120175.9,88825,209000.9
320313,202009,335,161,174,168245.25,181830.5,350075.75
320316,202009,109,83,26,86735,27170,113905
320320,202009,3402,1521,1881,1595716.15,1971915,3567631.15
320330,202009,259,195,64,203866.96,67925,271791.96
320332,202009,768,466,302,486971.5,316635.25,803606.75
320334,202009,238,144,94,150480.52,98230,248710.52
320335,202009,148,100,48,105545,50160,155705
320340,202009,554,386,168,403370.75,175560.5,578931.25
320350,202009,984,421,563,439945.97,590425.5,1030371.47
320360,202009,162,87,75,90915,79420,170335
320370,202009,241,178,63,187055.9,65835.5,252891.4
320380,202009,282,196,86,204820.5,89870,294690.5
320390,202009,1161,694,467,725230,488015.5,1213245.5
320400,202009,309,225,84,237215,87780,324995
320405,202009,949,393,556,411730.25,583110.5,994840.75
320410,202009,986,504,482,527725,505780.25,1033505.25
320420,202009,511,242,269,252890.75,281105,533995.75
320425,202009,187,100,87,104500,90915,195415
320430,202009,392,212,180,222585.25,188100,410685.25
320435,202009,159,107,52,111815,54340,166155
320440,202009,196,113,83,118085.28,86735.22,204820.50
320450,202009,127,68,59,71060,61655,132715
320455,202009,255,206,49,215270.5,51205,266475.5
320460,202009,273,167,106,174515,110770,285285
320465,202009,113,76,37,79420,38665,118085
320470,202009,695,420,275,438900.5,288420,727320.5
320480,202009,199,129,70,134805,73150.48,207955.48
320490,202009,3088,1522,1566,1593626.26,1641697.24,3235323.50
320495,202009,109,67,42,70015,43890.5,113905.5
320500,202009,9619,4706,4913,4921956.3,5143495.95,10065452.25
320501,202009,546,277,269,293645,281105,574750
320503,202009,291,203,88,212135.1,91960.02,304095.12
320506,202009,261,183,78,191235,81510,272745
320510,202009,1029,454,575,475475,600875,1076350
320515,202009,87,68,19,71060,19855,90915
320517,202009,216,152,64,158840,66880,225720
320520,202009,6935,2961,3974,3098426.8,4158057.5,7256484.3
320530,202009,6151,3034,3117,3176248.13,3262490,6438738.13
330010,202009,3104,1568,1536,1641697.5,1609300,3250997.5
330015,202009,162,67,95,70015.9,100320,170335.9
330020,202009,3701,1548,2153,1622886.1,2251975,3874861.1
330022,202009,252,128,124,133760,129580,263340
330023,202009,618,193,425,201685,445170,646855
330025,202009,575,106,469,110770,490105,600875
330030,202009,1912,1204,708,1262360.12,745085.5,2007445.62
330040,202009,2437,1237,1200,1294755,1254000.5,2548755.5
330045,202009,8969,2711,6258,2838221,6558420,9396641
330050,202009,892,570,322,595650,336490,932140
330060,202009,1011,599,412,627000.5,430540,1057540.5
330070,202009,3708,1322,2386,1384625.4,2500685.5,3885310.9
330080,202009,1586,693,893,728365.75,934230,1662595.75
330090,202009,384,227,157,237215,164065,401280
330093,202009,261,115,146,120175,152570,272745
330095,202009,77,45,32,47025,33440,80465
330100,202009,9892,4926,4966,5154987.67,5200967.25,10355954.92
330110,202009,477,202,275,212135.75,287375,499510.75
330115,202009,527,277,250,290510,262295,552805
330120,202009,380,192,188,200640,197506.5,398146.5
330130,202009,1542,382,1160,400235,1213245,1613480
330140,202009,611,322,289,337535,302005,639540
330150,202009,513,294,219,307230,229900,537130
330160,202009,213,125,88,130625,91960,222585
330170,202009,27127,9089,18038,9516817.6,18897784.42,28414602.02
330180,202009,237,140,97,147345,101365,248710
330185,202009,956,339,617,356345,647900,1004245
330187,202009,376,112,264,117040,275880,392920
330190,202009,5770,2202,3568,2305272.4,3746325.5,6051597.9
330200,202009,4709,1394,3315,1457776.81,3470445.5,4928222.31
330205,202009,440,252,188,263340,196460.5,459800.5
330210,202009,966,590,376,619685,395011,1014696
330220,202009,2680,1588,1092,1662596.2,1144275.5,2806871.7
330225,202009,573,291,282,304095,295735,599830
330227,202009,2427,733,1694,769120,1773365.25,2542485.25
330230,202009,255,144,111,150480,117040,267520
330240,202009,3821,1880,1941,1971915.75,2033572,4005487.75
330245,202009,149,66,83,68970.1,87780,156750.1
330250,202009,6678,3352,3326,3507381.14,3484032.02,6991413.16
330260,202009,610,159,451,167200,476520,643720
330270,202009,3596,1208,2388,1264450.5,2498596,3763046.5
330280,202009,454,288,166,303050.5,173470.45,476520.95
330285,202009,7021,2173,4848,2277055.75,5076612.25,7353668.00
330290,202009,654,235,419,245575.75,438900,684475.75
330300,202009,759,492,267,514262.22,280060,794322.22
330310,202009,444,247,197,258115.5,205865,463980.5
330320,202009,7857,2900,4957,3039906.49,5193652,8233558.49
330330,202009,9041,3383,5658,3545686.77,5928286,9473972.77
330340,202009,2672,1562,1110,1634380,1162040,2796420
330350,202009,18601,7027,11574,7360986.65,12124096.85,19485083.50
330360,202009,2228,1067,1161,1118151,1214290,2332441
330370,202009,1025,511,514,533997,539220,1073217
330380,202009,892,373,519,390830,543400.01,934230.01
330385,202009,631,321,310,335445,323950,659395
330390,202009,5594,2947,2647,3081706,2775520.5,5857226.5
330395,202009,313,185,128,193325,133760.75,327085.75
330400,202009,714,377,337,395010,352165,747175
330410,202009,507,366,141,383515.25,147345.5,530860.75
330411,202009,259,138,121,144210.55,126445,270655.55
330412,202009,241,97,144,101365.5,150480,251845.5
330414,202009,5401,2165,3236,2264517.7,3387890.5,5652408.2
330415,202009,607,264,343,275881.5,358435,634316.5
330420,202009,2226,1128,1098,1180851.55,1150545.5,2331397.05
330430,202009,1785,800,985,836001,1031417.5,1867418.5
330440,202009,292,138,154,145255,160930,306185
330450,202009,121,53,68,55385,72105,127490
330452,202009,2045,887,1158,926915,1214290.5,2141205.5
330455,202009,113025,39138,73887,40979849.07,77426257.04,118406106.11
330460,202009,259,111,148,115995,154660,270655
330470,202009,1226,665,561,695971.5,588336.75,1284308.25
330475,202009,1515,400,1115,418000,1166220,1584220
330480,202009,812,431,381,450395,398145,848540
330490,202009,14649,4666,9983,4887566.25,10459406.5,15346972.75
330500,202009,1420,608,812,635360,848540.14,1483900.14
330510,202009,10884,3718,7166,3894717.58,7514595.5,11409313.08
330513,202009,98,50,48,52250,50160,102410
330515,202009,808,333,475,349031.25,497420.5,846451.75
330520,202009,2494,874,1620,913330.35,1693945,2607275.35
330530,202009,206,117,89,122265.25,94050,216315.25
330540,202009,370,181,189,189145.5,197505.5,386651.0
330550,202009,2910,1006,1904,1054406.2,1998041,3052447.2
330555,202009,802,312,490,326040,512050,838090
330560,202009,695,225,470,235125,491150,726275
330570,202009,269,194,75,202730,78375,281105
330575,202009,790,287,503,299915,525636.25,825551.25
330580,202009,3394,1881,1513,1970871.62,1583175.5,3554047.12
330590,202009,282,146,136,152570.09,142120,294690.09
330600,202009,1188,739,449,773301,469205,1242506
330610,202009,1579,843,736,883341.25,770165,1653506.25
330615,202009,215,167,48,174515,50160,224675
330620,202009,1074,416,658,435765,687610,1123375
330630,202009,4112,2540,1572,2658480.96,1643785.75,4302266.71
350010,202009,584,385,199,402326.47,207955,610281.47
350020,202009,51,21,30,21945,31350,53295
350030,202009,513,318,195,332310.5,203775.5,536086.0
350040,202009,125,51,74,53295,77330,130625
350050,202009,309,160,149,167200,155705,322905
350055,202009,96,48,48,50160,50160,100320
350060,202009,87,32,55,33440,57475,90915
350070,202009,790,465,325,486970.49,340670.5,827640.99
350075,202009,74,50,24,52250,25080,77330
350080,202009,59,28,31,29260,32395,61655
350090,202009,82,48,34,50160,35530,85690
350100,202009,283,173,110,180785,114950,295735
350110,202009,59,41,18,42845,18810,61655
350115,202009,142,91,51,95095,53295,148390
350120,202009,107,68,39,71060,40755,111815
350130,202009,370,164,206,172425.03,217360,389785.03
350140,202009,43,27,16,28215,16720,44935
350150,202009,73,56,17,58520,17765,76285
350160,202009,2424,935,1489,980211,1564365,2544576
350170,202009,385,223,162,233036.35,171380.5,404416.85
350180,202009,163,94,69,99275,72105.5,171380.5
350190,202009,990,517,473,541310.29,496375.5,1037685.79
350200,202009,68,23,45,24035,47025,71060
350210,202009,1295,720,575,755536,601920.29,1357456.29
350220,202009,665,550,115,574750.29,123310,698060.29
350230,202009,75,48,27,50160,28215,78375
350240,202009,58,41,17,42845,17765,60610
350250,202009,1168,553,615,577886,642676.25,1220562.25
350260,202009,93,66,27,68970,28215,97185
350270,202009,886,591,295,617596,309321,926917
350275,202009,297,125,172,130625,179740,310365
350280,202009,4580,2307,2273,2421269.9,2381555,4802824.9
350290,202009,456,206,250,215270,262295.5,477565.5
350300,202009,53,27,26,28215,27170,55385
350310,202009,86,53,33,55385,34485,89870
350315,202009,55,26,29,27170,30305,57475
350320,202009,3321,1608,1713,1682450.5,1797400.5,3479851.0
350330,202009,1673,888,785,930052.12,823460,1753512.12
350335,202009,16,11,5,11495,5225,16720
350340,202009,123,53,70,55385,73150.75,128535.75
350350,202009,88,43,45,44935,47025,91960
350360,202009,111,71,40,75240,41800,117040
350370,202009,84,49,35,51205.29,36575,87780.29
350380,202009,778,329,449,343805,469206,813011
350390,202009,1593,605,988,633270.37,1038730.5,1672000.87
350395,202009,24,19,5,19855,5225,25080
350400,202009,1698,849,849,889297.12,890340.29,1779637.41
350410,202009,2726,1162,1564,1215335,1637534.29,2852869.29
350420,202009,253,151,102,159885.79,106590,266475.79
350430,202009,71,41,30,42845,32395,75240
350440,202009,155,111,44,117041,45980.5,163021.5
350450,202009,1663,975,688,1020965.56,721050.5,1742016.06
350460,202009,396,129,267,134805,279015,413820
350470,202009,19,10,9,10450,9405,19855
350480,202009,179,97,82,101365,85690,187055
350490,202009,234,113,121,118085,127490,245575
350500,202009,53,21,32,21945,33440,55385
350510,202009,167,108,59,112860,61655,174515
350520,202009,454,229,225,240350,236170,476520
350530,202009,438,201,237,211090,247665,458755
350535,202009,82,64,18,66880,18810,85690
350540,202009,372,188,184,197505,193325,390830
350550,202009,2677,1572,1105,1651100.83,1160996.58,2812097.41
350560,202009,612,417,195,435765,205865,641630
350570,202009,4170,1704,2466,1784861.29,2584286.35,4369147.64
350580,202009,365,178,187,186010,196460,382470
350590,202009,909,494,415,517275,433675,950950
350600,202009,6087,2892,3195,3028412.75,3341910.5,6370323.25
350610,202009,1503,777,726,817190.29,762850,1580040.29
350620,202009,29,19,10,19855,10450,30305
350630,202009,247,140,107,146300.29,111815.29,258115.58
350635,202009,969,379,590,396056.35,618640.5,1014696.85
350640,202009,115,88,27,93005,29260,122265
350650,202009,1885,1253,632,1313565.45,663575,1977140.45
350660,202009,745,309,436,322905,457710,780615
350670,202009,306,153,153,159885,159885,319770
350680,202009,174,90,84,94050,87781,181831
350690,202009,195,94,101,99275,105545,204820
350700,202009,795,380,415,398146,435765,833911
350710,202009,381,141,240,147345,250800,398145
350715,202009,55,45,10,47025,10450,57475
350720,202009,19,13,6,13585,6270,19855
350730,202009,45,28,17,29260,17765,47025
350740,202009,220,124,96,130625,100320,230945
350745,202009,23,11,12,11495,12540,24035
350750,202009,2205,1363,842,1431650.75,883025,2314675.75
350760,202009,3749,1592,2157,1668865.59,2259290,3928155.59
350770,202009,59,42,17,43890,17765,61655
350775,202009,40,29,11,30305,11495,41800
350780,202009,427,217,210,227810,219450,447260
350790,202009,366,151,215,157795,227810,385605
350800,202009,473,272,201,285285,212135,497420
350810,202009,519,415,104,437855.75,109725,547580.75
350820,202009,92,53,39,55385,40755,96140
350830,202009,79,40,39,41800,40755,82555
350840,202009,767,303,464,317680.5,488015,805695.5
350850,202009,1728,948,780,995885.5,817190.5,1813076.0
350860,202009,601,335,266,350075.75,277970,628045.75
350870,202009,429,281,148,293645,154660,448305
350880,202009,286,160,126,167200.25,131670.5,298870.75
350890,202009,39,25,14,26125,14630,40755
350900,202009,1468,461,1007,482790.75,1055450.29,1538241.04
350910,202009,25,14,11,14630,11495,26125
350920,202009,700,365,335,381425,351120,732545
350925,202009,1200,641,559,670891.45,587291.89,1258183.34
350930,202009,103,61,42,63745,43890,107635
350940,202009,724,398,326,418000,340670,758670
350945,202009,107,77,30,81510,31350,112860
350950,202009,16376,7588,8788,7944095.59,9211677.75,17155773.34
350960,202009,1409,622,787,652080,823460,1475540
350970,202009,1095,563,532,589269.19,555940.5,1145209.69
350980,202009,98,66,32,68970,33440,102410
350990,202009,373,133,240,138985,251845,390830
350995,202009,37,17,20,17765,20900,38665
351000,202009,632,429,203,449350.58,212135,661485.58
351010,202009,53,32,21,33440,21945,55385
351015,202009,50,34,16,35530,16720,52250
351020,202009,1578,944,634,986480.5,665665,1652145.5
351030,202009,340,217,123,226765,128535,355300
351040,202009,902,461,441,482790.95,463981.39,946772.34
351050,202009,3315,1494,1821,1569593.3,1908170,3477763.3
351060,202009,5308,2043,3265,2135981.7,3424465,5560446.7
351070,202009,406,257,149,268566.64,155705,424271.64
351080,202009,716,520,196,544445.5,204820,749265.5
351090,202009,54,24,30,25080,31350,56430
351100,202009,438,248,190,259160.7,198550,457710.7
351110,202009,2037,967,1070,1010516.31,1120240.5,2130756.81
351120,202009,67,35,32,36575,33440,70015
351130,202009,189,59,130,61655,136895,198550
351140,202009,322,212,110,222585,114950,337535
351150,202009,435,223,212,234080.75,221540.5,455621.25
351160,202009,280,182,98,191235.5,102410,293645.5
351170,202009,190,98,92,103455,96140,199595
351190,202009,89,63,26,65835,27170,93005
351200,202009,360,239,121,250800.5,126445,377245.5
351210,202009,114,55,59,57475,61655,119130
351220,202009,536,317,219,331266.91,230945,562211.91
351230,202009,265,183,82,191235,85690,276925
351240,202009,240,113,127,119130,132715,251845
351250,202009,80,57,23,59565.57,24035,83600.57
351260,202009,151,111,40,115995,41800,157795
351270,202009,45,18,27,18810,28215,47025
351280,202009,1010,456,554,477565,579975.79,1057540.79
351290,202009,241,103,138,107635,144210,251845
351300,202009,3757,1639,2118,1713720.11,2219580.29,3933300.40
351310,202009,747,366,381,383515,398145,781660
351320,202009,117,68,49,71060,51205,122265
351330,202009,39,25,14,26125,14630,40755
351340,202009,1253,730,523,762850,548625,1311475
351350,202009,2386,1371,1015,1433741.29,1063810,2497551.29
351360,202009,779,372,407,389785,427405,817190
351370,202009,381,191,190,202730.5,199595,402325.5
351380,202009,9001,4012,4989,4198818.02,5232316.79,9431134.81
351385,202009,25,17,8,17765,9405,27170
351390,202009,277,209,68,218405.35,71060,289465.35
351400,202009,67,42,25,43890,26125,70015
351410,202009,432,273,159,286330.77,166155,452485.77
351420,202009,72,53,19,55385,19855,75240
351430,202009,71,40,31,41800,33440,75240
351440,202009,782,545,237,569527.33,248710,818237.33
351450,202009,268,129,139,134805,145255,280060
351460,202009,128,57,71,59565,74195,133760
351470,202009,141,78,63,81510,65835,147345
351480,202009,492,282,210,294690.5,219450,514140.5
351490,202009,287,107,180,111815,191235,303050
351492,202009,27,19,8,19855,8360,28215
351495,202009,25,18,7,18810,7315,26125
351500,202009,3523,1460,2063,1528835.5,2164196.9,3693032.4
351510,202009,1942,730,1212,768076,1269675.5,2037751.5
351512,202009,17,13,4,13585,4180,17765
351515,202009,185,106,79,110770,82555,193325
351518,202009,731,460,271,480700,283195,763895
351519,202009,78,47,31,49115,32395,81510
351520,202009,146,89,57,94050,60610,154660
351530,202009,25,14,11,14630,11495,26125
351535,202009,131,79,52,82555,54340,136895
351540,202009,463,332,131,346940.6,136895,483835.6
351550,202009,1419,835,584,874667.08,610280,1484947.08
351560,202009,71,40,31,41800,33440,75240
351565,202009,9,7,2,7315,2090,9405
351570,202009,2707,1303,1404,1364770.5,1471360,2836130.5
351580,202009,39,34,5,35530,5225,40755
351590,202009,59,38,21,39710,21945,61655
351600,202009,185,132,53,138985,55385,194370
351610,202009,46,21,25,21945,26125,48070
351620,202009,5849,3257,2592,3414018.29,2722225.75,6136244.04
351630,202009,2824,1387,1437,1450460.75,1504800,2955260.75
351640,202009,1997,910,1087,954085.02,1139051.29,2093136.31
351650,202009,28,23,5,24035,5225,29260
351660,202009,136,87,49,91960,52250,144210
351670,202009,709,443,266,465026.5,279015,744041.5
351680,202009,66,57,9,60610,10450,71060
351685,202009,14,11,3,11495,3135,14630
351690,202009,303,206,97,215270.37,101365,316635.37
351700,202009,157,108,49,112860.5,51205,164065.5
351710,202009,70,46,24,48070,25080,73150
351720,202009,131,75,56,78375,58520,136895
351730,202009,106,68,38,72105,39710,111815
351740,202009,723,463,260,483835.6,272745,756580.6
351750,202009,356,146,210,152570,220495,373065
351760,202009,755,575,180,600875,190190,791065
351770,202009,306,254,52,265430.29,54340,319770.29
351780,202009,160,97,63,101365,65835,167200
351790,202009,254,132,122,140030,127490.75,267520.75
351800,202009,39,24,15,25080,15675,40755
351810,202009,119,81,38,84645,39710,124355
351820,202009,810,586,224,613415.5,234080,847495.5
351830,202009,544,188,356,198550,372020,570570
351840,202009,1909,913,996,959311,1046045,2005356
351850,202009,234,164,70,172425,73150,245575
351860,202009,657,457,200,478610.45,210045,688655.45
351870,202009,5569,2581,2988,2704464.86,3128733,5833197.86
351880,202009,19516,7888,11628,8252369.29,12177387.95,20429757.24
351885,202009,82,51,31,53295,32395,85690
351890,202009,70,56,14,58520,14630,73150
351900,202009,231,132,99,137940,103455,241395
351905,202009,82,32,50,33440,52250,85690
351907,202009,3446,1407,2039,1473450.85,2137025.5,3610476.35
351910,202009,179,73,106,77330,111815,189145
351920,202009,113,63,50,65835,52250,118085
351925,202009,91,59,32,61655,33440,95095
351930,202009,399,257,142,270655,148390,419045
351940,202009,239,103,136,107635,142120,249755
351950,202009,137,73,64,76285,66880,143165
351960,202009,932,458,474,478937.37,499510.5,978447.87
351970,202009,1911,995,916,1045000.5,960355.5,2005356.0
351980,202009,162,75,87,78375,90915,169290
351990,202009,262,171,91,178696,96140,274836
352000,202009,339,218,121,228855.5,126445,355300.5
352010,202009,386,242,144,253935,151525,405460
352020,202009,185,70,115,73150,121220,194370
352030,202009,1101,552,549,576840,576840,1153680
352040,202009,569,240,329,250800,344850,595650
352042,202009,290,82,208,85690,219451,305141
352044,202009,364,224,140,234080.5,146300,380380.5
352050,202009,3200,1234,1966,1289531.64,2063875.5,3353407.14
352060,202009,105,63,42,65835,43890,109725
352070,202009,91,68,23,71060.58,24035,95095.58
352080,202009,64,41,23,43890,24035,67925
352090,202009,160,107,53,111815,55385,167200
352100,202009,287,138,149,144210,155705.5,299915.5
352110,202009,116,37,79,38665,82555,121220
352115,202009,60,21,39,21945,40755,62700
352120,202009,80,53,27,55385.29,29260,84645.29
352130,202009,224,185,39,194370,40755,235125
352140,202009,186,86,100,89870,105545,195415
352150,202009,117,61,56,63745,58520,122265
352160,202009,138,87,51,90915,54340,145255
352170,202009,389,262,127,274835,132715,407550
352180,202009,623,392,231,409640.29,243485,653125.29
352190,202009,242,98,144,102410,151525,253935
352200,202009,29,14,15,14630,15675,30305
352210,202009,4152,1686,2466,1765112,2580106,4345218
352215,202009,60,35,25,36575,26125,62700
352220,202009,6689,2505,4184,2620862,4377506.29,6998368.29
352230,202009,3325,2142,1183,2242571.66,1240416.62,3482988.28
352240,202009,2509,1434,1075,1500620.5,1129646,2630266.5
352250,202009,2772,1331,1441,1390896.58,1511070,2901966.58
352260,202009,989,518,471,542355.65,494285.5,1036641.15
352265,202009,58,28,30,29260,31350,60610
352270,202009,394,224,170,234080,177650.25,411730.25
352280,202009,448,273,175,286330.58,183920,470250.58
352290,202009,174,103,71,107635,76285,183920
352300,202009,95,66,29,68970,30305,99275
352310,202009,6410,2825,3585,2961531.19,3757820.3,6719351.49
352320,202009,1037,542,495,567435.5,517275,1084710.5
352330,202009,527,260,267,272745,281105,553850
352340,202009,1344,610,734,639542,769121.5,1408663.5
352350,202009,338,201,137,211090,143165.5,354255.5
352360,202009,218,97,121,101365,127490,228855
352370,202009,107,70,37,73150,38665,111815
352380,202009,114,73,41,76285,42845,119130
352390,202009,2451,1045,1406,1092025.64,1472406.3,2564431.94
352400,202009,490,214,276,224675,291555.5,516230.5
352410,202009,873,610,263,638495.79,275880,914375.79
352420,202009,96,67,29,70015,31350,101365
352430,202009,1744,798,946,834956.87,992750.58,1827707.45
352440,202009,3206,1576,1630,1650056.97,1710665.5,3360722.47
352450,202009,200,162,38,169290,39710,209000
352460,202009,624,318,306,333355,319770,653125
352470,202009,651,222,429,231990.74,449350,681340.74
352480,202009,1419,786,633,823460,661485.5,1484945.5
352490,202009,65,23,42,24035,43890,67925
352500,202009,1231,521,710,546535.85,744041,1290576.85
352510,202009,712,379,333,397100.58,349030,746130.58
352520,202009,684,323,361,339625,377245,716870
352530,202009,1768,920,848,962445,889295.5,1851740.5
352540,202009,74,47,27,49115,28215,77330
352550,202009,193,114,79,119130,82555,201685
352560,202009,48,38,10,39710,10450,50160
352570,202009,690,341,349,358435.29,364705,723140.29
352580,202009,55,42,13,43890,13585,57475
352585,202009,20,6,14,6270,14630,20900
352590,202009,4398,2171,2227,2273920.79,2339756,4613676.79
352600,202009,349,250,99,261250,103455,364705
352610,202009,940,430,510,451440.67,533995,985435.67
352620,202009,1039,396,643,414865,674025,1088890
352630,202009,174,63,111,65835,117040,182875
352640,202009,505,337,168,356345,176605,532950
352650,202009,83,61,22,63745,22990,86735
352660,202009,63,38,25,39710,26125,65835
352670,202009,1676,883,793,922736.32,829730,1752466.32
352680,202009,925,575,350,602965,367840,970805
352690,202009,4514,2025,2489,2123442.38,2607275.29,4730717.67
352700,202009,103,61,42,64790,43890,108680
352710,202009,1391,726,665,760760,697015,1457775
352720,202009,1371,626,745,655215,780615.5,1435830.5
352725,202009,23,18,5,18810,5225,24035
352730,202009,391,196,195,204820,204820,409640
352740,202009,413,263,150,275881.4,156750.11,432631.51
352750,202009,19,13,6,13585,6270,19855
352760,202009,184,119,65,124355,67925,192280
352770,202009,88,66,22,68970,22990,91960
352780,202009,82,43,39,44935,40755,85690
352790,202009,26,20,6,20900,6270,27170
352800,202009,237,177,60,184965,62700,247665
352810,202009,156,96,60,100320,62700,163020
352820,202009,54,42,12,44935,12540,57475
352830,202009,77,52,25,54340,26125,80465
352840,202009,657,317,340,331265.25,355300,686565.25
352850,202009,1562,505,1057,530860,1108745,1639605
352860,202009,117,75,42,78375,43890,122265
352870,202009,46,30,16,31350,16720,48070
352880,202009,178,119,59,125400,61655,187055
352885,202009,31,21,10,21945,10450,32395
352890,202009,54,36,18,37620,18810.5,56430.5
352900,202009,4756,2287,2469,2401411.5,2589510.79,4990922.29
352910,202009,39,31,8,32395,8360,40755
352920,202009,659,394,265,411730,277970,689700
352930,202009,1229,584,645,613415.5,675070.75,1288486.25
352940,202009,6144,2505,3639,2623000.07,3814250.5,6437250.57
352950,202009,109,40,69,41800,74195,115995
352960,202009,56,36,20,37620,20900,58520
352965,202009,18,9,9,9405,9405,18810
352970,202009,523,400,123,418000.23,128535,546535.23
352980,202009,156,85,71,88825,74195,163020
352990,202009,983,451,532,472340,558030,1030370
353000,202009,60,25,35,27170,36575,63745
353010,202009,547,337,210,352165,219450,571615
353020,202009,303,219,84,230945,87780,318725
353030,202009,1254,572,682,599830.85,716870,1316700.85
353040,202009,89,55,34,57475,35530,93005
353050,202009,1316,851,465,890341.19,489060,1379401.19
353060,202009,8380,3599,4781,3769319.71,5017045,8786364.71
353070,202009,1749,1066,683,1115016.33,714593.99,1829610.32
353080,202009,1287,688,599,718960.47,628045,1347005.47
353090,202009,60,32,28,33440,29260,62700
353100,202009,51,41,10,42845,10450,53295
353110,202009,2091,636,1455,666710.5,1526745.5,2193456.0
353120,202009,97,49,48,51205,50160,101365
353130,202009,856,423,433,442035.41,456665,898700.41
353140,202009,556,228,328,238260.29,343805,582065.29
353150,202009,332,190,142,198550.29,149435,347985.29
353160,202009,93,74,19,77330,19855,97185
353170,202009,219,69,150,72105,156750,228855
353180,202009,1073,484,589,505780.75,618641,1124421.75
353190,202009,494,360,134,377245,140030,517275
353200,202009,225,105,120,109725,125400,235125
353205,202009,18,12,6,12540,6270,18810
353210,202009,72,40,32,41800,33440,75240
353215,202009,43,23,20,25080,20900,45980
353220,202009,78,45,33,47025,34485,81510
353230,202009,156,59,97,61655,101365,163020
353240,202009,316,161,155,168245,161975,330220
353250,202009,206,102,104,106590,110770,217360
353260,202009,460,316,144,331265.8,151525,482790.8
353270,202009,71,52,19,54340,19855,74195
353280,202009,101,49,52,51205,54340,105545
353282,202009,132,94,38,98230,39710,137940
353284,202009,24,16,8,16720,8360,25080
353286,202009,2,0,2,0,2090,2090
353290,202009,80,44,36,45980,37620,83600
353300,202009,446,235,211,245576.33,220495,466071.33
353310,202009,49,42,7,43890,7315,51205
353320,202009,49,28,21,29260,21945,51205
353325,202009,50,29,21,30305,21945.5,52250.5
353330,202009,60,41,19,42845.75,19855,62700.75
353340,202009,643,227,416,237215,435765,672980
353350,202009,905,434,471,453530,494285.5,947815.5
353360,202009,101,81,20,85690,21945,107635
353370,202009,110,62,48,64790,50160,114950
353380,202009,32,18,14,18810,14630,33440
353390,202009,1115,529,586,555940,613415.5,1169355.5
353400,202009,43,23,20,24035,21945,45980
353410,202009,109,65,44,67925,45980.25,113905.25
353420,202009,59,23,36,24035,37620,61655
353430,202009,579,389,190,408596.41,199595,608191.41
353440,202009,11099,4814,6285,5040037.11,6590816,11630853.11
353450,202009,57,30,27,31350,28215,59565
353460,202009,593,319,274,335445.25,287375,622820.25
353470,202009,2144,1118,1026,1172490.37,1076350,2248840.37
353475,202009,251,166,85,173470.5,88825,262295.5
353480,202009,187,155,32,161975,33440,195415
353490,202009,239,141,98,148390,102410.5,250800.5
353500,202009,204,118,86,123310.29,90915,214225.29
353510,202009,101,69,32,72105,33440,105545
353520,202009,207,147,60,153615,62700,216315
353530,202009,460,246,214,257070,223630,480700
353540,202009,383,252,131,263340,136895,400235
353550,202009,713,462,251,483836.47,262295,746131.47
353560,202009,586,235,351,245575,366795,612370
353570,202009,66,37,29,38665.5,31350,70015.5
353580,202009,349,255,94,268566.35,98230,366796.35
353590,202009,86,62,24,64790,25080,89870
353600,202009,275,160,115,167200.29,120175,287375.29
353610,202009,128,70,58,73150,60610,133760
353620,202009,616,321,295,335445.5,309320,644765.5
353625,202009,51,27,24,28215,25080,53295
353630,202009,234,169,65,177650.45,68970,246620.45
353640,202009,130,85,45,88825,47025,135850
353650,202009,933,350,583,365750,611325,977075
353657,202009,23,17,6,17765,6270,24035
353660,202009,274,145,129,151525,134805,286330
353670,202009,764,448,316,469205.79,332310.5,801516.29
353680,202009,102,77,25,80465.25,26125,106590.25
353690,202009,41,29,12,30305,12540,42845
353700,202009,276,197,79,205865,82555,288420
353710,202009,474,217,257,227810,268565.5,496375.5
353715,202009,48,34,14,35530,14630,50160
353720,202009,347,155,192,161975.5,200640,362615.5
353730,202009,1097,674,423,704330.5,447260.5,1151591.0
353740,202009,616,339,277,354256.25,290510.75,644767.00
353750,202009,76,45,31,48070,32395,80465
353760,202009,2997,1124,1873,1176671.15,1959376.65,3136047.80
353770,202009,90,73,17,76285,17765,94050
353780,202009,1238,586,652,613415.29,683430,1296845.29
353790,202009,508,307,201,321860.9,210045,531905.9
353800,202009,3432,1649,1783,1728450.5,1869576.5,3598027.0
353810,202009,230,131,99,136895,103455,240350
353820,202009,210,93,117,97185,124355,221540
353830,202009,52,45,7,47025,7315,54340
353850,202009,174,82,92,85690,96140,181830
353860,202009,509,223,286,233035,298870,531905
353870,202009,5367,2689,2678,2815233.75,2810006.75,5625240.50
353880,202009,679,466,213,488015,222585,710600
353890,202009,547,318,229,332310.5,239305.61,571616.11
353900,202009,133,70,63,73150,65835,138985
353910,202009,173,73,100,77330,104500,181830
353920,202009,429,240,189,250800.75,199595,450395.75
353930,202009,1012,595,417,621775,437856.1,1059631.1
353940,202009,192,94,98,99275,103455,202730
353950,202009,500,308,192,322905,201685,524590
353960,202009,75,60,15,62700,15675,78375
353970,202009,49,30,19,31350,19855,51205
353980,202009,1694,776,918,813010.5,962445,1775455.5
353990,202009,71,43,28,44935,29260,74195
354000,202009,382,181,201,189145,211090,400235
354010,202009,89,50,39,52250,40755.5,93005.5
354020,202009,510,326,184,340670,192280,532950
354025,202009,39,34,5,35530,5225,40755
354030,202009,51,31,20,32395,20900,53295
354040,202009,98,75,23,78375,24035,102410
354050,202009,171,97,74,101365.79,77330,178695.79
354060,202009,757,362,395,379335,414865,794200
354070,202009,915,523,392,548626,410685,959311
354075,202009,185,85,100,88825,104500,193325
354080,202009,312,131,181,136895,190190,327085
354085,202009,20,13,7,13585,7315,20900
354090,202009,289,166,123,173382,128535,301917
354100,202009,5567,2244,3323,2349160.75,3484032.35,5833193.10
354105,202009,95,45,50,47025,52250,99275
354110,202009,46,22,24,22990,25080,48070
354120,202009,141,99,42,103455,43890,147345
354130,202009,716,448,268,471295,282150.5,753445.5
354140,202009,3179,1470,1709,1537196.52,1790085.5,3327282.02
354150,202009,639,378,261,396055.87,274835,670890.87
354160,202009,651,413,238,431585.5,249756.39,681341.89
354165,202009,17,14,3,14630,3135,17765
354170,202009,171,117,54,122265,56430,178695
354180,202009,58,34,24,36575.59,25080,61655.59
354190,202009,189,79,110,84645,114950,199595
354200,202009,112,60,52,62700,55385,118085
354210,202009,59,22,37,24035,38665,62700
354220,202009,652,409,243,427405.29,253935,681340.29
354230,202009,163,69,94,72105,98230,170335
354240,202009,339,217,122,226765.62,127490,354255.62
354250,202009,82,51,31,53295,33440,86735
354260,202009,2064,969,1095,1017831.82,1146366.6,2164198.42
354270,202009,89,64,25,66880,26125,93005
354280,202009,44,21,23,21945,24035,45980
354290,202009,143,99,44,103455,45980,149435
354300,202009,377,263,114,274835.29,119130,393965.29
354310,202009,88,67,21,70015.5,21945,91960.5
354320,202009,201,100,101,105545,105545,211090
354323,202009,10,9,1,9405,1045,10450
354325,202009,116,67,49,70015.83,51205,121220.83
354330,202009,2426,807,1619,844211.5,1693945.75,2538157.25
354340,202009,10316,4906,5410,5140137.63,5680623.34,10820760.97
354350,202009,137,89,48,93005,50160,143165
354360,202009,69,36,33,37620,34485,72105
354370,202009,242,126,116,131670,121220,252890
354380,202009,185,114,71,119130,74195,193325
354390,202009,2668,955,1713,1000065,1796355.45,2796420.45
354400,202009,304,167,137,174515,143165,317680
354410,202009,615,294,321,307231.6,335445.5,642677.1
354420,202009,270,173,97,180785,102410,283195
354425,202009,304,181,123,189194,128535,317729
354430,202009,184,106,78,110770,82555,193325
354440,202009,35,26,9,27170,10450,37620
354450,202009,51,33,18,34485,18810,53295
354460,202009,102,57,45,60610,47025,107635
354470,202009,34,18,16,18810,16720,35530
354480,202009,112,61,51,63745,53295,117040
354490,202009,141,86,55,89870,57475,147345
354500,202009,384,182,202,191235,211090,402325
354510,202009,91,63,28,65835,29260,95095
354515,202009,36,12,24,12540,25080,37620
354520,202009,1584,677,907,710451.9,948860.5,1659312.4
354530,202009,768,382,386,400235.5,404415,804650.5
354540,202009,267,144,123,151525,129580,281105
354550,202009,36,23,13,24035,13585,37620
354560,202009,150,78,72,81510,76285,157795
354570,202009,132,89,43,93005,44935,137940
354580,202009,1869,878,991,920646.5,1039775.5,1960422.0
354600,202009,260,140,120,146300,125400,271700
354610,202009,72,60,12,63745.65,12540,76285.65
354620,202009,64,19,45,19855,47025,66880
354625,202009,16,9,7,9405,7315,16720
354630,202009,300,193,107,202730,111815,314545
354640,202009,795,501,294,524590.75,307230,831820.75
354650,202009,68,40,28,41800,29260,71060
354660,202009,782,579,203,609235.25,212135,821370.25
354670,202009,241,89,152,93005,159885,252890
354680,202009,1272,468,804,490105,842270,1332375
354690,202009,85,58,27,60610.5,28215,88825.5
354700,202009,67,48,19,50160,19855,70015
354710,202009,45,32,13,33440,13585,47025
354720,202009,20,19,1,19855,1045,20900
354730,202009,1744,727,1017,761805.55,1065900.5,1827706.05
354740,202009,75,51,24,53295,25080,78375
354750,202009,423,243,180,254980,188100,443080
354760,202009,458,277,181,291556.25,189145.5,480701.75
354765,202009,10,5,5,5225,5225,10450
354770,202009,343,227,116,237215,122265,359480
354780,202009,8180,3217,4963,3366994.21,5196786.2,8563780.41
354790,202009,101,58,43,60610,44935,105545
354800,202009,455,245,210,258115.16,219450,477565.16
354805,202009,97,44,53,45980.5,55385,101365.5
354810,202009,102,60,42,62700,43890,106590
354820,202009,206,82,124,85690.9,129580,215270.9
354830,202009,44,23,21,24035,21945,45980
354840,202009,54,37,17,38665,17765,56430
354850,202009,4488,1972,2516,2065966.6,2634445.81,4700412.41
354860,202009,325,158,167,165110,174515.04,339625.04
354870,202009,12032,5347,6685,5600160.78,7009862.25,12610023.03
354880,202009,2763,1027,1736,1074260.88,1818300.75,2892561.63
354890,202009,2908,1556,1352,1627066.75,1419110,3046176.75
354900,202009,63,43,20,44935,20900,65835
354910,202009,1241,640,601,669846,628045,1297891
354920,202009,42,34,8,35530,8360,43890
354925,202009,15,6,9,6270,9405,15675
354930,202009,35,32,3,33440.78,3135,36575.78
354940,202009,795,578,217,608453.04,229900,838353.04
354950,202009,200,129,71,134805.25,74195,209000.25
354960,202009,147,56,91,58520,95095,153615
354970,202009,969,638,331,669846.64,346940.5,1016787.14
354980,202009,8778,3146,5632,3296977.92,5900070.52,9197048.44
354990,202009,9368,4261,5107,4455883.5,5354580,9810463.5
354995,202009,549,178,371,186010,387695,573705
355000,202009,466,161,305,168245,318725,486970
355010,202009,596,365,231,383515.5,241395.29,624910.79
355020,202009,773,483,290,506825,305140.5,811965.5
355030,202009,207698,79555,128143,83296440.32,134258538.26,217554978.58
355040,202009,763,350,413,366795.5,433675,800470.5
355050,202009,150,91,59,95095,62700,157795
355060,202009,1627,811,816,850631.5,853765,1704396.5
355070,202009,1448,684,764,714780.77,800470.29,1515251.06
355080,202009,197,122,75,127490,78375,205865
355090,202009,282,165,117,172425,122265.19,294690.19
355100,202009,5013,2370,2643,2481774.1,2771340.5,5253114.6
355110,202009,242,163,79,170335,82555,252890
355120,202009,60,39,21,40755,21945,62700
355130,202009,47,27,20,29260,20900,50160
355140,202009,185,112,73,118085,77330,195415
355150,202009,663,392,271,410685.5,283195,693880.5
355160,202009,473,225,248,235125.29,259160.5,494285.79
355170,202009,2044,1066,978,1118150,1026190,2144340
355180,202009,677,282,395,296780,413820,710600
355190,202009,214,143,71,150480,74195,224675
355200,202009,112,64,48,66880,50160,117040
355210,202009,695,395,300,413820,316635,730455
355220,202009,7168,3657,3511,3828883.5,3678402.5,7507286.0
355230,202009,102,60,42,62700,43890,106590
355240,202009,4458,1843,2615,1931162.66,2735810,4666972.66
355250,202009,5812,2585,3227,2704479.89,3385800.25,6090280.14
355255,202009,49,28,21,29260,21945,51205
355260,202009,183,111,72,115995.5,75240,191235.5
355270,202009,164,103,61,107635,64790,172425
355280,202009,6379,2489,3890,2603097,4073410.5,6676507.5
355290,202009,78,63,15,66880,15675,82555
355300,202009,195,117,78,123310,81510,204820
355310,202009,110,59,51,61655,53295,114950
355320,202009,89,47,42,49115.25,44935,94050.25
355330,202009,280,161,119,169290,125400,294690
355340,202009,1467,511,956,535041.27,1003200,1538241.27
355350,202009,139,67,72,70015,75240,145255
355360,202009,169,111,58,115995,60610,176605
355365,202009,21,17,4,17765,4180,21945
355370,202009,1031,605,426,634316.08,449350,1083666.08
355380,202009,821,515,306,538175.5,320815,858990.5
355385,202009,74,52,22,54340,22990,77330
355390,202009,112,61,51,63745,53295,117040
355395,202009,197,111,86,115995.92,89870,205865.92
355400,202009,1693,1007,686,1053276.05,717915.29,1771191.34
355410,202009,4874,2273,2601,2384692.5,2723270.25,5107962.75
355420,202009,49,33,16,34485,16720,51205
355430,202009,379,234,145,244530.5,151525,396055.5
355440,202009,86,50,36,52250,37620,89870
355450,202009,458,225,233,235126.2,243485.52,478611.72
355460,202009,63,48,15,50160.35,16720,66880.35
355465,202009,44,26,18,27170,18810,45980
355470,202009,175,71,104,74195.75,109725,183920.75
355475,202009,11,7,4,7315,4180,11495
355480,202009,521,216,305,225720,318725,544445
355490,202009,118,83,35,86735,36575,123310
355495,202009,64,25,39,26125,40755,66880
355500,202009,1564,862,702,903927.05,734635.5,1638562.55
355510,202009,266,196,70,205865,73150,279015
355520,202009,33,24,9,25080,9405,34485
355530,202009,20,12,8,12540,8360,20900
355535,202009,75,34,41,35530,42845,78375
355540,202009,2465,969,1496,1014842.84,1567500.79,2582343.63
355550,202009,58,35,23,36575,24035,60610
355560,202009,251,117,134,123310,142120,265430
355570,202009,23,15,8,15675,8360,24035
355580,202009,243,172,71,181830,76285.5,258115.5
355590,202009,16,10,6,10450,6270,16720
355600,202009,272,139,133,145255,138985,284240
355610,202009,226,152,74,158840,77330,236170
355620,202009,1325,589,736,615505.5,771210,1386715.5
355630,202009,433,316,117,330220,122265.29,452485.29
355635,202009,111,51,60,54340,62700,117040
355640,202009,560,316,244,330220,257070,587290
355645,202009,850,332,518,346940,542356,889296
355650,202009,1977,835,1142,875710.5,1197570.5,2073281.0
355660,202009,247,131,116,136895,121220,258115
355670,202009,572,237,335,249755,351120,600875
355680,202009,203,113,90,120175,95095,215270
355690,202009,92,41,51,42845,53295.66,96140.66
355695,202009,17,11,6,11495,6270,17765
355700,202009,1135,590,545,619685.65,570571,1190256.65
355710,202009,2225,1201,1024,1256090.99,1070080.5,2326171.49
355715,202009,16,14,2,14630,2090,16720
355720,202009,227,136,91,142120.6,95095,237215.6
355730,202009,99,58,41,60610,42845,103455
410010,202009,134,109,25,113905,26125,140030
410020,202009,113,87,26,90915,27170,118085
410030,202009,168,96,72,100320,75240,175560
410040,202009,1183,581,602,611325,633270,1244595
410045,202009,39,29,10,30305,10450,40755
410050,202009,471,265,206,277970,217360,495330
410060,202009,284,210,74,219450,77330,296780
410070,202009,293,245,48,256025,50160,306185
410080,202009,171,106,65,111815,68970,180785
410090,202009,80,69,11,72105.9,11495,83600.9
410100,202009,288,201,87,210045,90915,300960
410105,202009,49,30,19,31350,19855,51205
410110,202009,334,201,133,210045,141075,351120
410115,202009,36,25,11,26125,11495,37620
410120,202009,415,209,206,218405,215270,433675
410130,202009,47,30,17,31350,17765,49115
410140,202009,3133,1497,1636,1566457.67,1713804.33,3280262.00
410150,202009,2682,1036,1646,1086801.35,1724251,2811052.35
410160,202009,508,313,195,327085,203775,530860
410165,202009,65,42,23,43890,24035,67925
410170,202009,177,115,62,120175,64790,184965
410180,202009,2250,1249,1001,1309385,1048135,2357520
410185,202009,38,33,5,34485,5225,39710
410190,202009,490,313,177,329175,184965,514140
410200,202009,941,678,263,711645,274835,986480
410210,202009,607,310,297,323950,312455,636405
410220,202009,46,21,25,21945,26125,48070
410230,202009,145,69,76,72105,81510,153615
410240,202009,751,489,262,511005.5,273790,784795.5
410250,202009,380,272,108,284240,114950,399190
410260,202009,294,164,130,172425,135850.5,308275.5
410270,202009,27,20,7,20900,7315,28215
410275,202009,55,43,12,44935,12540,57475
410280,202009,323,186,137,194370,144210,338580
410290,202009,250,152,98,158840,102410,261250
410300,202009,78,57,21,59565,21945,81510
410302,202009,19,12,7,12540,7315,19855
410304,202009,42,29,13,30305,13585,43890
410305,202009,215,110,105,114950,109725,224675
410310,202009,215,126,89,131670,93005,224675
410315,202009,47,34,13,35530,13585,49115
410320,202009,140,97,43,101365,45980,147345
410322,202009,34,23,11,24035,11495,35530
410330,202009,181,124,57,130625,59565,190190
410335,202009,102,58,44,60610,45980,106590
410337,202009,44,34,10,35530,10450,45980
410340,202009,38,31,7,32395,7315,39710
410345,202009,206,116,90,122265,94050,216315
410347,202009,47,36,11,37620,11495,49115
410350,202009,232,141,91,148390,95095,243485
410360,202009,467,293,174,308275.5,183921,492196.5
410370,202009,2346,989,1357,1037685.45,1421201.35,2458886.80
410380,202009,207,131,76,137940,79420,217360
410390,202009,392,269,123,281105,128535,409640
410395,202009,35,22,13,22990,13585,36575
410400,202009,847,382,465,403370.27,486970,890340.27
410405,202009,90,67,23,70015,24035,94050
410410,202009,30,22,8,22990,8360,31350
410420,202009,1675,788,887,823367.5,931095.85,1754463.35
410425,202009,177,70,107,73150,111815,184965
410430,202009,2308,1272,1036,1332375,1087846.4,2420221.4
410440,202009,378,275,103,287375,107635,395010
410442,202009,362,237,125,249755,130625,380380
410445,202009,429,305,124,319770,130625,450395
410450,202009,400,198,202,206910,211090,418000
410460,202009,509,259,250,270655,261250,531905
410465,202009,228,135,93,141075,97185,238260
410470,202009,245,147,98,153615,102410,256025
410480,202009,6224,2978,3246,3119328.75,3398341.75,6517670.50
410490,202009,1421,858,563,896610.51,588335.5,1484946.01
410500,202009,273,151,122,157795,127490,285285
410510,202009,167,124,43,129580,44935,174515
410520,202009,252,188,64,197505,66880,264385
410530,202009,296,103,193,107635,201685,309320
410540,202009,326,239,87,249755,91960,341715
410550,202009,1680,717,963,751355.2,1006335.5,1757690.7
410560,202009,147,103,44,107635,45980,153615
410570,202009,435,292,143,305141.3,149435,454576.3
410580,202009,3475,1495,1980,1568546.7,2074325.5,3642872.2
410590,202009,397,265,132,280042,137940,417982
410600,202009,192,165,27,172425,28215,200640
410610,202009,51,42,9,43890,9405,53295
410620,202009,249,166,83,174515.03,86735,261250.03
410630,202009,429,243,186,254980,197505,452485
410640,202009,1020,643,377,674025.75,395010,1069035.75
410645,202009,110,79,31,82555,32395,114950
410650,202009,361,233,128,244530,133760,378290
410655,202009,88,62,26,65835,27170,93005
410657,202009,25,8,17,8360,17765,26125
410660,202009,602,419,183,438900.52,191235,630135.52
410670,202009,73,61,12,63745,12540,76285
410680,202009,215,170,45,177650,47025,224675
410685,202009,18,11,7,11495,7315,18810
410690,202009,28482,11989,16493,12567174,17297890.25,29865064.25
410700,202009,327,241,86,252890,89870,342760
410710,202009,132,105,27,109725,28215,137940
410712,202009,39,28,11,29260,11495,40755
410715,202009,86,62,24,65835,25080,90915
410720,202009,695,394,301,415910,315590,731500
410725,202009,183,134,49,140030,51205,191235
410730,202009,95,47,48,50160,50160,100320
410740,202009,107,76,31,79420,32395,111815
410750,202009,262,174,88,181830,91960,273790
410752,202009,26,15,11,15675,11495,27170
410753,202009,56,23,33,24035,34485,58520
410754,202009,50,26,24,27170.5,25080,52250.5
410755,202009,85,50,35,52250,36575,88825
410760,202009,768,418,350,438900.5,365750,804650.5
410765,202009,1779,812,967,850630,1012606,1863236
410770,202009,110,85,25,88825,27170,115995
410773,202009,56,40,16,41800,16720,58520
410775,202009,183,137,46,143165,48070,191235
410780,202009,88,48,40,50160,41800,91960
410785,202009,60,47,13,49115,13585,62700
410790,202009,78,35,43,36575,44935,81510
410800,202009,289,175,114,182875,119130.5,302005.5
410810,202009,23,16,7,16720,7315.5,24035.5
410820,202009,172,125,47,130625,49115,179740
410830,202009,8537,3682,4855,3862322.78,5089151.1,8951473.88
410832,202009,108,73,35,77330,36575,113905
410840,202009,1461,784,677,820326.44,707465.25,1527791.69
410845,202009,60,37,23,38665,24035,62700
410850,202009,186,132,54,137940,56430,194370
410855,202009,64,51,13,53295,13585,66880
410860,202009,743,402,341,422180.5,358435,780615.5
410865,202009,102,75,27,78375,28215,106590
410870,202009,156,133,23,138985,24035,163020
410880,202009,1119,560,559,587290.5,586245,1173535.5
410890,202009,88,62,26,64790,27170,91960
410895,202009,70,54,16,56430,16720,73150
410900,202009,25,19,6,19855,6270,26125
410910,202009,16,13,3,13585,3135,16720
410920,202009,35,24,11,25080,11495,36575
410930,202009,528,324,204,338580,213180,551760
410940,202009,4402,2457,1945,2572443.4,2036705.5,4609148.9
410950,202009,106,77,29,80465,30305,110770
410960,202009,831,342,489,357390.5,511005,868395.5
410965,202009,65,47,18,49115,18810,67925
410970,202009,632,448,184,468160,192280,660440
410975,202009,126,78,48,83600.91,50160,133760.91
410980,202009,1626,726,900,759715.5,943635,1703350.5
410990,202009,269,187,82,195415,85690,281105
411000,202009,65,40,25,41800,26125.5,67925.5
411005,202009,29,24,5,25080,5225,30305
411007,202009,256,151,105,157795,109725,267520
411010,202009,611,411,200,429495,209000,638495
411020,202009,287,196,91,205865.85,95095,300960.85
411030,202009,18,10,8,10450,8360,18810
411040,202009,57,38,19,39710,19855,59565
411050,202009,206,158,48,165110,50160,215270
411060,202009,514,346,168,361570,175560,537130
411065,202009,54,46,8,48070,8360,56430
411070,202009,1257,753,504,786885,526680,1313565
411080,202009,246,174,72,181830,75240,257070
411090,202009,97,75,22,78375,22990,101365
411095,202009,284,110,174,114950,182875,297825
411100,202009,117,95,22,100320,22990,123310
411110,202009,132,83,49,86735,51205,137940
411120,202009,211,144,67,150480,70015,220495
411125,202009,239,102,137,108680,143165,251845
411130,202009,129,110,19,116343.33,19855,136198.33
411140,202009,211,139,72,145255,75240,220495
411150,202009,1221,795,426,836000,447260.54,1283260.54
411155,202009,120,81,39,84645,40755,125400
411160,202009,26,12,14,12540,14630,27170
411170,202009,52,47,5,49115,5225,54340
411180,202009,974,637,337,666710,353210,1019920
411190,202009,330,189,141,198550,147345,345895
411200,202009,663,403,260,423225,272745,695970
411210,202009,692,364,328,380380,343805.5,724185.5
411220,202009,156,112,44,118085,45980,164065
411230,202009,39,33,6,34485,6270,40755
411240,202009,122,78,44,81510,45980,127490
411250,202009,437,317,120,331265,125400,456665
411260,202009,16,11,5,11495,5225,16720
411270,202009,274,147,127,155705,132715,288420
411275,202009,182,159,23,167200,24035,191235
411280,202009,212,149,63,156750.29,65835,222585.29
411290,202009,63,48,15,50160,15675,65835
411295,202009,139,108,31,112860,32395,145255
411300,202009,79,36,43,37620,44935,82555
411310,202009,88,69,19,72105,20900,93005
411320,202009,787,523,264,548625,275880.5,824505.5
411325,202009,62,42,20,43890,20900,64790
411330,202009,907,579,328,605055.5,344850.99,949906.49
411340,202009,29,18,11,18810,11495,30305
411342,202009,65,48,17,51205,17765,68970
411345,202009,114,57,57,59565,59565,119130
411350,202009,481,365,116,383515.45,121220.5,504735.95
411360,202009,53,35,18,36575,18810,55385
411370,202009,14229,5760,8469,6040523.3,8868951.96,14909475.26
411373,202009,167,121,46,128535,48070,176605
411375,202009,78,62,16,64790,16720,81510
411380,202009,84,62,22,64790,22990,87780
411390,202009,127,78,49,81510,51205,132715
411400,202009,379,273,106,286330,110770,397100
411410,202009,446,224,222,234080,233035.5,467115.5
411420,202009,1003,436,567,455620,592515.85,1048135.85
411430,202009,471,269,202,282150,211090,493240
411435,202009,33,21,12,21945,12540,34485
411440,202009,460,359,101,375155,106590,481745
411450,202009,425,360,65,376200,67925,444125
411460,202009,777,290,487,305140,511005.57,816145.57
411470,202009,88,63,25,65835,26125,91960
411480,202009,669,370,299,389785.5,312455,702240.5
411490,202009,289,186,103,194370,108680,303050
411500,202009,101,83,18,87780,18810,106590
411510,202009,222,178,44,188100,47025,235125
411520,202009,6038,2269,3769,2374241,3946967.01,6321208.01
411530,202009,125,85,40,88825,41800,130625
411535,202009,52,20,32,20900,33440,54340
411540,202009,351,241,110,252890,114950,367840
411545,202009,56,40,16,41800,16720,58520
411550,202009,82,64,18,66880,18810,85690
411560,202009,404,172,232,179740,243485,423225
411570,202009,849,301,548,314545.2,572660,887205.2
411573,202009,22,15,7,15675,7315,22990
411575,202009,298,188,110,198550,115995,314545
411580,202009,1267,455,812,475475.85,849585,1325060.85
411585,202009,76,37,39,38665,42845,81510
411590,202009,23,16,7,16720,7315,24035
411600,202009,25,11,14,11495,14630,26125
411605,202009,236,96,140,100320,146300,246620
411610,202009,209,135,74,141075,78375,219450
411620,202009,376,197,179,206910,189145.5,396055.5
411630,202009,58,38,20,39710,20900,60610
411640,202009,33,24,9,25080,9405,34485
411650,202009,12,7,5,7315,5225,12540
411660,202009,36,24,12,25080,12540,37620
411670,202009,243,177,66,184965,70015,254980
411680,202009,166,137,29,143165,31350,174515
411690,202009,585,308,277,321860,291555,613415
411695,202009,61,45,16,47025,16720,63745
411700,202009,141,115,26,120175,27170,147345
411705,202009,105,69,36,72105,37620,109725
411710,202009,300,200,100,209000,104500,313500
411720,202009,132,89,43,93005,44935,137940
411721,202009,69,58,11,60610,11495,72105
411722,202009,105,45,60,47025,63745,110770
411725,202009,152,114,38,119130.5,39710,158840.5
411727,202009,86,66,20,68970,20900,89870
411729,202009,38,31,7,32395,7315,39710
411730,202009,558,351,207,366795,216315,583110
411740,202009,38,23,15,25080,15675,40755
411745,202009,68,49,19,51205,20900,72105
411750,202009,854,378,476,398145.5,499510,897655.5
411760,202009,1174,870,304,913330.6,317680,1231010.6
411770,202009,458,301,157,315590,164065,479655
411780,202009,351,228,123,238260,128535,366795
411790,202009,520,288,232,300960.22,243485,544445.22
411800,202009,158,119,39,124355.96,40755,165110.96
411810,202009,179,135,44,144210,45980,190190
411820,202009,2222,969,1253,1014696.7,1311475,2326171.7
411830,202009,11,10,1,10450,1045,11495
411840,202009,2022,1234,788,1291620,827641,2119261
411845,202009,53,19,34,19855,35530,55385
411850,202009,1219,670,549,703285.5,578930.75,1282216.25
411860,202009,49,31,18,32395.5,18810,51205.5
411870,202009,71,46,25,49115,26125,75240
411880,202009,421,265,156,276925,164065,440990
411885,202009,105,68,37,71060,38665,109725
411890,202009,309,199,110,209001.49,114950,323951.49
411900,202009,78,61,17,63745.5,17765,81510.5
411910,202009,181,141,40,147345,41800,189145
411915,202009,2196,892,1304,934230,1363725.05,2297955.05
411920,202009,119,96,23,100320,24035,124355
411925,202009,12,8,4,8360,4180,12540
411930,202009,808,584,224,611291.01,234080,845371.01
411940,202009,582,396,186,413820.85,194370,608190.85
411950,202009,1016,484,532,506825.76,556985,1063810.76
411960,202009,1045,698,347,729410.75,363660,1093070.75
411965,202009,19,13,6,13585,6270,19855
411970,202009,84,75,9,78375,9405,87780
411980,202009,166,108,58,113905,60610,174515
411990,202009,5159,2918,2241,3058722.14,2350275.25,5408997.39
411995,202009,509,167,342,176605,357390,533995
412000,202009,318,205,113,214225,118085,332310
412010,202009,45,28,17,29260,17765,47025
412015,202009,42,30,12,31350,12540,43890
412020,202009,32,25,7,26125,7315,33440
412030,202009,47,45,2,47025,2090,49115
412033,202009,51,29,22,30305,22990,53295
412035,202009,71,44,27,45980,28215,74195
412040,202009,45,25,20,26125.5,20900,47025.5
412050,202009,201,154,47,160930,49115,210045
412060,202009,790,582,208,609304.66,217360,826664.66
412065,202009,50,32,18,33440,18810,52250
412070,202009,163,109,54,114950,56430,171380
412080,202009,295,147,148,153615,154660,308275
412085,202009,37,16,21,16720,21945,38665
412090,202009,807,511,296,533995.25,312455,846450.25
412100,202009,247,207,40,216315,41800,258115
412110,202009,69,55,14,57475.5,14630,72105.5
412120,202009,328,196,132,204820,137940,342760
412125,202009,82,50,32,52250,33440,85690
412130,202009,37,23,14,24035.4,15675,39710.4
412135,202009,29,17,12,17765,12540,30305
412140,202009,350,229,121,239305,126445,365750
412150,202009,248,164,84,171380,87780,259160
412160,202009,89,51,38,53295,39710,93005
412170,202009,694,476,218,498465.5,228855,727320.5
412175,202009,37,27,10,28215,10450,38665
412180,202009,196,147,49,153615,52250,205865
412190,202009,330,261,69,272745,72105,344850
412200,202009,184,120,64,125400,66880,192280
412210,202009,74,57,17,59565,18810,78375
412215,202009,231,163,68,170642.23,71060,241702.23
412217,202009,65,52,13,54340,13585,67925
412220,202009,840,585,255,615505,266475,881980
412230,202009,324,198,126,207955,131670,339625
412240,202009,1350,663,687,694925,718960,1413885
412250,202009,409,253,156,264385,164065,428450
412260,202009,111,79,32,83600,33440,117040
412265,202009,177,138,39,144210,40755,184965
412270,202009,88,60,28,62700,29260,91960
412280,202009,90,72,18,75240,18810,94050
412290,202009,94,64,30,66880,31350,98230
412300,202009,211,139,72,146300,75240,221540
412310,202009,50,42,8,43890,8360,52250
412320,202009,99,81,18,84645,18810,103455
412330,202009,188,158,30,165110,31350,196460
412340,202009,156,109,47,114950,49115.5,164065.5
412350,202009,622,302,320,315590,335445,651035
412360,202009,26,22,4,22990,4180,27170
412370,202009,163,142,21,148390.3,22990,171380.3
412380,202009,257,195,62,204820,64790,269610
412382,202009,63,34,29,35530,30305,65835
412385,202009,151,107,44,111815,45980,157795
412390,202009,281,213,68,222585,71060,293645
412395,202009,71,59,12,61655,12540,74195
412400,202009,94,63,31,65835,32395,98230
412402,202009,229,114,115,119130.5,121220,240350.5
412405,202009,864,308,556,321860,582065,903925
412410,202009,970,596,374,622820.5,390830,1013650.5
412420,202009,13,12,1,12540,1045,13585
412430,202009,20,16,4,16720,4180,20900
412440,202009,613,332,281,346940,293645,640585
412450,202009,75,65,10,67925,10450,78375
412460,202009,93,72,21,75240,21945,97185
412470,202009,220,176,44,183920,47025,230945
412480,202009,145,107,38,111815.75,39710,151525.75
412490,202009,157,139,18,146300,18810,165110
412500,202009,430,350,80,367840.5,84645,452485.5
412510,202009,176,144,32,150480,33440,183920
412520,202009,93,61,32,63745,33440,97185
412530,202009,105,55,50,57475,52250,109725
412535,202009,90,68,22,71060,22990,94050
412540,202009,84,40,44,41800,45980,87780
412545,202009,89,61,28,63745,29260,93005
412550,202009,3826,1613,2213,1691855.5,2319170,4011025.5
412555,202009,13,9,4,9405,4180,13585
412560,202009,620,434,186,453531.5,194370,647901.5
412570,202009,769,388,381,407550,398145,805695
412575,202009,92,63,29,65835,30305,96140
412580,202009,177,117,60,122265,63745,186010
412590,202009,36,31,5,32395,5225,37620
412600,202009,171,124,47,129580.85,49115,178695.85
412610,202009,34,17,17,17765,17765,35530
412620,202009,146,122,24,128535,25080,153615
412625,202009,2144,1120,1024,1173536.04,1073216.85,2246752.89
412627,202009,67,51,16,54340,16720,71060
412630,202009,405,267,138,280060,145255,425315
412635,202009,67,18,49,18810,51205,70015
412640,202009,103,73,30,76285,31350,107635
412650,202009,336,219,117,228855,123310,352165
412660,202009,469,280,189,293645,199595,493240
412665,202009,46,41,5,42845,5225,48070
412667,202009,297,200,97,209000,101365,310365
412670,202009,65,53,12,55385,12540,67925
412680,202009,297,231,66,241395,68970.7,310365.7
412690,202009,106,68,38,71060,39710.5,110770.5
412700,202009,161,109,52,115960.16,54340,170300.16
412710,202009,1374,823,551,864216.25,577885,1442101.25
412720,202009,228,140,88,146300,91960,238260
412730,202009,188,158,30,165110,32395,197505
412740,202009,429,225,204,235125,213180,448305
412750,202009,434,246,188,258115,197505,455620
412760,202009,285,144,141,150480,147345.5,297825.5
412770,202009,2143,1186,957,1242505.29,1004246,2246751.29
412780,202009,138,107,31,111815,33440,145255
412785,202009,281,136,145,142120,152570,294690
412788,202009,36,20,16,20900,16720,37620
412790,202009,124,104,20,108680,20900,129580
412795,202009,150,105,45,109725,47025,156750
412796,202009,313,206,107,216315,113905,330220
412800,202009,622,371,251,389785.25,263340,653125.25
412810,202009,2961,1601,1360,1676182.88,1423290,3099472.88
412820,202009,938,580,358,607146.75,374110,981256.75
412830,202009,14,11,3,11495,3135,14630
412840,202009,231,165,66,173470,68970,242440
412850,202009,755,487,268,508915,280060,788975
412853,202009,170,84,86,87780,89870,177650
412855,202009,178,96,82,100320.09,85690,186010.09
412860,202009,94,63,31,65835,32395,98230
412862,202009,58,38,20,39710,20900,60610
412863,202009,6,5,1,5225,1045,6270
412865,202009,45,32,13,33440,13585,47025
412870,202009,109,67,42,70015,43890,113905
412880,202009,93,67,26,70015.5,27170,97185.5
420005,202009,41,37,4,38665,4180,42845
420010,202009,364,233,131,244530,136895,381425
420020,202009,80,67,13,70015,13585,83600
420030,202009,23,20,3,21945,3135,25080
420040,202009,104,80,24,83600,25080,108680
420050,202009,59,35,24,36575,25080,61655
420055,202009,18,18,0,18810,0,18810
420060,202009,29,23,6,24035,6270,30305
420070,202009,103,86,17,89870,17765,107635
420075,202009,11,11,0,11495,0,11495
420080,202009,42,37,5,38665,5225,43890
420090,202009,34,30,4,31350,4180,35530
420100,202009,149,126,23,131670.5,24035,155705.5
420110,202009,18,18,0,18810,0,18810
420120,202009,57,40,17,41800,17765,59565
420125,202009,79,61,18,64790,18810,83600
420127,202009,32,26,6,27170,6270,33440
420130,202009,430,260,170,271700,177650,449350
420140,202009,1296,720,576,752400.75,601920,1354320.75
420150,202009,43,36,7,37620,7315,44935
420160,202009,32,30,2,31350,2090,33440
420165,202009,16,11,5,11495,5225,16720
420170,202009,75,48,27,50160,28215,78375
420180,202009,22,19,3,19855,3135,22990
420190,202009,26,23,3,24035,3135,27170
420195,202009,132,64,68,66880,72105,138985
420200,202009,1264,561,703,588335.5,737770,1326105.5
420205,202009,82,47,35,49115,36575,85690
420207,202009,119,66,53,68970,55385,124355
420208,202009,19,15,4,15675,4180,19855
420209,202009,18,15,3,15675,3135,18810
420210,202009,512,238,274,248710,289465,538175
420213,202009,43,35,8,36575,8360,44935
420215,202009,27,24,3,25080,3135,28215
420220,202009,63,41,22,42845,22990,65835
420230,202009,835,468,367,490105,385605.5,875710.5
420240,202009,2224,1442,782,1515251.4,823460,2338711.4
420243,202009,41,31,10,32395,10450,42845
420245,202009,158,83,75,86735,78375,165110
420250,202009,62,41,21,42845,21945,64790
420253,202009,30,24,6,25080,6270,31350
420257,202009,13,10,3,10450,3135,13585
420260,202009,100,82,18,86735,18810,105545
420270,202009,31,26,5,27170,5225,32395
420280,202009,293,222,71,231990.75,74195.75,306186.50
420285,202009,23,13,10,13585,10450,24035
420287,202009,50,33,17,35530,17765,53295
420290,202009,977,674,303,704330.5,317680,1022010.5
420300,202009,1426,1119,307,1175628.1,320815.65,1496443.75
420310,202009,52,35,17,37620,17765,55385
420315,202009,35,28,7,29260.5,7315,36575.5
420320,202009,931,456,475,478610.1,497420,976030.1
420325,202009,1,0,1,0,1045,1045
420330,202009,119,78,41,81510,42845,124355
420340,202009,166,109,57,113905,59565,173470
420350,202009,260,183,77,191235,80465,271700
420360,202009,724,552,172,576840.83,182875,759715.83
420370,202009,117,70,47,73150,49115.5,122265.5
420380,202009,1174,812,362,850630.75,381425,1232055.75
420390,202009,248,174,74,182875,78375,261250
420395,202009,198,142,56,149435,58520,207955
420400,202009,240,184,56,193325.65,58520,251845.65
420410,202009,58,44,14,45980,14630,60610
420415,202009,35,29,6,30305,6270,36575
420417,202009,49,37,12,39710,12540,52250
420419,202009,11,11,0,11495,0,11495
420420,202009,2836,1742,1094,1827708.24,1147410.5,2975118.74
420425,202009,69,56,13,58520,13585,72105
420430,202009,1160,826,334,863170.45,349030,1212200.45
420435,202009,15,13,2,13585,2090,15675
420440,202009,100,71,29,75240.5,30305,105545.5
420445,202009,28,26,2,27170,2090,29260
420450,202009,77,39,38,40755,39710,80465
420455,202009,212,161,51,168245,53295,221540
420460,202009,2337,1503,834,1572726.32,874665.76,2447392.08
420470,202009,103,74,29,78375,30305,108680
420475,202009,7,7,0,7315,0,7315
420480,202009,845,635,210,665666,219450.5,885116.5
420490,202009,104,77,27,80465,28215.65,108680.65
420500,202009,453,237,216,248711.09,225720,474431.09
420510,202009,20,17,3,17765,3135,20900
420515,202009,26,17,9,17765,9405,27170
420517,202009,9,9,0,9405,0,9405
420519,202009,0,,,,,0.0
420520,202009,66,50,16,52250,16720,68970
420530,202009,161,108,53,112860.75,55385,168245.75
420535,202009,19,17,2,17765,2090,19855
420540,202009,5506,3291,2215,3449811.15,2329305.5,5779116.65
420543,202009,32,30,2,31350,2090,33440
420545,202009,206,146,60,154660,62700,217360
420550,202009,856,705,151,738816.4,157795,896611.4
420555,202009,35,26,9,27170,9405,36575
420560,202009,61,51,10,54340,10450,64790
420570,202009,158,91,67,95095,70015,165110
420580,202009,279,130,149,135850,155705,291555
420590,202009,512,350,162,365750,170335,536085
420600,202009,117,64,53,66880,55385,122265
420610,202009,38,35,3,36575,4180,40755
420620,202009,89,69,20,72105,20900,93005
420630,202009,153,104,49,108680,51205,159885
420640,202009,83,74,9,77330,9405,86735
420650,202009,242,122,120,128535,126445,254980
420660,202009,49,39,10,40755.5,10450,51205.5
420665,202009,35,26,9,28215,9405,37620
420670,202009,296,227,69,239305,72105,311410
420675,202009,12,11,1,11495,1045,12540
420680,202009,38,27,11,28215,11495,39710
420690,202009,179,140,39,146300,40755,187055
420700,202009,684,463,221,483835.46,230945,714780.46
420710,202009,150,81,69,84645,72105,156750
420720,202009,109,88,21,91960,21945,113905
420730,202009,611,380,231,397100.4,241395.5,638495.9
420740,202009,52,51,1,53295,1045,54340
420750,202009,497,338,159,356345,168245,524590
420757,202009,16,14,2,14630,2090,16720
420760,202009,38,30,8,31350,8360,39710
420765,202009,78,59,19,61655,19855,81510
420768,202009,48,42,6,43890,6270,50160
420770,202009,71,62,9,64790,9405,74195
420775,202009,40,37,3,38665,3135,41800
420780,202009,217,170,47,177650,49115,226765
420785,202009,12,9,3,9405,3135,12540
420790,202009,164,136,28,142120,29260,171380
420800,202009,66,50,16,52250,16720,68970
420810,202009,256,212,44,221540,45980,267520
420820,202009,2375,1348,1027,1413885.5,1074261.22,2488146.72
420830,202009,621,328,293,343805.5,307230,651035.5
420840,202009,152,107,45,112860,47025,159885
420845,202009,409,176,233,184825.66,243485.5,428311.16
420850,202009,259,190,69,198550,72105,270655
420860,202009,57,48,9,51205,9405,60610
420870,202009,126,87,39,90915,40755,131670
420880,202009,181,116,65,121220,67925,189145
420890,202009,936,467,469,490105.25,493240,983345.25
420895,202009,9,9,0,9405,0,9405
420900,202009,406,321,85,335445,88825,424270
420910,202009,5858,3238,2620,3396254.76,2746260,6142514.76
420915,202009,61,57,4,59565,4180,63745
420917,202009,21,14,7,14630,7315,21945
420920,202009,22,15,7,15675,7315,22990
420930,202009,2794,1732,1062,1813421,1112926.78,2926347.78
420940,202009,595,440,155,461891,161975.9,623866.9
420945,202009,9,7,2,7315,2090,9405
420950,202009,55,48,7,50160,7315,57475
420960,202009,107,85,22,88825,22990,111815
420970,202009,287,232,55,242441,57475,299916
420980,202009,23,22,1,22990,1045,24035
420985,202009,56,50,6,52250,6270,58520
420990,202009,82,58,24,60610,25080,85690
421000,202009,42,25,17,26125,17765,43890
421003,202009,50,34,16,35530,16720,52250
421005,202009,6,3,3,3135,3135,6270
421010,202009,779,522,257,545491,269610,815101
421020,202009,25,20,5,20900,5225,26125
421030,202009,119,98,21,102410.75,21945,124355.75
421040,202009,73,54,19,56430,19855,76285
421050,202009,354,251,103,262296,108680,370976
421055,202009,20,16,4,17765,4180,21945
421060,202009,91,52,39,54340,40755,95095
421070,202009,48,42,6,44935.5,6270,51205.5
421080,202009,35,31,4,32395,4180,36575
421085,202009,20,15,5,15675,5225,20900
421090,202009,35,27,8,29260,8360,37620
421100,202009,127,92,35,97185,36575,133760
421105,202009,196,158,38,167200,39710,206910
421110,202009,111,87,24,90915,25080,115995
421120,202009,168,121,47,126445.42,49115,175560.42
421125,202009,17,12,5,12540,5225,17765
421130,202009,826,517,309,542355,323950.5,866305.5
421140,202009,31,21,10,21945,10450,32395
421145,202009,41,33,8,34485,8360,42845
421150,202009,101,73,28,76285,29260,105545
421160,202009,67,46,21,48070,21945,70015
421165,202009,15,14,1,14630,1045,15675
421170,202009,183,154,29,161056,30305,191361
421175,202009,164,112,52,117040,54340,171380
421180,202009,46,32,14,33440.1,14630,48070.1
421185,202009,18,14,4,14630,4180,18810
421187,202009,1,0,1,0,1045,1045
421189,202009,45,30,15,31350,15675,47025
421190,202009,1699,1056,643,1106655,672980,1779635
421200,202009,95,71,24,74195,25080,99275
421205,202009,27,18,9,18810,9405,28215
421210,202009,175,120,55,125400,57475,182875
421220,202009,274,213,61,222585,64790,287375
421223,202009,47,38,9,39710,10450,50160
421225,202009,71,45,26,47025,27170,74195
421227,202009,86,67,19,70015,19855,89870
421230,202009,57,41,16,42845,16720,59565
421240,202009,18,18,0,18810,0,18810
421250,202009,375,216,159,225720.5,166155,391875.5
421260,202009,24,20,4,20900,4180,25080
421265,202009,2,2,0,2090,0,2090
421270,202009,46,41,5,42845,5225,48070
421280,202009,349,185,164,193325,171380,364705
421290,202009,330,218,112,227810,118085.5,345895.5
421300,202009,23,19,4,19855,4180,24035
421310,202009,46,33,13,34485,13585,48070
421315,202009,30,18,12,18810,12540,31350
421320,202009,128,82,46,86735,48070,134805
421330,202009,108,77,31,80465,32395,112860
421335,202009,39,27,12,28215,12540,40755
421340,202009,238,156,82,163020.25,86735,249755.25
421350,202009,189,109,80,113905.82,83600,197505.82
421360,202009,648,477,171,498465.25,181830,680295.25
421370,202009,197,150,47,157795,50160,207955
421380,202009,133,103,30,107635,31350,138985
421390,202009,18,12,6,12540,6270,18810
421400,202009,121,107,14,111815,14630,126445
421410,202009,17,15,2,15675,2090,17765
421415,202009,19,18,1,18810,1045,19855
421420,202009,129,106,23,110770,24035,134805
421430,202009,17,13,4,13585,4180,17765
421440,202009,58,49,9,52250,9405,61655
421450,202009,92,76,16,79420,16720.83,96140.83
421460,202009,63,51,12,53295,12540,65835
421470,202009,68,41,27,42845.25,28215,71060.25
421480,202009,726,552,174,577885,182875,760760
421490,202009,23,22,1,22990,1045,24035
421500,202009,497,317,180,331265.5,188100.25,519365.75
421505,202009,24,17,7,17765,7315,25080
421507,202009,32,25,7,26125,7315,33440
421510,202009,70,46,24,48070,26125,74195
421520,202009,56,47,9,49115,9405,58520
421530,202009,50,42,8,43890,8360,52250
421535,202009,25,23,2,24035,2090,26125
421540,202009,51,43,8,44935,8360,53295
421545,202009,104,75,29,78375,30305,108680
421550,202009,282,202,80,211090,84645,295735
421555,202009,21,18,3,18810,3135,21945
421560,202009,9,8,1,8360,1045,9405
421565,202009,119,80,39,83600,41800,125400
421567,202009,31,24,7,25080,7315,32395
421568,202009,32,28,4,29260,4180,33440
421569,202009,10,10,0,10450,0,10450
421570,202009,204,138,66,144210,68970,213180
421575,202009,28,23,5,24035,5225,29260
421580,202009,720,428,292,447328,307230,754558
421590,202009,21,19,2,19855,2090,21945
421600,202009,155,101,54,105545.5,56430.5,161976.0
421605,202009,109,76,33,79420.75,34485,113905.75
421610,202009,180,136,44,143165,45980,189145
421620,202009,1021,593,428,621775,451440,1073215
421625,202009,21,18,3,18810,3135,21945
421630,202009,308,193,115,201685.25,120176.5,321861.75
421635,202009,18,9,9,9405,9405,18810
421640,202009,101,83,18,86735,18810,105545
421650,202009,298,176,122,186010,127490,313500
421660,202009,2248,1338,910,1403437,953041,2356478
421670,202009,182,131,51,136895,55385,192280
421680,202009,178,161,17,168245,17765,186010
421690,202009,342,240,102,251846.25,107635.6,359481.85
421700,202009,54,37,17,38665,17765,56430
421710,202009,24,23,1,24035,1045,25080
421715,202009,6,5,1,5225,1045,6270
421720,202009,634,440,194,459800.5,203775,663575.5
421725,202009,17,6,11,6270,11495,17765
421730,202009,32,24,8,25080,8360,33440
421740,202009,92,34,58,35530,60610,96140
421750,202009,207,155,52,161975,55385,217360
421755,202009,23,21,2,22990,2090,25080
421760,202009,103,68,35,71060,36575,107635
421770,202009,664,415,249,433676.75,261250,694926.75
421775,202009,27,16,11,16720,11495,28215
421780,202009,193,151,42,157795.5,44935,202730.5
421790,202009,149,127,22,133760,22990,156750
421795,202009,17,14,3,14630,3135,17765
421800,202009,516,328,188,344850,196460,541310
421810,202009,69,55,14,57475,14630,72105
421820,202009,309,201,108,210045.5,114950,324995.5
421825,202009,139,118,21,124355,21945,146300
421830,202009,138,90,48,95095,50160,145255
421835,202009,6,4,2,4180,2090,6270
421840,202009,48,42,6,43890,6270,50160
421850,202009,80,68,12,71060,12540,83600
421860,202009,35,29,6,30305,6270,36575
421870,202009,1026,766,260,804651.25,272745,1077396.25
421875,202009,54,44,10,45980,10450,56430
421880,202009,170,118,52,123310,54340.5,177650.5
421885,202009,23,18,5,18810,5225,24035
421890,202009,133,93,40,97185,42845,140030
421895,202009,45,40,5,41800,5225,47025
421900,202009,151,117,34,124355,36575,160930
421910,202009,66,38,28,40755,29260,70015
421915,202009,30,25,5,26125,5225,31350
421917,202009,38,29,9,30305,9405,39710
421920,202009,39,35,4,36575,4180,40755
421930,202009,663,535,128,559075,136895,695970
421935,202009,52,45,7,47025,7315,54340
421940,202009,44,38,6,39710,6270,45980
421950,202009,876,589,287,615506,299915,915421
421960,202009,45,40,5,41800,5225,47025
421970,202009,353,225,128,235125.5,134805,369930.5
421985,202009,21,13,8,13585,8360,21945
422000,202009,0,,,,,0.0
430003,202009,195,56,139,58520,145255,203775
430005,202009,38,24,14,25080,14630,39710
430010,202009,267,194,73,203775,76285,280060
430020,202009,144,95,49,99275.5,51205,150480.5
430030,202009,121,97,24,102410,25080,127490
430040,202009,2912,1719,1193,1800537,1250865.5,3051402.5
430045,202009,66,55,11,58520,11495,70015
430047,202009,6,6,0,6270,0,6270
430050,202009,78,64,14,66880,14630,81510
430055,202009,12,11,1,11495,1045,12540
430057,202009,5,4,1,4180,1045,5225
430060,202009,3722,2149,1573,2249886.25,1646920,3896806.25
430063,202009,53,49,4,51205,4180,55385
430064,202009,151,120,31,125400,32395,157795
430066,202009,5,2,3,2090,3135,5225
430070,202009,43,29,14,30305,14630,44935
430080,202009,67,44,23,48070,24035,72105
430085,202009,29,10,19,10450,19855,30305
430087,202009,27,19,8,19855.75,8360,28215.75
430090,202009,72,65,7,68970,7315,76285
430100,202009,123,83,40,86735,42845,129580
430105,202009,153,83,70,86735,73150,159885
430107,202009,18,12,6,12540,6270,18810
430110,202009,451,255,196,266475,205865,472340
430120,202009,157,146,11,152570,11495,164065
430130,202009,799,487,312,508915.5,326040,834955.5
430140,202009,124,115,9,120175,9405,129580
430150,202009,111,71,40,74195,41800,115995
430155,202009,36,31,5,32395,5225,37620
430160,202009,3626,2125,1501,2223762.75,1570635.5,3794398.25
430163,202009,356,156,200,163020,210045,373065
430165,202009,30,19,11,19855,11495,31350
430170,202009,89,74,15,77330,15675,93005
430175,202009,75,59,16,61655,17765,79420
430180,202009,106,86,20,89870,20900,110770
430185,202009,30,20,10,20900,10450,31350
430187,202009,82,37,45,38665,47025,85690
430190,202009,215,119,96,124355,100320,224675
430192,202009,13,11,2,11495,2090,13585
430195,202009,15,10,5,10450,5225,15675
430200,202009,165,141,24,147345,25080,172425
430205,202009,21,20,1,20900,1045,21945
430210,202009,670,517,153,540265,159885,700150
430215,202009,13,11,2,11495,2090,13585
430220,202009,73,50,23,52250,24035,76285
430222,202009,12,6,6,6270,6270,12540
430223,202009,15,8,7,8360,7315,15675
430225,202009,2,1,1,1045,1045,2090
430230,202009,312,184,128,193325,134805.5,328130.5
430235,202009,54,42,12,43890,12540,56430
430237,202009,28,21,7,21945,7315,29260
430240,202009,123,82,41,86735,44935,131670
430245,202009,70,56,14,58520,14630,73150
430250,202009,184,110,74,114950,77330,192280
430258,202009,9,8,1,8360,1045,9405
430260,202009,31,27,4,28215,4180,32395
430265,202009,37,31,6,32395,6270,38665
430270,202009,523,393,130,410686.25,136895,547581.25
430280,202009,1032,625,407,654170,428450,1082620
430290,202009,397,216,181,225720,190190,415910
430300,202009,2096,1155,941,1209065.75,983345.5,2192411.25
430310,202009,2016,1016,1000,1062765.5,1046046.21,2108811.71
430320,202009,56,46,10,48070,10450,58520
430330,202009,98,86,12,90915,12540,103455
430340,202009,73,58,15,60610,15675,76285
430350,202009,1654,1116,538,1168310.5,564300,1732610.5
430355,202009,19,17,2,17765,2090,19855
430360,202009,85,43,42,44935,43890,88825
430367,202009,34,25,9,26125,9405,35530
430370,202009,53,47,6,49115,6270,55385
430380,202009,129,99,30,103455,31350,134805
430390,202009,589,368,221,384560,230945,615505
430400,202009,261,186,75,194370.5,79420,273790.5
430410,202009,54,43,11,44935,11495,56430
430420,202009,503,326,177,344850.85,184965,529815.85
430430,202009,55,54,1,55734.03,1045,56779.03
430435,202009,150,113,37,119130,38665,157795
430440,202009,484,318,166,332310,173470,505780
430450,202009,1143,943,200,988570,210045,1198615
430460,202009,5298,2769,2529,2898831.9,2656390.5,5555222.4
430461,202009,16,15,1,15675,1045,16720
430462,202009,10,6,4,6270,4180,10450
430463,202009,1100,594,506,621775,529815,1151590
430465,202009,24,13,11,13585,11495,25080
430466,202009,655,461,194,481745.5,203775,685520.5
430467,202009,105,58,47,60610,50160,110770
430468,202009,117,71,46,74195,48070,122265
430469,202009,23,18,5,18810,5225,24035
430470,202009,1157,643,514,672246.62,539220,1211466.62
430471,202009,53,35,18,36575,18810,55385
430480,202009,103,67,36,70015,37620,107635
430485,202009,6,6,0,6270.5,0,6270.5
430490,202009,75,60,15,62700,15675,78375
430495,202009,34,26,8,27170,8360,35530
430500,202009,190,128,62,133760,64790,198550
430510,202009,3452,2218,1234,2321990.13,1295800.5,3617790.63
430511,202009,16,16,0,16720,0,16720
430512,202009,153,107,46,111815,48070,159885
430513,202009,53,43,10,44935,10450,55385
430515,202009,28,26,2,27170,2090,29260
430517,202009,168,146,22,152570,22990,175560
430520,202009,341,236,105,246620,109725,356345
430530,202009,82,47,35,49115,36575,85690
430535,202009,446,305,141,319770,147345,467115
430537,202009,10,10,0,10450,0,10450
430540,202009,82,57,25,59565,26125,85690
430543,202009,356,113,243,118085,253935,372020
430544,202009,43,40,3,41800,3135,44935
430545,202009,375,189,186,198550,194370,392920
430550,202009,41,33,8,34485,8360,42845
430558,202009,2,2,0,2090,0,2090
430560,202009,55,29,26,30305,27170,57475
430570,202009,106,41,65,42845,67925,110770
430580,202009,131,106,25,110770,26125,136895
430583,202009,13,13,0,13585,0,13585
430585,202009,12,5,7,5225,7315,12540
430587,202009,14,7,7,7315,7315,14630
430590,202009,142,115,27,120175,29260,149435
430593,202009,2,2,0,2090,0,2090
430595,202009,17,14,3,14630,3135,17765
430597,202009,43,21,22,21945,22990,44935
430600,202009,219,161,58,168245,60610,228855
430605,202009,158,100,58,104500,60610,165110
430607,202009,24,20,4,20900,4180,25080
430610,202009,1623,756,867,792110,907060.5,1699170.5
430613,202009,2,2,0,2090,0,2090
430620,202009,108,79,29,82555,30305,112860
430630,202009,47,41,6,42845,6270,49115
430632,202009,32,27,5,28215,5225,33440
430635,202009,33,30,3,31350,3135,34485
430637,202009,60,30,30,31350,31350,62700
430640,202009,181,96,85,100320,88825.42,189145.42
430642,202009,21,17,4,17765,4180,21945
430645,202009,33,27,6,28215,6270,34485
430650,202009,246,201,45,211090.5,47025,258115.5
430655,202009,2,2,0,2090,0,2090
430660,202009,980,485,495,507870,520410.5,1028280.5
430670,202009,78,52,26,54340,27170,81510
430673,202009,69,42,27,43890,28215,72105
430675,202009,11,9,2,9405,2090,11495
430676,202009,522,307,215,320815,224675,545490
430680,202009,234,161,73,169291,76285,245576
430690,202009,529,326,203,343805,212135.29,555940.29
430692,202009,8,6,2,6270,2090,8360
430693,202009,140,89,51,93005,53295,146300
430695,202009,66,54,12,56430,12540,68970
430697,202009,56,35,21,36575,21945,58520
430700,202009,1484,1025,459,1074260.9,480700,1554960.9
430705,202009,24,22,2,22990,2090,25080
430710,202009,252,159,93,166155,98230,264385
430720,202009,107,92,15,96140,15675,111815
430730,202009,139,119,20,124355,20900,145255
430740,202009,74,50,24,52250,25080,77330
430745,202009,29,23,6,24035,6270,30305
430750,202009,327,219,108,228855,112860,341715
430755,202009,86,45,41,47025,42845,89870
430760,202009,381,212,169,224675.6,177699,402374.6
430770,202009,1503,779,724,819280.5,761805.5,1581086.0
430780,202009,299,188,111,196460,117040,313500
430781,202009,25,21,4,21945,4180,26125
430783,202009,60,49,11,51205,11495,62700
430786,202009,5,3,2,3135,2090,5225
430790,202009,512,338,174,354255,181830.5,536085.5
430800,202009,153,123,30,128535.76,31350,159885.76
430805,202009,41,36,5,37620,5225,42845
430807,202009,46,24,22,26125,22990,49115
430810,202009,73,44,29,45980,30305,76285
430820,202009,144,85,59,89870,61655,151525
430825,202009,9,7,2,7315,2090,9405
430830,202009,239,220,19,229900.5,19855,249755.5
430840,202009,126,84,42,88825,43890,132715
430843,202009,5,3,2,3135,2090,5225
430845,202009,72,40,32,42845,33440,76285
430850,202009,578,412,166,430540,176605,607145
430860,202009,161,104,57,108680,59565,168245
430865,202009,76,42,34,43890,35530,79420
430870,202009,82,67,15,70015,15675,85690
430880,202009,151,110,41,114950,42845,157795
430885,202009,9,7,2,7315,2090,9405
430890,202009,344,209,135,218405,143165,361570
430900,202009,512,352,160,367840,167200,535040
430905,202009,122,53,69,55385,72105,127490
430910,202009,281,155,126,161975,131670,293645
430912,202009,6,5,1,5225,1045,6270
430915,202009,34,30,4,31350,4180,35530
430920,202009,4329,2296,2033,2404545,2133890.25,4538435.25
430925,202009,5,4,1,4180,1045,5225
430930,202009,2085,1200,885,1257136.75,927960,2185096.75
430940,202009,255,165,90,173470,95095,268565
430950,202009,155,126,29,131670,30305,161975
430955,202009,24,12,12,12540,12540,25080
430957,202009,18,16,2,16720,2090,18810
430960,202009,245,164,81,171380,84645,256025
430965,202009,112,72,40,75240,41800,117040
430970,202009,83,69,14,72105,14630,86735
430975,202009,44,39,5,40755,5225,45980
430980,202009,47,28,19,29260,19855,49115
430990,202009,107,83,24,87780,25080,112860
430995,202009,115,109,6,113905,6270,120175
431000,202009,294,141,153,147346.1,160930,308276.1
431010,202009,355,199,156,207955,163020,370975
431020,202009,1848,1063,785,1115015.5,822415,1937430.5
431030,202009,40,32,8,33440,8360,41800
431033,202009,402,191,211,199595,220495,420090
431036,202009,11,6,5,6270,5225,11495
431040,202009,140,88,52,91960,54340,146300
431041,202009,40,26,14,28215.5,14630,42845.5
431043,202009,43,26,17,27170,17765,44935
431046,202009,10,6,4,6270,4180,10450
431050,202009,196,123,73,129580,76285,205865
431053,202009,67,40,27,41800,29260,71060
431055,202009,63,43,20,44935,20900,65835
431057,202009,18,18,0,18810,0,18810
431060,202009,1609,1047,562,1097252.09,590425.75,1687677.84
431065,202009,17,11,6,11495,6270,17765
431070,202009,66,61,5,63745,5225,68970
431075,202009,7,7,0,7315,0,7315
431080,202009,137,81,56,84645,58520,143165
431085,202009,35,31,4,32395,4180,36575
431087,202009,16,14,2,14630,2090,16720
431090,202009,54,42,12,43890,12540,56430
431100,202009,1217,734,483,768075.25,505780,1273855.25
431110,202009,227,137,90,143165,94050.5,237215.5
431112,202009,26,16,10,16720,10450,27170
431113,202009,35,25,10,26125,10450,36575
431115,202009,159,110,49,114950,51205,166155
431120,202009,606,361,245,377245,259160,636405
431123,202009,3,2,1,2090,1045,3135
431125,202009,94,85,9,88825,9405,98230
431127,202009,10,5,5,5225,5225,10450
431130,202009,692,456,236,477565,246620,724185
431140,202009,747,512,235,536085.5,247665,783750.5
431142,202009,26,22,4,22990.67,4180,27170.67
431150,202009,190,144,46,150480,49115,199595
431160,202009,47,44,3,45980,4180,50160
431162,202009,5,4,1,4180,1045,5225
431164,202009,6,6,0,6270,0,6270
431170,202009,105,83,22,86735,22990,109725
431171,202009,68,40,28,41800,29260,71060
431173,202009,1,1,0,1045,0,1045
431175,202009,196,99,97,103455.5,102410,205865.5
431177,202009,80,58,22,60610,25080,85690
431179,202009,12,10,2,10450,2090,12540
431180,202009,433,264,169,275880,176605,452485
431190,202009,78,60,18,62700,18810,81510
431198,202009,75,54,21,56430,21945,78375
431200,202009,20,16,4,16720,4180,20900
431205,202009,20,19,1,19855,1045,20900
431210,202009,96,60,36,62700,37620,100320
431213,202009,30,26,4,27170,4180,31350
431215,202009,22,19,3,19855,3135,22990
431217,202009,5,4,1,4180,1045,5225
431220,202009,66,57,9,59565,9405,68970
431225,202009,155,97,58,101365,60610,161975
431230,202009,101,87,14,90915,14630,105545
431235,202009,7,7,0,7315,0,7315
431237,202009,21,15,6,15675,6270,21945
431238,202009,10,6,4,6270,4180,10450
431240,202009,1017,637,380,667755,401280,1069035
431242,202009,39,38,1,39710,1045,40755
431244,202009,15,10,5,10450,5225,15675
431245,202009,51,38,13,39710,13585,53295
431247,202009,11,6,5,6270,5225,11495
431250,202009,277,144,133,150480,140030,290510
431260,202009,57,45,12,47025,12540,59565
431261,202009,18,11,7,11495,7315,18810
431262,202009,16,15,1,15675,1045,16720
431265,202009,149,79,70,83600,73150,156750
431267,202009,17,14,3,14630,3135,17765
431270,202009,322,261,61,272745,63745,336490
431275,202009,38,35,3,36575,3135,39710
431280,202009,21,17,4,17765,4180,21945
431290,202009,24,21,3,21945,3135,25080
431295,202009,2,2,0,2090,0,2090
431300,202009,22,19,3,19855,3135,22990
431301,202009,5,5,0,5225,0,5225
431303,202009,60,39,21,40755,21945,62700
431306,202009,245,131,114,136708.99,119130,255838.99
431308,202009,7,5,2,5225,2090,7315
431310,202009,64,53,11,56430,11495,67925
431320,202009,150,92,58,96140,60610,156750
431330,202009,178,112,66,117040,68970,186010
431333,202009,24,19,5,19855,5225,25080
431335,202009,9,5,4,5225,4180,9405
431337,202009,356,157,199,164065,209000,373065
431339,202009,19,17,2,17765,2090,19855
431340,202009,3022,1647,1375,1726257.94,1440011.25,3166269.19
431342,202009,37,24,13,25080,13585,38665
431344,202009,18,18,0,19855,0,19855
431346,202009,5,5,0,5225,0,5225
431349,202009,36,32,4,33440,4180,37620
431350,202009,938,541,397,567435.25,418000,985435.25
431360,202009,50,42,8,43890,8360,52250
431365,202009,337,152,185,159885,193325,353210
431370,202009,1200,685,515,718960.5,539220,1258180.5
431380,202009,96,84,12,87780,12540,100320
431390,202009,503,265,238,276925,248710,525635
431395,202009,298,126,172,131670,179740,311410
431400,202009,43,30,13,31350,13585,44935
431402,202009,106,75,31,78375,32395,110770
431403,202009,23,14,9,14630,9405,24035
431405,202009,675,376,299,393965.25,314545,708510.25
431406,202009,29,25,4,26125,4180,30305
431407,202009,53,41,12,42845,12540,55385
431410,202009,3373,2054,1319,2154790.5,1379400.75,3534191.25
431413,202009,15,12,3,12540,3135,15675
431415,202009,68,51,17,53295,17765,71060
431417,202009,24,11,13,11495,13585,25080
431420,202009,322,218,104,227810,108680,336490
431430,202009,54,23,31,24035,32395,56430
431440,202009,8901,6166,2735,6454973.08,2865440.66,9320413.74
431442,202009,28,13,15,13585,15675,29260
431445,202009,26,24,2,25080,2090,27170
431446,202009,4,4,0,4180,0,4180
431447,202009,84,58,26,60610,27170,87780
431449,202009,53,45,8,47025,8360,55385
431450,202009,416,274,142,286330,148390,434720
431454,202009,9,3,6,3135,6270,9405
431455,202009,52,41,11,42845,11495,54340
431460,202009,513,353,160,368885,167200,536085
431470,202009,117,88,29,91960,30305,122265
431475,202009,10,8,2,8360,2090,10450
431477,202009,36,24,12,25080,12540,37620
431478,202009,9,8,1,8360,1045,9405
431480,202009,516,309,207,324995,217360,542355
431490,202009,28529,15939,12590,16702244.55,13209848.25,29912092.80
431500,202009,78,63,15,65835,16720,82555
431505,202009,25,15,10,15675,10450,26125
431507,202009,9,7,2,7315,2090,9405
431510,202009,257,180,77,188100.25,80465,268565.25
431513,202009,24,21,3,21945,3135,25080
431514,202009,5,4,1,4180,1045,5225
431515,202009,81,67,14,70015,14630,84645
431517,202009,7,4,3,4180,3135,7315
431520,202009,40,36,4,37620,4180,41800
431530,202009,1454,655,799,684475,834955,1519430
431531,202009,24,23,1,24035,1045,25080
431532,202009,34,25,9,26125,9405,35530
431535,202009,27,15,12,15675,12540,28215
431540,202009,138,117,21,123310,22990,146300
431545,202009,14,12,2,12540,2090,14630
431550,202009,345,188,157,197505,165110,362615
431555,202009,12,12,0,12540,0,12540
431560,202009,4505,3086,1419,3231108.01,1488080,4719188.01
431570,202009,812,425,387,446216,406505,852721
431575,202009,40,24,16,25080,17765,42845
431580,202009,94,61,33,64790,35530,100320
431590,202009,138,117,21,122265,21945,144210
431595,202009,19,15,4,15675,4180,19855
431600,202009,247,144,103,150480,107635,258115
431610,202009,113,82,31,85690,32395,118085
431620,202009,43,36,7,37620,7315,44935
431630,202009,129,107,22,111815,22990,134805
431640,202009,1341,847,494,886160.5,517275.5,1403436.0
431642,202009,35,33,2,34485,2090,36575
431643,202009,45,21,24,21945,25080,47025
431645,202009,311,185,126,193325,131670,324995
431647,202009,9,8,1,8360,1045,9405
431650,202009,36,24,12,26125,12540,38665
431660,202009,306,195,111,203775,115995,319770
431670,202009,226,102,124,106590,131670,238260
431673,202009,3,3,0,3135,0,3135
431675,202009,25,20,5,20900,5225,26125
431680,202009,1124,827,297,865260,310365,1175625
431690,202009,4726,2833,1893,2969895.97,1989681,4959576.97
431695,202009,23,16,7,16720,7315,24035
431697,202009,2,0,2,0,2090,2090
431700,202009,178,137,41,143165,42845,186010
431710,202009,3994,1743,2251,1821435.5,2358565,4180000.5
431720,202009,1326,814,512,853243,538175,1391418
431725,202009,1,1,0,1045,0,1045
431730,202009,1155,783,372,821372.9,389785,1211157.9
431740,202009,1349,661,688,690745,721050.5,1411795.5
431750,202009,1829,1185,644,1241460.55,675070,1916530.55
431755,202009,5,4,1,4180,1045,5225
431760,202009,1034,654,380,685522,398145,1083667
431770,202009,412,296,116,309320,121220,430540
431775,202009,28,19,9,20900,9405,30305
431780,202009,541,327,214,342760,224675,567435
431790,202009,165,126,39,131670,40755,172425
431795,202009,12,10,2,10450,2090,12540
431800,202009,3195,1674,1521,1752467.7,1594671.5,3347139.2
431805,202009,19,17,2,17765,2090,19855
431810,202009,600,395,205,412775,215270,628045
431820,202009,326,193,133,201685,138985,340670
431830,202009,2304,1384,920,1447325.5,961400,2408725.5
431840,202009,482,320,162,336490,169290,505780
431842,202009,32,25,7,26125,7315,33440
431843,202009,12,9,3,9405,3135,12540
431844,202009,18,14,4,14630,4180,18810
431845,202009,27,25,2,26125,2090,28215
431846,202009,26,22,4,22990,4180,27170
431848,202009,10,8,2,8360,2090,10450
431849,202009,7,6,1,6270,1045,7315
431850,202009,786,633,153,663575,160930,824505
431860,202009,114,77,37,80465,38665,119130
431861,202009,7,2,5,2090,5225,7315
431862,202009,57,38,19,39710,19855,59565
431870,202009,3487,2005,1482,2102540.75,1550780,3653320.75
431880,202009,920,670,250,701195,261250,962445
431890,202009,1310,783,527,819280.5,551760,1371040.5
431900,202009,181,128,53,134805,55385,190190
431910,202009,53,39,14,40755,14630,55385
431912,202009,42,25,17,26125,18810,44935
431915,202009,121,94,27,98230,28215,126445
431920,202009,160,115,45,120175,47025,167200
431930,202009,79,66,13,68970,14630,83600
431935,202009,4,4,0,4180,0,4180
431936,202009,12,11,1,11495,1045,12540
431937,202009,20,15,5,15675,5225,20900
431940,202009,452,304,148,318725,154660.25,473385.25
431950,202009,494,312,182,327085.5,195415,522500.5
431960,202009,730,397,333,415910.5,349030,764940.5
431970,202009,69,62,7,65835,7315,73150
431971,202009,3,3,0,3135,0,3135
431973,202009,21,17,4,17765,4180,21945
431975,202009,9,8,1,8360,1045,9405
431980,202009,212,131,81,136895,84645,221540
431990,202009,1136,610,526,639472.52,549670,1189142.52
432000,202009,1740,916,824,957221.75,862126,1819347.75
432010,202009,276,188,88,196460,94050,290510
432020,202009,169,139,30,145255,31350,176605
432023,202009,15,13,2,13585,2090,15675
432026,202009,66,60,6,62700,6270,68970
432030,202009,67,34,33,35530,34485,70015
432032,202009,19,15,4,15675,4180,19855
432035,202009,55,44,11,45980,11495,57475
432040,202009,97,66,31,68970,32395,101365
432045,202009,5,4,1,4180,1045,5225
432050,202009,83,49,34,51205,35530,86735
432055,202009,125,92,33,96140,34485,130625
432057,202009,8,6,2,6270.5,2090,8360.5
432060,202009,35,32,3,33440,3135,36575
432065,202009,33,29,4,30305,4180,34485
432067,202009,91,82,9,85690,9405,95095
432070,202009,394,303,91,316897.5,96140,413037.5
432080,202009,819,568,251,593560,262295,855855
432085,202009,9,7,2,7315,2090,9405
432090,202009,264,176,88,183920,93005,276925
432100,202009,171,114,57,119130,60610,179740
432110,202009,552,369,183,386650,192280,578930
432120,202009,956,548,408,577886,427405.5,1005291.5
432130,202009,478,344,134,359480,140030,499510
432132,202009,23,20,3,20900,3135,24035
432135,202009,82,67,15,70015,15675,85690
432140,202009,271,210,61,219450,63745,283195
432143,202009,211,131,80,136895,83600,220495
432145,202009,273,185,88,194370,93005,287375
432146,202009,13,12,1,12540,1045,13585
432147,202009,113,61,52,63745,54340,118085
432149,202009,16,10,6,10450,6270,16720
432150,202009,878,533,345,556985.5,362615,919600.5
432160,202009,1506,770,736,805695.22,769120.16,1574815.38
432162,202009,4,3,1,3135,1045,4180
432163,202009,19,14,5,14630,5225,19855
432166,202009,123,89,34,93267.5,35530,128797.5
432170,202009,232,116,116,121220,121220,242440
432180,202009,545,333,212,349030,221540.5,570570.5
432183,202009,7,7,0,7315,0,7315
432185,202009,77,67,10,70015,10450,80465
432190,202009,472,275,197,289465,206910,496375
432195,202009,87,72,15,75240,15675,90915
432200,202009,399,251,148,263340,154660,418000
432210,202009,115,72,43,76285,44935,121220
432215,202009,40,36,4,37620,4180,41800
432218,202009,21,20,1,20900,1045,21945
432220,202009,658,341,317,357390,332310.29,689700.29
432225,202009,14,9,5,9405,5225,14630
432230,202009,136,92,44,97185,45980,143165
432232,202009,13,11,2,11495,2090,13585
432234,202009,4,3,1,3135,1045,4180
432235,202009,3,2,1,2090,1045,3135
432237,202009,27,16,11,16720,11495,28215
432240,202009,4299,2396,1903,2508001,1993861.5,4501862.5
432250,202009,1111,719,392,754490,409640,1164130
432252,202009,45,43,2,44935,2090,47025
432253,202009,59,48,11,50160,11495,61655
432254,202009,25,11,14,11495,14630,26125
432255,202009,15,12,3,12540,3135,15675
432260,202009,817,640,177,669845.5,184965,854810.5
432270,202009,238,180,58,189145,60610,249755
432280,202009,138,105,33,109725,34485,144210
432285,202009,2,2,0,2090,0,2090
432290,202009,66,57,9,59565,9405,68970
432300,202009,4688,2550,2138,2674087.07,2240480.5,4914567.57
432310,202009,130,105,25,109725,26125,135850
432320,202009,22,17,5,17765,5225,22990
432330,202009,19,13,6,13585,6270,19855
432335,202009,8,6,2,6270,2090,8360
432340,202009,39,33,6,34485,6270,40755
432345,202009,103,69,34,72105,35530,107635
432350,202009,20,19,1,19855,1045,20900
432360,202009,6,5,1,5225,1045,6270
432370,202009,23,22,1,24035,1045,25080
432375,202009,31,28,3,29260,3135,32395
432377,202009,8,8,0,8360,0,8360
432380,202009,172,75,97,78375,101365,179740
500020,202009,241,130,111,135850,117040,252890
500025,202009,138,69,69,72105,72105,144210
500060,202009,1445,907,538,948860.5,563255.5,1512116.0
500070,202009,789,373,416,389785.29,435765,825550.29
500080,202009,130,103,27,107635,28215,135850
500085,202009,136,111,25,115995.5,26125,142120.5
500090,202009,351,158,193,166155,201685,367840
500100,202009,713,373,340,393965,357391,751356
500110,202009,2254,1054,1200,1105610.5,1259225.75,2364836.25
500124,202009,262,145,117,151525,123310,274835
500150,202009,344,137,207,143165,216315,359480
500190,202009,516,353,163,368885,170335.5,539220.5
500200,202009,189,162,27,169290.2,28215,197505.2
500210,202009,1563,535,1028,561165,1074260.63,1635425.63
500215,202009,247,140,107,146300,111815,258115
500220,202009,733,477,256,499510.77,268565,768075.77
500230,202009,242,149,93,157795,97185,254980
500240,202009,660,456,204,478610.4,214225.5,692835.9
500260,202009,594,229,365,239305,381425,620730
500270,202009,30006,12779,17227,13384770.29,18060741.98,31445512.27
500280,202009,201,70,131,73150,136895,210045
500290,202009,1168,707,461,741950.5,483835,1225785.5
500295,202009,433,279,154,293645.5,160930,454575.5
500310,202009,78,25,53,26125,55385,81510
500315,202009,747,432,315,451440,331265,782705
500320,202009,3578,1769,1809,1853830.54,1901900,3755730.54
500325,202009,930,500,430,523546,452485.5,976031.5
500330,202009,1496,704,792,737770.12,827640,1565410.12
500345,202009,307,233,74,243485.5,77330,320815.5
500348,202009,255,149,106,155705,110770,266475
500350,202009,118,55,63,57475,65835,123310
500370,202009,5574,2484,3090,2602051,3235321,5837372
500375,202009,347,247,100,258115,104500,362615
500380,202009,587,332,255,347985,266475,614460
500390,202009,76,37,39,38665,40755,79420
500400,202009,215,138,77,146300,80465,226765
500410,202009,543,223,320,234080,336490,570570
500430,202009,522,372,150,389785,156750,546535
500440,202009,195,101,94,106590,98230,204820
500450,202009,393,169,224,178695,234080,412775
500460,202009,267,143,124,151525,129580,281105
500470,202009,432,341,91,358435.5,96140,454575.5
500480,202009,103,62,41,64790.5,42845,107635.5
500490,202009,105,45,60,47025,62700,109725
500500,202009,1427,517,910,541310,950950,1492260
500510,202009,43,35,8,36575,8360,44935
500515,202009,100,70,30,73150,31350,104500
500520,202009,312,168,144,175560,150480.5,326040.5
500525,202009,89,49,40,51205,41800,93005
500540,202009,880,381,499,400235,523545.5,923780.5
500560,202009,933,520,413,544445,432631.22,977076.22
500568,202009,981,558,423,586245,442035.5,1028280.5
500570,202009,1191,695,496,726276,521455,1247731
500580,202009,337,172,165,179740,172425,352165
500600,202009,339,164,175,171380,182875,354255
500620,202009,898,632,266,661485.42,279015,940500.42
500625,202009,78,62,16,64790,16720,81510
500627,202009,20,10,10,10450,10450,20900
500630,202009,1571,876,695,923782.54,728365,1652147.54
500635,202009,521,312,209,326040,218405,544445
500640,202009,378,200,178,210045,187055,397100
500660,202009,5501,2010,3491,2106721.25,3655411,5762132.25
500690,202009,603,208,395,217360,414865,632225
500710,202009,401,205,196,215270,204820,420090
500720,202009,933,539,394,567436.23,414865,982301.23
500730,202009,191,115,76,120175,80465,200640
500740,202009,888,371,517,388740,541310,930050
500750,202009,144,45,99,47025,103455,150480
500755,202009,122,89,33,93005.5,34485,127490.5
500769,202009,744,407,337,425315.5,353210,778525.5
500770,202009,414,218,196,227810,204820,432630
500780,202009,153,101,52,105545,54340,159885
500790,202009,1069,541,528,565345,552805,1118150
500793,202009,275,146,129,153615,134805.5,288420.5
500795,202009,176,120,56,125400,58520,183920
500797,202009,51,36,15,37620,15675,53295
500800,202009,436,193,243,201685,256025,457710
500830,202009,2228,1241,987,1301025,1037685,2338710
500840,202009,135,101,34,105545,35530,141075
510010,202009,172,89,83,93005,86735,179740
510020,202009,502,219,283,231990,296780,528770
510025,202009,1682,961,721,1006335,756580.5,1762915.5
510030,202009,668,345,323,362615,338580.5,701195.5
510035,202009,125,62,63,64790,65835,130625
510040,202009,400,186,214,194370,224675.3,419045.3
510050,202009,403,218,185,227810,196460.73,424270.73
510060,202009,120,59,61,61655,64790,126445
510080,202009,231,89,142,93005,148390,241395
510100,202009,64,27,37,28215,38665,66880
510120,202009,38,23,15,24035,15675,39710
510125,202009,386,240,146,250800,152570,403370
510130,202009,548,317,231,332310,241395.5,573705.5
510140,202009,424,124,300,129580,316635,446215
510160,202009,112,36,76,38665,79420,118085
510170,202009,788,481,307,503690.03,321860,825550.03
510180,202009,2921,1376,1545,1443146,1624976.25,3068122.25
510185,202009,19,8,11,8360,11495,19855
510190,202009,230,82,148,85690,154660,240350
510250,202009,2587,1530,1057,1603031,1109791,2712822
510260,202009,174,127,47,132715,49115,181830
510263,202009,462,261,201,272745.5,212135,484880.5
510267,202009,666,372,294,392920.5,308275,701195.5
510268,202009,63,29,34,30305,35530,65835
510269,202009,77,34,43,35530,44935,80465
510270,202009,384,195,189,204820,197505,402325
510279,202009,219,164,55,172425,57475,229900
510285,202009,184,73,111,76285,115995,192280
510300,202009,514,270,244,282150,256025,538175
510305,202009,206,98,108,102410,112860,215270
510310,202009,104,54,50,56430,52250,108680
510320,202009,849,533,316,559075,332310,891385
510325,202009,413,172,241,179740,251845,431585
510330,202009,430,238,192,248919,200640,449559
510335,202009,637,363,274,380380,287375,667755
510336,202009,55,39,16,40755,17765,58520
510337,202009,108,46,62,48070,64790,112860
510340,202009,17270,7826,9444,8198026.79,9891972.25,18089999.04
510343,202009,62,43,19,47025,19855,66880
510345,202009,163,106,57,110770,59565.5,170335.5
510350,202009,645,355,290,373065,304095.5,677160.5
510360,202009,202,124,78,129580,82555,212135
510370,202009,149,71,78,74195,81510,155705
510380,202009,87,64,23,66880,24035,90915
510385,202009,63,28,35,29260,36575,65835
510390,202009,108,47,61,49115,63745,112860
510395,202009,44,32,12,34485,12540,47025
510410,202009,711,464,247,485925,258115,744040
510420,202009,563,273,290,285285,305140,590425
510450,202009,49,24,25,25080,26125,51205
510452,202009,51,24,27,25080,28215,53295
510454,202009,52,24,28,25080,30305,55385
510455,202009,135,78,57,81510,59565,141075
510460,202009,178,84,94,87780,98230,186010
510480,202009,719,422,297,443080.2,310365,753445.2
510490,202009,352,176,176,183920,183920,367840
510500,202009,240,181,59,189145,61655,250800
510510,202009,783,459,324,481745.5,340670.5,822416.0
510515,202009,1223,635,588,666710,616550,1283260
510517,202009,257,113,144,119130,150480,269610
510520,202009,227,146,81,153615,84645,238260
510523,202009,100,76,24,79420,25080,104500
510525,202009,798,478,320,502645,338580,841225
510530,202009,20,14,6,14630,6270,20900
510550,202009,242,111,131,115995.53,138985,254980.53
510558,202009,288,143,145,149435,151525,300960
510560,202009,414,242,172,252890.5,180785,433675.5
510562,202009,640,467,173,488015,181830,669845
510590,202009,757,391,366,408595,383515,792110
510600,202009,236,124,112,130625,118085,248710
510610,202009,205,85,120,88825,125400,214225
510615,202009,185,83,102,86735,106590,193325
510617,202009,18,9,9,9405,9405,18810
510618,202009,119,57,62,59565,65835,125400
510619,202009,96,67,29,70015,30305,100320
510620,202009,170,96,74,100320,77330.7,177650.7
510621,202009,178,114,64,119130,68970,188100
510622,202009,499,303,196,318725,204820,523545
510623,202009,321,223,98,233035,102410,335445
510624,202009,94,47,47,49115,49115,98230
510625,202009,527,327,200,342760,209000.29,551760.29
510626,202009,111,69,42,72105,43890,115995
510627,202009,75,52,23,54340,24035,78375
510628,202009,152,90,62,94050,64790,158840
510629,202009,265,161,104,168245,108699,276944
510630,202009,433,225,208,235125,218405,453530
510631,202009,12,3,9,3135,9405,12540
510637,202009,347,200,147,209000,155705,364705
510642,202009,1001,532,469,556985,491150,1048135
510645,202009,2,0,2,0,2090,2090
510650,202009,1403,918,485,963490.5,509960,1473450.5
510665,202009,80,36,44,37620,45980,83600
510670,202009,59,33,26,34485,27170,61655
510675,202009,1152,735,417,769120.5,438900,1208020.5
510677,202009,345,177,168,184965,177650,362615
510680,202009,106,61,45,63745,48070,111815
510682,202009,203,104,99,109725,104500,214225
510685,202009,55,41,14,42845,14630,57475
510700,202009,577,333,244,347985,257070,605055
510704,202009,1154,603,551,632225,576840,1209065
510706,202009,134,66,68,68970,71060,140030
510710,202009,390,275,115,287375,120175,407550
510715,202009,58,40,18,42845,18810,61655
510718,202009,211,107,104,111815,108680,220495
510719,202009,39,17,22,17765,22990,40755
510720,202009,187,129,58,134805,60610,195415
510724,202009,84,33,51,34485,53295,87780
510726,202009,51,26,25,27170,26125,53295
510729,202009,63,27,36,28215,37620,65835
510730,202009,474,261,213,274835,222585,497420
510735,202009,116,48,68,51205,72105,123310
510740,202009,20,11,9,11495,9405,20900
510757,202009,24,18,6,18810,6270,25080
510760,202009,7168,3681,3487,3850826.5,3655412.67,7506239.17
510770,202009,684,322,362,337535,379335,716870
510774,202009,17,6,11,6270,11495,17765
510775,202009,105,81,24,84645,25080,109725
510776,202009,27,10,17,10450,17765,28215
510777,202009,195,83,112,86735,117040,203775
510779,202009,52,24,28,25080,29260,54340
510780,202009,277,156,121,164065,128535,292600
510785,202009,389,212,177,222585,184965,407550
510787,202009,196,94,102,98230,106590,204820
510788,202009,5,1,4,1045,4180,5225
510790,202009,2492,1309,1183,1370045.25,1240415,2610460.25
510792,202009,1147,646,501,676115,526680.66,1202795.66
510794,202009,115,62,53,64790,55385,120175
510795,202009,2324,1354,970,1425380.5,1025146,2450526.5
510800,202009,175,105,70,109725,73150,182875
510805,202009,178,118,60,124355,63745,188100
510810,202009,96,43,53,44935,55385,100320
510820,202009,237,119,118,124355.45,123310.12,247665.57
510830,202009,72,42,30,43890,31350,75240
510835,202009,14,9,5,9405,5225,14630
510840,202009,9101,4334,4767,4540528.5,5006595.5,9547124.0
510850,202009,220,90,130,94050,135850,229900
510860,202009,376,168,208,175560,220495.5,396055.5
510880,202009,68,50,18,52250,18810,71060
510885,202009,70,39,31,40755,32395,73150
510890,202009,66,37,29,39710,30305,70015
510895,202009,174,103,71,107635,74195.5,181830.5
520005,202009,121,51,70,53295,73150,126445
520010,202009,282,128,154,133760,160930.5,294690.5
520013,202009,714,459,255,480700,268565,749265
520015,202009,51,39,12,40755,12540,53295
520017,202009,86,49,37,51205.5,39710,90915.5
520020,202009,19,10,9,10450,9405,19855
520025,202009,2279,1173,1106,1226830.5,1157860,2384690.5
520030,202009,806,426,380,445170.5,397100,842270.5
520050,202009,69,48,21,50160,21945,72105
520055,202009,56,36,20,37620,20900,58520
520060,202009,176,116,60,121220,62700,183920
520080,202009,588,421,167,440990,174515,615505
520082,202009,18,12,6,12540,6270,18810
520085,202009,89,66,23,68970,24035,93005
520090,202009,92,62,30,64790,31350,96140
520110,202009,9239,3954,5285,4141336,5538502.5,9679838.5
520120,202009,13,8,5,8360,5225,13585
520130,202009,802,558,244,584155,256025.5,840180.5
520140,202009,11980,6640,5340,6953433.76,5595976.7,12549410.46
520145,202009,53,32,21,33440,21945,55385
520150,202009,161,127,34,132715,35530,168245
520160,202009,40,29,11,30305,11495,41800
520170,202009,255,148,107,154660,112860,267520
520180,202009,166,79,87,82555,90915,173470
520215,202009,201,135,66,142120,68970,211090
520235,202009,81,62,19,64790,19855,84645
520250,202009,129,74,55,78375,57475,135850
520260,202009,116,73,43,76285,44935,121220
520280,202009,47,32,15,33440,15675,49115
520310,202009,39,26,13,27170,13585,40755
520320,202009,180,113,67,119130,70015,189145
520330,202009,784,418,366,437855,382470,820325
520340,202009,362,216,146,225720,153615,379335
520350,202009,510,238,272,249755,286330,536085
520355,202009,87,50,37,52250,38665,90915
520357,202009,25,18,7,18810,7315,26125
520360,202009,1,1,0,1045,0,1045
520380,202009,132,72,60,75240,62700,137940
520390,202009,257,107,150,111815.5,156750,268565.5
520393,202009,16,12,4,12540,4180,16720
520396,202009,77,50,27,52250,28215,80465
520400,202009,201,117,84,122265,88825,211090
520410,202009,197,96,101,100320,105545,205865
520420,202009,21,14,7,14630,7315,21945
520425,202009,286,140,146,146300,152570,298870
520430,202009,483,239,244,249851.14,254980.75,504831.89
520440,202009,697,504,193,527725,201685,729410
520450,202009,1968,852,1116,890340,1173535,2063875
520455,202009,57,34,23,35530,24035,59565
520460,202009,38,23,15,24035,15675,39710
520465,202009,32,27,5,28215,5225,33440
520470,202009,431,278,153,291555,160930,452485
520480,202009,78,47,31,49115,32395,81510
520485,202009,114,39,75,41800,78375,120175
520490,202009,406,302,104,317680,108680,426360
520495,202009,160,97,63,101365,67925,169290
520500,202009,184,146,38,152570,41800,194370
520505,202009,188,108,80,112860,83600,196460
520510,202009,1794,849,945,888251,991707.25,1879958.25
520520,202009,44,31,13,32395,13585,45980
520530,202009,224,171,53,178695,55385,234080
520540,202009,584,398,186,416955,194370,611325
520545,202009,135,81,54,84645,57475,142120
520547,202009,57,33,24,34485,25080,59565
520549,202009,1219,566,653,591470.3,682385,1273855.3
520551,202009,306,163,143,170335,149435.5,319770.5
520552,202009,41,26,15,27170,15675,42845
520570,202009,14,8,6,8360,6270,14630
520580,202009,279,172,107,179740,112860,292600
520590,202009,148,91,57,95095,59565,154660
520620,202009,1138,528,610,552805.5,640585.25,1193390.75
520630,202009,39,23,16,24035,16720,40755
520640,202009,385,224,161,234080,168245,402325
520650,202009,64,36,28,37620,29260,66880
520660,202009,44,23,21,24035,21945,45980
520670,202009,37,31,6,32395,6270,38665
520680,202009,51,34,17,35530,17765,53295
520690,202009,42,11,31,11495,32395,43890
520710,202009,32,29,3,30305,3135,33440
520725,202009,201,146,55,152570,57475,210045
520735,202009,55,36,19,38665,19855,58520
520740,202009,419,201,218,210045,227810.5,437855.5
520750,202009,34,25,9,26125,9405,35530
520753,202009,66,46,20,48070,20900,68970
520760,202009,102,69,33,72105,34485,106590
520780,202009,286,209,77,219450,80465,299915
520790,202009,159,91,68,95095,73150,168245
520800,202009,3404,1841,1563,1925935.5,1641695,3567630.5
520810,202009,152,117,35,124355,38665,163020
520815,202009,5,4,1,4180,1045,5225
520830,202009,148,100,48,104500,50160,154660
520840,202009,349,232,117,242440,123310,365750
520850,202009,99,60,39,62700,40755,103455
520860,202009,1749,1130,619,1185030.5,649990.5,1835021.0
520870,202009,31709,14948,16761,15649928.42,17576908,33226836.42
520880,202009,1157,613,544,641630.5,568480.5,1210111.0
520890,202009,792,483,309,506825,322905,829730
520910,202009,969,516,453,540265.93,473385,1013650.93
520915,202009,100,76,24,79420,25080,104500
520920,202009,418,198,220,206910,230945,437855
520929,202009,18,16,2,16720,2090,18810
520940,202009,71,47,24,49115,25080,74195
520945,202009,18,12,6,12540,6270,18810
520960,202009,45,29,16,30305,16720,47025
520970,202009,344,208,136,217360,142120,359480
520980,202009,95,69,26,72105,27170,99275
520990,202009,452,309,143,322905,149435,472340
520993,202009,127,59,68,61655,71060,132715
520995,202009,245,141,104,147345.65,108680.5,256026.15
521000,202009,1560,911,649,954085.5,680295.5,1634381.0
521010,202009,682,336,346,351120,361570,712690
521015,202009,14,9,5,9405,5225,14630
521020,202009,1425,1012,413,1057540,432630.5,1490170.5
521030,202009,53,37,16,38665,16720,55385
521040,202009,946,603,343,632225.25,361570.5,993795.75
521056,202009,47,32,15,34485,15675,50160
521060,202009,131,86,45,89870,47025,136895
521080,202009,416,321,95,335445,101365,436810
521090,202009,552,359,193,375155,201685,576840
521100,202009,274,206,68,216315,71060,287375
521120,202009,1062,749,313,782705.5,329175,1111880.5
521130,202009,352,250,102,261250,106590.5,367840.5
521140,202009,177,99,78,103455,83600,187055
521150,202009,2633,1143,1490,1197570.17,1561230,2758800.17
521160,202009,32,16,16,16720,16720,33440
521170,202009,209,117,92,122265,97185,219450
521180,202009,1185,758,427,792110,447260.25,1239370.25
521190,202009,2546,1074,1472,1124420,1538240.5,2662660.5
521200,202009,55,41,14,42845,14630,57475
521205,202009,11,8,3,8360,3135,11495
521210,202009,123,72,51,76285,53295,129580
521220,202009,775,539,236,565345,246620.25,811965.25
521225,202009,32,22,10,22990,10450,33440
521230,202009,106,71,35,74195,36575,110770
521250,202009,6166,3491,2675,3656459.8,2802693,6459152.8
521260,202009,28,14,14,14630,14630,29260
521270,202009,143,111,32,115995,33440,149435
521280,202009,432,265,167,276925,174515,451440
521290,202009,27,13,14,13585,14630,28215
521295,202009,98,64,34,66880,35530,102410
521300,202009,219,121,98,126445,103455.5,229900.5
521305,202009,37,26,11,27170,11495,38665
521308,202009,1065,818,247,857945,260205,1118150
521310,202009,1332,763,569,799425,594605,1394030
521340,202009,19,15,4,15675,4180,19855
521350,202009,125,94,31,98230,32395,130625
521370,202009,178,125,53,130625,55385,186010
521375,202009,179,93,86,97185,89870,187055
521377,202009,49,38,11,39710,11495,51205
521380,202009,1063,677,386,711646.05,405460,1117106.05
521385,202009,14,9,5,9405,5225,14630
521390,202009,102,84,18,87780,18810,106590
521400,202009,344,229,115,239305,121220,360525
521405,202009,147,81,66,84645,68970,153615
521410,202009,67,46,21,48070,21945,70015
521440,202009,198,142,56,148390,58520,206910
521450,202009,727,416,311,435765,324995,760760
521460,202009,1150,741,409,777480,429495,1206975
521470,202009,12,9,3,9405,3135,12540
521480,202009,42,29,13,30305,13585.25,43890.25
521483,202009,311,185,126,193325.5,132715,326040.5
521486,202009,280,182,98,190190,102410,292600
521487,202009,24,12,12,12540,12540,25080
521490,202009,23,13,10,13585,11495,25080
521500,202009,122,76,46,79420,48070,127490
521520,202009,46,33,13,34485,13585,48070
521523,202009,723,431,292,451440,306185,757625
521525,202009,47,30,17,31350,17765,49115
521530,202009,244,132,112,137940,117040,254980
521540,202009,31,17,14,17765,14630,32395
521550,202009,88,38,50,39710.5,52250,91960.5
521560,202009,810,551,259,575795.5,274835.75,850631.25
521565,202009,63,43,20,44935,20900,65835
521570,202009,522,345,177,361570.5,184965.25,546535.75
521580,202009,55,31,24,32395,25080,57475
521590,202009,35,17,18,17765,18810,36575
521600,202009,22,12,10,12540,10450,22990
521630,202009,245,133,112,138985,117040.25,256025.25
521640,202009,310,166,144,173470,150480,323950
521645,202009,31,16,15,16720,15675,32395
521680,202009,241,149,92,157795,96140,253935
521690,202009,3,3,0,3135,0,3135
521710,202009,1140,552,588,577885,617595,1195480
521720,202009,566,394,172,413820,179740.85,593560.85
521730,202009,651,311,340,324995.5,356345,681340.5
521740,202009,904,389,515,409640,542355.5,951995.5
521760,202009,1937,1002,935,1049248.87,978120.5,2027369.37
521770,202009,821,520,301,545490,314545,860035
521800,202009,2009,1298,711,1359546.5,744040,2103586.5
521805,202009,33,18,15,18810,15675,34485
521810,202009,82,53,29,55385,30305,85690
521830,202009,957,684,273,715825.09,285285.35,1001110.44
521839,202009,89,54,35,56430,36575,93005
521850,202009,1107,579,528,605055.36,553850.5,1158905.86
521860,202009,343,213,130,222585,135850,358435
521870,202009,75,46,29,48070,30305,78375
521878,202009,32,16,16,16720,17765,34485
521880,202009,4717,2105,2612,2204951.5,2738947,4943898.5
521890,202009,600,425,175,444125.3,183920,628045.3
521900,202009,285,233,52,244530,54340,298870
521910,202009,163,116,47,121220,50160,171380
521920,202009,45,22,23,22990,25080,48070
521925,202009,53,31,22,32395,22990,55385
521930,202009,1162,641,521,670890.5,546535,1217425.5
521935,202009,35,26,9,27170,9405,36575
521940,202009,202,98,104,102410,108680,211090
521945,202009,16,13,3,13585,3135,16720
521950,202009,9,5,4,5225,4180,9405
521960,202009,71,53,18,55385,18810,74195
521970,202009,404,259,145,270655,151525,422180
521971,202009,99,53,46,55385,48070,103455
521973,202009,34,17,17,17765,17765,35530
521975,202009,1447,723,724,757625.41,764941.47,1522566.88
521980,202009,246,167,79,175560.5,82555,258115.5
521990,202009,78,56,22,58520,22990,81510
522000,202009,290,184,106,191915.29,110770,302685.29
522005,202009,18,10,8,10450,9405,19855
522010,202009,1129,630,499,659395,521455.5,1180850.5
522015,202009,61,37,24,38665,25080,63745
522020,202009,896,522,374,545490,392920.5,938410.5
522026,202009,23,14,9,14630,9405,24035
522028,202009,15,11,4,11495,4180,15675
522040,202009,779,318,461,332310.25,481745,814055.25
522045,202009,2321,1423,898,1488081.75,941546.25,2429628.00
522050,202009,155,75,80,78375,83600,161975
522060,202009,541,340,201,355300,210045,565345
522068,202009,112,78,34,81510,35530,117040
522070,202009,10,10,0,10450,0,10450
522100,202009,38,22,16,22990,16720,39710
522108,202009,40,31,9,32395,9405,41800
522119,202009,54,30,24,31350,25080,56430
522130,202009,79,33,46,34485,48070,82555
522140,202009,4086,2119,1967,2218535.6,2062830.5,4281366.1
522145,202009,49,34,15,35530,15675,51205
522150,202009,91,67,24,70015,25080,95095
522155,202009,53,36,17,37620,17765,55385
522157,202009,7,3,4,3135,4180,7315
522160,202009,1694,1000,694,1047090,725230,1772320
522170,202009,400,268,132,280060,137940,418000
522180,202009,38,18,20,18810,20900,39710
522185,202009,2069,829,1240,866306,1298935,2165241
522190,202009,48,26,22,27170,22990,50160
522200,202009,296,175,121,182875,126445,309320
522205,202009,142,96,46,100320,48070,148390
522220,202009,148,109,39,113905,40755,154660
522230,202009,33,25,8,26125,8360,34485
530010,202009,53977,27291,26686,28585223.63,27947498.2,56532721.83
110001,202010,506,404,102,422180,106590,528770
110002,202010,2839,1758,1081,1840245.5,1131735.5,2971981.0
110003,202010,82,68,14,71060,14630,85690
110004,202010,2028,1332,696,1395076.5,731500,2126576.5
110005,202010,439,349,90,364705.5,94050,458755.5
110006,202010,448,346,102,361570.5,106590,468160.5
110007,202010,69,57,12,59565,12540,72105
110008,202010,238,132,106,138985,110770,249755
110009,202010,891,648,243,680295,253935,934230
110010,202010,1698,1045,653,1096205.31,684475,1780680.31
110011,202010,1768,1371,397,1433740,415910,1849650
110012,202010,4099,2374,1725,2487100,1805760.5,4292860.5
110013,202010,770,615,155,642675,163020,805695
110014,202010,374,326,48,340670.5,50160,390830.5
110015,202010,1383,1113,270,1164132.05,283195,1447327.05
110018,202010,1093,682,411,713073.16,431585,1144658.16
110020,202010,15498,8874,6624,9295282.56,6954477.6,16249760.16
110025,202010,637,469,168,491150.5,176605,667755.5
110026,202010,39,27,12,28215,12540,40755
110028,202010,1630,1176,454,1232055.85,474431.5,1706487.35
110029,202010,138,124,14,129580,14630,144210
110030,202010,2417,1608,809,1687508.22,847496.35,2535004.57
110032,202010,313,241,72,252890.17,75240,328130.17
110033,202010,660,482,178,504735,187055,691790
110034,202010,343,254,89,265430.67,93005,358435.67
110037,202010,98,85,13,88825,13585,102410
110040,202010,372,252,120,264385,125400,389785
110045,202010,931,642,289,670891,303050.1,973941.1
110050,202010,92,80,12,83600.5,12540,96140.5
110060,202010,67,40,27,41800,28215,70015
110070,202010,106,70,36,74195,37620,111815
110080,202010,483,266,217,280060,229900,509960
110090,202010,30,26,4,27170,4180,31350
110092,202010,98,54,44,57475,45980,103455
110094,202010,203,147,56,153615,58520,212135
110100,202010,38,28,10,29260,10450,39710
110110,202010,90,51,39,53295,40755,94050
110120,202010,68,58,10,61655,10450,72105
110130,202010,288,237,51,247665,53295,300960
110140,202010,239,168,71,175560.5,74195,249755.5
110143,202010,45,37,8,38665,8360,47025
110145,202010,27,21,6,21945,6270,28215
110146,202010,22,12,10,12540,10450,22990
110147,202010,37,26,11,27170,11495,38665
110148,202010,34,23,11,24035,11495,35530
110149,202010,311,219,92,229900,96140,326040
110150,202010,128,99,29,103455,30305,133760
110155,202010,9,8,1,8360,1045,9405
110160,202010,68,55,13,57475,14630,72105
110170,202010,221,171,50,178695,52250,230945
110175,202010,66,50,16,52250,16720,68970
110180,202010,87,72,15,75240,15675,90915
120001,202010,215,161,54,168245,57475,225720
120005,202010,196,115,81,120175,84645,204820
120010,202010,1105,689,416,720005.72,434720,1154725.72
120013,202010,142,97,45,101365.56,47025,148390.56
120017,202010,107,60,47,62700,49115,111815
120020,202010,3540,2859,681,2993926.18,712690.5,3706616.68
120025,202010,545,306,239,320815.77,249755,570570.77
120030,202010,1070,919,151,962446.36,159885,1122331.36
120032,202010,36,32,4,33440,4180,37620
120033,202010,215,189,26,197505,27170,224675
120034,202010,172,127,45,132715,47025,179740
120035,202010,40,32,8,33440,8360,41800
120038,202010,400,263,137,274835,143165,418000
120039,202010,29,28,1,29260,1045,30305
120040,202010,14035,9592,4443,10039667.79,4651295.5,14690963.29
120042,202010,44,39,5,40755,5225,45980
120043,202010,11,3,8,3135,8360,11495
120045,202010,542,347,195,362615,204820,567435
120050,202010,1285,982,303,1026190.69,317680,1343870.69
120060,202010,1483,1217,266,1274900,279015,1553915
120070,202010,428,307,121,322905.82,126445,449350.82
120080,202010,176,109,67,114950,70015,184965
130002,202010,162,117,45,122265,47025,169290
130006,202010,103,66,37,68970,38665,107635
130008,202010,133,72,61,75240,63745,138985
130010,202010,148,83,65,86735,67925,154660
130014,202010,275,199,76,209000,79420,288420
130020,202010,102,63,39,65835,40755,106590
130030,202010,962,570,392,595650,409640,1005290
130040,202010,343,171,172,178695,179740,358435
130050,202010,565,293,272,306185,285285,591470
130060,202010,851,580,271,607145,283195,890340
130063,202010,601,342,259,357390,270655,628045
130068,202010,191,119,72,124355,75240,199595
130070,202010,1318,898,420,938410.5,438900,1377310.5
130080,202010,713,468,245,491150,257070,748220
130083,202010,71,39,32,40755,33440,74195
130090,202010,329,165,164,172425,171380,343805
130100,202010,1107,472,635,493240,666710,1159950
130110,202010,735,308,427,322905,447260,770165
130115,202010,161,67,94,70015,98230,168245
130120,202010,1630,1035,595,1081575,624910,1706485
130130,202010,619,425,194,446215,203775,649990
130140,202010,1574,1239,335,1295800,350075,1645875
130150,202010,417,365,52,381425,54340,435765
130160,202010,460,264,196,276925,204820,481745
130165,202010,42,33,9,34485,9405,43890
130170,202010,978,672,306,704263.12,319770,1024033.12
130180,202010,235,177,58,184965,60610,245575
130185,202010,2313,1070,1243,1119195,1303116,2422311
130190,202010,3416,2155,1261,2253020.5,1319835,3572855.5
130195,202010,277,222,55,231990,57475,289465
130200,202010,174,77,97,81510,101365,182875
130210,202010,76,38,38,39710,39710,79420
130220,202010,180,122,58,127490,60610,188100
130230,202010,380,246,134,258115,140030,398145
130240,202010,1313,830,483,869440,507870,1377310
130250,202010,4695,3003,1692,3140225.5,1774410,4914635.5
130255,202010,421,198,223,206910,233035,439945
130260,202010,57086,26787,30299,28036229.52,31730606.87,59766836.39
130270,202010,1547,1049,498,1098389.05,521455,1619844.05
130280,202010,121,69,52,72105,54340,126445
130290,202010,2125,1475,650,1543465,682385,2225850
130300,202010,432,303,129,316635,134805,451440
130310,202010,924,487,437,508915,457710,966625
130320,202010,520,277,243,289465,253935,543400
130330,202010,776,484,292,505780,307230,813010
130340,202010,3507,2007,1500,2098361,1574815.5,3673176.5
130350,202010,482,322,160,336490,168245,504735
130353,202010,938,401,537,419045,561165,980210
130356,202010,812,364,448,380380,470250,850630
130360,202010,89,66,23,68970,24035,93005
130370,202010,712,549,163,573705,170335,744040
130380,202010,685,524,161,547580,168245,715825
130390,202010,485,391,94,408595,98230,506825
130395,202010,161,39,122,40755,128535,169290
130400,202010,67,45,22,47025,22990,70015
130406,202010,2081,1253,828,1310430.5,866305,2176735.5
130410,202010,441,209,232,219450,243485,462935
130420,202010,2925,2378,547,2487100.75,571615,3058715.75
130423,202010,154,80,74,83600,77330,160930
130426,202010,162,83,79,86735,82555,169290
130430,202010,413,256,157,267520,164065,431585
130440,202010,198,63,135,65835,141075,206910
140002,202010,34,10,24,10450,25080,35530
140005,202010,201,122,79,127490,83600,211090
140010,202010,10407,6601,3806,6909545.2,3989812.15,10899357.35
140015,202010,126,55,71,57475,74195,131670
140017,202010,118,73,45,76285,47025,123310
140020,202010,474,307,167,320815,174515,495330
140023,202010,51,22,29,22990.35,30305,53295.35
140028,202010,22,12,10,12540,10450,22990
140030,202010,348,241,107,251845,111815,363660
140040,202010,63,42,21,43890,24035,67925
140045,202010,254,98,156,102410,163020,265430
140047,202010,639,406,233,424270.5,243485,667755.5
140050,202010,156,94,62,99275,65835,165110
140060,202010,48,33,15,34485,15675,50160
140070,202010,32,29,3,30305,3135,33440
150010,202010,4673,2848,1825,2980341,1917575.5,4897916.5
150013,202010,159,111,48,115995,51205,167200
150020,202010,1084,583,501,609235,523545,1132780
150030,202010,685,293,392,306185,409640,715825
150034,202010,198,123,75,128535,78375,206910
150040,202010,1476,844,632,881980,661485,1543465
150050,202010,673,375,298,391875,312455,704330
150060,202010,4851,3071,1780,3214332,1860532.63,5074864.63
150070,202010,388,196,192,204820,200640,405460
150080,202010,15115,7093,8022,7419503.2,8393444.5,15812947.7
150085,202010,431,268,163,281105,170335,451440
150090,202010,730,614,116,641630,121220,762850
150095,202010,367,229,138,239305,145255,384560
150100,202010,61,39,22,40755,22990,63745
150110,202010,202,105,97,110770,101365,212135
150120,202010,403,290,113,304095,118085,422180
150125,202010,46,17,29,17765,30305,48070
150130,202010,2010,1066,944,1113970,986480,2100450
150140,202010,54917,24719,30198,25850175.7,31607077.21,57457252.91
150145,202010,204,109,95,113905,99275,213180
150150,202010,2967,1276,1691,1333420,1769186,3102606
150157,202010,384,270,114,282150.5,120175,402325.5
150160,202010,127,97,30,101365,31350,132715
150170,202010,3643,2709,934,2830905,977075,3807980
150172,202010,339,234,105,244530,109725,354255
150175,202010,79,48,31,50160,32395,82555
150178,202010,772,504,268,526680,280060,806740
150180,202010,3171,1546,1625,1615570.25,1699170.5,3314740.75
150190,202010,347,216,131,225720.5,136895,362615.5
150195,202010,108,57,51,59565,53295,112860
150200,202010,195,92,103,96140,107635,203775
150210,202010,3126,2512,614,2625040,643720,3268760
150215,202010,557,354,203,372020.5,212135,584155.5
150220,202010,3615,2405,1210,2516361.32,1265495.6,3781856.92
150230,202010,1183,951,232,993795.37,243485,1237280.37
150240,202010,6331,3580,2751,3746325.85,2882110,6628435.85
150250,202010,43,19,24,19855,25080,44935
150260,202010,92,60,32,62700,33440,96140
150270,202010,2217,1436,781,1502710,821370.5,2324080.5
150275,202010,519,327,192,341715,200640,542355
150276,202010,107,42,65,43890,67925,111815
150277,202010,783,335,448,350075,468160,818235
150280,202010,358,233,125,243485,130625,374110
150285,202010,103,52,51,54340,53295,107635
150290,202010,1127,664,463,693880,483835,1177715
150293,202010,675,314,361,328130,377245,705375
150295,202010,506,229,277,240350,289465,529815
150300,202010,79,37,42,38665,43890,82555
150304,202010,174,104,70,108680,73150,181830
150307,202010,391,323,68,337535,72105,409640
150309,202010,572,408,164,426360,171380,597740
150310,202010,244,159,85,166155,88825,254980
150320,202010,1910,1329,581,1389850.27,608190,1998040.27
150330,202010,2027,1171,856,1224740,894520,2119260
150340,202010,198,130,68,135850,71060,206910
150345,202010,631,346,285,361570,297825,659395
150350,202010,404,314,90,328130,94050,422180
150360,202010,4643,2862,1781,2994970.75,1862190,4857160.75
150370,202010,816,555,261,579975.5,272745,852720.5
150375,202010,197,92,105,96140,109725,205865
150380,202010,1478,978,500,1024100,523545,1547645
150390,202010,798,464,334,484880,350075,834955
150400,202010,106,88,18,91960,18810,110770
150405,202010,1229,778,451,813010.3,472340,1285350.3
150410,202010,121,77,44,80465,45980,126445
150420,202010,7321,3942,3379,4121651.5,3537325.5,7658977.0
150430,202010,606,384,222,401280,233035,634315
150440,202010,439,280,159,292600,166155,458755
150442,202010,2317,1227,1090,1283261,1140095,2423356
150445,202010,541,350,191,365750,200640,566390
150450,202010,225,117,108,122265,112860,235125
150460,202010,735,549,186,573705,194370,768075
150470,202010,1308,783,525,819280,548625,1367905
150475,202010,229,175,54,182875,56430,239305
150480,202010,1301,902,399,942590,416955,1359545
150490,202010,665,392,273,411730,286330,698060
150495,202010,331,245,86,256025,89870,345895
150497,202010,271,187,84,195415,87780,283195
150500,202010,221,137,84,143165,87780,230945
150503,202010,1033,508,525,530860.5,549670.5,1080531.0
150506,202010,926,613,313,641630,327085,968715
150510,202010,1248,686,562,716870.5,588335,1305205.5
150520,202010,289,189,100,197505.5,104500,302005.5
150530,202010,1708,936,772,980210.25,808830.5,1789040.75
150540,202010,223,161,62,168245,64790,233035
150543,202010,821,424,397,443080,414865.5,857945.5
150548,202010,466,329,137,344850,143165,488015
150549,202010,61,42,19,43890,19855,63745
150550,202010,2916,1473,1443,1540330.75,1508980,3049310.75
150553,202010,3331,1873,1458,1961467,1525700,3487167
150555,202010,148,78,70,81510,73150,154660
150560,202010,32,14,18,14630,18810,33440
150563,202010,97,48,49,50160,51205,101365
150565,202010,188,113,75,118085,78375,196460
150570,202010,425,284,141,296780,147345,444125
150580,202010,1671,799,872,834955,911240,1746195
150590,202010,805,535,270,559075,282150,841225
150600,202010,470,280,190,293645,198550,492195
150610,202010,145,119,26,124355,27170,151525
150611,202010,121,82,39,85690,40755,126445
150613,202010,3220,1907,1313,1999085,1373130.5,3372215.5
150616,202010,529,301,228,314545,238260,552805
150618,202010,1328,700,628,731500,657305,1388805
150619,202010,390,294,96,307230,100320,407550
150620,202010,1261,730,531,762850,554895,1317745
150630,202010,311,201,110,210045,115995,326040
150635,202010,455,188,267,196460,280060,476520
150640,202010,51,26,25,27170,26125,53295
150650,202010,2371,1371,1000,1433740.5,1049180.5,2482921.0
150655,202010,238,178,60,186010,62700,248710
150658,202010,86,48,38,50160,39710,89870
150660,202010,537,351,186,366795,194370,561165
150670,202010,1068,370,698,387695,730455,1118150
150680,202010,10056,5231,4825,5474756.69,5055710,10530466.69
150690,202010,19,10,9,10450,9405,19855
150700,202010,479,314,165,328130,172425,500555
150710,202010,283,154,129,160930,135850,296780
150715,202010,811,504,307,526680,321860,848540
150720,202010,414,317,97,331265.5,101365,432630.5
150730,202010,1023,509,514,532950,539220,1072170
150740,202010,230,151,79,157795,84645,242440
150745,202010,779,426,353,445170,368885,814055
150746,202010,62,35,27,36575,28215,64790
150747,202010,227,173,54,180785,56430,237215
150750,202010,135,76,59,79420,61655,141075
150760,202010,1824,1185,639,1238325.62,669845,1908170.62
150770,202010,394,216,178,225720,186010,411730
150775,202010,102,47,55,49115,57475,106590
150780,202010,199,111,88,115995,91960,207955
150790,202010,873,492,381,515185,399190,914375
150795,202010,1515,898,617,938410,646855,1585265
150796,202010,350,199,151,207955,157795,365750
150797,202010,336,166,170,173470,178695,352165
150800,202010,1497,849,648,887205,677160,1564365
150803,202010,545,443,102,462935,106590,569525
150805,202010,206,120,86,125400,89870,215270
150808,202010,991,532,459,555940,479655,1035595
150810,202010,3241,2206,1035,2307360.97,1083665.5,3391026.47
150812,202010,437,220,217,229900,226765,456665
150815,202010,1042,649,393,678205,410685,1088890
150820,202010,1542,914,628,955130,657305,1612435
150830,202010,737,536,201,560120,210045,770165
150835,202010,207,120,87,125400,90915,216315
150840,202010,1373,838,535,877800,560120,1437920
160005,202010,62,43,19,44935,19855,64790
160010,202010,192,125,67,131670,71060,202730
160015,202010,130,80,50,83600,52250,135850
160020,202010,134,75,59,78375,61655,140030
160021,202010,57,24,33,25080,34485,59565
160023,202010,68,44,24,45980,25080,71060
160025,202010,23,10,13,10450,13585,24035
160027,202010,1475,838,637,875710.25,666710,1542420.25
160030,202010,15917,8136,7781,8511528.1,8139505.5,16651033.6
160040,202010,298,172,126,179740,131670,311410
160050,202010,717,359,358,375155,374110,749265
160053,202010,283,169,114,176605,119130,295735
160055,202010,27,18,9,18810,9405,28215
160060,202010,6519,3427,3092,3587486.25,3237410.5,6824896.75
160070,202010,178,102,76,106590,79420,186010
160080,202010,108,51,57,53295,59565,112860
170025,202010,28,15,13,15675,13585,29260
170030,202010,209,169,40,177650.62,41800,219450.62
170035,202010,221,106,115,110770,121220,231990
170040,202010,181,135,46,141075,48070,189145
170070,202010,323,198,125,206910,130625,337535
170100,202010,352,258,94,269610,98230,367840
170105,202010,57,45,12,47025,12540,59565
170110,202010,115,69,46,72105,48070,120175
170130,202010,69,33,36,34485,37620,72105
170190,202010,99,58,41,60610,42845,103455
170200,202010,373,253,120,265430,125400,390830
170210,202010,6119,3223,2896,3374055.55,3032591.93,6406647.48
170215,202010,114,48,66,50160,68970,119130
170220,202010,1379,1015,364,1061720,383515.87,1445235.87
170230,202010,150,98,52,102410,54340,156750
170240,202010,520,349,171,364705,178695,543400
170255,202010,1086,878,208,919600,217360,1136960
170270,202010,46,33,13,34485,13585,48070
170290,202010,116,79,37,82555,38665,121220
170300,202010,97,62,35,64790,36575,101365
170305,202010,48,37,11,38665,11495,50160
170307,202010,63,49,14,51205,14630,65835
170310,202010,120,67,53,70015,55385,125400
170320,202010,27,17,10,17765,10450,28215
170330,202010,29,26,3,27170,3135,30305
170360,202010,32,18,14,18810,14630,33440
170370,202010,102,50,52,52250,54340,106590
170380,202010,73,55,18,57475,18810,76285
170382,202010,43,36,7,37620,7315,44935
170384,202010,139,108,31,113905,32395,146300
170386,202010,68,26,42,28215,43890,72105
170388,202010,48,19,29,19855,30305,50160
170389,202010,26,21,5,21945,5225,27170
170390,202010,72,40,32,41800,33440,75240
170410,202010,32,27,5,28215,5225,33440
170460,202010,17,11,6,11495,6270,17765
170510,202010,38,29,9,30305,9405,39710
170550,202010,1552,900,652,941545,684475,1626020
170555,202010,110,80,30,83600,31350,114950
170560,202010,108,75,33,78375,34485,112860
170600,202010,40,17,23,17765,24035,41800
170610,202010,199,104,95,108680,100320.5,209000.5
170625,202010,35,20,15,20900,15675,36575
170650,202010,79,58,21,60610,21945,82555
170700,202010,584,438,146,457710.25,152570,610280.25
170710,202010,159,100,59,104500,61655,166155
170720,202010,90,72,18,75240,18810,94050
170730,202010,84,50,34,52250,35530,87780
170740,202010,85,59,26,62700,27170,89870
170755,202010,61,33,28,34485,29260,63745
170765,202010,142,75,67,78375,70015,148390
170770,202010,207,130,77,135850.5,80465,216315.5
170820,202010,614,408,206,426360,215270.5,641630.5
170825,202010,39,20,19,20900,19855,40755
170830,202010,85,68,17,71060,17765,88825
170900,202010,182,140,42,146300,43890,190190
170930,202010,910,488,422,510587.8,442035.5,952623.3
170950,202010,3128,1428,1700,1492260,1784860.88,3277120.88
170980,202010,15,10,5,10450,5225,15675
171050,202010,146,113,33,118085,34485,152570
171070,202010,41,34,7,35530,7315,42845
171090,202010,46,34,12,35530,12540,48070
171110,202010,23,16,7,16720,7315,24035
171150,202010,40,21,19,21945,19855,41800
171180,202010,29,15,14,15675,14630,30305
171190,202010,153,88,65,91960,68970,160930
171195,202010,67,56,11,58520,11495,70015
171200,202010,51,25,26,26125,27170,53295
171215,202010,4,3,1,3135,1045,4180
171240,202010,59,41,18,42845,18810,61655
171245,202010,57,48,9,50160,9405,59565
171250,202010,75,43,32,44935,33440,78375
171270,202010,16,11,5,11495,5225,16720
171280,202010,41,36,5,37620,5225,42845
171320,202010,994,569,425,595650,444125,1039775
171330,202010,426,211,215,220495,224675,445170
171360,202010,89,62,27,64790,28215,93005
171370,202010,35,18,17,18810,17765,36575
171380,202010,130,112,18,117040,18810,135850
171395,202010,52,33,19,34485,19855,54340
171420,202010,280,182,98,191235,102410,293645
171430,202010,73,58,15,60610,15675,76285
171488,202010,177,99,78,103455,81510,184965
171500,202010,58,34,24,35530,25080,60610
171510,202010,70,45,25,47025,26125,73150
171515,202010,43,34,9,35530,9405,44935
171525,202010,29,27,2,29190.33,2090,31280.33
171550,202010,13,9,4,9405,4180,13585
171570,202010,52,26,26,27170,27170,54340
171575,202010,304,198,106,207955,110770,318725
171610,202010,1745,882,863,922735,902880,1825615
171620,202010,138,95,43,99275,44935,144210
171630,202010,55,28,27,29260,28215,57475
171650,202010,304,210,94,219450,98230,317680
171660,202010,269,152,117,158840,122265.5,281105.5
171665,202010,61,41,20,42845,20900,63745
171670,202010,430,259,171,270655.25,180785,451440.25
171700,202010,64,58,6,60610,6270,66880
171720,202010,28,10,18,10450,18810,29260
171750,202010,101,52,49,54340,51205,105545
171780,202010,71,56,15,58520,15675,74195
171790,202010,81,68,13,71060,13585,84645
171800,202010,32,23,9,24035,9405,33440
171820,202010,2093,1189,904,1244595.46,945725.5,2190320.96
171830,202010,33,26,7,27170,7315,34485
171840,202010,64,41,23,42845,24035,66880
171845,202010,30,19,11,19855,11495,31350
171850,202010,40,30,10,31350,10450,41800
171855,202010,78,60,18,62700,18810,81510
171865,202010,7,6,1,6270,1045,7315
171870,202010,34,24,10,25080,10450,35530
171875,202010,80,56,24,58520,25080,83600
171880,202010,34,22,12,22990,12540,35530
171884,202010,50,27,23,28215,24035,52250
171886,202010,134,54,80,56430,85690,142120
171888,202010,31,25,6,26125,6270,32395
171889,202010,17,12,5,12540,5225,17765
171890,202010,56,48,8,50160,8360,58520
171900,202010,35,25,10,26125,10450,36575
172000,202010,40,31,9,32395,9405,41800
172010,202010,52,42,10,43890,10450,54340
172015,202010,26,17,9,17765.45,9405,27170.45
172020,202010,138,87,51,90915,53295,144210
172025,202010,39,26,13,27170,13585,40755
172030,202010,42,24,18,25080,18810,43890
172049,202010,84,55,29,57475,30305,87780
172065,202010,137,89,48,94050,50160,144210
172080,202010,107,70,37,73150,38665,111815
172085,202010,28,14,14,14630,14630,29260
172090,202010,426,323,103,338580.03,108680,447260.03
172093,202010,15,13,2,13585,2090,15675
172097,202010,17,11,6,12540,7315,19855
172100,202010,5080,2860,2220,2992880.75,2324080.7,5316961.45
172110,202010,77,48,29,50160,30305,80465
172120,202010,1641,1378,263,1441057.45,275880,1716937.45
172125,202010,11,10,1,10450,1045,11495
172130,202010,24,14,10,14630,10450,25080
172208,202010,202,122,80,127490,83600,211090
172210,202010,379,182,197,190190,207955,398145
210005,202010,2979,1868,1111,1958330.15,1166224,3124554.15
210010,202010,160,91,69,95095,72105,167200
210015,202010,40,29,11,30305,11495,41800
210020,202010,352,199,153,207955,160930,368885
210030,202010,329,216,113,225720,118085,343805
210040,202010,140,111,29,115995,30305,146300
210043,202010,252,191,61,199595,63745,263340
210047,202010,526,317,209,331265,218405,549670
210050,202010,287,210,77,219450,80465,299915
210055,202010,49,39,10,40755,10450,51205
210060,202010,541,435,106,455620,111815,567435
210070,202010,418,319,99,333355,103455,436810
210080,202010,127,114,13,119130,13585,132715
210083,202010,296,146,150,152570,157795,310365
210087,202010,3,2,1,2090,1045,3135
210090,202010,443,319,124,333355,129580,462935
210095,202010,433,330,103,344850,107635,452485
210100,202010,706,551,155,575795,161975,737770
210110,202010,123,80,43,83600,45980,129580
210120,202010,5049,3945,1104,4123572.85,1155770.12,5279342.97
210125,202010,193,118,75,123310,78375,201685
210130,202010,473,269,204,281105,213180,494285
210135,202010,26,19,7,19855,7315,27170
210140,202010,4379,3411,968,3565540.44,1012605,4578145.44
210150,202010,376,237,139,247665,145255,392920
210160,202010,3291,2795,496,2920776.36,519365,3440141.36
210170,202010,1151,926,225,967670,235125,1202795
210173,202010,126,110,16,114950,16720,131670
210177,202010,359,202,157,211090,164065,375155
210180,202010,31,17,14,17765,14630,32395
210190,202010,434,288,146,300960,152570,453530
210193,202010,2,2,0,2090,0,2090
210197,202010,73,53,20,55385,20900,76285
210200,202010,609,512,97,535040,101365,636405
210203,202010,228,155,73,161975,76285,238260
210207,202010,365,301,64,314545,66880,381425
210210,202010,747,690,57,721050,59565,780615
210215,202010,74,67,7,70015,7315,77330
210220,202010,389,328,61,343805,63745,407550
210230,202010,313,250,63,261250,65835,327085
210232,202010,1377,934,443,978120,463980,1442100
210235,202010,169,128,41,133760,42845,176605
210237,202010,37,22,15,22990,15675,38665
210240,202010,89,76,13,79420,13585,93005
210250,202010,181,154,27,160930,28215,189145
210255,202010,351,264,87,275880,91960,367840
210260,202010,398,273,125,285285,130625,415910
210270,202010,653,439,214,458755,225720,684475
210275,202010,76,60,16,62700,16720,79420
210280,202010,1048,698,350,731500.7,365750,1097250.7
210290,202010,535,357,178,373065,186010,559075
210300,202010,5333,3358,1975,3512246.46,2067010,5579256.46
210310,202010,113,78,35,81510,36575,118085
210312,202010,115,79,36,82555,37620,120175
210315,202010,110,90,20,94050,20900,114950
210317,202010,134,100,34,104500,35530,140030
210320,202010,2325,1977,348,2065965,364705,2430670
210325,202010,139,88,51,91960.5,53295.5,145256.0
210330,202010,4587,2630,1957,2748350.75,2048200,4796550.75
210340,202010,1248,932,316,974985,330220.5,1305205.5
210350,202010,635,526,109,549670,113905,663575
210355,202010,146,120,26,125400,27170,152570
210360,202010,2240,1542,698,1611390,731500,2342890
210370,202010,1228,601,627,628045,655215,1283260
210375,202010,189,95,94,99275,98230,197505
210380,202010,711,546,165,570570,173470,744040
210390,202010,195,167,28,174515,29260,203775
210400,202010,395,344,51,359480,53295,412775
210405,202010,984,692,292,723140,305140,1028280
210407,202010,53,42,11,43890,11495,55385
210408,202010,59,52,7,54340,7315,61655
210409,202010,322,280,42,292600,43890,336490
210410,202010,441,344,97,359480,102410,461890
210420,202010,203,168,35,175560,36575,212135
210430,202010,50,35,15,36575,15675,52250
210440,202010,337,228,109,238260,113905,352165
210450,202010,141,113,28,118085,29260,147345
210455,202010,232,124,108,129580.5,112860,242440.5
210460,202010,303,204,99,213180,103455,316635
210462,202010,66,54,12,56430,12540,68970
210465,202010,145,114,31,119130,32395,151525
210467,202010,519,380,139,397100,145255,542355
210470,202010,50,43,7,44935,7315,52250
210480,202010,1269,915,354,957220,369930.62,1327150.62
210490,202010,203,135,68,141075,72105,213180
210500,202010,507,308,199,323950,207955,531905
210510,202010,553,440,113,459800,118085,577885
210515,202010,365,230,135,240350,141075,381425
210520,202010,400,360,40,377245,41800,419045
210530,202010,9371,4924,4447,5148719.8,4650253.54,9798973.34
210535,202010,130,97,33,101365,34485,135850
210540,202010,1517,1010,507,1055450,529815,1585265
210542,202010,1179,606,573,633270,599831,1233101
210545,202010,20,18,2,18810,2090,20900
210547,202010,127,112,15,117040,15675,132715
210550,202010,681,495,186,517275.6,195415,712690.6
210560,202010,158,138,20,144210,20900,165110
210565,202010,21,16,5,16720,5225,21945
210570,202010,1307,1063,244,1110835.11,254980,1365815.11
210580,202010,120,103,17,107635,17765,125400
210590,202010,733,605,128,633270,134805,768075
210592,202010,37,35,2,36575,2090,38665
210594,202010,113,94,19,98230,19855,118085
210596,202010,103,88,15,91960,15675,107635
210598,202010,138,102,36,106590,37620,144210
210600,202010,317,273,44,285285,45980,331265
210610,202010,255,240,15,250800,15675,266475
210620,202010,43,27,16,28215,16720,44935
210630,202010,75,73,2,76285,2090,78375
210632,202010,1033,731,302,763895,315590,1079485
210635,202010,22,19,3,19855,3135,22990
210637,202010,121,87,34,90915,35530,126445
210640,202010,596,520,76,543400,79420,622820
210650,202010,401,334,67,349030,70015,419045
210660,202010,373,295,78,308275,81510,389785
210663,202010,36,27,9,28215,9405,37620
210667,202010,101,41,60,42845,62700,105545
210670,202010,242,215,27,224675,28215,252890
210675,202010,546,295,251,310365,262295,572660
210680,202010,223,145,78,151525,81510,233035
210690,202010,626,517,109,540265,113905,654170
210700,202010,157,120,37,125400,38665,164065
210710,202010,249,157,92,164065,96140,260205
210720,202010,130,117,13,122265,13585,135850
210725,202010,66,58,8,60610,8360,68970
210730,202010,24,18,6,18810,6270,25080
210735,202010,290,207,83,216315,86735.5,303050.5
210740,202010,522,452,70,472340,73150,545490
210745,202010,153,114,39,119130,40755,159885
210750,202010,2396,1214,1182,1269675.25,1235191,2504866.25
210760,202010,259,199,60,207955,62700,270655
210770,202010,371,290,81,303050,84645.5,387695.5
210780,202010,440,329,111,344850,115995,460845
210790,202010,183,151,32,157795,33440,191235
210800,202010,174,132,42,137940,43890,181830
210805,202010,55,50,5,52250,5225,57475
210810,202010,468,381,87,398145,90915,489060
210820,202010,2130,1763,367,1844425.9,384560,2228985.9
210825,202010,155,89,66,93005,68970,161975
210830,202010,736,486,250,507870,262295,770165
210840,202010,196,139,57,145255,59565,204820
210845,202010,232,163,69,170335,72105,242440
210850,202010,750,512,238,535040,248710,783750
210860,202010,3702,2085,1617,2178825.25,1689765,3868590.25
210870,202010,430,341,89,356345,93005,449350
210880,202010,75,58,17,60610,17765,78375
210890,202010,322,278,44,290510,45980,336490
210900,202010,628,407,221,426360,231990,658350
210905,202010,64,35,29,36575,30305,66880
210910,202010,1944,1467,477,1536151.06,500555,2036706.06
210920,202010,169,63,106,65835,110770,176605
210923,202010,82,65,17,67925,17765,85690
210927,202010,410,192,218,200640,227810,428450
210930,202010,72,58,14,60610,14630,75240
210940,202010,86,66,20,68970,20900,89870
210945,202010,193,104,89,108680,93005,201685
210950,202010,532,386,146,403370,152570,555940
210955,202010,82,51,31,54340,32395,86735
210960,202010,2186,1090,1096,1140095,1147410,2287505
210970,202010,116,102,14,106590,14630,121220
210975,202010,82,76,6,79420,6270,85690
210980,202010,1090,532,558,555940,583110.5,1139050.5
210990,202010,4018,2652,1366,2773430,1430605,4204035
211000,202010,1323,1067,256,1115015.5,267520,1382535.5
211003,202010,985,705,280,737770,292600,1030370
211010,202010,502,446,56,467115,58520,525635
211020,202010,1437,614,823,642675,860035,1502710
211023,202010,34,30,4,31350,4180,35530
211027,202010,73,52,21,54340,21945,76285
211030,202010,370,265,105,276925,110770,387695
211040,202010,299,247,52,258115.5,54340,312455.5
211050,202010,1167,779,388,814055,406505.5,1220560.5
211060,202010,634,551,83,576841,86735.46,663576.46
211065,202010,20,17,3,17765,3135,20900
211070,202010,889,736,153,769121.15,160930,930051.15
211080,202010,86,83,3,86735,3135,89870
211085,202010,55,28,27,29260,28215,57475
211090,202010,78,65,13,67925,13585,81510
211100,202010,487,403,84,421135,87780.5,508915.5
211102,202010,252,179,73,187055,76285,263340
211105,202010,222,157,65,164065,67925,231990
211107,202010,128,81,47,84645,49115,133760
211110,202010,819,539,280,563255,292600,855855
211120,202010,5273,2621,2652,2739991.05,2771340.4,5511331.45
211125,202010,35,26,9,27170,9405,36575
211130,202010,41567,19088,22479,19964731.8,23518772.75,43483504.55
211140,202010,403,352,51,367840,53295,421135
211150,202010,1202,817,385,853765,403370.5,1257135.5
211153,202010,168,104,64,109725,66880,176605
211157,202010,65,51,14,53295,14630,67925
211160,202010,700,600,100,628045,105545,733590
211163,202010,1,1,0,1045,0,1045
211167,202010,10,9,1,9405,1045,10450
211170,202010,422,314,108,328130,113905,442035
211172,202010,117,80,37,83600,38665,122265
211174,202010,254,157,97,164065,101365,265430
211176,202010,485,361,124,378290.5,129580,507870.5
211178,202010,95,63,32,65835,33440,99275
211180,202010,210,166,44,173470,45980,219450
211190,202010,71,65,6,67925,6270,74195
211195,202010,34,23,11,24035,11495,35530
211200,202010,151,131,20,136895,20900,157795
211210,202010,433,320,113,335410.16,118085,453495.16
211220,202010,4093,2392,1701,2505913.07,1779636,4285549.07
211223,202010,93,90,3,94050,3135,97185
211227,202010,66,52,14,54340,14630,68970
211230,202010,737,610,127,637450,132715,770165
211240,202010,405,318,87,332310,90915,423225
211245,202010,185,92,93,96140,97185,193325
211250,202010,1543,1334,209,1395075,218405,1613480
211260,202010,810,666,144,695970,150480,846450
211270,202010,1962,1604,358,1676180.5,374110.5,2050291.0
211280,202010,1749,1125,624,1175625,652080,1827705
211285,202010,206,125,81,130625,84645,215270
211290,202010,710,491,219,513095,228855,741950
211300,202010,758,602,156,629090,163020,792110
211400,202010,1526,941,585,983345,611325,1594670
220005,202010,15,14,1,14630,1045,15675
220010,202010,88,68,20,71060,21945,93005
220020,202010,704,557,147,582065,153615,735680
220025,202010,110,108,2,112860,2090,114950
220027,202010,44,35,9,36575,9405,45980
220030,202010,112,90,22,94050,22990,117040
220040,202010,1246,945,301,989615,315590,1305205
220045,202010,34,23,11,24035,11495,35530
220050,202010,691,577,114,602965.61,119130,722095.61
220060,202010,169,149,20,155705,20900,176605
220070,202010,111,101,10,105545,10450,115995
220080,202010,15,13,2,13585,2090,15675
220090,202010,33,27,6,28215,6270,34485
220095,202010,2,1,1,1045,1045,2090
220100,202010,20,16,4,16720,4180,20900
220105,202010,25,23,2,24035.5,2090,26125.5
220110,202010,228,208,20,217360,20900,238260
220115,202010,36,35,1,36575,1045,37620
220117,202010,21,20,1,20900,1045,21945
220120,202010,1476,1127,349,1179805,364705,1544510
220130,202010,31,30,1,31350,1045,32395
220140,202010,106,84,22,87780,22990,110770
220150,202010,499,370,129,386650,134805,521455
220155,202010,7,6,1,6270,1045,7315
220157,202010,19,15,4,15675,4180,19855
220160,202010,89,80,9,83600,9405,93005
220170,202010,33,32,1,33440,1045,34485
220173,202010,8,8,0,8360,0,8360
220177,202010,9,9,0,9405,0,9405
220180,202010,68,66,2,68970,2090,71060
220190,202010,1077,952,125,994840,130625,1125465
220191,202010,46,39,7,40755,7315,48070
220192,202010,82,79,3,82555,3135,85690
220194,202010,56,52,4,54340,4180,58520
220196,202010,100,84,16,87780,16720,104500
220198,202010,3,2,1,2090,1045,3135
220200,202010,412,340,72,355300.25,75240,430540.25
220202,202010,40,35,5,36575,6270,42845
220205,202010,53,47,6,49115,6270,55385
220207,202010,12,12,0,12540,0,12540
220208,202010,79,42,37,43890,38665,82555
220209,202010,33,29,4,30305,4180,34485
220210,202010,22,14,8,14630,8360,22990
220211,202010,26,24,2,25080,2090,27170
220213,202010,41,36,5,37620,5225.5,42845.5
220217,202010,41,31,10,32395,10450,42845
220220,202010,2182,1440,742,1505845,780615.5,2286460.5
220225,202010,8,3,5,3135,5225,8360
220230,202010,960,743,217,777480,226765,1004245
220240,202010,160,144,16,151525,16720,168245
220245,202010,32,29,3,30305.97,3135,33440.97
220250,202010,120,107,13,111815,13585,125400
220253,202010,46,39,7,40755,7315,48070
220255,202010,31,28,3,29260,3135,32395
220260,202010,706,527,179,551760,187055,738815
220265,202010,4,2,2,2090,2090,4180
220270,202010,762,686,76,717915,79420,797335
220271,202010,42,34,8,35530,8360,43890
220272,202010,21,21,0,21945,0,21945
220273,202010,17,15,2,15675,2090,17765
220275,202010,57,47,10,49115,10450,59565
220277,202010,18,15,3,15675,3135,18810
220280,202010,17,12,5,12540,5225,17765
220285,202010,44,40,4,41800,4180,45980
220290,202010,1473,1267,206,1324016,215270.25,1539286.25
220300,202010,35,34,1,35530,1045,36575
220310,202010,329,279,50,291555,52250,343805
220320,202010,438,406,32,424270.5,33440,457710.5
220323,202010,1,0,1,0,1045,1045
220325,202010,12,10,2,10450,2090,12540
220327,202010,11,11,0,11495,0,11495
220330,202010,229,168,61,175560,64790,240350
220335,202010,142,124,18,129580,18810,148390
220340,202010,39,27,12,28215,12540,40755
220342,202010,58,50,8,52250,8360,60610
220345,202010,82,74,8,77330,8360,85690
220350,202010,442,380,62,397100,64790,461890
220360,202010,43,31,12,32395,12540,44935
220370,202010,1234,1023,211,1072170,221540,1293710
220375,202010,19,17,2,17765,2090,19855
220380,202010,23,17,6,17765,6270,24035
220385,202010,13,12,1,12540,1045,13585
220390,202010,2313,1315,998,1376265.6,1042910.75,2419176.35
220400,202010,34,30,4,31350,4180,35530
220410,202010,21,18,3,18810,3135,21945
220415,202010,13,11,2,11495,2090,13585
220420,202010,125,105,20,109725,20900,130625
220430,202010,128,114,14,119130,14630,133760
220435,202010,24,17,7,17765,7315,25080
220440,202010,291,247,44,258115,45980,304095
220450,202010,334,170,164,177650,171380,349030
220455,202010,52,51,1,54340,1045,55385
220460,202010,19,18,1,18810,1045,19855
220465,202010,97,64,33,66880,34485,101365
220470,202010,243,210,33,219450,34485,253935
220480,202010,72,64,8,66880,8360,75240
220490,202010,89,76,13,79420,13585,93005
220500,202010,106,90,16,94050,16720,110770
220510,202010,416,324,92,338580,96140,434720
220515,202010,21,19,2,19855,2090,21945
220520,202010,368,330,38,344850.85,39710,384560.85
220525,202010,10,7,3,7315,3135,10450
220527,202010,19,14,5,14630,5225,19855
220530,202010,35,14,21,14630,21945,36575
220535,202010,4,4,0,4180,0,4180
220540,202010,68,56,12,58520,12540,71060
220545,202010,40,27,13,28215,13585,41800
220550,202010,711,561,150,586245,157795,744040
220551,202010,13,10,3,10450,3135,13585
220552,202010,15,15,0,15675,0,15675
220553,202010,53,48,5,50160,5225,55385
220554,202010,10,7,3,7315,3135,10450
220555,202010,34,31,3,32395,3135,35530
220556,202010,45,43,2,44935,2090,47025
220557,202010,56,53,3,55385,3135,58520
220558,202010,9,4,5,4180,5225,9405
220559,202010,2,2,0,2090,0,2090
220560,202010,70,46,24,48070,26125,74195
220570,202010,740,458,282,478610.5,296780,775390.5
220580,202010,554,508,46,531905,48070,579975
220585,202010,10,9,1,9405,1045,10450
220590,202010,15,15,0,15675,0,15675
220595,202010,64,48,16,50160,16720,66880
220600,202010,19,11,8,11495,8360,19855
220605,202010,25,23,2,24035,2090,26125
220610,202010,79,67,12,70015,12540,82555
220620,202010,559,465,94,485925,98230,584155
220630,202010,5,4,1,4180,1045,5225
220635,202010,37,32,5,33440,5225,38665
220640,202010,105,87,18,90915,18810,109725
220650,202010,113,106,7,110770,7315,118085
220660,202010,56,45,11,47025,11495,58520
220665,202010,5,5,0,5225,0,5225
220667,202010,20,18,2,18810,2090,20900
220669,202010,28,25,3,26125,3135,29260
220670,202010,67,53,14,55385,14630,70015
220672,202010,75,52,23,54340,24035,78375
220675,202010,36,28,8,29260,8360,37620
220680,202010,43,37,6,38665,6270,44935
220690,202010,47,44,3,45980,3135,49115
220695,202010,35,18,17,18810,17765,36575
220700,202010,1695,1308,387,1366860.5,404415,1771275.5
220710,202010,6,4,2,4180,2090,6270
220720,202010,106,90,16,94050,16720,110770
220730,202010,16,16,0,16720,0,16720
220735,202010,4,0,4,0,4180,4180
220740,202010,49,45,4,47025,4180,51205
220750,202010,110,95,15,99275,15675,114950
220755,202010,15,14,1,14630,1045,15675
220760,202010,67,61,6,64790,6270,71060
220770,202010,5657,3092,2565,3233232.01,2685650.5,5918882.51
220775,202010,17,10,7,10450,7315,17765
220777,202010,18,17,1,17765,1045,18810
220779,202010,1,0,1,0,1045,1045
220780,202010,899,763,136,797335,142120.5,939455.5
220785,202010,5,1,4,1045,4180,5225
220790,202010,1096,863,233,902880.05,244530,1147410.05
220793,202010,6,6,0,6270,0,6270
220795,202010,14,12,2,12540,2090,14630
220800,202010,3993,3075,918,3217555.81,961400,4178955.81
220810,202010,65,57,8,59565.5,8360,67925.5
220820,202010,240,219,21,228855,21945,250800
220830,202010,1248,1079,169,1127555,176605,1304160
220840,202010,2415,1680,735,1757692.59,771210.95,2528903.54
220850,202010,55,46,9,48070,9405,57475
220855,202010,8,5,3,5225,3135,8360
220860,202010,12,10,2,10450,2090,12540
220865,202010,31,29,2,30305,2090,32395
220870,202010,72,65,7,67925,7315,75240
220880,202010,323,257,66,268565,68970,337535
220885,202010,32,29,3,31350,3135,34485
220887,202010,13,12,1,12540,1045,13585
220890,202010,95,83,12,86735,12540,99275
220900,202010,23,14,9,14630,9405,24035
220910,202010,52,43,9,44935,9405,54340
220915,202010,11,10,1,10450,1045,11495
220920,202010,51,46,5,48070,5225,53295
220930,202010,43,42,1,43890,1045,44935
220935,202010,15,15,0,15675,0,15675
220937,202010,36,35,1,36575,1045,37620
220940,202010,54,50,4,52250,4180,56430
220945,202010,2,2,0,2090,0,2090
220950,202010,43,35,8,36575,8360,44935
220955,202010,23,21,2,21945,2090,24035
220960,202010,12,11,1,11495,1045,12540
220965,202010,37,33,4,34485,4180,38665
220970,202010,60,50,10,52250,10450,62700
220975,202010,16,14,2,14630,2090,16720
220980,202010,32,30,2,31350,2090,33440
220985,202010,63,56,7,59565,7315,66880
220987,202010,29,28,1,29260,1045,30305
220990,202010,24,23,1,24035,1045,25080
220995,202010,19,15,4,15675,4180,19855
220997,202010,67,55,12,57475,12540,70015
221000,202010,1181,1065,116,1112925,121220,1234145
221005,202010,47,42,5,43890,5225,49115
221010,202010,16,12,4,12540,4180,16720
221020,202010,39,38,1,39710,1045,40755
221030,202010,40,32,8,33440,8360,41800
221035,202010,23,23,0,24035,0,24035
221037,202010,12,8,4,8360,4180,12540
221038,202010,27,24,3,25080,3135,28215
221039,202010,22,22,0,22990,0,22990
221040,202010,254,217,37,226765,38665,265430
221050,202010,234,197,37,205865,38665,244530
221060,202010,1852,1615,237,1687675,247665,1935340
221062,202010,33,33,0,34485,0,34485
221063,202010,12,8,4,8360,4180,12540
221065,202010,61,49,12,51205,12540,63745
221070,202010,137,119,18,124355,18810,143165
221080,202010,369,318,51,332310,53295,385605
221090,202010,28,25,3,26125,3135,29260
221093,202010,47,33,14,34485,14630,49115
221095,202010,6,6,0,6270,0,6270
221097,202010,13,10,3,10450,3135,13585
221100,202010,25378,15068,10310,15764873.94,10794851.45,26559725.39
221110,202010,1103,839,264,876755,277970,1154725
221120,202010,541,398,143,415910.5,149435,565345.5
221130,202010,972,783,189,819280,197505,1016785
221135,202010,36,31,5,32395,5225,37620
221140,202010,45,39,6,40755,6270,47025
221150,202010,11,9,2,9405,2090,11495
221160,202010,13,13,0,13585,0,13585
221170,202010,16,16,0,16720,0,16720
230010,202010,167,153,14,159885,14630,174515
230015,202010,128,104,24,108680,25080,133760
230020,202010,1633,1378,255,1442100.5,266475,1708575.5
230030,202010,1675,1203,472,1257136,495330,1752466
230040,202010,219,186,33,194370,34485,228855
230050,202010,230,169,61,176605,63745,240350
230060,202010,162,129,33,135850,34485,170335
230070,202010,305,264,41,275880,42845,318725
230075,202010,852,732,120,764942,125400,890342
230080,202010,195,167,28,174515,29260,203775
230090,202010,126,90,36,94050,38665,132715
230100,202010,2174,1236,938,1293711.5,982300,2276011.5
230110,202010,2917,1880,1037,1965645.5,1085755.5,3051401.0
230120,202010,1020,800,220,836000,229900,1065900
230125,202010,153,125,28,132715,29260,161975
230130,202010,477,424,53,443080,55385,498465
230140,202010,222,185,37,193325,38665,231990
230150,202010,147,113,34,118085,35530,153615
230160,202010,938,794,144,829730,150480,980210
230170,202010,609,548,61,572660.5,63745,636405.5
230180,202010,73,67,6,70015,6270,76285
230185,202010,403,347,56,362615.77,58520,421135.77
230190,202010,2331,1833,498,1917575.15,520410,2437985.15
230195,202010,494,429,65,449350,67925,517275
230200,202010,413,338,75,354255,78375,432630
230205,202010,389,257,132,269610,137940,407550
230210,202010,1361,1057,304,1104565.38,318725,1423290.38
230220,202010,1585,1074,511,1122330,535040,1657370
230230,202010,970,819,151,855855,157795,1013650
230240,202010,1752,1507,245,1576123.45,257070,1833193.45
230250,202010,1780,1468,312,1535105,327085.5,1862190.5
230260,202010,3256,2026,1230,2119260,1285350,3404610
230270,202010,1369,1098,271,1147411.88,283195.5,1430607.38
230280,202010,2764,2074,690,2170465,725230.5,2895695.5
230290,202010,402,360,42,376200.72,43890,420090.72
230300,202010,533,384,149,401280,155705,556985
230310,202010,415,313,102,327085,107635,434720
230320,202010,925,787,138,822416,144210,966626
230330,202010,304,244,60,254980,62700,317680
230340,202010,452,364,88,380380,91960,472340
230350,202010,3173,2002,1171,2094180,1225785,3319965
230360,202010,277,224,53,234080,56430,290510
230365,202010,137,115,22,120175,22990,143165
230370,202010,10142,4931,5211,5158123.42,5452811,10610934.42
230380,202010,482,409,73,427405.5,76285,503690.5
230390,202010,547,306,241,319770,251845.5,571615.5
230393,202010,250,205,45,215270,47025,262295
230395,202010,353,285,68,297826.2,71060,368886.2
230400,202010,620,491,129,513095,135850,648945
230410,202010,2687,1678,1009,1757690.97,1060675.5,2818366.47
230420,202010,6262,4121,2141,4316898.54,2240480.2,6557378.74
230423,202010,333,290,43,304095,45980,350075
230425,202010,430,353,77,368885.85,80465,449350.85
230426,202010,121,99,22,103455,22990,126445
230427,202010,74,70,4,73150,4180,77330
230428,202010,1532,755,777,788975.5,813010,1601985.5
230430,202010,456,369,87,385605,90915,476520
230435,202010,892,645,247,675070,258115.77,933185.77
230440,202010,89132,39509,49623,41341263.55,51948009.82,93289273.37
230445,202010,317,220,97,229900,101365,331265
230450,202010,566,448,118,468160,123310,591470
230460,202010,69,53,16,55385,16720,72105
230465,202010,310,252,58,263340,60610,323950
230470,202010,2020,1591,429,1663640.5,448305.25,2111945.75
230480,202010,156,147,9,153615,9405,163020
230490,202010,305,243,62,253935,64790,318725
230495,202010,452,333,119,347985.5,124355,472340.5
230500,202010,1023,753,270,787930,283195,1071125
230510,202010,59,46,13,48070,13585,61655
230520,202010,384,301,83,314545.53,86735,401280.53
230523,202010,2371,1479,892,1546601.25,934230.5,2480831.75
230526,202010,278,235,43,245575,44935,290510
230530,202010,691,513,178,536085,186010,722095
230533,202010,203,190,13,198550,13585,212135
230535,202010,368,274,94,286330,98230,384560
230540,202010,1799,1591,208,1662595,218405,1881000
230550,202010,3831,2455,1376,2565477.33,1445235,4010712.33
230560,202010,583,441,142,460846,148390,609236
230565,202010,224,162,62,169290,64790,234080
230570,202010,289,256,33,267520,34485,302005
230580,202010,1174,848,326,891385,340670,1232055
230590,202010,1005,782,223,818235.25,233035,1051270.25
230600,202010,241,220,21,229900,21945,251845
230610,202010,379,292,87,305140,90915,396055
230620,202010,203,171,32,179740.5,33440,213180.5
230625,202010,772,537,235,561165.25,245575,806740.25
230630,202010,1337,1038,299,1084710,313500,1398210
230640,202010,3793,3204,589,3352360.5,616551.25,3968911.75
230650,202010,456,392,64,409640,66880,476520
230655,202010,695,586,109,612370,113905,726275
230660,202010,369,305,64,319770,66880,386650
230670,202010,450,383,67,400235,70015,470250
230680,202010,205,186,19,194370,19855,214225
230690,202010,918,775,143,809875,150480,960355
230700,202010,855,717,138,750310,144210.5,894520.5
230710,202010,691,655,36,684475,37620,722095
230720,202010,154,133,21,138985,21945,160930
230725,202010,211,165,46,172425,48070,220495
230730,202010,12213,6621,5592,6923062.05,5855138.37,12778200.42
230740,202010,669,539,130,563255.5,135850,699105.5
230750,202010,832,700,132,731500,138985,870485
230760,202010,1477,1273,204,1330285,213180,1543465
230763,202010,329,273,56,285285,58520,343805
230765,202010,7594,3481,4113,3642871.01,4307491.25,7950362.26
230770,202010,5070,2586,2484,2704462.4,2599960.5,5304422.9
230780,202010,732,641,91,669845.5,95095,764940.5
230790,202010,289,241,48,251845,50160,302005
230800,202010,1139,818,321,856900,335445,1192345
230810,202010,1349,1187,162,1241460,169290,1410750
230820,202010,367,253,114,264385.5,119130,383515.5
230830,202010,950,811,139,848540,146300,994840
230835,202010,277,240,37,250800,38665,289465
230837,202010,170,143,27,149435,28215,177650
230840,202010,928,727,201,761805.5,210045.5,971851.0
230850,202010,1471,1269,202,1327150,211090,1538240
230860,202010,302,226,76,236170,79420,315590
230870,202010,1841,1571,270,1641695,283195,1924890
230880,202010,67,51,16,53295,16720,70015
230890,202010,536,491,45,513095,47025,560120
230900,202010,283,205,78,214225,81510.31,295735.31
230910,202010,221,174,47,181830,49115,230945
230920,202010,422,337,85,353210,88825,442035
230930,202010,989,693,296,726275,309320,1035595
230940,202010,859,666,193,695970,201685,897655
230945,202010,522,423,99,443080.5,103455,546535.5
230950,202010,414,358,56,374110,58520,432630
230960,202010,2676,1791,885,1873685.5,924825.5,2798511.0
230970,202010,1706,950,756,996930,792110,1789040
230980,202010,203,165,38,172425,39710,212135
230990,202010,136,111,25,115995,26125,142120
231000,202010,191,177,14,184965,14630,199595
231010,202010,153,112,41,117040,42845,159885
231020,202010,1352,933,419,976030.25,437855,1413885.25
231025,202010,1062,784,278,820325,290510.5,1110835.5
231030,202010,1100,917,183,958265.4,191235,1149500.4
231040,202010,138,94,44,98230,45980,144210
231050,202010,948,838,110,876755,114950,991705
231060,202010,156,130,26,135850,27170,163020
231070,202010,1493,1033,460,1080530.75,480700,1561230.75
231080,202010,263,241,22,251845,22990,274835
231085,202010,618,374,244,390830.5,254980,645810.5
231090,202010,248,199,49,209000,51205,260205
231095,202010,166,133,33,138985,34485,173470
231100,202010,146,122,24,128535,26125,154660
231110,202010,372,314,58,328130,60610,388740
231120,202010,268,229,39,239305,40755,280060
231123,202010,156,147,9,153615,9405,163020
231126,202010,333,258,75,269610,78375,347985
231130,202010,4737,3697,1040,3869636.5,1087845.5,4957482.0
231135,202010,213,184,29,192280,30305,222585
231140,202010,3082,2263,819,2366925,855855,3222780
231150,202010,371,351,20,366795,20900,387695
231160,202010,1214,958,256,1002155.75,267520,1269675.75
231170,202010,519,357,162,373065,169290,542355
231180,202010,1710,1466,244,1531970,254980,1786950
231190,202010,209,176,33,183920,34485,218405
231195,202010,214,181,33,189145,34485,223630
231200,202010,802,656,146,686565,152570,839135
231210,202010,579,486,93,509960,97185,607145
231220,202010,1048,764,284,799426.7,296780,1096206.7
231230,202010,1475,1167,308,1220560,323950,1544510
231240,202010,1476,1046,430,1095160,449350,1544510
231250,202010,111,102,9,106590,9405,115995
231260,202010,276,180,96,189145,101365,290510
231270,202010,998,810,188,846451.15,196460,1042911.15
231280,202010,75,59,16,61655,16720,78375
231290,202010,7681,4317,3364,4514400,3516425.94,8030825.94
231300,202010,606,563,43,588335,44935,633270
231310,202010,751,694,57,725230.56,59565,784795.56
231320,202010,592,446,146,466071.5,152570,618641.5
231325,202010,99,86,13,89870,13585,103455
231330,202010,1990,1544,446,1616879.4,469205.5,2086084.9
231335,202010,254,225,29,235125,30305,265430
231340,202010,1723,1250,473,1307295,495330,1802625
231350,202010,1305,1053,252,1100385,263341.5,1363726.5
231355,202010,436,372,64,388740,66880,455620
231360,202010,513,373,140,391875.86,146300,538175.86
231370,202010,87,76,11,79420,11495,90915
231375,202010,292,211,81,220495,84645,305140
231380,202010,497,399,98,416955,102410,519365
231390,202010,206,161,45,168245,47025,215270
231395,202010,741,463,278,484880,291555,776435
231400,202010,1134,939,195,982300.25,203775.5,1186075.75
231410,202010,1332,1091,241,1140095,251845,1391940
240010,202010,392,173,219,180785.67,228855,409640.67
240020,202010,2267,1839,428,1924890.96,450395,2375285.96
240030,202010,119,99,20,104500,20900,125400
240040,202010,33,33,0,34485,0,34485
240050,202010,531,455,76,475475,79420,554895
240060,202010,67,63,4,65835,4180,70015
240070,202010,220,174,46,181830,48070,229900
240080,202010,530,361,169,377245,176605.01,553850.01
240090,202010,103,92,11,96140,11495,107635
240100,202010,1502,1415,87,1478675.37,90915,1569590.37
240110,202010,1047,686,361,718961,378290.75,1097251.75
240120,202010,143,113,30,118085,31350,149435
240130,202010,282,258,24,269610.5,25080,294690.5
240140,202010,77,56,21,59565,21945,81510
240145,202010,746,664,82,693880,85690,779570
240150,202010,21,16,5,16720,5225,21945
240160,202010,41,35,6,36575,6270,42845
240165,202010,36,28,8,29260.25,8360,37620.25
240170,202010,111,81,30,84645,31350,115995
240180,202010,92,70,22,73150,22990,96140
240185,202010,42,39,3,40755,3135,43890
240190,202010,15,13,2,13585,2090,15675
240200,202010,3091,1732,1359,1812032,1420156,3232188
240210,202010,172,132,40,138985,41800,180785
240220,202010,1098,796,302,832865.75,315590,1148455.75
240230,202010,851,781,70,817190.75,74195,891385.75
240240,202010,74,54,20,56430,20900,77330
240250,202010,91,78,13,81510,13585,95095
240260,202010,1804,1329,475,1390895.5,500555,1891450.5
240270,202010,184,162,22,169290,22990,192280
240280,202010,46,35,11,36575,11495,48070
240290,202010,48,46,2,48070,2090,50160
240300,202010,176,94,82,98230,86735,184965
240310,202010,2344,1286,1058,1343871.48,1108745.85,2452617.33
240320,202010,195,182,13,190190,13585,203775
240325,202010,4554,2691,1863,2814187.72,1952060.7,4766248.42
240330,202010,73,68,5,71060,5225,76285
240340,202010,69,45,24,47025,25080,72105
240350,202010,94,82,12,85690,12540,98230
240360,202010,556,345,211,361570,221540,583110
240370,202010,52,48,4,50160,4180,54340
240375,202010,65,39,26,40755,27170,67925
240380,202010,232,189,43,197505,44935.5,242440.5
240390,202010,12,11,1,11495,1045,12540
240400,202010,85,75,10,78375,10450,88825
240410,202010,15,8,7,8360,7315,15675
240420,202010,1007,731,276,765985,290510,1056495
240430,202010,263,247,16,258115,17765,275880
240440,202010,125,70,55,73150,57475,130625
240450,202010,226,153,73,159885.5,76285,236170.5
240460,202010,73,56,17,58520,17765,76285
240470,202010,237,212,25,221540,26125,247665
240480,202010,16,14,2,14630,2090,16720
240485,202010,82,68,14,71060,14630,85690
240490,202010,45,43,2,45980,2090,48070
240500,202010,86,64,22,66880,22990,89870
240510,202010,43,32,11,33440,11495,44935
240520,202010,115,110,5,114950,5225,120175
240530,202010,56,49,7,51205,7315,58520
240540,202010,77,65,12,67925,12540,80465
240550,202010,13,12,1,12540,1045,13585
240560,202010,381,278,103,290510.5,107635,398145.5
240570,202010,446,286,160,299915.5,168245.5,468161.0
240580,202010,1297,1017,280,1062765.25,293645,1356410.25
240590,202010,31,29,2,30305,2090,32395
240600,202010,106,101,5,105545,5225,110770
240610,202010,517,435,82,454575.5,85690,540265.5
240615,202010,19,18,1,18810,1045,19855
240620,202010,86,83,3,86735,3135,89870
240630,202010,38,33,5,34485,5225,39710
240640,202010,25,20,5,20900,5225,26125
240650,202010,243,198,45,206910,47025,253935
240660,202010,111,95,16,99275,16720,115995
240670,202010,310,178,132,186010.75,137940,323950.75
240680,202010,50,37,13,38665,13585,52250
240690,202010,47,44,3,45980,3135,49115
240700,202010,185,152,33,158840,34485,193325
240710,202010,2021,1250,771,1306251.25,805695,2111946.25
240720,202010,1070,790,280,825550,293645,1119195
240725,202010,66,61,5,63745,5225,68970
240730,202010,148,125,23,130625,24035,154660
240740,202010,230,196,34,204820,35530.85,240350.85
240750,202010,52,29,23,30305,26125,56430
240760,202010,46,41,5,42845,5225,48070
240770,202010,146,115,31,120175,32395,152570
240780,202010,671,557,114,583110,119130,702240
240790,202010,42,40,2,41800,2090,43890
240800,202010,9296,6312,2984,6599183.73,3123507.75,9722691.48
240810,202010,20478,11037,9441,11553532.05,9895108.9,21448640.95
240820,202010,239,141,98,148390.09,103455,251845.09
240830,202010,1621,1332,289,1391940.75,302005,1693945.75
240840,202010,77,67,10,70015,10450,80465
240850,202010,87,77,10,80465,10450,90915
240860,202010,107,103,4,107635,4180,111815
240870,202010,57,49,8,52250,8360,60610
240880,202010,30,27,3,28215,3135,31350
240890,202010,1124,641,483,671935.7,504735,1176670.7
240895,202010,60,41,19,42845,19855,62700
240910,202010,158,140,18,146300,18810,165110
240920,202010,13,10,3,10450,3135,13585
240930,202010,413,370,43,386650,44935,431585
240933,202010,51,33,18,34485,18810,53295
240940,202010,2376,2104,272,2199725.45,284240,2483965.45
240950,202010,49,44,5,45980,5225,51205
240960,202010,26,22,4,22990,4180,27170
240970,202010,112,82,30,85690,31350,117040
240980,202010,202,161,41,168245,42845,211090
240990,202010,130,86,44,89870,45980,135850
241000,202010,61,57,4,59565,4180,63745
241010,202010,69,52,17,54340,17765,72105
241020,202010,113,104,9,108680,9405,118085
241025,202010,12,5,7,5225,7315,12540
241030,202010,114,91,23,95095,24035,119130
241040,202010,44,31,13,32395,13585,45980
241050,202010,83,75,8,78375,8360,86735
241060,202010,29,24,5,25080,5225,30305
241070,202010,15,15,0,15675,0,15675
241080,202010,61,54,7,56430,7315,63745
241090,202010,59,46,13,48070,13585,61655
241100,202010,72,61,11,63745,11495,75240
241105,202010,9,3,6,3135,6270,9405
241110,202010,50,45,5,47025,5225,52250
241120,202010,1480,1120,360,1171445.5,378290,1549735.5
241140,202010,222,184,38,192281,39710,231991
241142,202010,40,34,6,35530,6270,41800
241150,202010,1177,1032,145,1079485,152570,1232055
241160,202010,17,16,1,16720,1045,17765
241170,202010,45,38,7,39710,7315,47025
241180,202010,43,36,7,37620,7315,44935
241190,202010,38,37,1,38665,1045,39710
241200,202010,3980,2054,1926,2150611.39,2018940,4169551.39
241210,202010,67,58,9,61655,9405,71060
241220,202010,1434,956,478,999021.1,499510,1498531.1
241230,202010,245,203,42,213180,43890,257070
241240,202010,56,44,12,45980,12540,58520
241250,202010,1141,1049,92,1096205.5,97185,1193390.5
241255,202010,53,41,12,42845,12540,55385
241260,202010,682,528,154,551760,161975,713735
241270,202010,63,44,19,45980,19855,65835
241280,202010,95,83,12,86735,12540,99275
241290,202010,124,86,38,89870,39710,129580
241300,202010,80,56,24,58520,25080,83600
241310,202010,52,37,15,38665.75,15675,54340.75
241320,202010,29,17,12,17765,12540,30305
241330,202010,63,55,8,57475,8360,65835
241335,202010,74,66,8,68970,8360,77330
241340,202010,182,133,49,138985,51205,190190
241350,202010,61,52,9,54340,9405,63745
241355,202010,50,43,7,44935,7315,52250
241360,202010,50,49,1,51205,1045,52250
241370,202010,54,42,12,43890,12540,56430
241380,202010,36,32,4,34485,4180,38665
241390,202010,87,66,21,68970,21945,90915
241400,202010,220,174,46,181830,49115,230945
241410,202010,183,164,19,171380,19855,191235
241415,202010,101,83,18,86735,18810,105545
241420,202010,101,75,26,78375,28215.1,106590.1
241430,202010,26,24,2,25080,2090,27170
241440,202010,531,430,101,449350,106590,555940
241445,202010,38,33,5,34485,5225,39710
241450,202010,274,225,49,235125,52250,287375
241460,202010,141,128,13,133760.25,13585,147345.25
241470,202010,34,29,5,30305,5225,35530
241475,202010,53,50,3,52250,3135,55385
241480,202010,97,68,29,71060,30305,101365
241490,202010,10,9,1,9405,1045,10450
241500,202010,47,36,11,37620,11495,49115
250010,202010,102,87,15,90915,15675,106590
250020,202010,33,29,4,30305,4180,34485
250030,202010,873,651,222,680295,231990,912285
250040,202010,375,307,68,320815,71060,391875
250050,202010,256,209,47,218405,49115,267520
250053,202010,55,41,14,42845,14630,57475
250057,202010,1,1,0,1045,0,1045
250060,202010,583,414,169,432630,176605,609235
250070,202010,711,572,139,597740.1,147345,745085.1
250073,202010,8,8,0,8360,0,8360
250077,202010,179,134,45,140030,47025,187055
250080,202010,429,338,91,353210.3,95095,448305.3
250090,202010,225,146,79,152570,83600,236170
250100,202010,519,428,91,450395,95095,545490
250110,202010,621,471,150,492195,156750,648945
250115,202010,20,7,13,7315,13585,20900
250120,202010,122,87,35,90915,36575,127490
250130,202010,583,469,114,490105,119130,609235
250135,202010,16,9,7,9405,7315,16720
250140,202010,88,78,10,81510,10450,91960
250150,202010,594,427,167,446215,174515,620730
250153,202010,10,7,3,7315,3135,10450
250157,202010,32,26,6,27170,6270,33440
250160,202010,233,183,50,191235,52250,243485
250170,202010,62,40,22,41800,22990,64790
250180,202010,4349,2944,1405,3077525.3,1470315,4547840.3
250190,202010,842,549,293,573705,306185.25,879890.25
250200,202010,51,41,10,42845,10450,53295
250205,202010,24,20,4,20900,4180,25080
250210,202010,85,75,10,78375,10450,88825
250215,202010,69,55,14,57475,14630,72105
250220,202010,25,18,7,18810,7315,26125
250230,202010,77,70,7,74195,7315,81510
250240,202010,234,194,40,202730,41800,244530
250250,202010,391,334,57,349030,59565,408595
250260,202010,45,38,7,39710,7315,47025
250270,202010,75,53,22,55385,22990,78375
250280,202010,387,316,71,330220,74195,404415
250290,202010,92,84,8,87780,8360,96140
250300,202010,546,367,179,383515,187055,570570
250310,202010,51,43,8,44935,8360,53295
250320,202010,1970,1317,653,1378355.85,682385.9,2060741.75
250330,202010,102,86,16,89870,16720,106590
250340,202010,25,23,2,24035,2090,26125
250350,202010,168,108,60,112860,62700,175560
250355,202010,33,26,7,27170,7315,34485
250360,202010,199,165,34,172425,35530,207955
250370,202010,2431,1606,825,1680360,863170,2543530
250375,202010,11,7,4,7315,4180,11495
250380,202010,54,42,12,43890,12540,56430
250390,202010,46,35,11,36575,11495,48070
250400,202010,16463,8318,8145,8701701.06,8526157.65,17227858.71
250403,202010,327,263,64,274835,66880,341715
250407,202010,63,50,13,52250,13585,65835
250410,202010,30,26,4,27170,4180,31350
250415,202010,43,29,14,31350,14630,45980
250420,202010,43,37,6,38665,6270,44935
250430,202010,1446,1244,202,1302331.25,212135,1514466.25
250435,202010,17,13,4,13585,4180,17765
250440,202010,677,565,112,590425,117040,707465
250450,202010,85,66,19,68970,19855,88825
250460,202010,458,302,156,315590,163020,478610
250470,202010,94,64,30,66880,31350,98230
250480,202010,334,268,66,280060,68970,349030
250485,202010,2,2,0,2090,0,2090
250490,202010,227,181,46,189145,49115,238260
250500,202010,96,70,26,73150,27170,100320
250510,202010,768,605,163,633270,170335,803605
250520,202010,182,123,59,128535,61655,190190
250523,202010,119,95,24,99275,25080,124355
250527,202010,106,83,23,86735,24035,110770
250530,202010,10,6,4,6270,4180,10450
250535,202010,35,25,10,26125,10450,36575
250540,202010,135,105,30,109725,31350,141075
250550,202010,72,69,3,72105,3135,75240
250560,202010,52,38,14,39710,14630,54340
250570,202010,165,135,30,141075,31350,172425
250580,202010,109,84,25,87847,26125,113972
250590,202010,24,14,10,14630,10450,25080
250600,202010,1406,915,491,956176.46,513095,1469271.46
250610,202010,158,129,29,134805,30305,165110
250620,202010,20,16,4,16720,4180,20900
250625,202010,73,53,20,55385,20900,76285
250630,202010,3065,1957,1108,2046112.43,1159950,3206062.43
250640,202010,220,174,46,181830,48070,229900
250650,202010,30,20,10,20900,10450,31350
250660,202010,50,39,11,40755,11495,52250
250670,202010,63,45,18,47025,18810,65835
250680,202010,409,330,79,344850,83600,428450
250690,202010,2063,1426,637,1490170.96,667755,2157925.96
250700,202010,938,809,129,847495.25,134805,982300.25
250710,202010,430,337,93,352165,97185,449350
250720,202010,114,84,30,87780,31350,119130
250730,202010,385,322,63,337535,65835,403370
250740,202010,54,51,3,53295,3135,56430
250750,202010,22328,13363,8965,13989310.28,9399777.12,23389087.40
250760,202010,104,80,24,83600,25080,108680
250770,202010,368,239,129,249755.6,134805,384560.6
250780,202010,65,43,22,44935,22990,67925
250790,202010,462,302,160,315590,167200,482790
250800,202010,152,137,15,143165,15675,158840
250810,202010,77,61,16,63745,16720,80465
250820,202010,150,124,26,129580,27170,156750
250830,202010,434,291,143,304095.5,149435,453530.5
250840,202010,54,48,6,50160,6270,56430
250850,202010,56,46,10,48070,10450,58520
250855,202010,13,11,2,11495,2090,13585
250860,202010,218,150,68,156750,72105,228855
250870,202010,30,26,4,27170,4180,31350
250880,202010,85,63,22,65835,22990,88825
250890,202010,2847,2130,717,2226895,751355.21,2978250.21
250900,202010,50,41,9,42845,9405,52250
250905,202010,117,88,29,91960,30305,122265
250910,202010,1124,818,306,854810,319770,1174580
250915,202010,108,75,33,78375,35530,113905
250920,202010,140,101,39,105545,40755,146300
250930,202010,175,102,73,106590,76285,182875
250933,202010,5,3,2,3135,2090,5225
250937,202010,10,10,0,10450,0,10450
250939,202010,34,26,8,27170,8360,35530
250940,202010,106,78,28,81510,29260,110770
250950,202010,73,50,23,52250,24035,76285
250960,202010,91,51,40,53295,41800,95095
250970,202010,1214,857,357,896610,375155,1271765
250980,202010,104,69,35,72105,37620,109725
250990,202010,165,129,36,134805,37620,172425
251000,202010,74,66,8,68970,8360,77330
251010,202010,113,84,29,87780,31350,119130
251020,202010,75,61,14,63745,14630,78375
251030,202010,48,35,13,36575,13585,50160
251040,202010,56,38,18,39710,18810,58520
251050,202010,24,21,3,21945,3135,25080
251060,202010,51,40,11,41800,11495,53295
251065,202010,4,3,1,4180,1045,5225
251070,202010,20,16,4,16720,4180,20900
251080,202010,5058,2405,2653,2518450.75,2777612.14,5296062.89
251090,202010,183,157,26,164065,27170,191235
251100,202010,18,17,1,17765,1045,18810
251110,202010,46,37,9,38665,9405,48070
251120,202010,1851,1136,715,1188167.25,748220.2,1936387.45
251130,202010,407,331,76,345895,79420,425315
251140,202010,560,363,197,379335,205865,585200
251150,202010,341,287,54,300960,56430,357390
251160,202010,88,71,17,75240,17765,93005
251170,202010,100,81,19,84645,19855,104500
251180,202010,292,176,116,183920,121220,305140
251190,202010,204,133,71,138985,74195,213180
251200,202010,274,221,53,230945,55385,286330
251203,202010,34,32,2,33440,2090,35530
251207,202010,88,72,16,75240,16720,91960
251210,202010,1482,1083,399,1131735,416955,1548690
251220,202010,48,36,12,37620,12540,50160
251230,202010,595,498,97,521455,101365,622820
251240,202010,95,65,30,67925,31350,99275
251250,202010,1414,1012,402,1058585.75,421135.75,1479721.50
251260,202010,11,7,4,7315,4180,11495
251270,202010,316,242,74,253935,78375,332310
251272,202010,64,56,8,58520,8360,66880
251274,202010,30,23,7,24035,7315,31350
251275,202010,34,20,14,20900,14630,35530
251276,202010,15,11,4,11495,4180,15675
251278,202010,9,7,2,7315,2090,9405
251280,202010,102,97,5,101365,5225,106590
251290,202010,813,577,236,602965,247665,850630
251300,202010,15,12,3,12540,3135,15675
251310,202010,330,240,90,250800,94050,344850
251315,202010,32,28,4,29260,4180,33440
251320,202010,64,50,14,52250,14630,66880
251330,202010,78,69,9,72105,9405,81510
251335,202010,15,10,5,10450,5225,15675
251340,202010,742,440,302,459800,316635,776435
251350,202010,34,33,1,34485,1045,35530
251360,202010,83,73,10,76285,10450,86735
251365,202010,15,15,0,15675,0,15675
251370,202010,5564,3721,1843,3892625.65,1931160.5,5823786.15
251380,202010,46,37,9,38665,9405,48070
251385,202010,3,3,0,3135,0,3135
251390,202010,820,616,204,643720,213180.5,856900.5
251392,202010,19,11,8,11495,8360,19855
251394,202010,8,8,0,9405,0,9405
251396,202010,12,8,4,8360,4180,12540
251398,202010,18,16,2,16720,2090,18810
251400,202010,41,33,8,34485,8360,42845
251410,202010,37,31,6,32395,6270,38665
251420,202010,101,71,30,74195,31350,105545
251430,202010,44,40,4,41800,4180,45980
251440,202010,44,27,17,28215,17765,45980
251445,202010,51,46,5,48070.25,5225,53295.25
251450,202010,407,354,53,369930,55385,425315
251455,202010,3,2,1,2090,1045,3135
251460,202010,14,12,2,12540,2090,14630
251465,202010,7,4,3,4180,3135,7315
251470,202010,50,39,11,40755,11495,52250
251480,202010,26,21,5,21945,5225,27170
251490,202010,126,80,46,84645,48070.5,132715.5
251500,202010,128,105,23,109725,24035,133760
251510,202010,53,33,20,34485,20900,55385
251520,202010,30,29,1,30305,1045,31350
251530,202010,4487,3159,1328,3306380.5,1390895,4697275.5
251540,202010,76,64,12,66880,12540,79420
251550,202010,418,316,102,330220,106590.25,436810.25
251560,202010,24,16,8,16720,8360,25080
251570,202010,20,18,2,18810,2090,20900
251580,202010,136,108,28,112860,29260,142120
251590,202010,116,85,31,89022.5,32395,121417.5
251593,202010,25,15,10,15675,10450,26125
251597,202010,99,79,20,82555,20900,103455
251600,202010,1115,784,331,821370.5,345895,1167265.5
251610,202010,238,179,59,188100,61655,249755
251615,202010,9,8,1,8360,1045,9405
251620,202010,4264,2776,1488,2901967.1,1554961.5,4456928.6
251630,202010,459,336,123,351120,128535,479655
251640,202010,142,101,41,105545,42845,148390
251650,202010,278,200,78,209000.75,81510,290510.75
251660,202010,189,169,20,176605,20900,197505
251670,202010,374,293,81,306185,84645,390830
251675,202010,8,6,2,6270,2090,8360
251680,202010,101,89,12,93005,12540,105545
251690,202010,322,266,56,279015,59565,338580
251700,202010,288,246,42,258115.9,43890,302005.9
251710,202010,21,14,7,14630,8360,22990
251720,202010,22,15,7,15675,7315.5,22990.5
251740,202010,12,9,3,9405,3135,12540
260005,202010,3284,1781,1503,1868019.99,1578995.5,3447015.49
260010,202010,1633,1185,448,1241460.55,468160.1,1709620.65
260020,202010,416,361,55,379335,57475,436810
260030,202010,608,420,188,438900,196460,635360
260040,202010,814,506,308,529815,321860,851675
260050,202010,1163,829,334,868395,352166,1220561
260060,202010,382,350,32,365750,33440,399190
260070,202010,1354,839,515,878845.5,542355.3,1421200.8
260080,202010,730,561,169,586245,176605,762850
260090,202010,494,326,168,340670,176605,517275
260100,202010,215,150,65,156750,67925,224675
260105,202010,239,130,109,135850,113905,249755
260110,202010,2867,2093,774,2189275.5,811965.5,3001241.0
260120,202010,2845,1440,1405,1506124.3,1471360.75,2977485.05
260130,202010,168,114,54,119130,57475,176605
260140,202010,2120,1372,748,1435832.3,782705,2218537.3
260150,202010,206,133,73,138985,79420,218405
260160,202010,324,269,55,282150,57475,339625
260170,202010,3391,2024,1367,2120306.45,1429561,3549867.45
260180,202010,162,130,32,135850,33440,169290
260190,202010,2340,1580,760,1651100,794200,2445300
260200,202010,969,778,191,814055.29,200640.5,1014695.79
260210,202010,1433,1015,418,1061720,438900,1500620
260220,202010,686,615,71,642675.5,74195,716870.5
260230,202010,1204,907,297,948860,310365,1259225
260240,202010,222,163,59,170335,61655,231990
260250,202010,92,67,25,70015,26125,96140
260260,202010,1042,732,310,767030,324995,1092025
260270,202010,410,321,89,336490,94050,430540
260280,202010,1287,917,370,959310,386650.5,1345960.5
260290,202010,6556,3537,3019,3699302.15,3163217.46,6862519.61
260300,202010,945,812,133,851675.5,138985,990660.5
260310,202010,517,412,105,430540,109725,540265
260320,202010,857,628,229,657305,240350,897655
260330,202010,64,44,20,45980,20900,66880
260340,202010,76,55,21,57475,21945,79420
260345,202010,5514,2988,2526,3124552.35,2645940,5770492.35
260350,202010,491,347,144,363660.5,150480,514140.5
260360,202010,245,135,110,141075,114950,256025
260370,202010,781,473,308,494285.25,328130.5,822415.75
260380,202010,585,429,156,448305,164065.47,612370.47
260390,202010,290,244,46,257070,48070,305140
260392,202010,112,96,16,100320,16720,117040
260400,202010,4206,2393,1813,2502776.72,1903990.5,4406767.22
260410,202010,14812,7703,7109,8059043.09,7439356.42,15498399.51
260415,202010,140,121,19,126445,19855,146300
260420,202010,1720,1053,667,1103521.77,699105,1802626.77
260430,202010,188,173,15,180785.35,15675,196460.35
260440,202010,197,142,55,148390,57475,205865
260450,202010,428,317,111,331265.96,115995,447260.96
260460,202010,813,426,387,445170,405460,850630
260470,202010,343,212,131,221540,136895.5,358435.5
260480,202010,239,154,85,160930,88825,249755
260490,202010,214,177,37,184965,38665,223630
260500,202010,1116,754,362,787930,379335,1167265
260510,202010,778,617,161,644765,169290,814055
260515,202010,230,207,23,217360,24035,241395
260520,202010,3260,2009,1251,2104630.5,1312520.95,3417151.45
260530,202010,790,649,141,679250,147345,826595
260540,202010,544,428,116,447260,121220,568480
260545,202010,15,11,4,11495,4180,15675
260550,202010,328,204,124,213180,129580,342760
260560,202010,513,386,127,404415.5,132715,537130.5
260570,202010,973,789,184,824505,192280,1016785
260580,202010,248,216,32,225720,33440,259160
260590,202010,638,365,273,382470,286330,668800
260600,202010,8106,4333,3773,4531123.34,3958460.5,8489583.84
260610,202010,486,325,161,339625,168245,507870
260620,202010,3662,1899,1763,1988636.65,1846515.58,3835152.23
260630,202010,83,76,7,79420,7315,86735
260640,202010,3524,1956,1568,2047155.8,1647965,3695120.8
260650,202010,326,238,88,248710,91960,340670
260660,202010,555,358,197,374110,205865,579975
260670,202010,105,77,28,80465,29260,109725
260680,202010,3750,2068,1682,2163150.22,1759780.5,3922930.72
260690,202010,130,93,37,97185,38665,135850
260700,202010,305,205,100,214225,104500,318725
260710,202010,42,35,7,36575,7315,43890
260720,202010,2472,1459,1013,1530926,1058585,2589511
260730,202010,702,526,176,551760,183920,735680
260740,202010,64,58,6,60610,6270,66880
260750,202010,596,420,176,438900,183920,622820
260760,202010,660,336,324,351120.23,338580,689700.23
260765,202010,983,509,474,532950,496375,1029325
260770,202010,221,161,60,169272,62700.5,231972.5
260775,202010,773,440,333,460846.25,350075,810921.25
260780,202010,249,155,94,163020,98230,261250
260790,202010,14184,7240,6944,7577161.06,7270067,14847228.06
260795,202010,169,110,59,114950,61655,176605
260800,202010,290,239,51,249755.5,53295,303050.5
260805,202010,176,117,59,122265,62700,184965
260810,202010,765,657,108,686565,112860,799425
260820,202010,285,183,102,191235.85,106590,297825.85
260825,202010,214,148,66,154660,68970,223630
260830,202010,385,185,200,194370,210045,404415
260840,202010,239,175,64,183920,66880,250800
260845,202010,175,120,55,125400,57475,182875
260850,202010,440,323,117,337535,122265,459800
260860,202010,250,189,61,197505,63745,261250
260870,202010,365,275,90,287375.29,96140,383515.29
260875,202010,731,518,213,541310,224675,765985
260880,202010,1601,1014,587,1061720,613415,1675135
260890,202010,2358,1665,693,1739926,724185,2464111
260900,202010,977,693,284,726275,296780,1023055
260910,202010,255,202,53,211090,56430,267520
260915,202010,291,214,77,223630,80465,304095
260920,202010,184,97,87,101365,90915,192280
260930,202010,397,336,61,351120,63745,414865
260940,202010,2699,1458,1241,1526746.4,1302070.5,2828816.9
260950,202010,2012,1150,862,1202795.75,902880,2105675.75
260960,202010,13715,6909,6806,7227227.78,7134218.82,14361446.60
260970,202010,421,353,68,368885,72105,440990
260980,202010,191,170,21,177650,21945,199595
260990,202010,2621,2119,502,2215401.35,525635,2741036.35
261000,202010,4267,2561,1706,2679380.75,1785905,4465285.75
261010,202010,200,120,80,125400,84645,210045
261020,202010,601,450,151,472340.99,157795,630135.99
261030,202010,257,177,80,184965,84645,269610
261040,202010,375,327,48,341715,50160,391875
261050,202010,507,437,70,456665,73150,529815
261060,202010,1389,888,501,927960.25,524590,1452550.25
261070,202010,8827,4310,4517,4509179.14,4729673.37,9238852.51
261080,202010,377,289,88,302005,91960,393965
261090,202010,2187,1674,513,1751424.7,538175.83,2289600.53
261100,202010,1161,810,351,847495.75,367840,1215335.75
261110,202010,8666,5268,3398,5512375.8,3557181,9069556.8
261120,202010,260,222,38,233035,39710,272745
261130,202010,569,341,228,356345,238260.55,594605.55
261140,202010,201,124,77,129580,80465,210045
261150,202010,683,423,260,442035.03,272745,714780.03
261153,202010,69,64,5,66880,5225,72105
261160,202010,74795,36976,37819,38698554.06,39645219.04,78343773.10
261170,202010,461,346,115,362615,120175,482790
261180,202010,1800,1118,682,1170400,713735,1884135
261190,202010,627,437,190,457710.9,199595,657305.9
261200,202010,214,182,32,191235,33440,224675
261210,202010,32,27,5,28215,5225,33440
261220,202010,2711,1909,802,1994906.12,839135,2834041.12
261230,202010,337,250,87,261250,90915,352165
261240,202010,454,396,58,413820,60610,474430
261245,202010,235,194,41,202730,42845,245575
261247,202010,171,134,37,140030,38665,178695
261250,202010,3172,1546,1626,1617660.5,1701260,3318920.5
261255,202010,245,221,24,230945,25080,256025
261260,202010,848,736,112,770165.06,118085,888250.06
261270,202010,200,143,57,149435,59565,209000
261280,202010,176,145,31,151525,32395,183920
261290,202010,114,83,31,86735,32395,119130
261300,202010,1288,942,346,985435,361570,1347005
261310,202010,808,540,268,567435,280060,847495
261320,202010,555,373,182,389785.7,190190.5,579976.2
261330,202010,964,739,225,773300,236170.29,1009470.29
261340,202010,294,165,129,172425,134805,307230
261350,202010,851,602,249,631180.5,260205,891385.5
261360,202010,1304,846,458,885115,478610,1363725
261370,202010,4850,2888,1962,3019006.5,2051336,5070342.5
261380,202010,549,417,132,435765.69,137940.5,573706.19
261390,202010,3609,2422,1187,2537261,1244595.75,3781856.75
261400,202010,294,266,28,277970,29260,307230
261410,202010,1094,723,371,757625,388740.5,1146365.5
261420,202010,878,544,334,569525.55,350075,919600.55
261430,202010,328,298,30,311410,31350,342760
261440,202010,117,108,9,112860,9405,122265
261450,202010,2545,2038,507,2132846.25,529815.5,2662661.75
261460,202010,727,576,151,602965.85,157795,760760.85
261470,202010,244,195,49,203775.5,51205,254980.5
261480,202010,445,345,100,360525,104452.97,464977.97
261485,202010,347,208,139,217360,145255,362615
261500,202010,611,413,198,433675.86,206910,640585.86
261510,202010,51,32,19,33440,19855,53295
261520,202010,99,86,13,89870,13585,103455
261530,202010,4130,2624,1506,2746261.98,1580040.25,4326302.23
261540,202010,1345,792,553,828685,581020,1409705
261550,202010,261,125,136,130625,142120,272745
261560,202010,849,560,289,587291.75,303050.5,890342.25
261570,202010,404,315,89,329175,94050,423225
261580,202010,378,295,83,308275,86735,395010
261590,202010,193,155,38,161975,39710,201685
261600,202010,288,229,59,239305,61655.5,300960.5
261610,202010,88,75,13,78375,13585,91960
261618,202010,73,59,14,61655,14630,76285
261620,202010,198,123,75,128535,78375,206910
261630,202010,552,430,122,450395,127490,577885
261640,202010,6420,3363,3057,3517473.09,3198745.75,6716218.84
261650,202010,484,306,178,320815,187055,507870
270010,202010,516,457,59,478610,61655,540265
270020,202010,284,232,52,242440,54340,296780
270030,202010,8826,5696,3130,5957548.28,3278166,9235714.28
270040,202010,2002,1265,737,1325060,772255,2097315
270050,202010,153,118,35,123310,36575,159885
270060,202010,111,60,51,62700,53295,115995
270070,202010,865,633,232,662530,242440,904970
270080,202010,37,31,6,32395,6270,38665
270090,202010,23,17,6,17765,6270,24035
270100,202010,1247,836,411,874665.75,430540,1305205.75
270110,202010,122,95,27,99275,28215,127490
270120,202010,227,186,41,194370,42845,237215
270130,202010,262,186,76,195415,79420,274835
270135,202010,114,70,44,74195,45980,120175
270140,202010,1370,867,503,905221.5,525635,1430856.5
270150,202010,255,202,53,211090,55385,266475
270160,202010,500,395,105,412775,109725,522500
270170,202010,792,515,277,538175,289465,827640
270180,202010,73,56,17,58520,17765,76285
270190,202010,90,77,13,80465,13585,94050
270200,202010,109,94,15,98230,15675,113905
270210,202010,515,290,225,303851.16,235125,538976.16
270220,202010,181,141,40,147345,41800.5,189145.5
270230,202010,2110,1287,823,1345996.93,860035,2206031.93
270235,202010,694,541,153,565379.83,159885,725264.83
270240,202010,3014,2390,624,2502776.42,653125.5,3155901.92
270250,202010,156,115,41,120175,42845,163020
270255,202010,219,190,29,198550,30305,228855
270260,202010,369,299,70,312455,73150,385605
270270,202010,98,43,55,44935,57475,102410
270280,202010,238,135,103,141075,107635,248710
270290,202010,1153,886,267,925870,280060,1205930
270300,202010,320,225,95,235125,99275,334400
270310,202010,857,700,157,731500.5,164065,895565.5
270320,202010,829,710,119,741950.5,124355,866305.5
270330,202010,298,250,48,261250,50160,311410
270340,202010,60,47,13,49115,13585,62700
270350,202010,89,49,40,51205,41800,93005
270360,202010,68,38,30,39710,31350,71060
270370,202010,57,46,11,48070,11495,59565
270375,202010,73,44,29,45980,30305,76285
270380,202010,1014,649,365,678205.5,382470,1060675.5
270390,202010,188,114,74,119130,78375,197505
270400,202010,713,530,183,554895.79,191235,746130.79
270410,202010,657,483,174,505780,181830,687610
270420,202010,403,279,124,292600,129580,422180
270430,202010,32879,23627,9252,24731226.89,9689814.07,34421040.96
270440,202010,485,384,101,401280,105545,506825
270450,202010,796,452,344,473385,359480,832865
270460,202010,187,150,37,156750,38665,195415
270470,202010,1479,1023,456,1070080,477565,1547645
270480,202010,544,449,95,471016.83,99275.5,570292.33
270490,202010,24,19,5,19855,5225,25080
270500,202010,490,413,77,431585,81510,513095
270510,202010,813,506,307,528770,320815,849585
270520,202010,293,189,104,197505,108680,306185
270530,202010,69,61,8,63745,8360,72105
270540,202010,108,84,24,88825,25080,113905
270550,202010,1737,1331,406,1394030,425315,1819345
270560,202010,266,144,122,150480,127490,277970
270570,202010,523,366,157,382470,165110,547580
270580,202010,97,72,25,75240,26125,101365
270590,202010,67,54,13,56430,13585,70015
270600,202010,176,147,29,153615,31350,184965
270610,202010,227,177,50,184999.83,52250,237249.83
270620,202010,28,27,1,28215,1045,29260
270630,202010,3754,2852,902,2982500.66,945725,3928225.66
270640,202010,867,645,222,678205,233035,911240
270642,202010,215,183,32,192280,34485,226765
270644,202010,253,161,92,168245,96140,264385
270650,202010,326,193,133,203322.59,140030,343352.59
270660,202010,242,202,40,211090,41800,252890
270670,202010,3059,2324,735,2430673.55,769120,3199793.55
270680,202010,433,257,176,269610,183920,453530
270690,202010,1180,776,404,812836.78,422180,1235016.78
270700,202010,28,23,5,24035,5225,29260
270710,202010,871,683,188,713735,197505,911240
270720,202010,239,187,52,197505,54340,251845
270730,202010,1847,1111,736,1162040.5,771210.25,1933250.75
270740,202010,44,31,13,32395,13585,45980
270750,202010,646,487,159,508915,166155,675070
270760,202010,291,210,81,219450,84645,304095
270770,202010,2754,1830,924,1917541.71,967670,2885211.71
270780,202010,78,50,28,52250,29260,81510
270790,202010,272,175,97,183920,101365,285285
270800,202010,1967,1582,385,1654235,402325,2056560
270810,202010,284,227,57,237215,59565,296780
270820,202010,143,95,48,99275,50160.5,149435.5
270830,202010,795,597,198,625955,207955,833910
270840,202010,1379,1054,325,1102475,340670.85,1443145.85
270850,202010,1496,934,562,978120.5,589380,1567500.5
270860,202010,2527,1675,852,1752291.29,891385,2643676.29
270870,202010,118,64,54,66880,57475,124355
270880,202010,895,703,192,734635,200640,935275
270890,202010,294,221,73,231990.5,76285,308275.5
270895,202010,64,55,9,57475.5,9405,66880.5
270900,202010,90,70,20,73150,20900,94050
270910,202010,304,248,56,259160,58520,317680
270915,202010,1896,1212,684,1272810.75,718960.6,1991771.35
270920,202010,473,397,76,415910,79420,495330
270930,202010,5901,4430,1471,4634575,1540330.03,6174905.03
270940,202010,2304,1800,504,1884135,527725,2411860
280010,202010,39,33,6,34485,6270,40755
280020,202010,483,416,67,435765.45,70015,505780.45
280030,202010,20616,13339,7277,13952865.77,7619101.47,21571967.24
280040,202010,334,218,116,227810,121220,349030
280050,202010,408,313,95,327085,99275,426360
280060,202010,349,223,126,233035.7,131670,364705.7
280067,202010,1071,771,300,805695,313500.62,1119195.62
280070,202010,122,99,23,103455,24035,127490
280100,202010,630,490,140,512050.5,146300,658350.5
280110,202010,74,69,5,72105,5225,77330
280120,202010,657,536,121,561165,126445,687610
280130,202010,1741,1143,598,1196525,624910.5,1821435.5
280140,202010,479,390,89,409640.5,93005,502645.5
280150,202010,394,284,110,297825,117040,414865
280160,202010,106,90,16,95095,16720,111815
280170,202010,399,276,123,288420.25,128535,416955.25
280190,202010,26,22,4,22990,4180,27170
280200,202010,29,25,4,26125,4180,30305
280210,202010,2914,2090,824,2188107.36,862125.5,3050232.86
280220,202010,39,31,8,32395,8360,40755
280230,202010,328,269,59,281105,61655,342760
280240,202010,120,114,6,119130,6270,125400
280250,202010,16,10,6,10450,6270,16720
280260,202010,81,73,8,76285,8360,84645
280270,202010,150,117,33,122265,34485,156750
280280,202010,193,122,71,127490.37,74195,201685.37
280290,202010,3334,2413,921,2525254.49,964535.1,3489789.59
280300,202010,1595,1244,351,1301060.33,367840,1668900.33
280310,202010,101,96,5,100320,5225,105545
280320,202010,649,457,192,478610,200640,679250
280330,202010,325,237,88,247665,91960,339625
280340,202010,407,329,78,343805,81510,425315
280350,202010,3679,2859,820,2990792.26,856901.52,3847693.78
280360,202010,478,316,162,330220,169290,499510
280370,202010,95,84,11,87780.65,11495,99275.65
280380,202010,52,41,11,42845,11495,54340
280390,202010,171,147,24,153615,25080,178695
280400,202010,357,245,112,256025.5,117040,373065.5
280410,202010,286,234,52,245575,54340,299915
280420,202010,169,142,27,148390,28215,176605
280430,202010,45,34,11,35530,11495,47025
280440,202010,700,549,151,573705.65,157795,731500.65
280445,202010,119,108,11,112860,11495,124355
280450,202010,1192,1029,163,1076350,170335,1246685
280460,202010,619,452,167,472341.63,174515,646856.63
280470,202010,182,170,12,177650,12540.75,190190.75
280480,202010,2694,1875,819,1961468.71,856901.24,2818369.95
280490,202010,261,246,15,257070.66,15675,272745.66
280500,202010,42,38,4,39710,4180,43890
280510,202010,140,113,27,118085,28215.5,146300.5
280520,202010,52,38,14,39710,14630,54340
280530,202010,77,48,29,50160,30305,80465
280540,202010,540,454,86,474430,89870,564300
280550,202010,732,678,54,708511.71,56430,764941.71
280560,202010,494,437,57,456665,59565,516230
280570,202010,2202,1721,481,1801581.45,503690.5,2305271.95
280580,202010,591,458,133,478610,138985,617595
280590,202010,211,133,78,138985,81510,220495
280600,202010,385,323,62,337535,64790,402325
280610,202010,111,85,26,89870,27170,117040
280620,202010,553,452,101,473385,106590,579975
280630,202010,154,128,26,133760,27170,160930
280640,202010,198,156,42,163020,43890,206910
280650,202010,92,59,33,61655,34485,96140
280660,202010,145,107,38,111815,39710,151525
280670,202010,1860,1167,693,1220563.37,725231.05,1945794.42
280680,202010,188,166,22,173470,24035,197505
280690,202010,80,71,9,74195,9405,83600
280700,202010,23,23,0,24035,0,24035
280710,202010,1471,1128,343,1179805,358435,1538240
280720,202010,115,74,41,77330,42845,120175
280730,202010,26,21,5,21945,5225,27170
280740,202010,2524,1882,642,1966690.5,672980,2639670.5
280750,202010,233,204,29,213180,30305,243485
280760,202010,785,542,243,566390.9,254980,821370.9
290010,202010,203,141,62,147345,64790,212135
290020,202010,185,167,18,174515,18810,193325
290030,202010,616,398,218,415910,229900,645810
290035,202010,131,108,23,112860,25080,137940
290040,202010,307,204,103,213180,107635,320815
290050,202010,84,65,19,68970,20900,89870
290060,202010,268,118,150,123310,156750,280060
290070,202010,5727,2755,2972,2883156.6,3110965.92,5994122.52
290080,202010,455,206,249,215270,260205,475475
290090,202010,387,175,212,182875,222585,405460
290100,202010,1640,1063,577,1113970,604011,1717981
290110,202010,831,482,349,503690.75,364705,868395.75
290115,202010,194,179,15,187055,15675,202730
290120,202010,767,508,259,530860,271700,802560
290130,202010,425,263,162,274835,169290,444125
290135,202010,301,230,71,240350,75240,315590
290140,202010,314,259,55,272745,57475,330220
290150,202010,136,97,39,101365,40755,142120
290160,202010,244,187,57,195415,59565,254980
290170,202010,92,66,26,68970,27170,96140
290180,202010,178,131,47,136895,50160,187055
290190,202010,438,359,79,375155,82555,457710
290195,202010,313,202,111,211090,118085,329175
290200,202010,271,222,49,231990,51205,283195
290205,202010,152,92,60,96140,62700,158840
290210,202010,1168,858,310,897655.5,324995,1222650.5
290220,202010,222,120,102,125400,106590,231990
290225,202010,283,115,168,120175,176605,296780
290230,202010,76,49,27,51205,28215,79420
290240,202010,360,131,229,136895,239305,376200
290250,202010,253,233,20,243485,20900,264385
290260,202010,326,268,58,280060.5,60610,340670.5
290265,202010,186,161,25,168245,26125,194370
290270,202010,1413,1176,237,1228920,247665.5,1476585.5
290280,202010,480,340,140,355300,148390,503690
290290,202010,1334,799,535,834955.97,560120.5,1395076.47
290300,202010,436,371,65,388740.5,67925,456665.5
290310,202010,300,137,163,143165,170335,313500
290320,202010,3998,2467,1531,2582195.3,1606165.1,4188360.4
290323,202010,192,165,27,172425,28215,200640
290327,202010,169,134,35,141075,36575,177650
290330,202010,111,56,55,58520,57475,115995
290340,202010,827,336,491,351120,514140,865260
290350,202010,633,380,253,399190.5,264385,663575.5
290360,202010,346,269,77,281106.64,80465,361571.64
290370,202010,917,387,530,405460.75,553850,959310.75
290380,202010,321,203,118,212135,124355,336490
290390,202010,2446,1521,925,1590491.25,968715,2559206.25
290395,202010,248,143,105,150480.25,109725,260205.25
290400,202010,271,203,68,212135.5,71060,283195.5
290405,202010,246,211,35,221540,36575,258115
290410,202010,626,525,101,548625.53,106590,655215.53
290420,202010,251,201,50,210045,52250,262295
290430,202010,477,313,164,327085,171380,498465
290440,202010,75,66,9,68970,9405,78375
290450,202010,201,152,49,159885,51205,211090
290460,202010,1959,1175,784,1228920,820325,2049245
290470,202010,1386,608,778,637450.5,816145,1453595.5
290475,202010,557,522,35,546535.2,36575,583110.2
290480,202010,288,164,124,171380,130625,302005
290485,202010,240,220,20,229900,20900,250800
290490,202010,1226,878,348,919600,363660,1283260
290500,202010,747,382,365,400235,382470,782705
290510,202010,227,179,48,187055,51205,238260
290515,202010,156,95,61,99275,63745,163020
290520,202010,1409,926,483,968715,504736.44,1473451.44
290530,202010,301,278,23,290510,24035,314545
290540,202010,104,55,49,57475,51205,108680
290550,202010,158,135,23,141075,24035,165110
290560,202010,3174,1378,1796,1442100,1879955,3322055
290570,202010,6233,3019,3214,3157991.9,3368037.41,6526029.31
290580,202010,1280,757,523,791065,546535,1337600
290590,202010,575,475,100,496375,104500,600875
290600,202010,1772,1218,554,1273855.63,581020,1854875.63
290610,202010,206,185,21,193325.5,21945,215270.5
290620,202010,358,322,36,336490,38665,375155
290630,202010,2002,849,1153,887205,1204885.5,2092090.5
290640,202010,149,120,29,125400,30305,155705
290650,202010,1814,840,974,879891.42,1019920,1899811.42
290660,202010,280,227,53,237215,55385,292600
290670,202010,942,487,455,508916.5,476520,985436.5
290680,202010,1229,988,241,1033505,251845,1285350
290682,202010,306,228,78,238260.8,82555,320815.8
290685,202010,241,158,83,165110,86735,251845
290687,202010,1054,682,372,712860.1,388740,1101600.1
290689,202010,145,77,68,80465,71060,151525
290690,202010,610,259,351,270655,367840,638495
290700,202010,244,121,123,126445,128535,254980
290710,202010,751,512,239,535040,250800,785840
290720,202010,1024,830,194,867350,203775,1071125
290730,202010,1168,671,497,701195.75,519365,1220560.75
290740,202010,17,14,3,14630,3135,17765
290750,202010,1421,635,786,663575,821370.75,1484945.75
290755,202010,72,65,7,67925,7315,75240
290760,202010,291,252,39,264385,40755,305140
290770,202010,188,176,12,183920,12540,196460
290780,202010,1115,851,264,889296,275880,1165176
290790,202010,364,254,110,265430,114950.5,380380.5
290800,202010,2472,1004,1468,1049180.5,1535105,2584285.5
290810,202010,465,320,145,334400,151525,485925
290820,202010,396,233,163,243485,171380,414865
290830,202010,425,303,122,316635,127490,444125
290840,202010,1748,1083,665,1138006.7,698060.5,1836067.2
290850,202010,843,441,402,462935,421135,884070
290860,202010,643,291,352,305140,368885,674025
290870,202010,630,449,181,470250.6,190190.6,660441.2
290880,202010,121,66,55,68970,57475,126445
290890,202010,390,264,126,275880,132715,408595
290900,202010,168,127,41,132715,42845,175560
290910,202010,388,295,93,309320,98230,407550
290920,202010,210,183,27,191235,28215,219450
290930,202010,823,624,199,653125.5,207955,861080.5
290940,202010,243,204,39,213180,40755,253935
290950,202010,156,95,61,99275,63745,163020
290960,202010,474,334,140,350075,146300,496375
290970,202010,244,212,32,223630,33440,257070
290980,202010,1635,1152,483,1205930.7,506826,1712756.7
290990,202010,386,325,61,339625,63745,403370
291000,202010,855,259,596,270655,625955,896610
291005,202010,2313,1011,1302,1057540,1364770.42,2422310.42
291010,202010,160,145,15,151525,15675,167200
291020,202010,101,81,20,84645,20900,105545
291030,202010,97,70,27,73150,28215,101365
291040,202010,613,343,270,358435,282150,640585
291050,202010,1434,791,643,828685,672980,1501665
291060,202010,1543,843,700,881980,732545,1614525
291070,202010,1964,1462,502,1529880.62,526680.62,2056561.24
291072,202010,7172,2666,4506,2789105.5,4719222,7508327.5
291075,202010,242,196,46,204820,48070,252890
291077,202010,58,39,19,40755,19855,60610
291080,202010,20303,8833,11470,9245117.46,12022726.27,21267843.73
291085,202010,299,246,53,257070,55385,312455
291090,202010,303,125,178,130625.5,186010,316635.5
291100,202010,660,203,457,212135,477565,689700
291110,202010,417,317,100,332310,104500,436810
291120,202010,2387,1194,1193,1249820.75,1251910,2501730.75
291125,202010,64,31,33,32395,34485,66880
291130,202010,200,177,23,184965,24035,209000
291140,202010,131,106,25,110770,26125.5,136895.5
291150,202010,393,148,245,154660,256025,410685
291160,202010,385,313,72,327085.25,75240,402325.25
291165,202010,44,35,9,36575,9405,45980
291170,202010,3168,1576,1592,1647967.42,1665730.5,3313697.92
291180,202010,1265,509,756,531905,791065,1322970
291185,202010,93,88,5,91960,5225,97185
291190,202010,1381,633,748,662530.25,783750,1446280.25
291200,202010,172,127,45,132715,47025,179740
291210,202010,2291,917,1374,958265.2,1440010.5,2398275.7
291220,202010,275,207,68,216315,71060,287375
291230,202010,978,337,641,352165.5,669845,1022010.5
291240,202010,428,399,29,416955.5,31350,448305.5
291250,202010,438,354,84,369930,88825,458755
291260,202010,59,49,10,51205,10450,61655
291270,202010,1156,480,676,501600,708510,1210110
291280,202010,356,169,187,176605,196460,373065
291290,202010,1722,893,829,934230.5,867350.5,1801581.0
291300,202010,232,185,47,193325,49115,242440
291310,202010,222,200,22,209000,22990,231990
291320,202010,1361,956,405,1001110,423225,1424335
291330,202010,131,112,19,118085,19855,137940
291340,202010,212,125,87,130625,90915,221540
291345,202010,131,91,40,95095,41800,136895
291350,202010,1640,582,1058,608190,1107700.75,1715890.75
291360,202010,8380,4040,4340,4224935.75,4543662.25,8768598.00
291370,202010,1120,646,474,677160.5,495330,1172490.5
291380,202010,267,212,55,221540,58520,280060
291390,202010,3916,1710,2206,1789042.41,2308405.5,4097447.91
291400,202010,2071,1482,589,1548690,617595.84,2166285.84
291410,202010,194,168,26,175560,28215,203775
291420,202010,120,88,32,91960,33440,125400
291430,202010,167,90,77,94050,80465.02,174515.02
291440,202010,519,427,92,447260.5,96140,543400.5
291450,202010,928,594,334,620730.25,350075,970805.25
291460,202010,1868,1521,347,1590490.5,363660.5,1954151.0
291465,202010,2180,1038,1142,1088890.5,1195480,2284370.5
291470,202010,2868,1448,1420,1515250.97,1485990.5,3001241.47
291480,202010,11811,5225,6586,5468489.88,6900137.75,12368627.63
291490,202010,614,245,369,256025,385605,641630
291500,202010,379,224,155,235125,161975,397100
291510,202010,1213,471,742,494285,776435,1270720
291520,202010,947,430,517,449350,541310,990660
291530,202010,944,252,692,263340,723140,986480
291535,202010,122,100,22,104500,22990,127490
291540,202010,350,107,243,113905.5,254980,368885.5
291550,202010,1233,580,653,607145,682385.5,1289530.5
291560,202010,5268,2644,2624,2766115,2746261,5512376
291570,202010,202,105,97,109725,101365,211090
291580,202010,1198,737,461,770165.55,482790,1252955.55
291590,202010,89,37,52,38665,54340.87,93005.87
291600,202010,1144,565,579,590425.25,605055,1195480.25
291610,202010,1458,706,752,737770,786885,1524655
291620,202010,567,263,304,274835,317680,592515
291630,202010,481,149,332,155705,346940,502645
291640,202010,3969,2021,1948,2115082.2,2038796.5,4153878.7
291650,202010,426,290,136,303051.12,142120,445171.12
291660,202010,393,159,234,166155.29,244530,410685.29
291670,202010,226,136,90,143165,94050,237215
291680,202010,653,391,262,408595,273790.5,682385.5
291685,202010,584,326,258,340670,269610,610280
291690,202010,525,314,211,329175,220495.27,549670.27
291700,202010,980,761,219,796290,228855,1025145
291710,202010,1626,789,837,824505,875710.5,1700215.5
291720,202010,431,290,141,303050,148390,451440
291730,202010,935,548,387,573705,404415,978120
291733,202010,290,197,93,205865,97185,303050
291735,202010,76,57,19,59565,19855,79420
291740,202010,356,273,83,285285,86735,372020
291750,202010,2160,1403,757,1467180.38,791065,2258245.38
291760,202010,2946,1632,1314,1706485,1378355,3084840
291770,202010,781,526,255,549671.05,267520,817191.05
291780,202010,58,36,22,37620,22990,60610
291790,202010,158,81,77,84645,80465,165110
291800,202010,10040,4147,5893,4337798.09,6170726.5,10508524.59
291810,202010,1105,825,280,862125.5,292600,1154725.5
291820,202010,280,201,79,210045,83600,293645
291830,202010,1052,420,632,438901.46,661485,1100386.46
291835,202010,565,525,40,548625,41800,590425
291840,202010,4863,2458,2405,2569655.75,2520540.5,5090196.25
291845,202010,274,89,185,93005,193325,286330
291850,202010,327,289,38,302005,39710,341715
291855,202010,264,104,160,110770,167200,277970
291860,202010,172,108,64,112860,66880,179740
291870,202010,84,35,49,36575,51205,87780
291875,202010,178,165,13,172425,13585,186010
291880,202010,454,362,92,378290,96140,474430
291890,202010,245,78,167,81510,174515.5,256025.5
291900,202010,59,34,25,35530,26125,61655
291905,202010,127,92,35,96140.5,36575,132715.5
291910,202010,161,131,30,136895,31350,168245
291915,202010,433,384,49,401280.25,51205,452485.25
291920,202010,5112,2546,2566,2664750.5,2685650.5,5350401.0
291930,202010,171,101,70,105545.55,73150,178695.55
291940,202010,360,207,153,216315.5,159885,376200.5
291950,202010,1145,925,220,966626,231990,1198616
291955,202010,1247,743,504,778525,529815.25,1308340.25
291960,202010,192,138,54,144210,56430,200640
291970,202010,761,577,184,602965,192280,795245
291980,202010,1501,1328,173,1389851.23,180785.5,1570636.73
291990,202010,134,124,10,129580,10450,140030
291992,202010,175,91,84,95095,87780,182875
291995,202010,188,122,66,127490,68970,196460
292000,202010,396,302,94,316635,98230,414865
292010,202010,319,221,98,230945,102410,333355
292020,202010,301,221,80,230945,83600,314545
292030,202010,146,113,33,118085,34485,152570
292040,202010,629,319,310,334400,323950,658350
292045,202010,109,98,11,102410,11495,113905
292050,202010,947,690,257,721050,270655.5,991705.5
292060,202010,905,745,160,778525.65,167200,945725.65
292070,202010,58,18,40,18810,41800,60610
292080,202010,140,95,45,99275,47025,146300
292090,202010,541,187,354,196460,370975,567435
292100,202010,1475,625,850,654170,889295,1543465
292105,202010,192,170,22,177650,22990,200640
292110,202010,2268,821,1447,858990,1519430,2378420
292120,202010,697,550,147,574750,154660,729410
292130,202010,444,249,195,260205,203775,463980
292140,202010,210,170,40,177650,41800,219450
292145,202010,161,87,74,90915,77330,168245
292150,202010,1477,1204,273,1259225,285285,1544510
292160,202010,170,138,32,145255,33440,178695
292170,202010,1202,1046,156,1093070,163020,1256090
292180,202010,222,162,60,169290,62700,231990
292190,202010,161,104,57,108680,59565,168245
292200,202010,1346,489,857,512050,895565.5,1407615.5
292205,202010,124,108,16,113905,16720,130625
292210,202010,367,255,112,266475,117040.25,383515.25
292220,202010,30,22,8,22990,8360,31350
292225,202010,39,33,6,34485,6270,40755
292230,202010,965,762,203,797335.75,212135,1009470.75
292240,202010,613,441,172,460845.75,179740,640585.75
292250,202010,1730,1134,596,1185030,622820,1807850
292260,202010,409,245,164,256059.83,171380,427439.83
292265,202010,250,180,70,188100,74195,262295
292270,202010,739,337,402,352165,420090,772255
292273,202010,210,115,95,120175,99275,219450
292275,202010,173,85,88,88825,91960,180785
292280,202010,145,101,44,105545,47025,152570
292285,202010,77,63,14,65835,14630,80465
292290,202010,578,390,188,407550,197505.59,605055.59
292300,202010,1682,625,1057,656260,1107700.3,1763960.3
292303,202010,112,73,39,76285,40755,117040
292305,202010,115,86,29,89870,30305,120175
292310,202010,930,603,327,631181.25,341715.9,972897.15
292320,202010,595,454,141,474430,148390,622820
292330,202010,174,100,74,104500,77330,181830
292335,202010,279,220,59,229900,61655,291555
292340,202010,578,402,176,420090,183920,604010
292350,202010,273,147,126,153615,131670,285285
292360,202010,709,540,169,564300.9,177650,741950.9
292370,202010,736,566,170,592515,178695,771210
292380,202010,637,517,120,540265.35,125400,665665.35
292390,202010,462,188,274,196460,286330,482790
292400,202010,3606,2236,1370,2340803.11,1437921,3778724.11
292405,202010,267,175,92,182875,96140,279015
292410,202010,135,83,52,86735,54340,141075
292420,202010,295,256,39,267520,40755,308275
292430,202010,540,406,134,424270,141075,565345
292440,202010,599,511,88,535040.16,91960,627000.16
292450,202010,244,192,52,200640,55385,256025
292460,202010,550,411,139,429495.95,145255,574750.95
292465,202010,210,176,34,183920,35530,219450
292467,202010,134,81,53,84645,55385,140030
292470,202010,293,199,94,207955,99275,307230
292480,202010,364,250,114,261250,120175.5,381425.5
292490,202010,237,167,70,174515,74195,248710
292500,202010,867,381,486,398145.15,508915,907060.15
292510,202010,3448,1594,1854,1667820.6,1939520,3607340.6
292520,202010,1092,513,579,536085,605055,1141140
292525,202010,396,284,112,296780,117040,413820
292530,202010,4423,1777,2646,1858010.96,2769251,4627261.96
292540,202010,480,269,211,281105,220495,501600
292550,202010,1105,584,521,611325,544445,1155770
292560,202010,332,310,22,323950,22990,346940
292570,202010,306,239,67,249755,70015,319770
292575,202010,490,327,163,341715,170335,512050
292580,202010,993,654,339,683430,354255.5,1037685.5
292590,202010,562,489,73,512050,76285,588335
292593,202010,140,111,29,115995,30305,146300
292595,202010,203,156,47,163020,49115,212135
292600,202010,1251,908,343,949905.29,358435,1308340.29
292610,202010,133,101,32,105545,33440,138985
292620,202010,524,442,82,461890,85690,547580
292630,202010,1441,806,635,842270.98,664620,1506890.98
292640,202010,837,578,259,605055,271700,876755
292650,202010,191,159,32,166155.5,33440,199595.5
292660,202010,2030,1453,577,1520475,602965.42,2123440.42
292665,202010,147,104,43,108680,44935,153615
292670,202010,391,314,77,329175,80465,409640
292680,202010,261,194,67,202730,70015.5,272745.5
292690,202010,194,143,51,149435,53295,202730
292700,202010,975,647,328,678205.55,346940,1025145.55
292710,202010,116,101,15,105545,15675,121220
292720,202010,925,525,400,548625,419045,967670
292730,202010,198,92,106,96140,110770,206910
292740,202010,68806,33505,35301,35063947.36,36966886.33,72030833.69
292750,202010,388,275,113,287375.95,119130,406505.95
292760,202010,345,287,58,299916.45,60610,360526.45
292770,202010,832,353,479,368885,503690,872575
292780,202010,418,163,255,170335,266475,436810
292790,202010,781,397,384,414865,401280,816145
292800,202010,1266,755,511,788975,533995,1322970
292805,202010,397,123,274,128535,287375,415910
292810,202010,1490,846,644,884071.5,676115,1560186.5
292820,202010,713,596,117,624911.25,123310,748221.25
292830,202010,108,88,20,91960,20900,112860
292840,202010,690,562,128,587290,133760,721050
292850,202010,143,95,48,99275,50160,149435
292860,202010,2163,1262,901,1321925.5,942590,2264515.5
292870,202010,3498,2332,1166,2439030.95,1219515,3658545.95
292880,202010,1491,980,511,1025145.05,536085,1561230.05
292890,202010,519,441,78,460845,81510,542355
292895,202010,139,94,45,98230,47025,145255
292900,202010,381,273,108,285285.4,112860,398145.4
292905,202010,479,239,240,250800,250800,501600
292910,202010,464,348,116,363660.75,122265,485925.75
292920,202010,523,228,295,238260,308275,546535
292925,202010,497,457,40,477565,41800,519365
292930,202010,627,379,248,396055,259160,655215
292935,202010,283,121,162,126445,169290,295735
292937,202010,229,157,72,164065,75240,239305
292940,202010,193,149,44,155705,45980,201685
292950,202010,1175,587,588,614460.75,616550.6,1231011.35
292960,202010,580,409,171,427405,178695,606100
292970,202010,245,172,73,179740.62,76285,256025.62
292975,202010,111,64,47,66880,49115,115995
292980,202010,287,195,92,203775.52,96140,299915.52
292990,202010,1327,986,341,1034551.05,358435,1392986.05
293000,202010,114,79,35,82555,36575,119130
293010,202010,2803,1667,1136,1744106.25,1190255.72,2934361.97
293015,202010,638,519,119,542355,124355,666710
293020,202010,330,269,61,281105,63745,344850
293030,202010,603,524,79,547580,82555,630135
293040,202010,357,282,75,294690,78375,373065
293050,202010,2879,1703,1176,1780680.5,1228920.5,3009601.0
293060,202010,260,208,52,217360.6,54340,271700.6
293070,202010,3497,1758,1739,1840247.72,1818301.75,3658549.47
293075,202010,92,61,31,63745,32395,96140
293076,202010,73,53,20,55385,20900,76285
293077,202010,516,296,220,309320.5,229900,539220.5
293080,202010,438,393,45,413820.85,47025,460845.85
293090,202010,130,117,13,122265,13585,135850
293100,202010,526,367,159,383515,166155,549670
293105,202010,342,250,92,261250,96140,357390
293110,202010,165,116,49,121220,51205,172425
293120,202010,306,208,98,218405,102410,320815
293130,202010,246,170,76,177650,79420,257070
293135,202010,8058,3156,4902,3303246.75,5133043.5,8436290.25
293140,202010,212,132,80,137940,83600,221540
293150,202010,327,283,44,296780,47025,343805
293160,202010,423,253,170,264385,177650,442035
293170,202010,178,120,58,125400,60610,186010
293180,202010,529,373,156,390830.5,164065,554895.5
293190,202010,1341,932,409,977076.11,428450,1405526.11
293200,202010,549,483,66,504735,68970,573705
293210,202010,395,298,97,311410,101365,412775
293220,202010,2480,1045,1435,1093070,1500620,2593690
293230,202010,1744,644,1100,672980.94,1150545,1823525.94
293240,202010,234,215,19,224675,19855,244530
293245,202010,126,107,19,111815,19855,131670
293250,202010,728,259,469,270655.9,490105,760760.9
293260,202010,306,254,52,265430,55385,320815
293270,202010,1165,538,627,563255.25,657305,1220560.25
293280,202010,276,153,123,159885,128535,288420
293290,202010,3052,1984,1068,2074325,1119195,3193520
293300,202010,738,526,212,549670.75,221540,771210.75
293305,202010,195,153,42,160930,43890,204820
293310,202010,152,115,37,120175,38665,158840
293315,202010,165,129,36,134805,37620,172425
293317,202010,91,65,26,67925,27170,95095
293320,202010,1053,576,477,602965.92,498465,1101430.92
293325,202010,181,66,115,68970,120175,189145
293330,202010,13745,6385,7360,6681732.91,7703743.75,14385476.66
293340,202010,275,196,79,204820,82555,287375
293345,202010,248,202,46,211090,48070,259160
293350,202010,611,352,259,367840,271700,639540
293360,202010,1527,1094,433,1144275,453530,1597805
310010,202010,138,75,63,78375,65835.5,144210.5
310020,202010,1035,567,468,595650,491150,1086800
310030,202010,328,262,66,273790,68970,342760
310040,202010,43,29,14,30305,14630,44935
310050,202010,176,109,67,114950,70015,184965
310060,202010,253,173,80,180785.5,83600,264385.5
310070,202010,15,10,5,10450,5225,15675
310080,202010,40,25,15,26125,15675,41800
310090,202010,1024,533,491,556987,513096,1070083
310100,202010,305,223,82,233035,85690,318725
310110,202010,708,388,320,405460,335445,740905
310120,202010,379,217,162,227810,169290,397100
310130,202010,33,19,14,19855,14630,34485
310140,202010,26,13,13,13585,13585,27170
310150,202010,1196,813,383,849585.75,400236,1249821.75
310160,202010,2056,1005,1051,1053362.15,1103520.5,2156882.65
310163,202010,86,48,38,50160,39710,89870
310170,202010,2548,1120,1428,1171445.85,1492262,2663707.85
310180,202010,151,55,96,57475,100320,157795
310190,202010,482,328,154,343805,161975,505780
310200,202010,485,310,175,323950,183920,507870
310205,202010,58,39,19,40755,19855,60610
310210,202010,283,227,56,237215,58520,295735
310220,202010,59,32,27,33440,28215,61655
310230,202010,279,192,87,200640,90915,291555
310240,202010,106,93,13,97185,13585,110770
310250,202010,96,79,17,83600,17765,101365
310260,202010,764,401,363,419046.17,379335,798381.17
310270,202010,270,173,97,182875.6,101365,284240.6
310280,202010,377,275,102,287375,106590,393965
310285,202010,206,150,56,156750,58520,215270
310290,202010,241,130,111,135850,115995,251845
310300,202010,156,127,29,133760,30305,164065
310310,202010,9,7,2,8360,2090,10450
310320,202010,28,10,18,10450,18810,29260
310330,202010,41,27,14,28215,14630,42845
310340,202010,1732,1141,591,1193392,619685.5,1813077.5
310350,202010,2780,1476,1304,1543465,1368950,2912415
310360,202010,41,34,7,35530,7315,42845
310370,202010,116,96,20,100320,20900,121220
310375,202010,103,38,65,39710,67925,107635
310380,202010,48,28,20,29260,20900,50160
310390,202010,96,63,33,65835,34485,100320
310400,202010,2341,1501,840,1572725.5,879890,2452615.5
310410,202010,126,69,57,72105,59565,131670
310420,202010,661,346,315,361570,329175,690745
310430,202010,303,188,115,196460,120175,316635
310440,202010,74,42,32,43890,33440,77330
310445,202010,80,65,15,67925,15675,83600
310450,202010,623,385,238,402325,249755,652080
310460,202010,258,180,78,188100,81510,269610
310470,202010,508,322,186,336490,195415,531905
310480,202010,81,52,29,54340,30305,84645
310490,202010,535,247,288,258115,302005,560120
310500,202010,135,53,82,55385,85690,141075
310510,202010,601,418,183,436810,192280,629090
310520,202010,136,94,42,98230,43890,142120
310530,202010,109,46,63,48070,65835,113905
310540,202010,475,273,202,286330,211090,497420
310550,202010,74,48,26,50160,27170,77330
310560,202010,2968,2036,932,2129711,974985,3104696
310570,202010,89,58,31,60610,32395,93005
310590,202010,369,235,134,245575.25,142120,387695.25
310600,202010,148,81,67,84645.5,70015,154660.5
310610,202010,57,22,35,22990,36575,59565
310620,202010,46965,22304,24661,23349418.08,25834496.4,49183914.48
310630,202010,651,401,250,419045,262295.5,681340.5
310640,202010,126,99,27,103455,28215,131670
310650,202010,162,144,18,150480,18810,169290
310660,202010,97,65,32,67925,33440,101365
310665,202010,61,46,15,48070,15675,63745
310670,202010,6703,2854,3849,2992882.5,4029520.9,7022403.4
310680,202010,56,34,22,35530,22990,58520
310690,202010,613,425,188,444125.25,197505,641630.25
310700,202010,60,39,21,40755,21945,62700
310710,202010,1328,903,425,946770.5,446215.5,1392986.0
310720,202010,134,35,99,36575,105545,142120
310730,202010,1463,1002,461,1047091.25,485925,1533016.25
310740,202010,966,536,430,560121,450395.25,1010516.25
310750,202010,242,146,96,153615.65,100320,253935.65
310760,202010,63,47,16,49115,17765.5,66880.5
310770,202010,86,43,43,44935,44935,89870
310780,202010,360,291,69,304095,72105,376200
310790,202010,103,83,20,86735,20900,107635
310800,202010,445,208,237,217360.25,247665,465025.25
310810,202010,171,121,50,126445.72,52250,178695.72
310820,202010,340,268,72,280060,75240,355300
310825,202010,193,164,29,171380,30305,201685
310830,202010,472,224,248,234080.5,260205,494285.5
310840,202010,365,213,152,223630,158840,382470
310850,202010,81,66,15,68970,15675,84645
310855,202010,393,312,81,328130,84645,412775
310860,202010,1578,1160,418,1215337.5,436811.25,1652148.75
310870,202010,54,44,10,45980,10450,56430
310880,202010,83,64,19,66880,19855,86735
310890,202010,308,175,133,182875,140030,322905
310900,202010,655,298,357,313509.86,375167.96,688677.82
310910,202010,238,161,77,169290.5,81510,250800.5
310920,202010,452,266,186,277971.45,194370.5,472341.95
310925,202010,32,26,6,27170,6270,33440
310930,202010,1293,820,473,856900,496375,1353275
310940,202010,696,345,351,360525,367840,728365
310945,202010,117,74,43,77330,47025,124355
310950,202010,228,183,45,191235,48070,239305
310960,202010,76,24,52,25080,55385,80465
310970,202010,166,102,64,106590,66880.5,173470.5
310980,202010,48,30,18,31350,18810,50160
310990,202010,162,82,80,85690,85690,171380
311000,202010,814,398,416,415911.49,436810.5,852721.99
311010,202010,47,41,6,43890,6270,50160
311020,202010,47,28,19,29260,19855,49115
311030,202010,387,224,163,235125.5,170335,405460.5
311040,202010,42,32,10,33440,10450,43890
311050,202010,478,186,292,194370,305140,499510
311060,202010,781,431,350,450395,365750.5,816145.5
311070,202010,337,147,190,155705,198550,354255
311080,202010,109,58,51,60610,53295,113905
311090,202010,339,157,182,164065,191235,355300
311100,202010,579,349,230,364705,241395,606100
311110,202010,688,479,209,502645,218405,721050
311115,202010,72,50,22,52250,22990,75240
311120,202010,1061,565,496,591470.5,519365,1110835.5
311130,202010,336,201,135,211090,141075,352165
311140,202010,169,90,79,94050,82555,176605
311150,202010,343,221,122,230945,128535,359480
311160,202010,713,508,205,530860.5,214225,745085.5
311170,202010,86,68,18,71060,18810,89870
311180,202010,329,218,111,228855,117040.5,345895.5
311190,202010,42,21,21,21945,21945,43890
311200,202010,326,229,97,239305,102410,341715
311205,202010,34,24,10,25080,10450,35530
311210,202010,43,38,5,39710.5,5225,44935.5
311220,202010,29,24,5,25080,5225,30305
311230,202010,1640,1077,563,1125465.5,589380,1714845.5
311240,202010,188,120,68,125400,71060,196460
311250,202010,55,21,34,21945,35530,57475
311260,202010,553,347,206,362615,215270,577885
311265,202010,121,82,39,85690,40755,126445
311270,202010,290,195,95,203775,99275,303050
311280,202010,209,96,113,100320,119130,219450
311290,202010,103,84,19,87780,19855,107635
311300,202010,579,362,217,379335,227810,607145
311310,202010,21,16,5,16720,5225,21945
311320,202010,654,485,169,506825,176605,683430
311330,202010,1075,788,287,826595,300960.5,1127555.5
311340,202010,2630,1862,768,1947881.4,805695,2753576.4
311350,202010,275,213,62,222585,64790,287375
311360,202010,176,105,71,109725,74195,183920
311370,202010,1224,496,728,518320.25,760760,1279080.25
311380,202010,8,7,1,7315,1045,8360
311390,202010,251,136,115,142120,120175,262295
311400,202010,137,85,52,88825,54340,143165
311410,202010,116,61,55,63745,57475,121220
311420,202010,300,163,137,171380,143165,314545
311430,202010,843,556,287,582065,299915.5,881980.5
311440,202010,458,323,135,337535,142120,479655
311450,202010,309,187,122,195415,128535,323950
311455,202010,280,192,88,200640,91960,292600
311460,202010,139,61,78,63745,81510,145255
311470,202010,25,13,12,13585,12540,26125
311480,202010,49,23,26,24035,27170,51205
311490,202010,13,9,4,9405,4180,13585
311500,202010,24,11,13,11495,13585,25080
311510,202010,633,435,198,455620,210045,665665
311520,202010,39,31,8,32395,8360,40755
311530,202010,1805,1317,488,1377312.45,509960,1887272.45
311535,202010,65,44,21,45980,21945,67925
311540,202010,34,30,4,31350,4180,35530
311545,202010,167,123,44,128535,45980,174515
311547,202010,36,30,6,31350,6270,37620
311550,202010,698,318,380,333355,398145,731500
311560,202010,42,28,14,29260,14630,43890
311570,202010,284,189,95,197505,99275,296780
311580,202010,338,197,141,205865,147345,353210
311590,202010,32,29,3,30305,3135,33440
311600,202010,105,83,22,86735,24035,110770
311610,202010,255,217,38,226765.25,39710,266475.25
311615,202010,88,69,19,72105,19855,91960
311620,202010,25,14,11,14630,11495,26125
311630,202010,88,74,14,77330,14630,91960
311640,202010,132,63,69,65835,72105,137940
311650,202010,116,77,39,81510,41800,123310
311660,202010,408,197,211,205865,220495,426360
311670,202010,152,101,51,105545,53295,158840
311680,202010,207,153,54,159885,56430,216315
311690,202010,16,12,4,12540,4180,16720
311700,202010,194,136,58,142120,60610,202730
311710,202010,195,131,64,137940,66880,204820
311720,202010,43,31,12,32395.5,12540,44935.5
311730,202010,566,384,182,401280,190190,591470
311740,202010,30,21,9,21945,9405,31350
311750,202010,723,483,240,505780.76,250800,756580.76
311760,202010,67,30,37,31350,38665,70015
311770,202010,390,196,194,205865.5,202730,408595.5
311780,202010,178,89,89,94050.5,93005,187055.5
311783,202010,86,77,9,80465,9405,89870
311787,202010,35,12,23,12540,24035,36575
311790,202010,258,113,145,118085,151525,269610
311800,202010,682,447,235,468160.42,246620,714780.42
311810,202010,49,39,10,40755,10450,51205
311820,202010,117,96,21,100320,21945,122265
311830,202010,1886,1158,728,1213246,763895,1977141
311840,202010,1006,557,449,583111,469205.25,1052316.25
311850,202010,12,8,4,8360,4180,12540
311860,202010,9557,4133,5424,4331527.75,5683755.5,10015283.25
311870,202010,121,64,57,67925,59565,127490
311880,202010,925,671,254,702240,265430,967670
311890,202010,200,97,103,102324,107635,209959
311900,202010,74,30,44,31350,45980,77330
311910,202010,1399,876,523,917510.75,546535.5,1464046.25
311920,202010,231,150,81,157795,85690,243485
311930,202010,898,510,388,535040.5,406505,941545.5
311940,202010,2481,1292,1189,1354320,1248775.15,2603095.15
311950,202010,54,39,15,40755,15675,56430
311960,202010,60,44,16,45980,16720,62700
311970,202010,24,15,9,15675,9405,25080
311980,202010,43,34,9,35530,9405,44935
311990,202010,38,29,9,30305,9405,39710
311995,202010,58,37,21,38665,21945,60610
312000,202010,31,21,10,21945,10450,32395
312010,202010,76,60,16,63745,16720,80465
312015,202010,76,57,19,59565,19855,79420
312020,202010,128,86,42,90915,43890,134805
312030,202010,60,45,15,47025,15675,62700
312040,202010,84,51,33,53295.5,34485,87780.5
312050,202010,202,112,90,117040,94050,211090
312060,202010,22,12,10,12540,10450,22990
312070,202010,75,48,27,50160,28215,78375
312080,202010,531,241,290,251845,303050,554895
312083,202010,56,37,19,38665,20900,59565
312087,202010,102,79,23,82555,24035,106590
312090,202010,3178,1881,1297,1967737,1356410.5,3324147.5
312100,202010,149,105,44,109484.65,45980,155464.65
312110,202010,118,67,51,70015,53295,123310
312120,202010,135,100,35,104500.29,37620,142120.29
312125,202010,90,50,40,52250,41800,94050
312130,202010,125,81,44,85690,45980,131670
312140,202010,135,104,31,110770.5,32395,143165.5
312150,202010,41,32,9,33440,10450,43890
312160,202010,1555,1022,533,1068086,556985.5,1625071.5
312170,202010,10,8,2,8360,2090,10450
312180,202010,113,70,43,73150,44935,118085
312190,202010,34,30,4,31350,4180,35530
312200,202010,751,640,111,668800.5,117040,785840.5
312210,202010,111,59,52,61655,54340,115995
312220,202010,131,101,30,106590.25,31350,137940.25
312230,202010,3646,1675,1971,1753510.4,2063876,3817386.4
312235,202010,156,105,51,109725,53295,163020
312240,202010,93,67,26,70015,28215,98230
312245,202010,188,128,60,134805,62700,197505
312247,202010,73,50,23,52250,24035,76285
312250,202010,176,83,93,86735,97185,183920
312260,202010,108,71,37,74195,38665,112860
312270,202010,132,77,55,80465,57475,137940
312280,202010,27,14,13,14630,13585,28215
312290,202010,146,104,42,108680,43890,152570
312300,202010,209,136,73,142120,76285,218405
312310,202010,62,55,7,58520,7315,65835
312320,202010,423,267,156,279015,164065.75,443080.75
312330,202010,89,78,11,81510,11495,93005
312340,202010,36,17,19,17765,19855,37620
312350,202010,16,9,7,9405,8360,17765
312352,202010,90,68,22,71060,22990,94050
312360,202010,579,243,336,254980,352165,607145
312370,202010,317,175,142,182875,148390,331265
312380,202010,137,91,46,95095,48070,143165
312385,202010,162,130,32,135850,33440,169290
312390,202010,297,186,111,195415,115995.5,311410.5
312400,202010,379,283,96,295735,100321,396056
312410,202010,1001,315,686,329175,717915.5,1047090.5
312420,202010,624,475,149,496375.5,155705,652080.5
312430,202010,862,629,233,658351.11,243485,901836.11
312440,202010,40,30,10,31350,10450,41800
312450,202010,208,131,77,136895,81510,218405
312460,202010,31,16,15,16720,15675,32395
312470,202010,45,31,14,32395,14630,47025
312480,202010,190,117,73,122265,77330,199595
312490,202010,268,186,82,195415,85690,281105
312500,202010,35,20,15,20900,15675,36575
312510,202010,516,201,315,211090,330220,541310
312520,202010,31,9,22,9405,22990,32395
312530,202010,45,31,14,32395,14630,47025
312540,202010,93,82,11,85690,11495,97185
312550,202010,36,29,7,30305,7315,37620
312560,202010,210,157,53,164065.5,55385,219450.5
312570,202010,428,251,177,262295,184965,447260
312580,202010,89,47,42,49115,43890,93005
312590,202010,244,195,49,203775,52250,256025
312595,202010,134,119,15,124355,15675,140030
312600,202010,66,36,30,37620.25,31350,68970.25
312610,202010,1592,808,784,846452,821370.5,1667822.5
312620,202010,213,153,60,159885,62700,222585
312630,202010,68,57,11,59565,11495,71060
312640,202010,40,11,29,11495,30305,41800
312650,202010,147,121,26,126445.5,27170,153615.5
312660,202010,91,64,27,66880.76,28215,95095.76
312670,202010,919,589,330,616550,344850,961400
312675,202010,29,24,5,25080,5225,30305
312680,202010,74,44,30,45980,31350,77330
312690,202010,243,125,118,130625,123310,253935
312695,202010,28,24,4,25080,4180,29260
312700,202010,226,131,95,136895,99275,236170
312705,202010,81,65,16,67925,16720,84645
312707,202010,129,89,40,93005,41800,134805
312710,202010,1862,994,868,1039776.41,909150,1948926.41
312720,202010,58,30,28,31350,29260,60610
312730,202010,284,166,118,174515,125400,299915
312733,202010,47,38,9,39710,9405,49115
312735,202010,22,14,8,14630,8360,22990
312737,202010,63,35,28,36575,29260,65835
312738,202010,59,40,19,41800,19855,61655
312740,202010,83,54,29,56430,30305,86735
312750,202010,89,62,27,64790,28215,93005
312760,202010,289,208,81,217360,85690,303050
312770,202010,8092,3670,4422,3846650.25,4629350,8476000.25
312780,202010,443,339,104,355300,109725,465025
312790,202010,22,16,6,16720,6270,22990
312800,202010,1583,1101,482,1151590.75,504735.65,1656326.40
312810,202010,367,235,132,245575,140030,385605
312820,202010,186,144,42,150480,43890,194370
312825,202010,25,16,9,16720,9405,26125
312830,202010,227,129,98,134805,102410,237215
312840,202010,158,106,52,110770,54340,165110
312850,202010,45,39,6,40755,6270,47025
312860,202010,155,97,58,101365,60610,161975
312870,202010,1063,550,513,576841.69,539220,1116061.69
312880,202010,124,87,37,90915,38665,129580
312890,202010,155,110,45,114950,47025,161975
312900,202010,191,144,47,150480,49115,199595
312910,202010,174,92,82,97185,86735,183920
312920,202010,151,84,67,87780,70015,157795
312930,202010,322,225,97,235125,102410,337535
312940,202010,122,84,38,87780,39710,127490
312950,202010,691,471,220,494285.5,231990,726275.5
312960,202010,161,120,41,125400.9,42845,168245.9
312965,202010,76,64,12,66880,12540,79420
312970,202010,273,225,48,235125.25,50160,285285.25
312980,202010,2456,1230,1226,1289531,1284305,2573836
312990,202010,45,24,21,25080,21945,47025
313000,202010,52,27,25,28215,26125,54340
313005,202010,171,133,38,138985,39710.5,178695.5
313010,202010,917,359,558,375155.5,585200,960355.5
313020,202010,197,102,95,106590,99275,205865
313030,202010,193,131,62,136895.35,64790,201685.35
313040,202010,76,24,52,25080,54340,79420
313050,202010,178,130,48,136895,50160,187055
313055,202010,39,29,10,30305,10450,40755
313060,202010,130,88,42,91960,43890,135850
313065,202010,63,44,19,45980,19855.5,65835.5
313070,202010,137,70,67,73150,70015,143165
313080,202010,38,17,21,17765,21945,39710
313090,202010,661,436,225,455620,235125,690745
313100,202010,187,63,124,65835,129580,195415
313110,202010,131,67,64,71060,67925,138985
313115,202010,209,114,95,120175,100320,220495
313120,202010,833,472,361,493240,377245.5,870485.5
313130,202010,5744,3106,2638,3258312.2,2767161.75,6025473.95
313140,202010,142,76,66,79420,68970,148390
313150,202010,307,240,67,253935,70015,323950
313160,202010,187,139,48,145255.5,50160,195415.5
313170,202010,1400,940,460,984391,480700,1465091
313180,202010,301,177,124,186010.5,129580,315590.5
313190,202010,742,442,300,461890.5,315590,777480.5
313200,202010,26,21,5,21945,5225,27170
313210,202010,1002,844,158,884072.55,165110.5,1049183.05
313220,202010,286,176,110,183920,114950.5,298870.5
313230,202010,259,197,62,206910.87,64790,271700.87
313240,202010,2144,1092,1052,1142188,1099340,2241528
313250,202010,1260,957,303,1001110.5,316635.8,1317746.3
313260,202010,93,49,44,51205,45980,97185
313270,202010,985,570,415,596695.75,433676.5,1030372.25
313280,202010,51,43,8,44935,8360,53295
313290,202010,211,169,42,176605,43890,220495
313300,202010,348,182,166,190190,173470,363660
313310,202010,263,123,140,128535,146300,274835
313320,202010,381,282,99,294690,103455,398145
313330,202010,1400,854,546,893475.5,571615.5,1465091.0
313340,202010,324,232,92,242440,96140,338580
313350,202010,495,328,167,344850,175560,520410
313360,202010,139,70,69,73150,72105,145255
313370,202010,221,69,152,72105,159885,231990
313375,202010,286,169,117,179740,122265,302005
313380,202010,1347,702,645,733590.5,674025,1407615.5
313390,202010,52,47,5,49115,5225,54340
313400,202010,397,270,127,282150,132716,414866
313410,202010,23,14,9,14630,9405,24035
313420,202010,4560,2425,2135,2537261.4,2241526,4778787.4
313430,202010,143,68,75,72105,78375,150480
313440,202010,1406,960,446,1005291.81,467117,1472408.81
313450,202010,69,28,41,29260,42845,72105
313460,202010,385,170,215,178695.5,225720,404415.5
313470,202010,528,245,283,256025,295735.5,551760.5
313480,202010,146,107,39,111815.5,40755,152570.5
313490,202010,517,235,282,246620.5,294690.25,541310.75
313500,202010,26,14,12,14630,12540,27170
313505,202010,1020,800,220,838090,230945,1069035
313507,202010,102,60,42,62700,43890,106590
313510,202010,2823,1772,1051,1854968.54,1103520,2958488.54
313520,202010,3446,2679,767,2804783.16,801515,3606298.16
313530,202010,33,21,12,21945,12540,34485
313535,202010,61,47,14,49115,14630,63745
313540,202010,70,52,18,54340,18810,73150
313545,202010,112,94,18,98230,18810,117040
313550,202010,228,193,35,201685,37620.5,239305.5
313560,202010,340,164,176,173470,183920,357390
313570,202010,63,24,39,25080,40755,65835
313580,202010,1321,736,585,769120.5,612371.5,1381492.0
313590,202010,68,38,30,39710,31350,71060
313600,202010,671,405,266,424270,280060.5,704330.5
313610,202010,60,46,14,48070,14630,62700
313620,202010,1390,695,695,728366,729410,1457776
313630,202010,1612,1215,397,1269676,414865,1684541
313640,202010,120,73,47,76285,49115,125400
313650,202010,232,106,126,110770,131670,242440
313652,202010,17,17,0,17765,0,17765
313655,202010,69,46,23,48070,24035,72105
313657,202010,48,44,4,45980,4180,50160
313660,202010,132,89,43,95095,44953.81,140048.81
313665,202010,640,292,348,305140.75,364705,669845.75
313670,202010,10288,6991,3297,7321272.8,3452681.25,10773954.05
313680,202010,38,30,8,31350,8360,39710
313690,202010,142,108,34,112860,36575,149435
313695,202010,64,47,17,49115,17765,66880
313700,202010,311,252,59,263340.5,61655,324995.5
313710,202010,142,100,42,104500,43890,148390
313720,202010,1110,514,596,537130.5,625956.5,1163087.0
313730,202010,75,44,31,45980,32395,78375
313740,202010,149,120,29,125400,30305,155705
313750,202010,427,308,119,322905,125400,448305
313753,202010,231,172,59,179740,62700,242440
313760,202010,1318,483,835,504735.5,874666.5,1379402.0
313770,202010,378,272,106,284240.25,111815,396055.25
313780,202010,775,403,372,421135,388740,809875
313790,202010,28,27,1,28215,1045,29260
313800,202010,137,83,54,86735,56430,143165
313810,202010,76,43,33,44935,34485,79420
313820,202010,1310,615,695,642676,727320.5,1369996.5
313830,202010,57,41,16,42845,16720,59565
313835,202010,61,50,11,52250,11495,63745
313840,202010,1648,982,666,1027236.5,697016,1724252.5
313850,202010,205,75,130,78375,135850,214225
313860,202010,469,355,114,370975.5,120175,491150.5
313862,202010,161,107,54,112860,56430,169290
313865,202010,119,89,30,93005,31350,124355
313867,202010,51,40,11,41800,11495,53295
313868,202010,33,19,14,19855,14630,34485
313870,202010,115,61,54,63745,56430,120175
313880,202010,379,232,147,242440,154660,397100
313890,202010,330,170,160,179740,167200,346940
313900,202010,874,476,398,497420.91,418000.25,915421.16
313910,202010,147,104,43,108680,44935,153615
313920,202010,636,444,192,468160,200640.44,668800.44
313925,202010,31,28,3,29260,3135,32395
313930,202010,852,661,191,691790,200640,892430
313940,202010,1871,1153,718,1205930,751355,1957285
313950,202010,867,544,323,568480,337535,906015
313960,202010,1410,805,605,842270.9,632227,1474497.9
313970,202010,170,108,62,112860,64790,177650
313980,202010,206,132,74,137940.25,77330,215270.25
313990,202010,238,157,81,164065,84645,248710
314000,202010,892,591,301,619685.85,316635,936320.85
314010,202010,83,49,34,52250,35530,87780
314015,202010,62,15,47,15675,49115,64790
314020,202010,53,33,20,34485,20900,55385
314030,202010,76,35,41,36575,42845,79420
314040,202010,45,26,19,27170,19855,47025
314050,202010,286,168,118,176605,123310,299915
314053,202010,98,63,35,65835,36575,102410
314055,202010,301,187,114,195415,119130,314545
314060,202010,132,114,18,119130.04,18810,137940.04
314070,202010,1044,539,505,563255,531905,1095160
314080,202010,208,132,76,137940.25,79420.4,217360.65
314085,202010,144,98,46,102410,48070,150480
314090,202010,377,269,108,281105.25,114950,396055.25
314100,202010,507,408,99,427405.75,104500,531905.75
314110,202010,795,393,402,410685.5,420090,830775.5
314120,202010,72,44,28,45980,29260,75240
314130,202010,19,10,9,10450,9405,19855
314140,202010,1113,684,429,714780,451440,1166220
314150,202010,184,118,66,124355,68970,193325
314160,202010,333,252,81,263340,84645,347985
314170,202010,81,62,19,64790,19855,84645
314180,202010,731,645,86,674025.5,89870.25,763895.75
314190,202010,100,59,41,61655,42845,104500
314200,202010,495,337,158,352165,167200.5,519365.5
314210,202010,248,190,58,198550,60610.5,259160.5
314220,202010,305,225,80,235125.5,84645,319770.5
314225,202010,59,42,17,43890,17765,61655
314230,202010,118,52,66,54340,68970,123310
314240,202010,148,108,40,112860,41800,154660
314250,202010,52,29,23,30305,24035,54340
314260,202010,212,105,107,109725,111815,221540
314270,202010,369,285,84,297825,87780,385605
314280,202010,701,379,322,398145,337535,735680
314290,202010,539,431,108,450395,112860,563255
314300,202010,356,259,97,270655.25,102410.25,373065.50
314310,202010,1361,926,435,974203.32,460845,1435048.32
314315,202010,33,26,7,27170,7315,34485
314320,202010,591,392,199,411730.5,209000,620730.5
314330,202010,11074,5373,5701,5626283.48,5976356.78,11602640.26
314340,202010,603,271,332,283195,347986,631181
314345,202010,48,33,15,34485,15675,50160
314350,202010,183,115,68,120175,71060,191235
314360,202010,58,35,23,36575,24035,60610
314370,202010,65,43,22,44935,22990,67925
314380,202010,95,60,35,62700,36575,99275
314390,202010,3329,2118,1211,2217491.85,1268630,3486121.85
314400,202010,693,487,206,509961.3,216315,726276.3
314410,202010,482,313,169,329175,176605,505780
314420,202010,15,8,7,8360,7315,15675
314430,202010,2417,882,1535,922735.36,1606165.5,2528900.86
314435,202010,181,106,75,112860,78375,191235
314437,202010,27,21,6,21945,6270,28215
314440,202010,96,68,28,71060,29260,100320
314450,202010,157,109,48,113905,50160,164065
314460,202010,642,304,338,317680,353210.5,670890.5
314465,202010,96,60,36,62700,37620,100320
314467,202010,68,56,12,58520,12540,71060
314470,202010,416,207,209,216316.45,218405,434721.45
314480,202010,1049,492,557,518320,584155,1102475
314490,202010,45,30,15,31350,15675,47025
314500,202010,278,194,84,203775.5,89870,293645.5
314505,202010,111,70,41,73150,42845,115995
314510,202010,241,197,44,205865,45980,251845
314520,202010,1294,685,609,716875.51,640586.5,1357462.01
314530,202010,738,592,146,619686.01,154660,774346.01
314535,202010,167,99,68,103455,71060,174515
314537,202010,62,37,25,38665,26125,64790
314540,202010,16,10,6,10450,6270,16720
314545,202010,50,32,18,33440,18810,52250
314550,202010,80,41,39,42845,40755,83600
314560,202010,854,461,393,481745.5,412775,894520.5
314570,202010,21,16,5,16720,5225,21945
314580,202010,15,5,10,5225,10450,15675
314585,202010,26,17,9,17765,9405,27170
314587,202010,83,70,13,73150,13585,86735
314590,202010,553,392,161,409640.25,168245,577885.25
314600,202010,938,600,338,629091,354255.29,983346.29
314610,202010,948,491,457,513095.5,479655,992750.5
314620,202010,134,99,35,103455,36575,140030
314625,202010,97,70,27,73150,28215,101365
314630,202010,1174,623,551,651035.25,575795,1226830.25
314640,202010,81,52,29,54340,31350.5,85690.5
314650,202010,180,102,78,106590,81510,188100
314655,202010,61,46,15,48070,15675,63745
314660,202010,16,13,3,13585,3135,16720
314670,202010,199,152,47,158840.5,49115,207955.5
314675,202010,209,122,87,127490,90915,218405
314690,202010,593,312,281,326040,293645,619685
314700,202010,2263,1216,1047,1272812,1100385,2373197
314710,202010,1694,962,732,1009471.75,765985.5,1775457.25
314720,202010,389,231,158,241395,167200,408595
314730,202010,514,267,247,279015.79,258115,537130.79
314740,202010,724,343,381,359480,398145,757625
314750,202010,17,14,3,14630,3135,17765
314760,202010,344,154,190,160930,198550,359480
314770,202010,107,73,34,76285,35530,111815
314780,202010,20,8,12,8360,12540,20900
314790,202010,2389,1499,890,1573771,932140,2505911
314795,202010,46,36,10,38665,10450,49115
314800,202010,2920,1701,1219,1783817.22,1279080,3062897.22
314810,202010,1509,853,656,892430,687610,1580040
314820,202010,105,57,48,59565,50160,109725
314830,202010,212,170,42,177650,43890,221540
314840,202010,87,54,33,56430,34485,90915
314850,202010,397,195,202,204820.5,211090,415910.5
314860,202010,665,508,157,530860,165110,695970
314870,202010,1527,795,732,831820.5,765985,1597805.5
314875,202010,54,48,6,50160,6270,56430
314880,202010,44,30,14,31350,14630,45980
314890,202010,53,31,22,33440,22990,56430
314900,202010,30,23,7,24035,7315,31350
314910,202010,243,159,84,166155,88825,254980
314915,202010,136,121,15,127490,15675,143165
314920,202010,104,65,39,67925,40755,108680
314930,202010,1054,510,544,532950.5,572660.5,1105611.0
314940,202010,48,38,10,39710,10450,50160
314950,202010,30,21,9,21945,9405,31350
314960,202010,31,23,8,24035,8360,32395
314970,202010,148,72,76,75240,79420,154660
314980,202010,309,195,114,203775,119130,322905
314990,202010,438,234,204,246620,216315,462935
314995,202010,161,65,96,67925,100320,168245
315000,202010,81,61,20,63745,20900,84645
315010,202010,43,28,15,29260,15675,44935
315015,202010,165,131,34,136895,35530,172425
315020,202010,68,56,12,58520,12540,71060
315030,202010,106,81,25,84645.5,26125,110770.5
315040,202010,71,48,23,50160,24035,74195
315050,202010,185,107,78,112860,81510,194370
315053,202010,45,34,11,35530,11495,47025
315057,202010,104,80,24,83600,25080,108680
315060,202010,75,63,12,65835.8,12540,78375.8
315070,202010,105,59,46,61655,48070,109725
315080,202010,378,301,77,314545,80465,395010
315090,202010,93,55,38,57475,39710,97185
315100,202010,79,39,40,40755,41800,82555
315110,202010,272,145,127,151525,133760,285285
315120,202010,1728,835,893,875710,936320.2,1812030.2
315130,202010,343,248,95,259160,99275,358435
315140,202010,528,296,232,310365,242441,552806
315150,202010,973,461,512,482790,536085,1018875
315160,202010,213,105,108,109725,112860,222585
315170,202010,316,209,107,219450.5,111815,331265.5
315180,202010,3247,1346,1901,1409706.5,1992816.25,3402522.75
315190,202010,312,188,124,196460,129580,326040
315200,202010,1221,719,502,752400,526680,1279080
315210,202010,1657,944,713,988570.25,747175,1735745.25
315213,202010,31,19,12,19855,12540,32395
315217,202010,199,155,44,161975,45980,207955
315220,202010,1580,1182,398,1236235.95,418000,1654235.95
315230,202010,171,123,48,128535.5,50160,178695.5
315240,202010,424,271,153,283195,159886,443081
315250,202010,2581,1252,1329,1309385,1389850.5,2699235.5
315260,202010,145,82,63,85690,66880,152570
315270,202010,130,91,39,95095,40755,135850
315280,202010,643,413,230,432630,240350,672980
315290,202010,188,119,69,124355,73150,197505
315300,202010,80,58,22,60610,22990,83600
315310,202010,74,66,8,68970,8360,77330
315320,202010,160,95,65,99275,67925,167200
315330,202010,55,45,10,47025,10450,57475
315340,202010,389,281,108,295735,112860,408595
315350,202010,153,92,61,96140,63745,159885
315360,202010,88,40,48,42845,50160,93005
315370,202010,54,34,20,35530,20900,56430
315380,202010,8,8,0,8360,0,8360
315390,202010,64,18,46,18810,48070.5,66880.5
315400,202010,833,618,215,645811.25,225720,871531.25
315410,202010,330,194,136,202730.5,142121.5,344852.0
315415,202010,56,42,14,43890,14630,58520
315420,202010,196,142,54,148390.5,56430,204820.5
315430,202010,657,376,281,393965.5,295735,689700.5
315440,202010,94,64,30,66880,31350,98230
315445,202010,234,193,41,201685,42845,244530
315450,202010,181,136,45,142120,47025,189145
315460,202010,4050,1946,2104,2036705.5,2199725,4236430.5
315470,202010,40,16,24,16720,25080,41800
315480,202010,69,20,49,20900,51205,72105
315490,202010,679,410,269,428450,281105,709555
315500,202010,18,12,6,12540,6270,18810
315510,202010,148,100,48,104500,50160,154660
315520,202010,72,63,9,65835,9405,75240
315530,202010,47,24,23,25080,24035,49115
315540,202010,242,165,77,172425,80465,252890
315550,202010,184,147,37,153615,38665,192280
315560,202010,739,592,147,621775.5,153615,775390.5
315570,202010,312,155,157,161977.19,164065,326042.19
315580,202010,708,478,230,499510,241395.5,740905.5
315590,202010,199,102,97,106590,102410,209000
315600,202010,302,229,73,239305,77330,316635
315610,202010,101,52,49,54340,51205,105545
315620,202010,36,28,8,29260,8360,37620
315630,202010,129,85,44,88825,45980,134805
315640,202010,76,44,32,45980,33440,79420
315645,202010,46,31,15,32395,15675.5,48070.5
315650,202010,172,123,49,128535.5,51205,179740.5
315660,202010,457,200,257,209000.5,269610,478610.5
315670,202010,2386,1135,1251,1189212.24,1309385,2498597.24
315680,202010,831,588,243,615505,256025,871530
315690,202010,668,459,209,480701.97,219450,700151.97
315700,202010,1894,987,907,1032461.21,953040,1985501.21
315710,202010,350,102,248,106590,259160,365750
315720,202010,454,278,176,290510,184965,475475
315725,202010,185,148,37,154660.5,38665,193325.5
315727,202010,53,22,31,22990,32395,55385
315730,202010,43,40,3,41800,3135,44935
315733,202010,89,59,30,61655,31350,93005
315737,202010,50,37,13,38665,13585,52250
315740,202010,32,25,7,26125,7315,33440
315750,202010,159,118,41,123310,42845.05,166155.05
315760,202010,38,28,10,29260,10450,39710
315765,202010,119,69,50,72105,52250,124355
315770,202010,222,139,83,145255,86735,231990
315780,202010,3515,1745,1770,1829795.75,1852785,3682580.75
315790,202010,233,181,52,189145,54340,243485
315800,202010,300,207,93,216315,97185,313500
315810,202010,92,56,36,58520,37620,96140
315820,202010,751,542,209,566390.5,218405,784795.5
315830,202010,125,80,45,83600,48070,131670
315840,202010,86,56,30,58520,31350,89870
315850,202010,261,183,78,191235.6,81510,272745.6
315860,202010,15,6,9,6270,9405,15675
315870,202010,38,29,9,30305,9405,39710
315880,202010,105,67,38,70015,40755,110770
315890,202010,86,66,20,68970,20900,89870
315895,202010,420,274,146,286330.75,152571,438901.75
315900,202010,67,31,36,32395,37620,70015
315910,202010,41,24,17,25080,17765,42845
315920,202010,160,107,53,111815,55385.75,167200.75
315930,202010,53,19,34,19855,35530,55385
315935,202010,130,102,28,107635.5,30305,137940.5
315940,202010,101,74,27,77330,28215,105545
315950,202010,37,29,8,30305,8360,38665
315960,202010,535,255,280,266475,294690.5,561165.5
315970,202010,35,28,7,29260,7315,36575
315980,202010,672,335,337,351120,354255,705375
315990,202010,251,147,104,153615,108680.5,262295.5
316000,202010,47,30,17,31350,17765,49115
316010,202010,78,67,11,70015,11495,81510
316020,202010,116,99,17,103455,17765,121220
316030,202010,379,209,170,219450.5,177650.75,397101.25
316040,202010,524,216,308,225720.5,321860.5,547581.0
316045,202010,51,45,6,47025,6270,53295
316050,202010,17,13,4,13585,4180,17765
316060,202010,95,63,32,65835,34485,100320
316070,202010,1082,689,393,720005.75,411730,1131735.75
316080,202010,96,64,32,68016.96,33440,101456.96
316090,202010,42,21,21,21945,21945,43890
316095,202010,96,76,20,79420,20900,100320
316100,202010,309,177,132,184965.25,137940,322905.25
316105,202010,39,25,14,26125,14630,40755
316110,202010,1866,1476,390,1544510.62,412775,1957285.62
316120,202010,79,56,23,58520,24035,82555
316130,202010,123,91,32,95095.5,33440,128535.5
316140,202010,31,20,11,20900,11495,32395
316150,202010,206,144,62,150480,64790,215270
316160,202010,79,45,34,47025,36575,83600
316165,202010,64,46,18,48070,18810,66880
316170,202010,185,122,63,127490,65835,193325
316180,202010,201,85,116,88825,121220.5,210045.5
316190,202010,135,98,37,102410,38665,141075
316200,202010,663,361,302,379335,317680,697015
316210,202010,781,515,266,539399.74,277970,817369.74
316220,202010,120,79,41,82555,42845,125400
316225,202010,27,15,12,15675,12540,28215
316230,202010,34,20,14,20900,14630,35530
316240,202010,645,517,128,541310,133760,675070
316245,202010,127,109,18,113905,18810,132715
316250,202010,1522,1028,494,1075306.5,517275,1592581.5
316255,202010,128,100,28,105545,29260,134805
316257,202010,179,93,86,97185,89870,187055
316260,202010,196,137,59,143165.25,62700.5,205865.75
316265,202010,27,18,9,18810,9405,28215
316270,202010,683,480,203,502645.5,212135.6,714781.1
316280,202010,543,333,210,349030.29,219450.5,568480.79
316290,202010,749,494,255,517275.65,266475,783750.65
316292,202010,510,201,309,210045,323950,533995
316294,202010,96,58,38,60610,39710,100320
316295,202010,307,131,176,136895.5,184965,321860.5
316300,202010,109,71,38,74195,39710,113905
316310,202010,27,14,13,14630,13585,28215
316320,202010,50,26,24,28215,25080,53295
316330,202010,163,111,52,115995.25,54340,170335.25
316340,202010,133,89,44,94050,45980,140030
316350,202010,194,137,57,143165.74,59565,202730.74
316360,202010,22,15,7,15675,7315,22990
316370,202010,1117,563,554,590425.75,582065,1172490.75
316380,202010,118,87,31,90915,32395,123310
316390,202010,113,81,32,84645,33440,118085
316400,202010,133,102,31,106590,32395,138985
316410,202010,302,219,83,228855,86735,315590
316420,202010,200,133,67,138985,71060,210045
316430,202010,153,81,72,84645,75240,159885
316440,202010,88,42,46,43890,48070,91960
316443,202010,40,38,2,39710,2090,41800
316447,202010,53,41,12,42845,12540,55385
316450,202010,221,169,52,177650,54340,231990
316460,202010,77,26,51,27170,53295,80465
316470,202010,1669,1217,452,1271758.26,474430,1746188.26
316480,202010,11,8,3,8360,3135,11495
316490,202010,18,6,12,6270,12540,18810
316500,202010,151,102,49,106590,51205,157795
316510,202010,149,113,36,118085,37620,155705
316520,202010,191,115,76,121220,79420,200640
316530,202010,164,106,58,110770,60610,171380
316540,202010,144,75,69,78375,72105,150480
316550,202010,141,90,51,94050,53295,147345
316553,202010,298,134,164,140030,172425.72,312455.72
316555,202010,43,37,6,38665,6270,44935
316556,202010,12,9,3,9405,3135,12540
316557,202010,23,19,4,19855,4180,24035
316560,202010,68,48,20,50160,20900,71060
316570,202010,217,197,20,205865.5,20900,226765.5
316580,202010,20,14,6,14630,6270,20900
316590,202010,102,85,17,88825,17765,106590
316600,202010,175,143,32,149435.5,33440,182875.5
316610,202010,65,49,16,51205,16720,67925
316620,202010,138,103,35,107635,36575,144210
316630,202010,43,34,9,35530,9405,44935
316640,202010,22,14,8,14630,8360,22990
316650,202010,69,57,12,59565,12540,72105
316660,202010,8,3,5,3135,5225,8360
316670,202010,438,150,288,156750,300960,457710
316680,202010,159,111,48,115995,50160,166155
316690,202010,184,113,71,119130,74195,193325
316695,202010,62,52,10,55385,10450,65835
316700,202010,17,11,6,11495,6270,17765
316710,202010,777,581,196,607145.25,204820,811965.25
316720,202010,5008,2428,2580,2544576.99,2701326,5245902.99
316730,202010,17,16,1,16720,1045,17765
316740,202010,139,89,50,93005,52250,145255
316750,202010,17,10,7,10450,7315,17765
316760,202010,324,259,65,270655,67925,338580
316770,202010,151,82,69,85690,72105,157795
316780,202010,67,41,26,42845,27170,70015
316790,202010,55,39,16,40755,16720,57475
316800,202010,1750,1091,659,1141140,691791.25,1832931.25
316805,202010,24,17,7,17765,8360,26125
316810,202010,65,40,25,41800,26125,67925
316820,202010,41,21,20,21945,20900,42845
316830,202010,97,43,54,44935,56430,101365
316840,202010,523,303,220,317680,229900,547580
316850,202010,328,220,108,229900,112860,342760
316860,202010,5917,2605,3312,2723273.9,3469401.25,6192675.15
316870,202010,1522,970,552,1014697.25,578930.5,1593627.75
316880,202010,128,61,67,63745,70015,133760
316890,202010,238,163,75,170335,78375,248710
316900,202010,419,294,125,307230.65,130625,437855.65
316905,202010,20,10,10,10450,11495,21945
316910,202010,69,29,40,30305,41800,72105
316920,202010,140,109,31,113905,32395,146300
316930,202010,1890,965,925,1010516.5,967670.75,1978187.25
316935,202010,911,548,363,573705.1,380380.5,954085.6
316940,202010,1096,617,479,645810.5,501600.5,1147411.0
316950,202010,179,87,92,90915,96140,187055
316960,202010,1094,608,486,638496,507870,1146366
316970,202010,650,511,139,536085,146300,682385
316980,202010,74,40,34,41800,35530,77330
316990,202010,2145,1425,720,1494350.85,755535.74,2249886.59
317000,202010,334,254,80,265430,83600,349030
317005,202010,238,167,71,174515,74195,248710
317010,202010,6358,3506,2852,3669000.23,2990790.5,6659790.73
317020,202010,15943,6970,8973,7297279.23,9409185.6,16706464.83
317030,202010,81,31,50,32395,52250,84645
317040,202010,3036,1896,1140,1981321.5,1195480.5,3176802.0
317043,202010,73,53,20,56430,20900,77330
317047,202010,35,18,17,18810,17765,36575
317050,202010,158,122,36,127490,37620,165110
317052,202010,134,102,32,106590,34485,141075
317057,202010,169,131,38,136895,39710,176605
317060,202010,62,38,24,39710,25080,64790
317065,202010,54,43,11,44935,11495,56430
317070,202010,1960,904,1056,946770.75,1105610.5,2052381.25
317075,202010,102,54,48,56430,50160,106590
317080,202010,906,466,440,486970.25,462935,949905.25
317090,202010,664,520,144,544445,150480,694925
317100,202010,423,318,105,332310,110770,443080
317103,202010,103,83,20,86735,20900,107635
317107,202010,45,39,6,40755,6270,47025
317110,202010,115,50,65,52250,67925,120175
317115,202010,42,37,5,38665,5225,43890
317120,202010,1930,920,1010,964536.5,1055450.5,2019987.0
317130,202010,1954,1298,656,1359546.5,686565,2046111.5
317140,202010,10,8,2,8360,2090,10450
317150,202010,260,154,106,160930.5,111815,272745.5
317160,202010,314,236,78,247666.29,81510,329176.29
317170,202010,217,147,70,153615,74195,227810
317180,202010,442,301,141,314545,147345,461890
317190,202010,265,187,78,195415,81510,276925
317200,202010,821,573,248,598787.9,259160,857947.9
317210,202010,184,101,83,105545,86735,192280
317220,202010,24,13,11,13585,11495,25080
320010,202010,605,435,170,455620.25,177650,633270.25
320013,202010,122,86,36,89870,37620,127490
320016,202010,264,168,96,176605,100320,276925
320020,202010,713,416,297,435767.37,310365,746132.37
320030,202010,151,107,44,111815.04,45980.33,157795.37
320035,202010,139,102,37,106590,38665,145255
320040,202010,483,245,238,256025,249755,505780
320050,202010,107,76,31,79420,32395,111815
320060,202010,1682,789,893,825619.91,936321.75,1761941.66
320070,202010,100,61,39,63745,41800,105545
320080,202010,803,462,341,482790.75,356345,839135.75
320090,202010,1249,830,419,869440,438900,1308340
320100,202010,327,187,140,195415,148390,343805
320110,202010,125,80,45,83601.25,47025,130626.25
320115,202010,112,92,20,96140,20900,117040
320120,202010,3492,1838,1654,1925938.15,1733655,3659593.15
320130,202010,7450,3368,4082,3527923.02,4277187,7805110.02
320140,202010,439,288,151,300960,158841.16,459801.16
320150,202010,2056,1157,899,1210110.75,941545.43,2151656.18
320160,202010,656,294,362,307230,379335.5,686565.5
320170,202010,110,87,23,93005.1,24035.02,117040.12
320180,202010,55,32,23,33440,24035,57475
320190,202010,239,154,85,160930,88825,249755
320200,202010,58,43,15,44935,15675,60610
320210,202010,899,490,409,512051,427405.5,939456.5
320220,202010,295,101,194,105545,202730,308275
320225,202010,84,66,18,68970,18810,87780
320230,202010,619,387,232,404415,243485,647900
320240,202010,3312,1584,1728,1656327.5,1812030.5,3468358.0
320245,202010,472,320,152,334400.5,159885,494285.5
320250,202010,224,114,110,119130,115995,235125
320255,202010,135,104,31,109725,32395,142120
320260,202010,222,140,82,146300.7,86735.12,233035.82
320265,202010,156,118,38,124355,39710,164065
320270,202010,151,119,32,124355,33440,157795
320280,202010,1110,627,483,657306.07,504735.02,1162041.09
320290,202010,57,49,8,51205,8360,59565
320300,202010,583,403,180,421136.37,188101.6,609237.97
320305,202010,675,357,318,374110,332310.5,706420.5
320310,202010,195,110,85,117040.9,88825,205865.9
320313,202010,337,162,175,169290.25,182875.5,352165.75
320316,202010,109,83,26,86735,27170,113905
320320,202010,3396,1517,1879,1588400.65,1972960,3561360.65
320330,202010,258,195,63,203775,65835,269610
320332,202010,762,462,300,482791.5,313500.25,796291.75
320334,202010,241,143,98,150480.52,102410,252890.52
320335,202010,150,101,49,105545,51205,156750
320340,202010,557,386,171,403370.75,178695.5,582066.25
320350,202010,1016,434,582,453530.97,609235.5,1062766.47
320360,202010,163,87,76,90915,79420,170335
320370,202010,242,179,63,187055.9,65835.5,252891.4
320380,202010,280,194,86,203775.5,89870,293645.5
320390,202010,1153,688,465,720005,486970.5,1206975.5
320400,202010,312,227,85,238260,88825,327085
320405,202010,952,393,559,411730.25,586245.5,997975.75
320410,202010,958,491,467,513095,489060.25,1002155.25
320420,202010,509,242,267,252890.75,281105,533995.75
320425,202010,188,100,88,104500,91960,196460
320430,202010,397,213,184,222585.25,192280,414865.25
320435,202010,160,106,54,110770,56430,167200
320440,202010,196,113,83,118085.28,86735.22,204820.50
320450,202010,128,69,59,72105,61655,133760
320455,202010,251,204,47,214225.5,50160,264385.5
320460,202010,277,167,110,175560,114950,290510
320465,202010,114,77,37,80465,38665,119130
320470,202010,697,418,279,438900.5,291555,730455.5
320480,202010,199,128,71,133760,74195,207955
320490,202010,3080,1513,1567,1584221.26,1639608.8,3223830.06
320495,202010,111,68,43,71060,44935.5,115995.5
320500,202010,9580,4669,4911,4892696.3,5146630.95,10039327.25
320501,202010,539,271,268,286330,281105,567435
320503,202010,291,203,88,212135.1,93005.02,305140.12
320506,202010,263,185,78,193325,81510,274835
320510,202010,1031,452,579,472340,606100,1078440
320515,202010,84,64,20,67925,20900,88825
320517,202010,216,152,64,158840,66880,225720
320520,202010,6956,2958,3998,3099471.8,4184182.5,7283654.3
320530,202010,6162,3038,3124,3183563.22,3269805.5,6453368.72
330010,202010,3088,1557,1531,1631247.5,1612435,3243682.5
330015,202010,165,68,97,71060.9,101365,172425.9
330020,202010,3710,1544,2166,1617661.1,2267650,3885311.1
330022,202010,252,129,123,134805,128535,263340
330023,202010,639,202,437,211090,461890,672980
330025,202010,578,107,471,111815,494285,606100
330030,202010,1909,1195,714,1249820.12,747175.5,1996995.62
330040,202010,2439,1231,1208,1289530,1268630.5,2558160.5
330045,202010,9009,2716,6293,2843446,6603355,9446801
330050,202010,888,565,323,592515,337535,930050
330060,202010,1010,600,410,629091.25,429495,1058586.25
330070,202010,3728,1326,2402,1390895.4,2515315.5,3906210.9
330080,202010,1583,691,892,725230.75,935275,1660505.75
330090,202010,385,227,158,237215,165110,402325
330093,202010,260,114,146,119130,152570,271700
330095,202010,76,44,32,47025,33440,80465
330100,202010,9880,4902,4978,5127817.67,5227091.25,10354908.92
330110,202010,478,201,277,211090.75,291555,502645.75
330115,202010,525,277,248,289465,259160,548625
330120,202010,383,193,190,201685,198551.5,400236.5
330130,202010,1548,379,1169,397100,1222650,1619750
330140,202010,611,321,290,336490,303050,639540
330150,202010,513,295,218,308275,227810,536085
330160,202010,213,125,88,130625,91960,222585
330170,202010,27068,9031,18037,9459342.6,18919729.49,28379072.09
330180,202010,235,138,97,144210,101365,245575
330185,202010,962,340,622,356345,651035,1007380
330187,202010,385,115,270,120175,282150,402325
330190,202010,5813,2205,3608,2307361.9,3783945.5,6091307.4
330200,202010,4711,1394,3317,1461956.81,3486120.5,4948077.31
330205,202010,440,251,189,262295,197505.5,459800.5
330210,202010,959,586,373,612370,391876,1004246
330220,202010,2686,1587,1099,1661551.2,1150545.5,2812096.7
330225,202010,570,288,282,302005,296780,598785
330227,202010,2426,728,1698,764940,1777545.25,2542485.25
330230,202010,254,144,110,150480,114950,265430
330240,202010,3813,1867,1946,1956240.75,2040887,3997127.75
330245,202010,151,66,85,68970.1,88825,157795.1
330250,202010,6666,3335,3331,3489256.25,3493437.02,6982693.27
330260,202010,591,151,440,164065,473385,637450
330270,202010,3594,1203,2391,1262360.5,2512181,3774541.5
330280,202010,453,287,166,299915.5,173470.45,473385.95
330285,202010,7005,2153,4852,2257200.75,5087062.25,7344263.00
330290,202010,658,236,422,246620.75,443080,689700.75
330300,202010,764,491,273,514261.47,287375,801636.47
330310,202010,443,244,199,254980.5,210045,465025.5
330320,202010,7844,2881,4963,3016916.49,5204102,8221018.49
330330,202010,9060,3369,5691,3525901.43,5964861,9490762.43
330340,202010,2667,1557,1110,1631245,1162040,2793285
330350,202010,18612,6999,11613,7345311.65,12188887.13,19534198.78
330360,202010,2233,1066,1167,1116061,1223695.5,2339756.5
330370,202010,1020,507,513,531907,538175,1070082
330380,202010,897,375,522,391875,548625.01,940500.01
330385,202010,633,321,312,335445,326040,661485
330390,202010,5612,2941,2671,3079616,2800601.32,5880217.32
330395,202010,313,185,128,193325,134805.75,328130.75
330400,202010,718,379,339,396055,354255,750310
330410,202010,507,365,142,382470.25,148390.5,530860.75
330411,202010,260,136,124,144210.55,129580,273790.55
330412,202010,238,96,142,100320.5,149435,249755.5
330414,202010,5370,2144,3226,2248842.7,3385800.5,5634643.2
330415,202010,605,263,342,275881.5,357390,633271.5
330420,202010,2220,1119,1101,1175626.55,1153680.5,2329307.05
330430,202010,1782,798,984,836001,1033507.5,1869508.5
330440,202010,293,137,156,143165,163020,306185
330450,202010,121,54,67,56430,71060,127490
330452,202010,2053,888,1165,929005,1222650.5,2151655.5
330455,202010,113271,39079,74192,40940138.27,77847392.48,118787530.75
330460,202010,255,110,145,114950,152570,267520
330470,202010,1222,665,557,695971.75,585201.75,1281173.50
330475,202010,1529,402,1127,421135,1177715,1598850
330480,202010,813,430,383,450395,400235,850630
330490,202010,14730,4668,10062,4889656.25,10541962.45,15431618.70
330500,202010,1418,607,811,634315,847495.14,1481810.14
330510,202010,10885,3705,7180,3881132.43,7532360.5,11413492.93
330513,202010,97,49,48,51205,50160,101365
330515,202010,800,330,470,345896.25,494285.5,840181.75
330520,202010,2494,866,1628,904970.35,1704395,2609365.35
330530,202010,203,113,90,119130.25,94050,213180.25
330540,202010,368,180,188,188100.5,197505.5,385606.0
330550,202010,2917,1006,1911,1055451.13,2002221,3057672.13
330555,202010,796,309,487,322905,512050,834955
330560,202010,699,226,473,237215,497420,734635
330570,202010,271,195,76,203775,79420,283195
330575,202010,795,288,507,300960,530861.25,831821.25
330580,202010,3394,1876,1518,1962511.62,1595715.5,3558227.12
330590,202010,280,145,135,152570.09,141075,293645.09
330600,202010,1190,740,450,773301,473385,1246686
330610,202010,1579,845,734,884073.25,772255.75,1656329.00
330615,202010,217,168,49,175560,51205,226765
330620,202010,1073,417,656,435765,686565,1122330
330630,202010,4116,2537,1579,2655345.96,1654235.75,4309581.71
350010,202010,581,383,198,402326.47,206910,609236.47
350020,202010,53,21,32,21945,33440,55385
350030,202010,512,318,194,334400.5,205865.5,540266.0
350040,202010,125,51,74,53295,77330,130625
350050,202010,312,162,150,169290,156750,326040
350055,202010,98,49,49,51205,51205,102410
350060,202010,88,32,56,33440,58520,91960
350070,202010,784,459,325,482790.49,341716,824506.49
350075,202010,73,49,24,51205,25080,76285
350080,202010,59,28,31,29260,32395,61655
350090,202010,82,48,34,50160,35530,85690
350100,202010,285,175,110,182875,114950,297825
350110,202010,61,43,18,44935,18810,63745
350115,202010,139,89,50,93005,53295,146300
350120,202010,105,67,38,70015,39710,109725
350130,202010,369,162,207,169290.03,218405,387695.03
350140,202010,42,26,16,27170,16720,43890
350150,202010,72,56,16,58520,17765,76285
350160,202010,2411,933,1478,976031,1552870,2528901
350170,202010,383,220,163,230946.35,171380.5,402326.85
350180,202010,163,92,71,96140,74195.5,170335.5
350190,202010,991,517,474,540265.29,498465.5,1038730.79
350200,202010,68,23,45,24035,47025,71060
350210,202010,1296,721,575,754491,604010.29,1358501.29
350220,202010,658,544,114,571615.29,120175,691790.29
350230,202010,75,48,27,50160,28215,78375
350240,202010,58,41,17,42845,17765,60610
350250,202010,1170,551,619,575796.5,647901.25,1223697.75
350260,202010,94,67,27,70015,28215,98230
350270,202010,886,592,294,619686,308275.5,927961.5
350275,202010,293,123,170,129580,177650,307230
350280,202010,4557,2305,2252,2412910.83,2365880,4778790.83
350290,202010,458,206,252,216315,264385.5,480700.5
350300,202010,53,27,26,28215,27170,55385
350310,202010,82,51,31,53295,32395,85690
350315,202010,56,26,30,27170,31350,58520
350320,202010,3310,1602,1708,1681405.5,1795310.5,3476716.0
350330,202010,1672,886,786,927962.36,826595,1754557.36
350335,202010,16,11,5,11495,5225,16720
350340,202010,123,53,70,55385,73150.75,128535.75
350350,202010,91,46,45,48070,47025,95095
350360,202010,109,71,38,74195,39710,113905
350370,202010,85,49,36,51205.29,37620,88825.29
350380,202010,779,329,450,344850,473386,818236
350390,202010,1603,600,1003,631180.37,1050225.5,1681405.87
350395,202010,23,19,4,19855,5225,25080
350400,202010,1690,840,850,879892.12,893475.29,1773367.41
350410,202010,2733,1161,1572,1213245,1647984.29,2861229.29
350420,202010,250,150,100,157795.79,104500,262295.79
350430,202010,72,42,30,43890,31350,75240
350440,202010,152,109,43,113906,44935.5,158841.5
350450,202010,1661,970,691,1016785.56,727320.5,1744106.06
350460,202010,398,130,268,135850,280060,415910
350470,202010,19,10,9,10450,9405,19855
350480,202010,179,96,83,100320,86735,187055
350490,202010,237,114,123,119130,128535,247665
350500,202010,53,21,32,21945,34485,56430
350510,202010,167,107,60,111815,62700,174515
350520,202010,449,229,220,239305,231990,471295
350530,202010,434,198,236,206910,248710,455620
350535,202010,81,62,19,64790,19855,84645
350540,202010,371,188,183,196460,192280,388740
350550,202010,2674,1554,1120,1628110.83,1173536.58,2801647.41
350560,202010,603,414,189,434720,199595,634315
350570,202010,4164,1695,2469,1774411.29,2586376.35,4360787.64
350580,202010,366,178,188,186010,196460,382470
350590,202010,912,492,420,516230,439945,956175
350600,202010,6064,2880,3184,3019007.25,3348180.5,6367187.75
350610,202010,1494,771,723,808830.29,759715,1568545.29
350620,202010,28,18,10,19855,10450,30305
350630,202010,249,139,110,145255.29,115995.29,261250.58
350635,202010,969,377,592,393966.35,620730.5,1014696.85
350640,202010,117,90,27,94050,28215,122265
350650,202010,1871,1245,626,1304160.45,663575,1967735.45
350660,202010,747,306,441,320815,460845,781660
350670,202010,305,151,154,158840,160930,319770
350680,202010,173,89,84,94050,88826,182876
350690,202010,196,95,101,99275,105545,204820
350700,202010,798,378,420,396056,438900,834956
350710,202010,381,138,243,145255,253935,399190
350715,202010,53,43,10,45980,10450,56430
350720,202010,19,13,6,13585,6270,19855
350730,202010,45,28,17,29260,17765,47025
350740,202010,215,123,92,128535,97185,225720
350745,202010,22,10,12,10450,12540,22990
350750,202010,2205,1360,845,1424335.75,883025,2307360.75
350760,202010,3745,1584,2161,1659460.59,2265560,3925020.59
350770,202010,58,41,17,42845,17765,60610
350775,202010,41,29,12,30305,12540,42845
350780,202010,425,215,210,224675,220495,445170
350790,202010,364,151,213,157795,225720,383515
350800,202010,474,273,201,287375,211090,498465
350810,202010,515,409,106,429495.75,110770,540265.75
350820,202010,93,53,40,55385,41800,97185
350830,202010,79,40,39,41800,41800,83600
350840,202010,763,301,462,314545.5,482790,797335.5
350850,202010,1722,944,778,989615.5,813011,1802626.5
350860,202010,602,334,268,350075.75,281105,631180.75
350870,202010,429,280,149,292600,155705,448305
350880,202010,287,160,127,167200.25,133760.5,300960.75
350890,202010,40,25,15,26125,15675,41800
350900,202010,1472,460,1012,481745.75,1058585.29,1540331.04
350910,202010,26,14,12,14630,12540,27170
350920,202010,705,365,340,382470,357390,739860
350925,202010,1196,640,556,671936.45,585201.89,1257138.34
350930,202010,101,61,40,63745,41800,105545
350940,202010,722,396,326,414865,340670,755535
350945,202010,108,78,30,81510,31350,112860
350950,202010,16387,7566,8821,7916925.59,9244072.75,17160998.34
350960,202010,1417,623,794,651035,831820,1482855
350970,202010,1089,559,530,587179.19,558030.5,1145209.69
350980,202010,99,66,33,68970,34485,103455
350990,202010,370,133,237,138985,248710,387695
350995,202010,36,16,20,16720,20900,37620
351000,202010,635,430,205,449350.58,214225,663575.58
351010,202010,54,33,21,34485,21945,56430
351015,202010,49,34,15,35530,15675,51205
351020,202010,1573,943,630,988570.5,659395,1647965.5
351030,202010,340,215,125,224675,130625,355300
351040,202010,903,461,442,481745.95,463980.89,945726.84
351050,202010,3308,1488,1820,1559143.3,1905035,3464178.3
351060,202010,5318,2022,3296,2122396.7,3452680,5575076.7
351070,202010,403,257,146,269611.64,154660,424271.64
351080,202010,714,516,198,540265.5,207955,748220.5
351090,202010,53,24,29,25080,30305,55385
351100,202010,437,247,190,258115.7,198550,456665.7
351110,202010,2034,962,1072,1008426.31,1121285.5,2129711.81
351120,202010,67,35,32,36575,33440,70015
351130,202010,184,59,125,61655,133760,195415
351140,202010,322,212,110,222585,115995,338580
351150,202010,435,224,211,234080.75,223630.5,457711.25
351160,202010,282,182,100,190190.5,104500,294690.5
351170,202010,188,98,90,102410,94050,196460
351190,202010,87,61,26,64790,27170,91960
351200,202010,359,236,123,247665.5,128535,376200.5
351210,202010,116,55,61,57475,63745,121220
351220,202010,531,316,215,330221.91,225720,555941.91
351230,202010,265,183,82,191235,85690,276925
351240,202010,241,113,128,118085,133760,251845
351250,202010,81,57,24,59565.57,25080,84645.57
351260,202010,150,111,39,115995,41800,157795
351270,202010,44,18,26,18810,27170,45980
351280,202010,1011,458,553,478610.29,578930.79,1057541.08
351290,202010,236,102,134,106590,140030,246620
351300,202010,3749,1626,2123,1701180.11,2223760.29,3924940.40
351310,202010,742,366,376,382470,395010,777480
351320,202010,115,66,49,68970,51205,120175
351330,202010,39,25,14,26125,14630,40755
351340,202010,1245,726,519,759715.5,546535,1306250.5
351350,202010,2373,1358,1015,1423291.29,1063810,2487101.29
351360,202010,777,370,407,387695,425315,813010
351370,202010,379,190,189,199595.5,200640,400235.5
351380,202010,8970,3981,4989,4167466.81,5231271.79,9398738.60
351385,202010,25,17,8,17765,8360,26125
351390,202010,277,208,69,218405.35,72105,290510.35
351400,202010,67,42,25,43890,26125,70015
351410,202010,427,269,158,281105.77,167200,448305.77
351420,202010,71,52,19,55385,19855,75240
351430,202010,72,40,32,41800,33440,75240
351440,202010,779,541,238,567437.33,249755,817192.33
351450,202010,268,129,139,134805,146300,281105
351460,202010,127,57,70,59565,73150,132715
351470,202010,140,78,62,81510,65835,147345
351480,202010,494,285,209,298870.79,218405,517275.79
351490,202010,287,106,181,110770,189145,299915
351492,202010,27,19,8,19855,8360,28215
351495,202010,26,18,8,18810,8360,27170
351500,202010,3523,1454,2069,1525700.5,2167331.9,3693032.4
351510,202010,1958,734,1224,768076,1281170.5,2049246.5
351512,202010,17,13,4,13585,4180,17765
351515,202010,181,103,78,107635,81510,189145
351518,202010,724,458,266,478610,281105,759715
351519,202010,78,47,31,49115,33440,82555
351520,202010,146,90,56,94050,60610,154660
351530,202010,24,14,10,14630,10450,25080
351535,202010,133,81,52,84645,54340,138985
351540,202010,463,331,132,345895.6,137940,483835.6
351550,202010,1400,817,583,863172.08,611325,1474497.08
351560,202010,71,39,32,40755,33440,74195
351565,202010,10,7,3,7315,3135,10450
351570,202010,2710,1299,1411,1360590.5,1479720,2840310.5
351580,202010,39,34,5,35530,5225,40755
351590,202010,58,37,21,38665,21945,60610
351600,202010,187,133,54,138985,56430,195415
351610,202010,47,22,25,22990,26125,49115
351620,202010,5834,3234,2600,3394163.75,2730585.75,6124749.50
351630,202010,2842,1385,1457,1449416,1525700,2975116
351640,202010,2011,905,1106,947815.02,1158906.2,2106721.22
351650,202010,28,24,4,25080,4180,29260
351660,202010,135,87,48,90915,50160,141075
351670,202010,708,440,268,460846.5,280060,740906.5
351680,202010,65,56,9,58520,9405,67925
351685,202010,13,10,3,10450,3135,13585
351690,202010,300,202,98,212135.37,102410,314545.37
351700,202010,160,109,51,113905.5,53295,167200.5
351710,202010,71,46,25,48070,27170,75240
351720,202010,131,75,56,78375,58520,136895
351730,202010,105,67,38,71060,39710,110770
351740,202010,722,462,260,485925.6,273790,759715.6
351750,202010,356,144,212,150480,221540,372020
351760,202010,756,576,180,601920,189145,791065
351770,202010,307,256,51,269610.29,53295,322905.29
351780,202010,161,96,65,100320,68970,169290
351790,202010,250,129,121,136895,127490.75,264385.75
351800,202010,39,24,15,25080,15675,40755
351810,202010,117,81,36,84645,37620,122265
351820,202010,811,586,225,612370.92,235125,847495.92
351830,202010,540,186,354,195415,369930,565345
351840,202010,1915,910,1005,953041.6,1050225,2003266.6
351850,202010,230,163,67,170335,72105,242440
351860,202010,651,453,198,473385.45,209000,682385.45
351870,202010,5554,2564,2990,2688789.1,3136048.48,5824837.58
351880,202010,19545,7847,11698,8224154.29,12256808.3,20480962.59
351885,202010,82,51,31,53295,32395,85690
351890,202010,69,55,14,57475,14630,72105
351900,202010,230,130,100,135850,104500,240350
351905,202010,81,31,50,32395,52250,84645
351907,202010,3460,1403,2057,1470315.85,2151655.5,3621971.35
351910,202010,176,71,105,74195,110770,184965
351920,202010,115,62,53,64790,55385,120175
351925,202010,88,57,31,59565,32395,91960
351930,202010,395,254,141,265430,148390,413820
351940,202010,238,102,136,108680,142120,250800
351950,202010,138,74,64,77330,66880,144210
351960,202010,925,456,469,477892.37,492195.5,970087.87
351970,202010,1914,989,925,1036640.5,970805.5,2007446.0
351980,202010,162,74,88,77330,91960,169290
351990,202010,259,168,91,176606,95095,271701
352000,202010,339,218,121,227810.5,127490,355300.5
352010,202010,387,242,145,253935,152570,406505
352020,202010,183,70,113,73150,118085,191235
352030,202010,1102,553,549,578930,576840,1155770
352040,202010,564,238,326,249755,343805,593560
352042,202010,288,82,206,85690,219451,305141
352044,202010,359,220,139,233035.5,146300,379335.5
352050,202010,3197,1224,1973,1282216.64,2067010.5,3349227.14
352060,202010,103,62,41,64790,42845,107635
352070,202010,90,68,22,71060.58,24035,95095.58
352080,202010,64,41,23,42845,24035,66880
352090,202010,155,102,53,106590,55385,161975
352100,202010,289,140,149,146300,156750.5,303050.5
352110,202010,116,36,80,37620,83600,121220
352115,202010,60,21,39,21945,40755,62700
352120,202010,80,53,27,55385.29,28215,83600.29
352130,202010,221,184,37,192280,39710,231990
352140,202010,184,86,98,89870,102410,192280
352150,202010,117,60,57,62700,59565,122265
352160,202010,135,87,48,91960,51205,143165
352170,202010,387,261,126,273790,131670,405460
352180,202010,629,394,235,412775.29,245575.85,658351.14
352190,202010,244,100,144,104500,150480,254980
352200,202010,29,14,15,14630,15675,30305
352210,202010,4155,1682,2473,1759782.5,2590556,4350338.5
352215,202010,61,35,26,36575,27170,63745
352220,202010,6678,2489,4189,2608322,4385866.29,6994188.29
352230,202010,3317,2136,1181,2234211.66,1238326.62,3472538.28
352240,202010,2518,1437,1081,1504800.5,1133826.42,2638626.92
352250,202010,2785,1324,1461,1387761.58,1533015.5,2920777.08
352260,202010,992,519,473,542355,494285.5,1036640.5
352265,202010,56,27,29,28215,30305,58520
352270,202010,388,219,169,230945,178695.25,409640.25
352280,202010,456,275,181,287375.58,189145,476520.58
352290,202010,174,102,72,107635,76285,183920
352300,202010,94,65,29,68970,30305,99275
352310,202010,6415,2814,3601,2945856.19,3771405.3,6717261.49
352320,202010,1043,546,497,570570.5,519365,1089935.5
352330,202010,522,257,265,269610,277970,547580
352340,202010,1336,604,732,634317,769121.5,1403438.5
352350,202010,339,201,138,210045,144210.5,354255.5
352360,202010,219,97,122,101365,127490,228855
352370,202010,106,69,37,72105,38665,110770
352380,202010,112,72,40,75240,41800,117040
352390,202010,2470,1055,1415,1104565.5,1480766.3,2585331.8
352400,202010,494,214,280,223630,292600.5,516230.5
352410,202010,868,603,265,633270.79,277970,911240.79
352420,202010,96,67,29,70015,30305,100320
352430,202010,1746,796,950,832866.87,996930.58,1829797.45
352440,202010,3217,1566,1651,1639606.97,1730520.5,3370127.47
352450,202010,200,161,39,168245,40755,209000
352460,202010,626,316,310,332310,326040,658350
352470,202010,649,222,427,231990.5,451440,683430.5
352480,202010,1424,783,641,819280,669845.5,1489125.5
352490,202010,66,23,43,24035,44935,68970
352500,202010,1234,521,713,544446.12,745085,1289531.12
352510,202010,713,377,336,396055.29,351120,747175.29
352520,202010,690,320,370,335445,387695,723140
352530,202010,1753,913,840,958265,879890.5,1838155.5
352540,202010,74,47,27,49115,28215,77330
352550,202010,194,114,80,119130,83600,202730
352560,202010,49,38,11,39710,11495,51205
352570,202010,691,337,354,353210.29,373065,726275.29
352580,202010,55,42,13,43890,13585,57475
352585,202010,20,6,14,6270,14630,20900
352590,202010,4379,2158,2221,2262425.79,2337665.5,4600091.29
352600,202010,349,249,100,260205,104500,364705
352610,202010,939,428,511,447260.67,535040,982300.67
352620,202010,1033,393,640,411730,669845,1081575
352630,202010,176,64,112,66880,118085,184965
352640,202010,508,338,170,353210,177650,530860
352650,202010,80,60,20,63745,21945,85690
352660,202010,62,37,25,38665,26125,64790
352670,202010,1678,879,799,919601.32,834955,1754556.32
352680,202010,920,571,349,600875,364705,965580
352690,202010,4502,2007,2495,2101497.09,2616680.29,4718177.38
352700,202010,104,61,43,63745,44935,108680
352710,202010,1393,728,665,763895,698060,1461955
352720,202010,1374,623,751,653125,786885.5,1440010.5
352725,202010,23,18,5,18810,5225,24035
352730,202010,386,193,193,202730,203775,406505
352740,202010,412,264,148,276926.4,154660.11,431586.51
352750,202010,18,12,6,13585,6270,19855
352760,202010,181,116,65,123310,67925,191235
352770,202010,90,66,24,68970,25080,94050
352780,202010,81,42,39,43890,40755,84645
352790,202010,26,20,6,20900,6270,27170
352800,202010,235,176,59,183920,62700,246620
352810,202010,156,97,59,101365,62700,164065
352820,202010,51,41,10,42845,10450,53295
352830,202010,76,52,24,54340,25080,79420
352840,202010,655,316,339,331265.25,355300,686565.25
352850,202010,1569,504,1065,527725,1117105,1644830
352860,202010,116,75,41,78375,43890,122265
352870,202010,46,30,16,31350,16720,48070
352880,202010,179,117,62,123310,64790,188100
352885,202010,31,21,10,21945,10450,32395
352890,202010,54,36,18,37620,18810.5,56430.5
352900,202010,4730,2275,2455,2381556.5,2579060.5,4960617.0
352910,202010,39,31,8,32395,8360,40755
352920,202010,658,394,264,413820,275880.42,689700.42
352930,202010,1228,586,642,612370.5,672980.25,1285350.75
352940,202010,6129,2487,3642,2602100.07,3815295.5,6417395.57
352950,202010,109,38,71,40755,74195,114950
352960,202010,58,37,21,38665,21945,60610
352965,202010,18,9,9,9405,9405,18810
352970,202010,523,400,123,418000.73,128535,546535.73
352980,202010,157,85,72,88825,75240,164065
352990,202010,981,450,531,470250,555940,1026190
353000,202010,59,25,34,26125,35530,61655
353010,202010,546,337,209,352165,218405,570570
353020,202010,303,220,83,229900,87780,317680
353030,202010,1262,570,692,597740.85,726275,1324015.85
353040,202010,90,55,35,57475,36575,94050
353050,202010,1309,847,462,886161.19,484880,1371041.19
353060,202010,8378,3578,4800,3747374.71,5027495,8774869.71
353070,202010,1749,1056,693,1108746.33,728178.99,1836925.32
353080,202010,1284,688,596,721050.47,625955,1347005.47
353090,202010,60,31,29,33440,30305,63745
353100,202010,48,38,10,40755,10450,51205
353110,202010,2086,635,1451,666710.5,1518385.5,2185096.0
353120,202010,97,49,48,51205,50160,101365
353130,202010,852,422,430,443080.41,450395,893475.41
353140,202010,550,225,325,236170.29,339625,575795.29
353150,202010,331,188,143,196460.29,149435,345895.29
353160,202010,93,73,20,77330,21945,99275
353170,202010,222,68,154,71060,160930,231990
353180,202010,1080,489,591,511005.75,623866.25,1134872.00
353190,202010,491,357,134,375155,140030,515185
353200,202010,225,105,120,109725,126445,236170
353205,202010,19,12,7,12540,7315,19855
353210,202010,70,39,31,40755,32395,73150
353215,202010,42,23,19,24035,19855,43890
353220,202010,77,45,32,47025,33440,80465
353230,202010,156,58,98,61655,102410,164065
353240,202010,319,163,156,170335,163020,333355
353250,202010,207,102,105,106590,109725,216315
353260,202010,458,313,145,327085.8,152570,479655.8
353270,202010,73,54,19,56430,19855,76285
353280,202010,103,49,54,51205,56430,107635
353282,202010,130,91,39,96140,40755,136895
353284,202010,23,16,7,16720,7315,24035
353286,202010,2,0,2,0,2090,2090
353290,202010,79,44,35,45980,36575,82555
353300,202010,448,235,213,245576.33,222585,468161.33
353310,202010,48,41,7,43890,7315,51205
353320,202010,48,27,21,29260,21945,51205
353325,202010,50,29,21,30305,21945.5,52250.5
353330,202010,58,40,18,41800.75,18810,60610.75
353340,202010,646,228,418,240350,437855,678205
353350,202010,901,433,468,452485,492195.45,944680.45
353360,202010,103,82,21,85690,21945,107635
353370,202010,111,64,47,66880,49115,115995
353380,202010,33,18,15,18810,15675,34485
353390,202010,1113,527,586,551760,616550.5,1168310.5
353400,202010,43,23,20,24035,20900,44935
353410,202010,109,64,45,67925,47025.25,114950.25
353420,202010,59,23,36,24035,37620,61655
353430,202010,575,385,190,402326.41,198550,600876.41
353440,202010,11154,4827,6327,5054667.44,6627391,11682058.44
353450,202010,56,30,26,31350,28215,59565
353460,202010,590,317,273,333355.25,286330,619685.25
353470,202010,2140,1107,1033,1162040.37,1079485,2241525.37
353475,202010,249,164,85,172425.5,88825,261250.5
353480,202010,184,152,32,159885,33440,193325
353490,202010,238,141,97,148390,102410.5,250800.5
353500,202010,205,119,86,124355.29,89870,214225.29
353510,202010,98,66,32,68970,33440,102410
353520,202010,206,146,60,152570,62700,215270
353530,202010,466,247,219,258115,228855,486970
353540,202010,384,252,132,263340,138985,402325
353550,202010,712,460,252,482791.47,264385,747176.47
353560,202010,586,234,352,244530,367840,612370
353570,202010,66,37,29,39710.5,30305,70015.5
353580,202010,349,253,96,265431.35,100320,365751.35
353590,202010,85,62,23,64790,24035,88825
353600,202010,274,160,114,167200.29,119130,286330.29
353610,202010,128,70,58,73150,61655,134805
353620,202010,624,324,300,338580.5,315590,654170.5
353625,202010,49,26,23,27170,25080,52250
353630,202010,235,169,66,176605.45,68970,245575.45
353640,202010,129,85,44,88825,47025,135850
353650,202010,932,347,585,362615,612370,974985
353657,202010,23,17,6,17765,6270,24035
353660,202010,273,144,129,150480,134805,285285
353670,202010,762,448,314,470250.79,329175.5,799426.29
353680,202010,105,79,26,82555.25,27170,109725.25
353690,202010,39,29,10,30305,10450,40755
353700,202010,279,196,83,205865,86735,292600
353710,202010,469,214,255,224675,267520.5,492195.5
353715,202010,47,33,14,35530,14630,50160
353720,202010,347,154,193,160930.5,201685,362615.5
353730,202010,1086,668,418,703285.5,443080.5,1146366.0
353740,202010,613,337,276,353211.25,289465.75,642677.00
353750,202010,77,45,32,47025,33440,80465
353760,202010,3001,1120,1881,1173536.15,1971916.65,3145452.80
353770,202010,87,70,17,74195,17765,91960
353780,202010,1245,584,661,610280.29,690745,1301025.29
353790,202010,503,305,198,320816.4,209000,529816.4
353800,202010,3427,1638,1789,1720090.5,1876891.5,3596982.0
353810,202010,230,130,100,135850,104500,240350
353820,202010,210,92,118,96140,123310,219450
353830,202010,53,46,7,48070,7315,55385
353850,202010,171,81,90,84645,96140,180785
353860,202010,510,222,288,233035,303050,536085
353870,202010,5358,2671,2687,2799558.75,2822546.75,5622105.50
353880,202010,683,466,217,488015,226765,714780
353890,202010,545,318,227,332310.5,238260.61,570571.11
353900,202010,132,70,62,73150,64790,137940
353910,202010,172,75,97,78375,101365,179740
353920,202010,426,239,187,249755.75,196460,446215.75
353930,202010,1015,598,417,625955,436811.1,1062766.1
353940,202010,193,94,99,98230,103455,201685
353950,202010,500,308,192,321860,202730,524590
353960,202010,77,62,15,64790,15675,80465
353970,202010,44,29,15,30305,16720,47025
353980,202010,1686,769,917,809875.43,962445,1772320.43
353990,202010,71,43,28,44935,29260,74195
354000,202010,381,179,202,188100,211090,399190
354010,202010,89,50,39,52250,40755.5,93005.5
354020,202010,511,324,187,339625,196460,536085
354025,202010,39,34,5,35530,5225,40755
354030,202010,51,31,20,32395,20900,53295
354040,202010,98,74,24,77330,26125,103455
354050,202010,172,98,74,102410.79,77330,179740.79
354060,202010,759,363,396,380380,414865,795245
354070,202010,908,515,393,540266,411730,951996
354075,202010,183,83,100,86735,104500,191235
354080,202010,312,132,180,137940,188100,326040
354085,202010,20,13,7,13585,7315,20900
354090,202010,287,166,121,173382,126445,299827
354100,202010,5542,2233,3309,2338711.53,3474627.35,5813338.88
354105,202010,95,44,51,45980,53295,99275
354110,202010,46,22,24,22990,25080,48070
354120,202010,140,98,42,102410,43890,146300
354130,202010,716,448,268,469205,280060,749265
354140,202010,3176,1459,1717,1531971.52,1800535.5,3332507.02
354150,202010,635,378,257,395010.87,270655,665665.87
354160,202010,645,408,237,427405.5,249756.39,677161.89
354165,202010,17,14,3,14630,3135,17765
354170,202010,171,117,54,123310,56430,179740
354180,202010,57,34,23,35530.59,24035,59565.59
354190,202010,188,78,110,82555,114950,197505
354200,202010,111,59,52,61655,54340,115995
354210,202010,59,22,37,22990,38665,61655
354220,202010,651,413,238,432630.29,253935,686565.29
354230,202010,164,69,95,72105,99275,171380
354240,202010,340,219,121,228855.62,128535,357390.62
354250,202010,82,51,31,53295,32395,85690
354260,202010,2073,974,1099,1018876.82,1149501.6,2168378.42
354270,202010,86,63,23,65835,24035,89870
354280,202010,46,22,24,22990,25080,48070
354290,202010,141,98,43,102410,44935,147345
354300,202010,373,262,111,273790.29,117040,390830.29
354310,202010,89,68,21,71060.5,21945,93005.5
354320,202010,200,99,101,104500,105545,210045
354323,202010,10,9,1,9405,1045,10450
354325,202010,114,64,50,67925.83,52250,120175.83
354330,202010,2414,805,1609,841076.5,1685585.75,2526662.25
354340,202010,10296,4878,5418,5110877.29,5674352.75,10785230.04
354350,202010,138,89,49,93005,51205,144210
354360,202010,67,36,31,37620,33440,71060
354370,202010,238,124,114,131670,119130,250800
354380,202010,179,111,68,115995,72105,188100
354390,202010,2663,956,1707,1003200,1792175,2795375
354400,202010,305,166,139,173470,145255,318725
354410,202010,613,291,322,306186.6,337535.5,643722.1
354420,202010,268,172,96,179740,100320,280060
354425,202010,303,180,123,189194,128535,317729
354430,202010,180,103,77,107635,80465,188100
354440,202010,33,25,8,27170,9405,36575
354450,202010,51,33,18,34485,18810,53295
354460,202010,101,57,44,59565,45980,105545
354470,202010,34,18,16,18810,16720,35530
354480,202010,111,62,49,64790,52250,117040
354490,202010,141,87,54,90915,57475,148390
354500,202010,387,182,205,191235,214225,405460
354510,202010,92,63,29,65835,30305,96140
354515,202010,36,11,25,12540,26125,38665
354520,202010,1591,678,913,711496.75,959310.5,1670807.25
354530,202010,777,384,393,401280.5,410685,811965.5
354540,202010,263,141,122,149435,128535,277970
354550,202010,36,23,13,24035,13585,37620
354560,202010,151,78,73,81510,76285,157795
354570,202010,130,89,41,93005,43890,136895
354580,202010,1848,866,982,907061,1031415.5,1938476.5
354600,202010,258,137,121,145255,126445,271700
354610,202010,72,61,11,63745.15,11495,75240.15
354620,202010,64,17,47,17765,49115,66880
354625,202010,15,9,6,9405,6270,15675
354630,202010,294,188,106,196460,110770,307230
354640,202010,798,504,294,527725.75,307230,834955.75
354650,202010,67,39,28,40755,29260,70015
354660,202010,778,578,200,605055.54,213180,818235.54
354670,202010,237,89,148,94050,157795,251845
354680,202010,1271,466,805,489060,845405,1334465
354690,202010,84,57,27,59565.5,28215,87780.5
354700,202010,66,47,19,49115,19855,68970
354710,202010,45,32,13,33440,13585,47025
354720,202010,20,19,1,19855,1045,20900
354730,202010,1732,721,1011,754490.55,1059630.5,1814121.05
354740,202010,74,50,24,52250,25080,77330
354750,202010,420,241,179,251845,188100,439945
354760,202010,456,274,182,287376.25,190190.5,477566.75
354765,202010,10,5,5,5225,5225,10450
354770,202010,345,227,118,237215,123310,360525
354780,202010,8161,3192,4969,3350274.21,5211416.2,8561690.41
354790,202010,100,56,44,58520,45980,104500
354800,202010,451,241,210,252890,220495,473385
354805,202010,97,44,53,45980.5,55385,101365.5
354810,202010,103,61,42,63745,43890,107635
354820,202010,204,81,123,85690.9,128535,214225.9
354830,202010,43,22,21,22990,21945,44935
354840,202010,55,38,17,39710,17765,57475
354850,202010,4482,1962,2520,2059696.1,2642805.81,4702501.91
354860,202010,328,157,171,164065,178695.04,342760.04
354870,202010,11996,5318,6678,5568811.03,7005682.25,12574493.28
354880,202010,2742,1012,1730,1064855.88,1817255.75,2882111.63
354890,202010,2916,1558,1358,1635426.75,1425380,3060806.75
354900,202010,63,43,20,44935,20900,65835
354910,202010,1241,636,605,667756,635360,1303116
354920,202010,41,33,8,35530,8360,43890
354925,202010,15,7,8,7315,8360,15675
354930,202010,36,32,4,33440.78,4180,37620.78
354940,202010,795,576,219,604273.04,230945,835218.04
354950,202010,199,128,71,134805.25,74195,209000.25
354960,202010,146,55,91,57475,95095,152570
354970,202010,969,640,329,670891.64,346940.5,1017832.14
354980,202010,8757,3127,5630,3275033.45,5914700.52,9189733.97
354990,202010,9362,4238,5124,4444388.5,5366075,9810463.5
354995,202010,547,177,370,184965,388740,573705
355000,202010,465,161,304,168245,317680,485925
355010,202010,592,362,230,378290.5,240350.29,618640.79
355020,202010,769,480,289,502645,302005.5,804650.5
355030,202010,207663,79239,128424,83015614.01,134616973.39,217632587.40
355040,202010,775,350,425,365750.5,446215,811965.5
355050,202010,152,91,61,95095,63745,158840
355060,202010,1628,810,818,848541.5,855855,1704396.5
355070,202010,1450,686,764,717915.77,802560.29,1520476.06
355080,202010,193,120,73,126445,77330,203775
355090,202010,285,166,119,173470,124355.19,297825.19
355100,202010,5009,2370,2639,2480729.1,2770295.5,5251024.6
355110,202010,241,162,79,169290,82555,251845
355120,202010,57,37,20,38665,21945,60610
355130,202010,46,27,19,28215,19855,48070
355140,202010,183,110,73,114950,76285,191235
355150,202010,665,390,275,407550.5,287375,694925.5
355160,202010,472,222,250,233035.29,261250.5,494285.79
355170,202010,2038,1058,980,1109790.4,1028280,2138070.4
355180,202010,674,281,393,293645,410685,704330
355190,202010,213,142,71,149435,74195,223630
355200,202010,111,63,48,65835,50160,115995
355210,202010,696,392,304,411730,317680,729410
355220,202010,7170,3632,3538,3805893.67,3707662.5,7513556.17
355230,202010,101,60,41,62700,43890,106590
355240,202010,4448,1831,2617,1918622.16,2745215,4663837.16
355250,202010,5812,2570,3242,2695075.32,3396250.25,6091325.57
355255,202010,49,28,21,29260,21945,51205
355260,202010,180,112,68,117040.5,73150,190190.5
355270,202010,166,105,61,109725,63745,173470
355280,202010,6384,2477,3907,2595782,4095355.5,6691137.5
355290,202010,77,63,14,65835,14630,80465
355300,202010,197,118,79,123310,82555,205865
355310,202010,110,59,51,61655,53295,114950
355320,202010,89,46,43,48070.61,44935,93005.61
355330,202010,277,160,117,167200,123310,290510
355340,202010,1469,508,961,535041.27,1006335,1541376.27
355350,202010,140,67,73,70015,76285,146300
355360,202010,168,110,58,114950,60610,175560
355365,202010,21,17,4,17765,4180,21945
355370,202010,1034,609,425,639541.08,446215,1085756.08
355380,202010,826,517,309,540265.5,324995,865260.5
355385,202010,75,51,24,54340,25080,79420
355390,202010,107,60,47,62700,49115,111815
355395,202010,196,110,86,114950.92,89870,204820.92
355400,202010,1689,1003,686,1048051.68,718960.29,1767011.97
355410,202010,4869,2263,2606,2369018.25,2729540.25,5098558.50
355420,202010,49,33,16,34485,16720,51205
355430,202010,379,233,146,245575.5,152570,398145.5
355440,202010,86,49,37,51205,38665,89870
355450,202010,455,223,232,234081.2,245575,479656.2
355460,202010,64,48,16,50160.35,16720,66880.35
355465,202010,45,26,19,27170,19855,47025
355470,202010,174,71,103,74195.75,108680,182875.75
355475,202010,11,7,4,7315,4180,11495
355480,202010,526,215,311,224675,324995,549670
355490,202010,117,82,35,86735,36575,123310
355495,202010,63,25,38,26125,39710,65835
355500,202010,1562,861,701,901837.05,734635.5,1636472.55
355510,202010,269,198,71,206910.29,74195,281105.29
355520,202010,31,23,8,24035,8360,32395
355530,202010,20,12,8,12540,8360,20900
355535,202010,75,34,41,35530,42845,78375
355540,202010,2468,968,1500,1011707.84,1571680.79,2583388.63
355550,202010,60,37,23,38665,24035,62700
355560,202010,250,117,133,122265,138985,261250
355570,202010,23,15,8,15675,8360,24035
355580,202010,243,172,71,179740,74195.5,253935.5
355590,202010,17,11,6,11495,6270,17765
355600,202010,271,137,134,145255,140030,285285
355610,202010,225,151,74,158840,77330,236170
355620,202010,1327,586,741,614460.5,777480,1391940.5
355630,202010,432,315,117,329175,124355.29,453530.29
355635,202010,112,52,60,54340,62700,117040
355640,202010,553,312,241,328130,253935,582065
355645,202010,852,332,520,346940,543401,890341
355650,202010,1968,832,1136,872576.35,1190255,2062831.35
355660,202010,248,131,117,136895,122265,259160
355670,202010,575,238,337,249755,353210,602965
355680,202010,204,113,91,119130,96140,215270
355690,202010,91,41,50,42845,52250.66,95095.66
355695,202010,18,12,6,12540,6270,18810
355700,202010,1130,588,542,614460.65,569526,1183986.65
355710,202010,2223,1197,1026,1254000.5,1075305.5,2329306.0
355715,202010,16,14,2,14630,2090,16720
355720,202010,229,138,91,144210.6,95095,239305.6
355730,202010,98,58,40,60610,42845,103455
410010,202010,133,109,24,113905,25080,138985
410020,202010,113,87,26,90915,27170,118085
410030,202010,165,94,71,100320,74195,174515
410040,202010,1197,588,609,614460,637450,1251910
410045,202010,37,28,9,30305,9405,39710
410050,202010,471,265,206,276925,216315,493240
410060,202010,283,209,74,219450,77330,296780
410070,202010,291,243,48,253935,50160,304095
410080,202010,173,107,66,111815,68970,180785
410090,202010,79,69,10,72105.9,10450,82555.9
410100,202010,288,201,87,210045,90915,300960
410105,202010,48,29,19,30305,19855,50160
410110,202010,335,200,135,209000,141075,350075
410115,202010,35,24,11,26125,11495,37620
410120,202010,418,207,211,217360,220495,437855
410130,202010,49,31,18,32395,18810,51205
410140,202010,3135,1493,1642,1567502.67,1721119.58,3288622.25
410150,202010,2675,1035,1640,1081576.35,1721116,2802692.35
410160,202010,513,316,197,330220,205865,536085
410165,202010,62,40,22,41800,22990,64790
410170,202010,176,113,63,119130,65835,184965
410180,202010,2244,1244,1000,1306250,1053360,2359610
410185,202010,37,32,5,33440,5225,38665
410190,202010,494,315,179,331265,187055,518320
410200,202010,947,678,269,710600,282150,992750
410210,202010,606,305,301,319770,314545,634315
410220,202010,44,20,24,21945,25080,47025
410230,202010,145,69,76,73150,79420,152570
410240,202010,745,480,265,504735.5,276925,781660.5
410250,202010,378,270,108,282150,112860,395010
410260,202010,301,167,134,174515,140030.5,314545.5
410270,202010,27,20,7,20900,7315,28215
410275,202010,55,43,12,44935,12540,57475
410280,202010,321,183,138,192280,144210,336490
410290,202010,251,152,99,159885,103455,263340
410300,202010,79,57,22,59565,22990,82555
410302,202010,20,13,7,13585,7315,20900
410304,202010,42,29,13,30305,13585,43890
410305,202010,216,110,106,114950,110770,225720
410310,202010,212,125,87,130625,91960,222585
410315,202010,46,33,13,34485,13585,48070
410320,202010,139,96,43,100320,44935,145255
410322,202010,33,22,11,22990,11495,34485
410330,202010,181,123,58,128535,60610,189145
410335,202010,102,57,45,59565,47025,106590
410337,202010,45,34,11,35530,11495,47025
410340,202010,38,32,6,33440,6270,39710
410345,202010,204,115,89,121220,93005,214225
410347,202010,47,36,11,37620,11495,49115
410350,202010,233,141,92,147345,96140,243485
410360,202010,466,291,175,304095.5,182876,486971.5
410370,202010,2333,980,1353,1026190.45,1421201.85,2447392.30
410380,202010,205,129,76,135850,79420,215270
410390,202010,390,268,122,281105,128535,409640
410395,202010,35,22,13,22990,13585,36575
410400,202010,840,377,463,395010.27,484880,879890.27
410405,202010,89,66,23,68970,24035,93005
410410,202010,31,22,9,22990,9405,32395
410420,202010,1672,786,886,821276.99,931095.85,1752372.84
410425,202010,175,70,105,73150,109725,182875
410430,202010,2304,1261,1043,1327150,1090981.15,2418131.15
410440,202010,377,275,102,288420,106590,395010
410442,202010,363,237,126,247665,131670,379335
410445,202010,428,303,125,316635,131670,448305
410450,202010,399,196,203,205865,212135,418000
410460,202010,509,258,251,269610,263340,532950
410465,202010,228,135,93,141075,97185,238260
410470,202010,248,148,100,154660,104500,259160
410480,202010,6226,2969,3257,3108182.33,3415061.75,6523244.08
410490,202010,1416,854,562,895565.51,590425.5,1485991.01
410500,202010,269,150,119,156750,124355,281105
410510,202010,166,123,43,128535,44935,173470
410520,202010,253,188,65,196460,67925,264385
410530,202010,301,104,197,108680,206910,315590
410540,202010,325,237,88,247665,91960,339625
410550,202010,1687,716,971,750310.2,1018875.5,1769185.7
410560,202010,148,103,45,107635,47025,154660
410570,202010,431,290,141,305141.3,148390,453531.3
410580,202010,3477,1492,1985,1563321.33,2084775.5,3648096.83
410590,202010,397,265,132,280042,137940,417982
410600,202010,196,167,29,174515,30305,204820
410610,202010,51,42,9,43890,9405,53295
410620,202010,247,165,82,172425.03,86735,259160.03
410630,202010,432,243,189,256025,197505,453530
410640,202010,1017,643,374,674025.75,392920,1066945.75
410645,202010,110,79,31,82555,32395,114950
410650,202010,358,232,126,242440,132715,375155
410655,202010,89,63,26,65835,27170,93005
410657,202010,26,9,17,9405,17765,27170
410660,202010,602,415,187,435765.52,195415,631180.52
410670,202010,74,62,12,64790,12540,77330
410680,202010,216,171,45,178695,47025,225720
410685,202010,18,11,7,11495,7315,18810
410690,202010,28493,11935,16558,12499249.5,17364771.1,29864020.6
410700,202010,327,241,86,252890,90915,343805
410710,202010,131,103,28,109725,29260,138985
410712,202010,38,27,11,28215,11495,39710
410715,202010,86,62,24,64790,25080,89870
410720,202010,688,387,301,404415,315590,720005
410725,202010,181,132,49,137940,51205,189145
410730,202010,96,47,49,49115,51205,100320
410740,202010,107,76,31,79420,32395,111815
410750,202010,265,176,89,184965,93005,277970
410752,202010,25,15,10,15675,10450,26125
410753,202010,56,23,33,24035,34485,58520
410754,202010,50,26,24,27170.5,25080,52250.5
410755,202010,85,50,35,52250,36575,88825
410760,202010,764,415,349,435765.5,366795,802560.5
410765,202010,1785,807,978,845405.28,1025146,1870551.28
410770,202010,111,85,26,88825,27170,115995
410773,202010,56,40,16,41800,16720,58520
410775,202010,182,136,46,142120,48070,190190
410780,202010,88,48,40,50160,41800,91960
410785,202010,59,46,13,48070,13585,61655
410790,202010,79,35,44,36575,45980,82555
410800,202010,286,175,111,182875,118085.5,300960.5
410810,202010,25,17,8,17765,8360.5,26125.5
410820,202010,173,126,47,131670,49115,180785
410830,202010,8545,3667,4878,3843512.7,5112140.5,8955653.2
410832,202010,107,73,34,76285,35530,111815
410840,202010,1458,778,680,815101.44,712690.25,1527791.69
410845,202010,54,33,21,34485,21945,56430
410850,202010,185,132,53,137940,55385,193325
410855,202010,62,50,12,52250,12540,64790
410860,202010,748,401,347,420090.5,363660,783750.5
410865,202010,102,75,27,78375,28215,106590
410870,202010,156,133,23,138985,24035,163020
410880,202010,1124,562,562,587290.5,589380,1176670.5
410890,202010,89,63,26,65835,27170,93005
410895,202010,73,54,19,56430,19855,76285
410900,202010,24,18,6,18810,6270,25080
410910,202010,16,13,3,13585,3135,16720
410920,202010,36,25,11,26125,11495,37620
410930,202010,528,326,202,340670,211090,551760
410940,202010,4406,2440,1966,2558544.71,2061785.5,4620330.21
410950,202010,107,77,30,80465,31350,111815
410960,202010,837,343,494,360525.5,520410,880935.5
410965,202010,64,45,19,47025,19855,66880
410970,202010,628,444,184,465025,192280,657305
410975,202010,127,78,49,81510.16,51205,132715.16
410980,202010,1629,723,906,758670.5,948860,1707530.5
410990,202010,271,189,82,197505,87780,285285
411000,202010,65,40,25,41800,26125.5,67925.5
411005,202010,29,24,5,25080,5225,30305
411007,202010,257,151,106,157795,110770,268565
411010,202010,612,410,202,428450,211090,639540
411020,202010,289,196,93,204820.25,97185,302005.25
411030,202010,18,10,8,10450,8360,18810
411040,202010,55,37,18,38665,18810,57475
411050,202010,205,156,49,163020,52250,215270
411060,202010,516,346,170,361570,177650,539220
411065,202010,52,45,7,47025,7315,54340
411070,202010,1256,749,507,783750,529815,1313565
411080,202010,241,171,70,178695,73150,251845
411090,202010,97,75,22,78375,22990,101365
411095,202010,287,110,177,114950,184965,299915
411100,202010,116,95,21,99275,22990,122265
411110,202010,132,81,51,86735,53295,140030
411120,202010,213,144,69,150480,72105,222585
411125,202010,243,102,141,106590,148390,254980
411130,202010,129,110,19,114950,19855,134805
411140,202010,213,139,74,145255,77330,222585
411150,202010,1227,797,430,834955,451440.54,1286395.54
411155,202010,119,81,38,84645,39710,124355
411160,202010,25,11,14,11495,14630,26125
411170,202010,53,47,6,49115,6270,55385
411180,202010,978,640,338,669845,354255,1024100
411190,202010,334,191,143,199595,149435,349030
411200,202010,668,405,263,423225.29,275880,699105.29
411210,202010,688,363,325,379335,339625.5,718960.5
411220,202010,159,112,47,117040,49115,166155
411230,202010,40,33,7,34485,7315,41800
411240,202010,118,74,44,78375,45980,124355
411250,202010,437,317,120,331265,125400,456665
411260,202010,16,11,5,11495,5225,16720
411270,202010,273,145,128,153615,133760,287375
411275,202010,182,160,22,167200,22990,190190
411280,202010,213,149,64,155705.29,66880,222585.29
411290,202010,63,48,15,50160,15675,65835
411295,202010,137,108,29,112860,31350,144210
411300,202010,80,36,44,37620,45980,83600
411310,202010,89,69,20,72105,20900,93005
411320,202010,784,519,265,544445,276925,821370
411325,202010,63,42,21,43890,21945,65835
411330,202010,909,578,331,604985.83,345895.99,950881.82
411340,202010,29,18,11,18810,11495,30305
411342,202010,65,48,17,50160,17765,67925
411345,202010,115,56,59,58520,61655,120175
411350,202010,480,362,118,379335.45,123310.5,502645.95
411360,202010,53,34,19,35530,19855,55385
411370,202010,14227,5731,8496,5998305.53,8903402.63,14901708.16
411373,202010,171,120,51,126445,53295,179740
411375,202010,78,62,16,64790,16720,81510
411380,202010,83,60,23,62700,24035,86735
411390,202010,129,78,51,81510,53295,134805
411400,202010,382,274,108,286330,112860,399190
411410,202010,447,222,225,233035,235125.5,468160.5
411420,202010,993,430,563,451440,589380.5,1040820.5
411430,202010,469,268,201,280060,213180,493240
411435,202010,34,21,13,21945,13585,35530
411440,202010,461,361,100,379335,104500,483835
411450,202010,426,359,67,376200,71060,447260
411460,202010,780,290,490,305140,514140.57,819280.57
411470,202010,88,62,26,64790,27170,91960
411480,202010,667,366,301,383515.5,314545,698060.5
411490,202010,289,185,104,193325,110770,304095
411500,202010,100,82,18,85690,18810,104500
411510,202010,220,177,43,184965,45980,230945
411520,202010,6045,2252,3793,2362746,3981452.01,6344198.01
411530,202010,126,86,40,89870,41800,131670
411535,202010,52,20,32,20900,33440,54340
411540,202010,352,240,112,251845,117040,368885
411545,202010,56,40,16,41800,16720,58520
411550,202010,84,64,20,66880,20900,87780
411560,202010,399,167,232,174515,243485,418000
411570,202010,854,299,555,313500.2,581020,894520.2
411573,202010,24,15,9,15675,9405,25080
411575,202010,296,187,109,195415,113905,309320
411580,202010,1266,452,814,473385.85,853765,1327150.85
411585,202010,76,37,39,38665,40755,79420
411590,202010,20,13,7,14630,7315,21945
411600,202010,24,10,14,10450,14630,25080
411605,202010,237,97,140,101365,147345,248710
411610,202010,209,134,75,141075,78375,219450
411620,202010,370,196,174,205865,183920,389785
411630,202010,57,38,19,39710,19855,59565
411640,202010,32,23,9,24035,9405,33440
411650,202010,12,7,5,7315,5225,12540
411660,202010,38,25,13,26125,13585,39710
411670,202010,241,176,65,184965,67925,252890
411680,202010,164,135,29,142120,30305,172425
411690,202010,585,308,277,321860,290510,612370
411695,202010,62,45,17,47025,17765,64790
411700,202010,142,115,27,120175,28215,148390
411705,202010,106,70,36,73150,37620,110770
411710,202010,296,197,99,205865,104500,310365
411720,202010,133,89,44,94050,45980,140030
411721,202010,67,56,11,58520,11495,70015
411722,202010,104,44,60,47025,62700,109725
411725,202010,153,115,38,120175.5,39710,159885.5
411727,202010,85,65,20,67925,20900,88825
411729,202010,38,31,7,32395,7315,39710
411730,202010,556,350,206,365750,215270,581020
411740,202010,39,23,16,24035,16720,40755
411745,202010,68,49,19,51205,19855,71060
411750,202010,853,373,480,392920.5,502645,895565.5
411760,202010,1177,868,309,908105.6,323950,1232055.6
411770,202010,458,301,157,315590,165110,480700
411780,202010,350,228,122,238260,127490,365750
411790,202010,528,292,236,305140.22,246620,551760.22
411800,202010,159,119,40,125400.96,41800,167200.96
411810,202010,175,132,43,137940,44935,182875
411820,202010,2229,966,1263,1011561.7,1322970,2334531.7
411830,202010,10,9,1,9405,1045,10450
411840,202010,2019,1231,788,1288485,823461,2111946
411845,202010,54,19,35,19855,37620,57475
411850,202010,1225,672,553,704330.5,579975.75,1284306.25
411860,202010,48,31,17,32395.5,17765,50160.5
411870,202010,73,46,27,48070,28215,76285
411880,202010,420,266,154,277970,161975,439945
411885,202010,104,68,36,71060,37620,108680
411890,202010,306,198,108,206911.49,113905,320816.49
411900,202010,81,61,20,63745.5,20900,84645.5
411910,202010,180,140,40,146300,41800,188100
411915,202010,2208,890,1318,931095,1380445.05,2311540.05
411920,202010,121,96,25,100320,26125,126445
411925,202010,13,8,5,8360,5225,13585
411930,202010,806,579,227,608257.72,237215,845472.72
411940,202010,584,396,188,414865.85,197505,612370.85
411950,202010,1022,482,540,505780.76,564300,1070080.76
411960,202010,1054,698,356,731500.75,373065,1104565.75
411965,202010,19,13,6,13585,6270,19855
411970,202010,85,75,10,78375,10450,88825
411980,202010,167,107,60,111815,62700,174515
411990,202010,5138,2903,2235,3043709.1,2341915.25,5385624.35
411995,202010,513,166,347,175560,364705,540265
412000,202010,315,202,113,211090,118085,329175
412010,202010,46,28,18,29260,18810,48070
412015,202010,42,30,12,31350,12540,43890
412020,202010,32,25,7,26125,7315,33440
412030,202010,45,43,2,45980,2090,48070
412033,202010,52,28,24,29260,25080,54340
412035,202010,72,44,28,47025,29260,76285
412040,202010,45,25,20,26125.5,20900,47025.5
412050,202010,204,155,49,161975,51205,213180
412060,202010,785,575,210,603452.66,219450,822902.66
412065,202010,52,32,20,33440,20900,54340
412070,202010,161,108,53,112860,56430,169290
412080,202010,296,147,149,153615,155705,309320
412085,202010,38,16,22,16720,22990,39710
412090,202010,808,512,296,535040.25,309320,844360.25
412100,202010,245,206,39,216315,41800,258115
412110,202010,69,54,15,56430.01,15675,72105.01
412120,202010,328,195,133,203775,138985,342760
412125,202010,82,50,32,52250,33440,85690
412130,202010,37,23,14,24035.4,14630,38665.4
412135,202010,29,16,13,16720,13585,30305
412140,202010,354,229,125,240350,130625,370975
412150,202010,251,166,85,173470,88825,262295
412160,202010,89,51,38,53295,40755,94050
412170,202010,694,475,219,498465.5,228855,727320.5
412175,202010,37,26,11,27170,11495,38665
412180,202010,194,145,49,151525,52250,203775
412190,202010,328,259,69,270655,72105,342760
412200,202010,185,121,64,126445,66880,193325
412210,202010,72,56,16,58520,16720,75240
412215,202010,233,165,68,172732.23,71060,243792.23
412217,202010,65,52,13,54340,13585,67925
412220,202010,839,585,254,612370,266475,878845
412230,202010,325,198,127,206910,132715,339625
412240,202010,1347,658,689,689700.75,721050,1410750.75
412250,202010,407,251,156,263340,163020,426360
412260,202010,111,79,32,82555,33440,115995
412265,202010,179,138,41,144210,42845,187055
412270,202010,85,59,26,61655,29260,90915
412280,202010,90,72,18,75240,18810,94050
412290,202010,93,64,29,66880,30305,97185
412300,202010,212,141,71,147345,75240,222585
412310,202010,49,42,7,43890,8360,52250
412320,202010,97,80,17,84645,17765,102410
412330,202010,185,156,29,165110,30305,195415
412340,202010,158,110,48,114950,50160.5,165110.5
412350,202010,623,301,322,314545,336490,651035
412360,202010,26,22,4,22990,4180,27170
412370,202010,164,142,22,148390.3,22990,171380.3
412380,202010,256,194,62,202730,64790,267520
412382,202010,63,34,29,35530,30305,65835
412385,202010,150,106,44,110770,45980,156750
412390,202010,280,212,68,223630,71060,294690
412395,202010,70,58,12,60610,12540,73150
412400,202010,95,64,31,66880,33440,100320
412402,202010,228,112,116,117040.5,121220,238260.5
412405,202010,872,306,566,319770,592515,912285
412410,202010,972,592,380,620730.5,397100,1017830.5
412420,202010,13,12,1,12540,1045,13585
412430,202010,21,17,4,17765,4180,21945
412440,202010,613,328,285,344850,297825,642675
412450,202010,75,65,10,67925,10450,78375
412460,202010,93,72,21,75240,21945,97185
412470,202010,216,172,44,180785,47025,227810
412480,202010,145,106,39,110770.75,40755,151525.75
412490,202010,158,139,19,145255,19855,165110
412500,202010,434,352,82,367840.56,85690,453530.56
412510,202010,177,143,34,150480,35530,186010
412520,202010,93,61,32,63745,33440,97185
412530,202010,105,55,50,57475,52250,109725
412535,202010,90,67,23,71060,24035,95095
412540,202010,82,39,43,40755,44935,85690
412545,202010,89,61,28,63745,29260,93005
412550,202010,3833,1596,2237,1673046.02,2341846.5,4014892.52
412555,202010,13,9,4,9405,4180,13585
412560,202010,620,433,187,452486.5,195415,647901.5
412570,202010,763,386,377,403370,395010,798380
412575,202010,91,63,28,65835,29260,95095
412580,202010,176,117,59,122265,62700,184965
412590,202010,37,32,5,33440,5225,38665
412600,202010,170,123,47,128535.85,50160,178695.85
412610,202010,36,17,19,17765,19855,37620
412620,202010,144,121,23,126445,24035,150480
412625,202010,2140,1113,1027,1166221.04,1075306.85,2241527.89
412627,202010,68,50,18,52250,18810,71060
412630,202010,403,266,137,279015,143165,422180
412635,202010,65,18,47,18810,49115,67925
412640,202010,103,73,30,76285,31350,107635
412650,202010,329,215,114,225720,119130,344850
412660,202010,469,280,189,292600,198550,491150
412665,202010,45,40,5,41800,5225,47025
412667,202010,297,199,98,207955,102410,310365
412670,202010,65,53,12,55385,12540,67925
412680,202010,298,231,67,241395,71060.7,312455.7
412690,202010,106,68,38,71060,39710.5,110770.5
412700,202010,162,109,53,113905,55385,169290
412710,202010,1375,818,557,856901.25,584155,1441056.25
412720,202010,228,140,88,146300,94050,240350
412730,202010,188,159,29,166155,31350,197505
412740,202010,423,222,201,234080,213180,447260
412750,202010,427,240,187,254980,196460,451440
412760,202010,287,146,141,152570,147345.05,299915.05
412770,202010,2139,1181,958,1235190.29,1003201,2238391.29
412780,202010,137,107,30,111815,32395,144210
412785,202010,287,138,149,144210,155705,299915
412788,202010,39,23,16,24035.5,16720,40755.5
412790,202010,121,102,19,106590,19855,126445
412795,202010,151,106,45,110770,47025,157795
412796,202010,316,205,111,215270,115995,331265
412800,202010,626,370,256,387695.25,268565,656260.25
412810,202010,2953,1592,1361,1668867.25,1429560,3098427.25
412820,202010,933,576,357,602966.75,375155,978121.75
412830,202010,14,11,3,11495,3135,14630
412840,202010,234,165,69,172425.94,72105,244530.94
412850,202010,749,481,268,504735,282150,786885
412853,202010,172,85,87,88825,90915,179740
412855,202010,177,96,81,100320.09,84645,184965.09
412860,202010,94,64,30,66880,32395,99275
412862,202010,58,37,21,38665,21945,60610
412863,202010,7,5,2,5225,2090,7315
412865,202010,45,32,13,33440,13585,47025
412870,202010,109,67,42,70015,43890,113905
412880,202010,92,66,26,68970.5,27170,96140.5
420005,202010,41,37,4,38665,4180,42845
420010,202010,364,232,132,242440,137940,380380
420020,202010,79,66,13,68970,13585,82555
420030,202010,23,20,3,20900,3135,24035
420040,202010,103,80,23,83600,24035,107635
420050,202010,57,35,22,36575,22990,59565
420055,202010,19,19,0,19855,0,19855
420060,202010,29,23,6,24035,6270,30305
420070,202010,102,85,17,88825,17765,106590
420075,202010,11,11,0,11495,0,11495
420080,202010,43,38,5,39710,5225,44935
420090,202010,34,30,4,31350,4180,35530
420100,202010,148,126,22,131670.5,22990,154660.5
420110,202010,19,19,0,19855,0,19855
420120,202010,58,41,17,42845,17765,60610
420125,202010,79,61,18,63745,18810,82555
420127,202010,32,26,6,27170,6270,33440
420130,202010,435,266,169,277970,176605,454575
420140,202010,1296,720,576,752400.75,605055,1357455.75
420150,202010,44,37,7,38665,7315,45980
420160,202010,32,30,2,31350,2090,33440
420165,202010,16,11,5,11495,5225,16720
420170,202010,75,48,27,50160,28215,78375
420180,202010,22,19,3,19855,3135,22990
420190,202010,26,23,3,24035,3135,27170
420195,202010,131,63,68,65835,71060,136895
420200,202010,1254,555,699,582065.5,734635,1316700.5
420205,202010,87,47,40,49115,41800,90915
420207,202010,120,66,54,68970,56430,125400
420208,202010,19,15,4,15675,4180,19855
420209,202010,18,15,3,15675,3135,18810
420210,202010,512,240,272,250800,284240,535040
420213,202010,43,35,8,36575,8360,44935
420215,202010,27,24,3,25080,3135,28215
420220,202010,63,41,22,42845,22990,65835
420230,202010,831,466,365,488015,384560.5,872575.5
420240,202010,2217,1441,776,1510026.4,814055,2324081.4
420243,202010,41,31,10,32395,10450,42845
420245,202010,162,84,78,87780,81510,169290
420250,202010,61,40,21,41800,21945,63745
420253,202010,29,23,6,24035,6270,30305
420257,202010,13,10,3,10450,3135,13585
420260,202010,99,82,17,85690,17765,103455
420270,202010,30,25,5,26125,5225,31350
420280,202010,289,218,71,230945.75,75240.75,306186.50
420285,202010,22,13,9,13585,9405,22990
420287,202010,49,32,17,34485,17765,52250
420290,202010,971,668,303,700150.5,318725,1018875.5
420300,202010,1424,1116,308,1171447.95,321860.65,1493308.60
420310,202010,52,35,17,36575,17765,54340
420315,202010,35,27,8,28215.5,8360,36575.5
420320,202010,935,451,484,474430.1,505780,980210.1
420325,202010,1,0,1,0,1045,1045
420330,202010,119,78,41,81510,42845,124355
420340,202010,164,108,56,113905,59565,173470
420350,202010,261,183,78,191235,81510,272745
420360,202010,722,551,171,576841.33,179740,756581.33
420370,202010,117,69,48,73150,50160.5,123310.5
420380,202010,1179,817,362,853765.75,380380.5,1234146.25
420390,202010,246,173,73,181830,77330,259160
420395,202010,195,140,55,148390,58520,206910
420400,202010,241,184,57,192280.65,59565,251845.65
420410,202010,59,44,15,47025,15675,62700
420415,202010,35,29,6,30305,6270,36575
420417,202010,49,37,12,38665,12540,51205
420419,202010,11,11,0,11495,0,11495
420420,202010,2835,1741,1094,1823528.24,1145320.5,2968848.74
420425,202010,69,56,13,58520,13585,72105
420430,202010,1148,817,331,855855.45,345895,1201750.45
420435,202010,15,13,2,13585,2090,15675
420440,202010,101,71,30,74195.5,31350,105545.5
420445,202010,28,26,2,27170,2090,29260
420450,202010,78,39,39,40755,40755,81510
420455,202010,209,159,50,169290,52250,221540
420460,202010,2325,1491,834,1564367.5,876755,2441122.5
420470,202010,101,74,27,77330,28215,105545
420475,202010,7,7,0,7315,0,7315
420480,202010,850,637,213,665666,222585.5,888251.5
420490,202010,102,76,26,80465,28215.65,108680.65
420500,202010,451,236,215,246621.09,225720,472341.09
420510,202010,20,18,2,18810,3135,21945
420515,202010,26,17,9,17765,9405,27170
420517,202010,9,9,0,9405,0,9405
420519,202010,0,,,,,0.0
420520,202010,66,50,16,52250,16720,68970
420530,202010,159,106,53,111815.75,55385,167200.75
420535,202010,19,17,2,17765,2090,19855
420540,202010,5516,3294,2222,3446675.65,2329305.5,5775981.15
420543,202010,32,30,2,31350,2090,33440
420545,202010,204,146,58,152570,60610,213180
420550,202010,852,700,152,732546.4,158840,891386.4
420555,202010,35,26,9,27170,9405,36575
420560,202010,61,51,10,53295,10450,63745
420570,202010,159,91,68,95095,71060,166155
420580,202010,279,132,147,137940,153615.5,291555.5
420590,202010,514,352,162,367840,169290,537130
420600,202010,117,64,53,66880,55385,122265
420610,202010,40,36,4,37620,4180,41800
420620,202010,89,69,20,72105,20900,93005
420630,202010,152,103,49,108680,51205,159885
420640,202010,83,74,9,77330,9405,86735
420650,202010,241,121,120,126445,125400,251845
420660,202010,49,39,10,40755.5,10450,51205.5
420665,202010,35,26,9,27170,9405,36575
420670,202010,296,228,68,238260,71060,309320
420675,202010,11,10,1,10450,1045,11495
420680,202010,37,27,10,28215,10450,38665
420690,202010,177,137,40,143165,41800,184965
420700,202010,683,462,221,485925.46,231990,717915.46
420710,202010,146,78,68,81510,71060,152570
420720,202010,110,89,21,93005,21945,114950
420730,202010,611,380,231,398145.4,241395.5,639540.9
420740,202010,52,51,1,53295,1045,54340
420750,202010,492,334,158,351120,165110,516230
420757,202010,16,14,2,14630,2090,16720
420760,202010,39,31,8,32395,8360,40755
420765,202010,79,60,19,62700,19855,82555
420768,202010,48,42,6,43890,6270,50160
420770,202010,71,62,9,64790,9405,74195
420775,202010,41,37,4,38665,4180,42845
420780,202010,220,173,47,180785,49115,229900
420785,202010,12,9,3,9405,3135,12540
420790,202010,164,135,29,141075,30305,171380
420800,202010,65,49,16,52250,16720,68970
420810,202010,257,211,46,221540,48070,269610
420820,202010,2374,1343,1031,1406570.5,1080531.22,2487101.72
420830,202010,621,323,298,340670.5,312455,653125.5
420840,202010,153,107,46,111815,48070,159885
420845,202010,411,176,235,183920,246620.5,430540.5
420850,202010,256,187,69,195415,72105,267520
420860,202010,55,46,9,49115,9405,58520
420870,202010,126,87,39,90915,40755,131670
420880,202010,180,113,67,118085,70015,188100
420890,202010,939,468,471,490105.25,493240,983345.25
420895,202010,9,9,0,9405,0,9405
420900,202010,406,320,86,335445,89870,425315
420910,202010,5818,3199,2619,3358633.58,2743125,6101758.58
420915,202010,61,57,4,59565,4180,63745
420917,202010,22,15,7,15675,7315,22990
420920,202010,22,15,7,15675,7315,22990
420930,202010,2780,1721,1059,1802971,1109791.42,2912762.42
420940,202010,591,435,156,455621,164065.9,619686.9
420945,202010,8,6,2,6270,2090,8360
420950,202010,55,48,7,50160,7315,57475
420960,202010,109,87,22,90915,22990,113905
420970,202010,284,229,55,240351,57475,297826
420980,202010,23,22,1,22990,1045,24035
420985,202010,55,49,6,52250,6270,58520
420990,202010,82,58,24,60610,25080,85690
421000,202010,43,25,18,26125,18810,44935
421003,202010,49,33,16,34485,16720,51205
421005,202010,6,3,3,3135,3135,6270
421010,202010,777,517,260,540266,271700.75,811966.75
421020,202010,25,20,5,20900,5225,26125
421030,202010,117,98,19,102410.75,19855,122265.75
421040,202010,72,53,19,55385,19855,75240
421050,202010,350,245,105,257071,110770,367841
421055,202010,20,16,4,16720,4180,20900
421060,202010,89,50,39,52250,40755,93005
421070,202010,50,43,7,44935.5,7315,52250.5
421080,202010,35,31,4,32395,4180,36575
421085,202010,20,15,5,15675,5225,20900
421090,202010,36,28,8,29260,8360,37620
421100,202010,125,91,34,96140,35530,131670
421105,202010,190,153,37,159885,38665,198550
421110,202010,108,85,23,88825,24035,112860
421120,202010,169,123,46,128535.42,48070,176605.42
421125,202010,17,12,5,12540,5225,17765
421130,202010,828,516,312,541310,326040.5,867350.5
421140,202010,31,21,10,21945,10450,32395
421145,202010,41,33,8,34485,8360,42845
421150,202010,100,71,29,74195,30305,104500
421160,202010,67,46,21,48070,21945,70015
421165,202010,15,14,1,14630,1045,15675
421170,202010,184,155,29,162101,30305,192406
421175,202010,161,110,51,114950,53295,168245
421180,202010,46,32,14,33440.1,14630,48070.1
421185,202010,18,14,4,14630,4180,18810
421187,202010,1,0,1,0,1045,1045
421189,202010,46,31,15,32395,15675,48070
421190,202010,1699,1055,644,1106655,677160,1783815
421200,202010,94,70,24,73150,25080,98230
421205,202010,28,19,9,19855,9405,29260
421210,202010,173,118,55,124355,57475,181830
421220,202010,271,209,62,220495,64790,285285
421223,202010,45,36,9,39710,9405,49115
421225,202010,70,45,25,47025,26125,73150
421227,202010,85,67,18,70015,18810,88825
421230,202010,55,40,15,41800,15675,57475
421240,202010,17,17,0,18810,0,18810
421250,202010,369,213,156,222585.5,164065,386650.5
421260,202010,24,20,4,20900,4180,25080
421265,202010,3,2,1,2090,1045,3135
421270,202010,48,42,6,43890,6270,50160
421280,202010,350,184,166,192280,173470,365750
421290,202010,327,216,111,225720,115995.5,341715.5
421300,202010,23,19,4,19855,4180,24035
421310,202010,46,33,13,34485,13585,48070
421315,202010,30,18,12,18810,12540,31350
421320,202010,128,81,47,85690,49115,134805
421330,202010,110,78,32,81510,33440,114950
421335,202010,39,27,12,28215,12540,40755
421340,202010,237,155,82,161975.25,85690,247665.25
421350,202010,189,107,82,111815.82,85690,197505.82
421360,202010,651,474,177,495330.25,184965,680295.25
421370,202010,198,150,48,157795,50160,207955
421380,202010,134,104,30,108680,31350,140030
421390,202010,17,11,6,11495,6270,17765
421400,202010,123,108,15,112860,15675,128535
421410,202010,17,15,2,15675,2090,17765
421415,202010,19,18,1,18810,1045,19855
421420,202010,129,105,24,109725,25080,134805
421430,202010,17,13,4,13585,4180,17765
421440,202010,57,48,9,50160,9405,59565
421450,202010,92,76,16,80465,16720.83,97185.83
421460,202010,63,50,13,52250,13585,65835
421470,202010,68,41,27,42845.25,28215,71060.25
421480,202010,722,550,172,574750,179740,754490
421490,202010,23,22,1,22990,1045,24035
421500,202010,488,313,175,328130.5,184965.25,513095.75
421505,202010,24,17,7,17765,7315,25080
421507,202010,32,25,7,26125,7315,33440
421510,202010,71,46,25,48070,26125,74195
421520,202010,56,47,9,49115,9405,58520
421530,202010,49,41,8,42845,8360,51205
421535,202010,25,23,2,24035,2090,26125
421540,202010,52,44,8,45980,8360,54340
421545,202010,103,74,29,77330,30305,107635
421550,202010,284,204,80,213180,85690,298870
421555,202010,19,16,3,17765,3135,20900
421560,202010,9,8,1,8360,1045,9405
421565,202010,119,80,39,83600,40755,124355
421567,202010,31,24,7,25080,7315,32395
421568,202010,32,28,4,29260,4180,33440
421569,202010,11,11,0,11495,0,11495
421570,202010,202,138,64,144210,66880,211090
421575,202010,28,23,5,24035,5225,29260
421580,202010,725,430,295,449418,310365,759783
421590,202010,21,19,2,19855,2090,21945
421600,202010,155,101,54,105545.5,56430.5,161976.0
421605,202010,106,73,33,77330.75,34485,111815.75
421610,202010,179,136,43,142120,44935,187055
421620,202010,1023,596,427,623865,448305,1072170
421625,202010,21,18,3,18810,3135,21945
421630,202010,306,191,115,201685.25,121221.5,322906.75
421635,202010,18,9,9,9405,9405,18810
421640,202010,101,84,17,87780,17765,105545
421650,202010,300,176,124,186010,129580,315590
421660,202010,2250,1338,912,1400302,954086,2354388
421670,202010,180,130,50,136895,52250,189145
421680,202010,176,160,16,168245,16720,184965
421690,202010,341,240,101,250801.25,105545.6,356346.85
421700,202010,54,37,17,38665,17765,56430
421710,202010,25,23,2,24035,2090,26125
421715,202010,5,4,1,4180,1045,5225
421720,202010,628,439,189,458756.27,197505,656261.27
421725,202010,17,6,11,6270,11495,17765
421730,202010,33,24,9,25080,9405,34485
421740,202010,91,33,58,35530,61655,97185
421750,202010,206,154,52,161975,56430,218405
421755,202010,23,21,2,21945,2090,24035
421760,202010,101,68,33,71060,34485,105545
421770,202010,666,411,255,431586.75,266475,698061.75
421775,202010,27,16,11,16720,11495,28215
421780,202010,192,148,44,155705.5,45980,201685.5
421790,202010,148,126,22,133760,22990,156750
421795,202010,17,14,3,14630,3135,17765
421800,202010,513,322,191,337535,199595,537130
421810,202010,69,55,14,57475,14630,72105
421820,202010,309,202,107,211090.5,111815,322905.5
421825,202010,140,119,21,124355,21945,146300
421830,202010,138,90,48,94050,50160,144210
421835,202010,7,4,3,4180,3135,7315
421840,202010,46,41,5,42845,6270,49115
421850,202010,80,67,13,70015,13585,83600
421860,202010,35,29,6,30305,6270,36575
421870,202010,1020,761,259,796291.25,271700,1067991.25
421875,202010,54,44,10,45980,10450,56430
421880,202010,169,118,51,123310,54340.5,177650.5
421885,202010,22,17,5,17765,5225,22990
421890,202010,134,93,41,97185,42845,140030
421895,202010,45,40,5,41800,5225,47025
421900,202010,152,118,34,123310,35530,158840
421910,202010,65,37,28,38665,29260,67925
421915,202010,30,24,6,26125,6270,32395
421917,202010,38,29,9,30305,9405,39710
421920,202010,39,35,4,36575,4180,40755
421930,202010,662,531,131,558030,137940,695970
421935,202010,52,45,7,47025,7315,54340
421940,202010,44,38,6,39710,6270,45980
421950,202010,872,587,285,613416,298870,912286
421960,202010,45,40,5,41800,5225,47025
421970,202010,347,222,125,233035.5,130625,363660.5
421985,202010,21,13,8,13585,8360,21945
422000,202010,0,,,,,0.0
430003,202010,196,56,140,59565,146300,205865
430005,202010,37,23,14,25080,14630,39710
430010,202010,270,195,75,203775,78375,282150
430020,202010,141,93,48,97185.5,50160,147345.5
430030,202010,122,98,24,102410,25080,127490
430040,202010,2912,1712,1200,1792177,1254000.5,3046177.5
430045,202010,67,56,11,58520,11495,70015
430047,202010,7,7,0,7315,0,7315
430050,202010,80,65,15,67925,15675,83600
430055,202010,11,10,1,10450,1045,11495
430057,202010,5,4,1,4180,1045,5225
430060,202010,3714,2142,1572,2244660.75,1650055,3894715.75
430063,202010,54,50,4,52250,4180,56430
430064,202010,150,120,30,125400,31350,156750
430066,202010,5,2,3,2090,3135,5225
430070,202010,43,29,14,30305,14630,44935
430080,202010,69,45,24,47025,25080,72105
430085,202010,29,10,19,10450,19855,30305
430087,202010,27,17,10,18810.75,10450,29260.75
430090,202010,71,64,7,66880,7315,74195
430100,202010,124,84,40,88825,41800,130625
430105,202010,150,83,67,86735,71060,157795
430107,202010,18,12,6,12540,6270,18810
430110,202010,455,256,199,267520,207955,475475
430120,202010,159,147,12,153615,12540,166155
430130,202010,798,486,312,508915.5,326040,834955.5
430140,202010,124,115,9,120175,9405,129580
430150,202010,110,70,40,74195,41800,115995
430155,202010,33,28,5,29260,5225,34485
430160,202010,3614,2115,1499,2214357.75,1571680.5,3786038.25
430163,202010,358,156,202,163020,211090,374110
430165,202010,30,20,10,20900,10450,31350
430170,202010,88,73,15,76285,15675,91960
430175,202010,74,58,16,61655,16720,78375
430180,202010,105,86,19,89870,19855,109725
430185,202010,29,18,11,18810,11495,30305
430187,202010,79,37,42,38665,44935,83600
430190,202010,215,118,97,123310,101365,224675
430192,202010,13,11,2,11495,2090,13585
430195,202010,16,10,6,10450,6270,16720
430200,202010,165,141,24,147345,25080,172425
430205,202010,20,20,0,20900,0,20900
430210,202010,673,517,156,543121.33,164030.16,707151.49
430215,202010,11,10,1,10450,1045,11495
430220,202010,75,51,24,53295,25080,78375
430222,202010,13,6,7,6270,7315,13585
430223,202010,15,8,7,8360,7315,15675
430225,202010,2,1,1,1045,1045,2090
430230,202010,309,183,126,191235,132715.5,323950.5
430235,202010,53,41,12,43890,12540,56430
430237,202010,28,21,7,21945,7315,29260
430240,202010,121,80,41,83600,42845,126445
430245,202010,70,57,13,59565,13585,73150
430250,202010,181,106,75,110770,78375,189145
430258,202010,9,8,1,8360,1045,9405
430260,202010,31,27,4,28215,4180,32395
430265,202010,37,31,6,32395,6270,38665
430270,202010,518,388,130,405461.25,135850,541311.25
430280,202010,1035,623,412,653125,430540,1083665
430290,202010,398,216,182,225720,190190,415910
430300,202010,2092,1149,943,1204885.75,991705.5,2196591.25
430310,202010,2017,1010,1007,1059630.5,1055451.21,2115081.71
430320,202010,55,46,9,48070,9405,57475
430330,202010,98,86,12,89870,12540,102410
430340,202010,73,58,15,60610,15675,76285
430350,202010,1656,1115,541,1167266,567435,1734701
430355,202010,21,19,2,19855,2090,21945
430360,202010,85,43,42,44935,43890,88825
430367,202010,34,25,9,26125,9405,35530
430370,202010,52,47,5,49115,5225,54340
430380,202010,125,96,29,100320,30305,130625
430390,202010,586,366,220,383515,231990,615505
430400,202010,257,185,72,193325.5,76285,269610.5
430410,202010,54,43,11,44935,11495,56430
430420,202010,504,326,178,341715.85,188100,529815.85
430430,202010,55,54,1,55734.03,1045,56779.03
430435,202010,151,113,38,118085,39710,157795
430440,202010,485,317,168,332310,175560,507870
430450,202010,1142,941,201,985435,210045,1195480
430460,202010,5299,2750,2549,2884201.9,2677290.28,5561492.18
430461,202010,16,15,1,15675,1045,16720
430462,202010,10,6,4,6270,4180,10450
430463,202010,1109,593,516,619685,539220,1158905
430465,202010,24,13,11,13585,11495,25080
430466,202010,650,456,194,476520.5,203775,680295.5
430467,202010,107,58,49,60610,52250,112860
430468,202010,116,69,47,72105,49115,121220
430469,202010,22,17,5,17765,5225,22990
430470,202010,1152,640,512,670156.62,537130,1207286.62
430471,202010,54,36,18,37620,18810,56430
430480,202010,103,66,37,68970,38665,107635
430485,202010,7,7,0,7315.5,0,7315.5
430490,202010,74,59,15,61655,15675,77330
430495,202010,34,26,8,27170,8360,35530
430500,202010,189,127,62,133760,64790,198550
430510,202010,3433,2199,1234,2306315.13,1294755.74,3601070.87
430511,202010,16,16,0,16720,0,16720
430512,202010,152,106,46,110770,48070,158840
430513,202010,54,44,10,45980,10450,56430
430515,202010,28,26,2,27170,2090,29260
430517,202010,167,144,23,150480,24035,174515
430520,202010,339,235,104,245575,108680,354255
430530,202010,84,47,37,49115,38665,87780
430535,202010,443,300,143,313500,149435,462935
430537,202010,10,10,0,10450,0,10450
430540,202010,82,57,25,59565,26125,85690
430543,202010,359,112,247,118085,258115,376200
430544,202010,43,40,3,41800,3135,44935
430545,202010,381,188,193,196460.5,201685,398145.5
430550,202010,41,33,8,34485,8360,42845
430558,202010,2,2,0,2090,0,2090
430560,202010,55,29,26,30305,27170,57475
430570,202010,107,41,66,42845,68970,111815
430580,202010,130,105,25,109725,27170,136895
430583,202010,13,13,0,13585,0,13585
430585,202010,10,5,5,5225,6270,11495
430587,202010,15,7,8,7315,8360,15675
430590,202010,142,115,27,120175,28215,148390
430593,202010,2,2,0,2090,0,2090
430595,202010,17,14,3,14630,3135,17765
430597,202010,41,19,22,19855,22990,42845
430600,202010,218,160,58,167200,60610,227810
430605,202010,159,98,61,103455,63745,167200
430607,202010,25,20,5,20900,5225,26125
430610,202010,1627,752,875,786885,915420.5,1702305.5
430613,202010,3,3,0,3135,0,3135
430620,202010,111,79,32,82555,33440,115995
430630,202010,46,40,6,42845,6270,49115
430632,202010,32,27,5,28215,5225,33440
430635,202010,35,31,4,32395,4180,36575
430637,202010,62,30,32,31350,33440,64790
430640,202010,182,97,85,102410,88825.5,191235.5
430642,202010,22,18,4,18810,4180,22990
430645,202010,33,27,6,28215,6270,34485
430650,202010,243,199,44,207955.5,45980,253935.5
430655,202010,2,2,0,2090,0,2090
430660,202010,979,486,493,508915,516231,1025146
430670,202010,78,52,26,54340,27170,81510
430673,202010,69,42,27,43890,28215,72105
430675,202010,11,9,2,9405,2090,11495
430676,202010,523,310,213,323950,224675,548625
430680,202010,231,158,73,165110.5,76285,241395.5
430690,202010,528,325,203,339625,213180.29,552805.29
430692,202010,8,6,2,6270,2090,8360
430693,202010,138,88,50,91960,52250,144210
430695,202010,65,54,11,56430,11495,67925
430697,202010,58,36,22,37620,22990,60610
430700,202010,1474,1019,455,1066945.9,479655,1546600.9
430705,202010,26,23,3,24035,3135,27170
430710,202010,251,159,92,166155,96140,262295
430720,202010,109,94,15,98230,15675,113905
430730,202010,139,119,20,124355,20900,145255
430740,202010,74,51,23,53295,24035,77330
430745,202010,29,23,6,24035,6270,30305
430750,202010,327,218,109,228855,113905,342760
430755,202010,90,48,42,50160,43890,94050
430760,202010,381,210,171,219450.6,178744,398194.6
430770,202010,1498,775,723,815100.5,756580,1571680.5
430780,202010,304,191,113,200640,118085,318725
430781,202010,25,21,4,21945,4180,26125
430783,202010,61,49,12,51205,12540,63745
430786,202010,5,3,2,3135,2090,5225
430790,202010,514,336,178,351120,187055.5,538175.5
430800,202010,152,122,30,127490.76,31350,158840.76
430805,202010,43,36,7,37620,7315,44935
430807,202010,45,23,22,24035,22990,47025
430810,202010,73,44,29,45980,30305,76285
430820,202010,143,84,59,88825,61655,150480
430825,202010,10,8,2,8360,2090,10450
430830,202010,239,220,19,229900.5,19855,249755.5
430840,202010,128,84,44,87780,45980,133760
430843,202010,5,3,2,3135,2090,5225
430845,202010,73,40,33,41800,34485,76285
430850,202010,577,412,165,431585,174515,606100
430860,202010,160,103,57,109725,59565,169290
430865,202010,76,42,34,43890,35530,79420
430870,202010,83,68,15,71060,15675,86735
430880,202010,152,110,42,114950,43890,158840
430885,202010,11,9,2,9405,2090,11495
430890,202010,336,202,134,212135,140030,352165
430900,202010,506,352,154,367840,161975,529815
430905,202010,124,53,71,56430,74195,130625
430910,202010,280,157,123,164065,131670,295735
430912,202010,6,5,1,5225,1045,6270
430915,202010,35,31,4,32395,4180,36575
430920,202010,4330,2290,2040,2401410,2139115.25,4540525.25
430925,202010,5,4,1,4180,1045,5225
430930,202010,2075,1191,884,1247731.75,926915,2174646.75
430940,202010,255,166,89,173470,93005,266475
430950,202010,154,125,29,130625,31350,161975
430955,202010,23,12,11,12540,11495,24035
430957,202010,19,17,2,17765,2090,19855
430960,202010,245,163,82,170335,85690,256025
430965,202010,112,71,41,74195,42845,117040
430970,202010,84,69,15,72105,15675,87780
430975,202010,43,38,5,39710,5225,44935
430980,202010,47,29,18,30305,18810,49115
430990,202010,101,78,23,81510,24035,105545
430995,202010,114,108,6,112860,6270,119130
431000,202010,294,140,154,146301.1,160930,307231.1
431010,202010,348,196,152,204820,160930,365750
431020,202010,1843,1056,787,1107700,825550,1933250
431030,202010,40,32,8,33440,8360,41800
431033,202010,403,192,211,200640,220495,421135
431036,202010,11,6,5,6270,5225,11495
431040,202010,141,87,54,90915,56430,147345
431041,202010,39,26,13,27170.5,14630,41800.5
431043,202010,43,26,17,27170,17765,44935
431046,202010,11,8,3,8360,4180,12540
431050,202010,196,124,72,129580,75240,204820
431053,202010,67,40,27,41800,28215,70015
431055,202010,62,42,20,43890,20900,64790
431057,202010,18,18,0,18810,0,18810
431060,202010,1606,1046,560,1095162.09,587290.75,1682452.84
431065,202010,17,11,6,11495,6270,17765
431070,202010,65,60,5,62700,5225,67925
431075,202010,7,7,0,7315,0,7315
431080,202010,136,81,55,84645,58520,143165
431085,202010,34,31,3,32395,4180,36575
431087,202010,16,14,2,14630,2090,16720
431090,202010,55,43,12,44935,12540,57475
431100,202010,1216,732,484,764940.5,505780,1270720.5
431110,202010,226,137,89,144210,93005.5,237215.5
431112,202010,27,16,11,16720,11495,28215
431113,202010,35,25,10,26125,10450,36575
431115,202010,157,109,48,113905,50160,164065
431120,202010,604,359,245,375155,257070,632225
431123,202010,3,2,1,2090,1045,3135
431125,202010,93,84,9,87780,9405,97185
431127,202010,10,5,5,5225,5225,10450
431130,202010,695,456,239,476520,249755,726275
431140,202010,739,507,232,533995.5,244530,778525.5
431142,202010,26,22,4,22990.67,4180,27170.67
431150,202010,191,144,47,150480,49115,199595
431160,202010,47,44,3,45980,3135,49115
431162,202010,5,4,1,4180,1045,5225
431164,202010,6,6,0,6270,0,6270
431170,202010,105,83,22,86735,22990,109725
431171,202010,67,40,27,41800,28215,70015
431173,202010,1,1,0,1045,0,1045
431175,202010,198,100,98,104500.5,102410,206910.5
431177,202010,83,60,23,62700,24035,86735
431179,202010,12,10,2,10450,2090,12540
431180,202010,435,265,170,277970,178695,456665
431190,202010,78,60,18,62700,18810,81510
431198,202010,73,54,19,56430,20900,77330
431200,202010,20,16,4,16720,4180,20900
431205,202010,20,19,1,19855,1045,20900
431210,202010,95,60,35,62700,36575,99275
431213,202010,30,26,4,27170,4180,31350
431215,202010,22,19,3,19855,3135,22990
431217,202010,5,4,1,4180,1045,5225
431220,202010,65,56,9,58520,9405,67925
431225,202010,154,99,55,103455,58520,161975
431230,202010,98,85,13,89870,13585,103455
431235,202010,7,7,0,7315,0,7315
431237,202010,18,14,4,14630,4180,18810
431238,202010,10,6,4,6270,4180,10450
431240,202010,1019,634,385,663575,403370,1066945
431242,202010,39,38,1,39710,1045,40755
431244,202010,14,10,4,10450,4180,14630
431245,202010,51,38,13,39710,13585,53295
431247,202010,11,6,5,6270,5225,11495
431250,202010,275,141,134,147345,140030,287375
431260,202010,59,47,12,49115,12540,61655
431261,202010,18,11,7,11495,7315,18810
431262,202010,15,14,1,14630,1045,15675
431265,202010,149,79,70,82555,73150,155705
431267,202010,18,15,3,15675,3135,18810
431270,202010,321,261,60,273790,62700,336490
431275,202010,38,35,3,36575,3135,39710
431280,202010,21,17,4,17765,4180,21945
431290,202010,23,20,3,20900,3135,24035
431295,202010,2,2,0,2090,0,2090
431300,202010,21,19,2,19855,2090,21945
431301,202010,5,5,0,5225,0,5225
431303,202010,60,39,21,40755,21945,62700
431306,202010,242,129,113,134618.99,118085,252703.99
431308,202010,7,5,2,5225,2090,7315
431310,202010,63,52,11,55385,11495,66880
431320,202010,154,93,61,97185,63745,160930
431330,202010,179,111,68,115995,72035.33,188030.33
431333,202010,24,19,5,19855,5225,25080
431335,202010,8,4,4,5225,4180,9405
431337,202010,354,155,199,161975,207955,369930
431339,202010,19,17,2,17765,2090,19855
431340,202010,3019,1640,1379,1721032.44,1446281.25,3167313.69
431342,202010,37,24,13,25080,13585,38665
431344,202010,18,18,0,18810,0,18810
431346,202010,5,5,0,5225,0,5225
431349,202010,35,31,4,32395,4180,36575
431350,202010,942,542,400,567435.75,420090,987525.75
431360,202010,50,42,8,43890,8360,52250
431365,202010,338,151,187,159885,196460,356345
431370,202010,1200,685,515,716870.5,539220,1256090.5
431380,202010,96,84,12,87780,12540,100320
431390,202010,502,265,237,276925,248710,525635
431395,202010,298,126,172,131670,179740,311410
431400,202010,45,30,15,31350,15675,47025
431402,202010,106,75,31,78375,32395,110770
431403,202010,23,14,9,14630,9405,24035
431405,202010,677,374,303,391875.25,316635,708510.25
431406,202010,29,25,4,26125,4180,30305
431407,202010,53,41,12,42845,12540,55385
431410,202010,3364,2051,1313,2146430.5,1377310.75,3523741.25
431413,202010,15,12,3,12540,3135,15675
431415,202010,66,50,16,52250,16720,68970
431417,202010,25,12,13,12540,13585,26125
431420,202010,322,218,104,227810,108680,336490
431430,202010,54,23,31,24035,32395,56430
431440,202010,8880,6154,2726,6442432.6,2859170.91,9301603.51
431442,202010,28,13,15,13585,15675,29260
431445,202010,26,24,2,25080,2090,27170
431446,202010,5,4,1,4180,1045,5225
431447,202010,84,58,26,60610,27170,87780
431449,202010,51,43,8,44935,8360,53295
431450,202010,413,274,139,286330,146300,432630
431454,202010,8,3,5,3135,5225,8360
431455,202010,52,41,11,42845,11495,54340
431460,202010,510,353,157,368885,164065,532950
431470,202010,117,88,29,91960,30305,122265
431475,202010,10,8,2,8360,2090,10450
431477,202010,36,23,13,24035,13585,37620
431478,202010,9,8,1,8360,1045,9405
431480,202010,520,311,209,326040,218405.5,544445.5
431490,202010,28467,15876,12591,16633169.3,13212985.19,29846154.49
431500,202010,78,63,15,65835,15675,81510
431505,202010,25,15,10,15675,10450,26125
431507,202010,9,7,2,7315,2090,9405
431510,202010,259,182,77,190190.25,80465,270655.25
431513,202010,24,21,3,21945,3135,25080
431514,202010,5,4,1,4180,1045,5225
431515,202010,81,67,14,70015,14630,84645
431517,202010,7,3,4,3936.16,4180,8116.16
431520,202010,40,36,4,37620,4180,41800
431530,202010,1450,655,795,684475,831820,1516295
431531,202010,24,23,1,24035,1045,25080
431532,202010,33,24,9,25080,9405,34485
431535,202010,27,15,12,15675,12540,28215
431540,202010,140,120,20,125400,20900,146300
431545,202010,14,12,2,12540,2090,14630
431550,202010,346,189,157,197505,164065,361570
431555,202010,12,12,0,12540,0,12540
431560,202010,4509,3080,1429,3223827.85,1495395,4719222.85
431570,202010,815,423,392,443081,409640,852721
431575,202010,43,24,19,25080,19855,44935
431580,202010,93,61,32,63745,33440,97185
431590,202010,137,116,21,121220,21945,143165
431595,202010,19,15,4,15675,4180,19855
431600,202010,245,142,103,148390,108680,257070
431610,202010,115,84,31,88825,32395,121220
431620,202010,43,36,7,37620,7315,44935
431630,202010,127,104,23,109725,24035,133760
431640,202010,1335,841,494,883025.5,517275.5,1400301.0
431642,202010,36,34,2,35530,2090,37620
431643,202010,46,21,25,21945,26125,48070
431645,202010,311,185,126,193325,131670,324995
431647,202010,9,8,1,8360,1045,9405
431650,202010,36,24,12,25080,12540,37620
431660,202010,280,175,105,184965,109725,294690
431670,202010,226,102,124,106590,130625,237215
431673,202010,7,7,0,7315,0,7315
431675,202010,25,20,5,20900,5225,26125
431680,202010,1121,826,295,864215,310365,1174580
431690,202010,4732,2822,1910,2956310.42,1999086,4955396.42
431695,202010,23,17,6,17765,6270,24035
431697,202010,2,0,2,0,2090,2090
431700,202010,178,137,41,143165,42845,186010
431710,202010,3991,1737,2254,1821435.5,2360655,4182090.5
431720,202010,1329,815,514,855333,538175,1393508
431725,202010,1,1,0,1045,0,1045
431730,202010,1159,784,375,820327.9,393965,1214292.9
431740,202010,1352,661,691,691790,722095.5,1413885.5
431750,202010,1819,1180,639,1235190.55,672980,1908170.55
431755,202010,6,5,1,5225,1045,6270
431760,202010,1036,655,381,685522,399190,1084712
431770,202010,412,295,117,308275,122265,430540
431775,202010,26,19,7,19855,7315,27170
431780,202010,539,323,216,340670,225720,566390
431790,202010,163,125,38,130625,40755,171380
431795,202010,12,10,2,10450,2090,12540
431800,202010,3185,1664,1521,1742017.7,1593626,3335643.7
431805,202010,21,19,2,19855,2090,21945
431810,202010,598,395,203,413820,213180,627000
431820,202010,327,193,134,201685,140030,341715
431830,202010,2291,1369,922,1433740.5,964535,2398275.5
431840,202010,481,320,161,334400,168245,502645
431842,202010,33,26,7,27170,7315,34485
431843,202010,12,9,3,9405,3135,12540
431844,202010,19,15,4,15675,4180,19855
431845,202010,27,25,2,26125,2090,28215
431846,202010,26,22,4,22990,4180,27170
431848,202010,10,8,2,8360,2090,10450
431849,202010,7,6,1,6270,1045,7315
431850,202010,784,633,151,662530,158840,821370
431860,202010,115,78,37,81510,38665,120175
431861,202010,6,2,4,2090,4180,6270
431862,202010,57,38,19,39710,19855,59565
431870,202010,3490,1999,1491,2094180.75,1565410,3659590.75
431880,202010,925,673,252,703285,264385,967670
431890,202010,1314,783,531,820325.5,554895,1375220.5
431900,202010,179,126,53,132715,55385,188100
431910,202010,53,39,14,40755,14630,55385
431912,202010,42,26,16,27170,16720,43890
431915,202010,122,94,28,98230,29260,127490
431920,202010,159,114,45,119130,47025,166155
431930,202010,79,66,13,68970,13585,82555
431935,202010,4,4,0,4180,0,4180
431936,202010,12,11,1,11495,1045,12540
431937,202010,19,14,5,14630,5225,19855
431940,202010,455,304,151,317680,157795.25,475475.25
431950,202010,491,311,180,324995.5,190190,515185.5
431960,202010,731,396,335,415910.5,352165,768075.5
431970,202010,70,63,7,65835,7315,73150
431971,202010,3,3,0,3135,0,3135
431973,202010,21,17,4,17765,4180,21945
431975,202010,9,8,1,8360,1045,9405
431980,202010,210,130,80,135850,84645,220495
431990,202010,1134,607,527,634247.52,551760,1186007.52
432000,202010,1734,907,827,949906.75,865260.25,1815167.00
432010,202010,269,184,85,192280,89870,282150
432020,202010,170,140,30,146300,31350,177650
432023,202010,15,13,2,13585,2090,15675
432026,202010,67,60,7,62700,7315,70015
432030,202010,68,34,34,35530,35530,71060
432032,202010,19,15,4,15675,4180,19855
432035,202010,55,44,11,45980,11495,57475
432040,202010,94,66,28,68970,29260,98230
432045,202010,5,4,1,4180,1045,5225
432050,202010,83,49,34,51205,35530,86735
432055,202010,125,92,33,96140,34485,130625
432057,202010,8,6,2,6270.5,2090,8360.5
432060,202010,34,31,3,32395,3135,35530
432065,202010,33,29,4,30305,4180,34485
432067,202010,89,80,9,83600,9405,93005
432070,202010,389,300,89,313762.5,94050,407812.5
432080,202010,820,570,250,595650,262295,857945
432085,202010,9,7,2,7315,2090,9405
432090,202010,265,175,90,183920,94050,277970
432100,202010,170,112,58,117040,60610,177650
432110,202010,551,366,185,384560,193325,577885
432120,202010,960,549,411,574751,430540.5,1005291.5
432130,202010,478,343,135,358435,141075,499510
432132,202010,23,20,3,20900,3135,24035
432135,202010,82,67,15,70015,15675,85690
432140,202010,270,209,61,218405,63745,282150
432143,202010,211,132,79,137940,82555,220495
432145,202010,270,185,85,193325,88825,282150
432146,202010,13,12,1,12540,1045,13585
432147,202010,113,60,53,63745,55385,119130
432149,202010,16,10,6,10450,6270,16720
432150,202010,876,534,342,558030.5,358435,916465.5
432160,202010,1514,768,746,804650.22,781660,1586310.22
432162,202010,4,3,1,3135,1045,4180
432163,202010,19,14,5,14630,5225,19855
432166,202010,123,90,33,94312.5,35530,129842.5
432170,202010,232,117,115,122265,120175,242440
432180,202010,543,330,213,345895,223630.5,569525.5
432183,202010,7,7,0,7315,0,7315
432185,202010,76,66,10,68970,10450,79420
432190,202010,477,277,200,289465,209000,498465
432195,202010,87,72,15,75240,15675,90915
432200,202010,399,252,147,263340,155705,419045
432210,202010,116,73,43,76285,44935,121220
432215,202010,40,36,4,37620,4180,41800
432218,202010,21,20,1,20900,1045,21945
432220,202010,656,340,316,356345,330220.29,686565.29
432225,202010,14,9,5,9405,5225,14630
432230,202010,134,90,44,95095,47025,142120
432232,202010,13,11,2,11495,2090,13585
432234,202010,4,3,1,3135,1045,4180
432235,202010,3,2,1,2090,1045,3135
432237,202010,26,16,10,16720,10450,27170
432240,202010,4287,2385,1902,2498596,1994906.5,4493502.5
432250,202010,1109,712,397,746130,416955,1163085
432252,202010,45,43,2,44935,2090,47025
432253,202010,59,48,11,50160,11495,61655
432254,202010,25,11,14,11495,14630,26125
432255,202010,14,12,2,12540,2090,14630
432260,202010,819,641,178,671935.5,188100,860035.5
432270,202010,235,179,56,187055,59565,246620
432280,202010,138,105,33,109725,34485,144210
432285,202010,2,2,0,2090,0,2090
432290,202010,65,56,9,58520,9405,67925
432300,202010,4675,2533,2142,2654441.06,2247796,4902237.06
432310,202010,130,105,25,109725,26125,135850
432320,202010,22,17,5,17765,5225,22990
432330,202010,16,11,5,11495,5225,16720
432335,202010,8,6,2,6270,2090,8360
432340,202010,39,33,6,34485,6270,40755
432345,202010,105,69,36,72105,37620,109725
432350,202010,21,20,1,20900,1045,21945
432360,202010,5,4,1,5225,1045,6270
432370,202010,22,21,1,21945,1045,22990
432375,202010,31,28,3,29260,3135,32395
432377,202010,8,8,0,8360,0,8360
432380,202010,175,75,100,78375,104500,182875
500020,202010,243,131,112,136895,117040,253935
500025,202010,139,69,70,72105,73150,145255
500060,202010,1443,904,539,944680.5,564300.5,1508981.0
500070,202010,784,372,412,388740.29,430540,819280.29
500080,202010,128,102,26,106590,27170,133760
500085,202010,134,109,25,113905.5,26125,140030.5
500090,202010,353,157,196,165110,204820,369930
500100,202010,710,372,338,389785,355301.5,745086.5
500110,202010,2254,1053,1201,1103521,1258180.75,2361701.75
500124,202010,264,144,120,151525,125400,276925
500150,202010,346,134,212,140030,221540,361570
500190,202010,518,353,165,368885,174515.5,543400.5
500200,202010,189,162,27,169290.2,28215,197505.2
500210,202010,1565,531,1034,554895,1081575,1636470
500215,202010,244,139,105,145255,110770,256025
500220,202010,731,476,255,497420.77,267520,764940.77
500230,202010,239,146,93,152570,97185,249755
500240,202010,656,453,203,475475,213180.5,688655.5
500260,202010,591,229,362,239305,381425,620730
500270,202010,29969,12724,17245,13328618.95,18068057.06,31396676.01
500280,202010,203,70,133,73150,138985,212135
500290,202010,1159,700,459,733590.5,481745,1215335.5
500295,202010,431,278,153,290510.5,159885,450395.5
500310,202010,78,25,53,26125,55385,81510
500315,202010,752,434,318,453530,332310,785840
500320,202010,3583,1764,1819,1850695.54,1908170,3758865.54
500325,202010,926,498,428,522501,448305.5,970806.5
500330,202010,1493,702,791,736725,830775,1567500
500345,202010,303,230,73,242440.5,76285,318725.5
500348,202010,255,148,107,155705,111815,267520
500350,202010,119,55,64,57475,66880,124355
500370,202010,5582,2477,3105,2594736.5,3260401,5855137.5
500375,202010,345,247,98,258115,102410,360525
500380,202010,591,332,259,346940,270655,617595
500390,202010,75,36,39,37620,40755,78375
500400,202010,217,139,78,145255,81510,226765
500410,202010,541,222,319,231990,333355,565345
500430,202010,524,373,151,389785,158840,548625
500440,202010,194,100,94,105545,98230,203775
500450,202010,396,168,228,176605,238260,414865
500460,202010,269,143,126,149435,131670,281105
500470,202010,430,337,93,353210.5,97185,450395.5
500480,202010,103,62,41,64790.83,42845,107635.83
500490,202010,106,45,61,47025,63745,110770
500500,202010,1421,515,906,539220,950950,1490170
500510,202010,42,35,7,36575,7315,43890
500515,202010,102,70,32,73150,33440,106590
500520,202010,309,168,141,175560,148390.5,323950.5
500525,202010,89,49,40,51205,41800,93005
500540,202010,881,380,501,397100,524590.5,921690.5
500560,202010,931,518,413,543400,432630.5,976030.5
500568,202010,981,556,425,581020,444125.5,1025145.5
500570,202010,1192,695,497,726276.5,520410,1246686.5
500580,202010,335,170,165,177650,173470,351120
500600,202010,335,162,173,169290,181830,351120
500620,202010,903,636,267,664620.42,279015,943635.42
500625,202010,78,62,16,64790,16720,81510
500627,202010,20,10,10,10450,10450,20900
500630,202010,1572,876,696,916467.58,728365,1644832.58
500635,202010,519,310,209,323950.5,218405,542355.5
500640,202010,376,200,176,209000,186010,395010
500660,202010,5506,2000,3506,2094181.25,3672131,5766312.25
500690,202010,603,209,394,218405,412775,631180
500710,202010,404,206,198,215270,207955,423225
500720,202010,925,533,392,560121.23,410685,970806.23
500730,202010,188,114,74,120175,78375,198550
500740,202010,892,372,520,389785,543400,933185
500750,202010,144,45,99,48070,104500,152570
500755,202010,122,89,33,93005.5,34485,127490.5
500769,202010,741,403,338,421135.5,356345,777480.5
500770,202010,417,216,201,225720,210045,435765
500780,202010,150,101,49,105545,53295,158840
500790,202010,1066,537,529,563255,554895,1118150
500793,202010,274,144,130,152570,135850.5,288420.5
500795,202010,179,121,58,126445,60610,187055
500797,202010,49,35,14,36575,14630,51205
500800,202010,438,193,245,201685,257070,458755
500830,202010,2221,1235,986,1294755,1034550,2329305
500840,202010,134,100,34,104500,35530,140030
510010,202010,171,88,83,91960,86735,178695
510020,202010,505,217,288,226765,302005,528770
510025,202010,1676,958,718,1002155.2,751355.5,1753510.7
510030,202010,668,346,322,361570,336490.5,698060.5
510035,202010,126,62,64,64790,66880,131670
510040,202010,398,183,215,191235,224675.3,415910.3
510050,202010,397,217,180,226765,188100.73,414865.73
510060,202010,119,59,60,61655,63745,125400
510080,202010,229,88,141,91960,147345,239305
510100,202010,64,27,37,28215,38665,66880
510120,202010,37,22,15,22990,15675,38665
510125,202010,385,239,146,250800,153615,404415
510130,202010,536,311,225,326040,236170.5,562210.5
510140,202010,423,122,301,129580,314545,444125
510160,202010,109,35,74,36575,77330,113905
510170,202010,788,478,310,499510.03,323950,823460.03
510180,202010,2914,1370,1544,1435831,1621841.25,3057672.25
510185,202010,19,8,11,8360,11495,19855
510190,202010,232,83,149,86735,155705,242440
510250,202010,2578,1527,1051,1599896,1102476,2702372
510260,202010,172,125,47,130625,49115,179740
510263,202010,461,257,204,269610.5,213180,482790.5
510267,202010,665,371,294,387695.5,307230,694925.5
510268,202010,63,29,34,30305,35530,65835
510269,202010,76,33,43,34485,44935,79420
510270,202010,383,194,189,202730,197505,400235
510279,202010,216,163,53,171380,55385,226765
510285,202010,187,74,113,77330,118085,195415
510300,202010,517,270,247,282150,258115,540265
510305,202010,207,99,108,103455,113905,217360
510310,202010,105,54,51,56430,53295,109725
510320,202010,847,531,316,556985,331265,888250
510325,202010,417,174,243,182875,254980,437855
510330,202010,429,237,192,248710,200640,449350
510335,202010,640,364,276,380380,290510,670890
510336,202010,56,39,17,40755,17765,58520
510337,202010,107,45,62,48070,64790,112860
510340,202010,17198,7792,9406,8164586.57,9874207.25,18038793.82
510343,202010,62,43,19,44935,19855,64790
510345,202010,162,105,57,109725,59565.5,169290.5
510350,202010,651,353,298,369930,311410.5,681340.5
510360,202010,202,123,79,128535,82555,211090
510370,202010,152,72,80,75240,84645,159885
510380,202010,86,64,22,66880,24035,90915
510385,202010,63,28,35,29260,36575,65835
510390,202010,109,47,62,49115,64790,113905
510395,202010,44,32,12,33440,12540,45980
510410,202010,708,459,249,480700,261250,741950
510420,202010,561,272,289,284240,304095,588335
510450,202010,50,25,25,26125,26125,52250
510452,202010,51,24,27,25080,28215,53295
510454,202010,53,24,29,25080,30305,55385
510455,202010,136,78,58,81510,61655,143165
510460,202010,179,83,96,86735,100320,187055
510480,202010,711,419,292,437855.2,307230,745085.2
510490,202010,351,175,176,182875,183920,366795
510500,202010,239,180,59,188100,61655,249755
510510,202010,784,460,324,481745.5,339625.5,821371.0
510515,202010,1230,637,593,666710,620730,1287440
510517,202010,256,112,144,117040,150480,267520
510520,202010,224,146,78,152570,81510,234080
510523,202010,103,79,24,83600,25080,108680
510525,202010,805,479,326,502645,340670,843315
510530,202010,20,14,6,14630,6270,20900
510550,202010,243,111,132,115995.53,137940,253935.53
510558,202010,286,140,146,147345,152570,299915
510560,202010,414,243,171,253935.5,179740,433675.5
510562,202010,638,466,172,489060,179740,668800
510590,202010,754,388,366,405460,382470,787930
510600,202010,236,125,111,130625,115995,246620
510610,202010,205,84,121,87780,126445,214225
510615,202010,183,83,100,86735,104500,191235
510617,202010,18,9,9,9405,9405,18810
510618,202010,119,57,62,59565,64790,124355
510619,202010,93,65,28,67925,29260,97185
510620,202010,168,95,73,99275,76285,175560
510621,202010,177,113,64,118085,66880,184965
510622,202010,495,299,196,312455,205865,518320
510623,202010,323,223,100,233035,104500,337535
510624,202010,95,47,48,49115,50160,99275
510625,202010,525,327,198,341715,210045.29,551760.29
510626,202010,109,68,41,72105,42845,114950
510627,202010,75,52,23,54340,24035,78375
510628,202010,153,90,63,94050,65835,159885
510629,202010,267,160,107,167200,111833.81,279033.81
510630,202010,430,223,207,233035,216315,449350
510631,202010,12,3,9,3135,9405,12540
510637,202010,349,199,150,207955,156750,364705
510642,202010,997,529,468,554895,497420,1052315
510645,202010,2,0,2,0,2090,2090
510650,202010,1390,910,480,953040.5,504735,1457775.5
510665,202010,81,35,46,36575,48070,84645
510670,202010,59,33,26,34485,27170,61655
510675,202010,1146,731,415,765985.5,436810,1202795.5
510677,202010,344,177,167,184965,176605,361570
510680,202010,106,60,46,62700,48070,110770
510682,202010,203,103,100,108680,104500,213180
510685,202010,55,41,14,42845,14630,57475
510700,202010,572,330,242,345895,254980,600875
510704,202010,1152,603,549,631180,575795,1206975
510706,202010,134,66,68,68970,71060,140030
510710,202010,393,278,115,291555,120175,411730
510715,202010,58,40,18,41800,18810,60610
510718,202010,209,107,102,111815,108680,220495
510719,202010,40,17,23,17765,24035,41800
510720,202010,186,128,58,133760,60610,194370
510724,202010,84,33,51,34485,53295,87780
510726,202010,51,26,25,27170,26125,53295
510729,202010,57,23,34,24035,35530,59565
510730,202010,481,264,217,275880,226765,502645
510735,202010,113,47,66,49115,68970,118085
510740,202010,19,10,9,10450,9405,19855
510757,202010,24,18,6,18810,6270,25080
510760,202010,7166,3673,3493,3846542,3659591.75,7506133.75
510770,202010,677,321,356,336490,374110,710600
510774,202010,16,5,11,6270,11495,17765
510775,202010,107,80,27,83600,28215,111815
510776,202010,27,10,17,10450,17765,28215
510777,202010,194,82,112,85690,118085,203775
510779,202010,52,24,28,25080,29260,54340
510780,202010,279,157,122,165110,128535,293645
510785,202010,389,211,178,220495,186010,406505
510787,202010,194,93,101,98230,106590,204820
510788,202010,5,1,4,1045,4180,5225
510790,202010,2489,1312,1177,1373180.75,1237280,2610460.75
510792,202010,1140,640,500,668800,525635.66,1194435.66
510794,202010,114,62,52,64790,54340,119130
510795,202010,2307,1344,963,1407615.5,1008426,2416041.5
510800,202010,176,105,71,109725,74195,183920
510805,202010,178,118,60,123310,62700,186010
510810,202010,97,43,54,44935,56430,101365
510820,202010,239,119,120,124355.45,125400.12,249755.57
510830,202010,72,41,31,42845,32395,75240
510835,202010,14,9,5,9405,5225,14630
510840,202010,9082,4315,4767,4527988.69,5004505.5,9532494.19
510850,202010,220,89,131,93005,136895,229900
510860,202010,371,167,204,174515,214225.5,388740.5
510880,202010,70,51,19,53295,19855,73150
510885,202010,70,39,31,40755,32395,73150
510890,202010,64,36,28,37620,29260,66880
510895,202010,171,101,70,106590,74195.5,180785.5
520005,202010,128,54,74,56430,77330,133760
520010,202010,281,127,154,132715,160930.5,293645.5
520013,202010,709,457,252,478610,266475,745085
520015,202010,51,39,12,40755,12540,53295
520017,202010,86,49,37,51205.5,38665,89870.5
520020,202010,19,10,9,10450,9405,19855
520025,202010,2301,1188,1113,1243550.5,1167265,2410815.5
520030,202010,807,426,381,445170,399190,844360
520050,202010,68,47,21,49115,21945,71060
520055,202010,57,36,21,37620,21945,59565
520060,202010,175,115,60,120175,62700,182875
520080,202010,584,421,163,442035,173470,615505
520082,202010,19,13,6,13585,6270,19855
520085,202010,90,66,24,68970,25080,94050
520090,202010,92,62,30,64790,31350,96140
520110,202010,9242,3951,5291,4140291,5546863,9687154
520120,202010,12,7,5,8360,5225,13585
520130,202010,803,559,244,585200,258115.5,843315.5
520140,202010,11959,6629,5330,6946118.75,5580301.7,12526420.45
520145,202010,53,32,21,33440,22990,56430
520150,202010,161,127,34,132715,35530,168245
520160,202010,40,29,11,30305,11495,41800
520170,202010,252,145,107,152570,111815,264385
520180,202010,164,79,85,82555,88825,171380
520215,202010,205,138,67,144210,70015,214225
520235,202010,83,64,19,66880,20900,87780
520250,202010,130,73,57,76285,59565,135850
520260,202010,115,73,42,76285,44935,121220
520280,202010,46,31,15,32395,15675,48070
520310,202010,39,26,13,27170,13585,40755
520320,202010,179,112,67,117040,70015,187055
520330,202010,782,419,363,439945,381425,821370
520340,202010,360,215,145,226765,153615.5,380380.5
520350,202010,508,238,270,248710,285285,533995
520355,202010,86,50,36,52250,37620,89870
520357,202010,25,18,7,18810,7315,26125
520360,202010,1,1,0,1045,0,1045
520380,202010,134,73,61,76285,63745,140030
520390,202010,254,106,148,110770.5,156750,267520.5
520393,202010,18,13,5,13585,5225,18810
520396,202010,76,49,27,52250,28215,80465
520400,202010,197,115,82,121220,85690,206910
520410,202010,197,97,100,101365,105545,206910
520420,202010,21,14,7,14630,7315,21945
520425,202010,284,139,145,145255,151525,296780
520430,202010,484,239,245,249851.14,257070.75,506921.89
520440,202010,702,507,195,531905,203775,735680
520450,202010,1979,848,1131,889295,1182940,2072235
520455,202010,58,33,25,34485,26125,60610
520460,202010,37,22,15,22990,15675,38665
520465,202010,32,27,5,28215,5225,33440
520470,202010,429,280,149,292600,156750,449350
520480,202010,78,47,31,49115,32395,81510
520485,202010,115,39,76,40755,79420,120175
520490,202010,406,301,105,315590,109725,425315
520495,202010,159,97,62,101365,64790,166155
520500,202010,184,146,38,152570,39710,192280
520505,202010,188,108,80,112860,83600,196460
520510,202010,1787,845,942,887205.93,989617.25,1876823.18
520520,202010,43,30,13,31350,13585,44935
520530,202010,224,171,53,179740,55385,235125
520540,202010,584,398,186,416955,195415,612370
520545,202010,135,80,55,84645,57475,142120
520547,202010,57,33,24,34485,25080,59565
520549,202010,1212,561,651,588335.8,687610,1275945.8
520551,202010,306,164,142,171380,148390.5,319770.5
520552,202010,41,26,15,27170,15675,42845
520570,202010,14,8,6,8360,6270,14630
520580,202010,277,171,106,178695,110770,289465
520590,202010,147,91,56,95095,59565,154660
520620,202010,1132,526,606,551760.5,635360.25,1187120.75
520630,202010,39,22,17,22990,17765,40755
520640,202010,386,224,162,234080,169290,403370
520650,202010,64,36,28,37620,29260,66880
520660,202010,44,23,21,24035,21945,45980
520670,202010,37,31,6,32395,6270,38665
520680,202010,51,34,17,35530,17765,53295
520690,202010,42,11,31,11495,32395,43890
520710,202010,32,29,3,30305,3135,33440
520725,202010,205,150,55,156750,57475,214225
520735,202010,56,36,20,37620,20900,58520
520740,202010,422,204,218,213180,227810,440990
520750,202010,34,25,9,26125,9405,35530
520753,202010,66,45,21,47025,21945,68970
520760,202010,101,68,33,71060,34485,105545
520780,202010,284,208,76,218405,79420,297825
520790,202010,156,91,65,95095,71060,166155
520800,202010,3408,1839,1569,1928026,1645875.2,3573901.2
520810,202010,147,114,33,120175,34485,154660
520815,202010,5,4,1,4180,1045,5225
520830,202010,147,100,47,104500,50160,154660
520840,202010,347,232,115,242440,120175,362615
520850,202010,99,60,39,62700,40755,103455
520860,202010,1744,1125,619,1175625.5,648945.5,1824571.0
520870,202010,31690,14890,16800,15583048.47,17593628,33176676.47
520880,202010,1158,614,544,643720.5,568480.5,1212201.0
520890,202010,795,483,312,504735,328130,832865
520910,202010,975,518,457,541310.93,479655,1020965.93
520915,202010,99,76,23,79420,24035,103455
520920,202010,421,200,221,209000,230945,439945
520929,202010,18,16,2,16720,2090,18810
520940,202010,72,48,24,50160,25080,75240
520945,202010,18,12,6,12540,6270,18810
520960,202010,45,29,16,30305,16720,47025
520970,202010,343,207,136,216315,142120,358435
520980,202010,95,69,26,72105,27170,99275
520990,202010,450,309,141,322905,148390,471295
520993,202010,121,56,65,58520,67925,126445
520995,202010,247,140,107,148390.65,111815.26,260205.91
521000,202010,1545,903,642,946770.5,678205.5,1624976.0
521010,202010,678,335,343,350075,359480,709555
521015,202010,14,9,5,9405,5225,14630
521020,202010,1425,1012,413,1058585,433675.5,1492260.5
521030,202010,55,37,18,38665,18810,57475
521040,202010,945,604,341,632225.25,358435.5,990660.75
521056,202010,48,33,15,34485,15675,50160
521060,202010,129,85,44,88929.5,45980,134909.5
521080,202010,413,318,95,332310,99275,431585
521090,202010,554,361,193,379335,201685,581020
521100,202010,274,206,68,215270,71060,286330
521120,202010,1057,746,311,779570.5,327085,1106655.5
521130,202010,352,250,102,261250,106590.5,367840.5
521140,202010,177,99,78,103455,81510,184965
521150,202010,2628,1140,1488,1193390.5,1560185,2753575.5
521160,202010,29,15,14,16720,14630,31350
521170,202010,214,119,95,124355,99275,223630
521180,202010,1181,756,425,791065.5,448305.25,1239370.75
521190,202010,2520,1063,1457,1120240,1536150.5,2656390.5
521200,202010,55,41,14,42845,14630,57475
521205,202010,11,8,3,8360,3135,11495
521210,202010,122,72,50,75240,52250,127490
521220,202010,770,537,233,564300,243485.25,807785.25
521225,202010,32,22,10,22990,10450,33440
521230,202010,107,71,36,74195,37620,111815
521250,202010,6165,3480,2685,3644964.55,2810008,6454972.55
521260,202010,29,14,15,14630,15675,30305
521270,202010,143,110,33,114950,34485,149435
521280,202010,431,263,168,274835,175560,450395
521290,202010,26,14,12,14630,12540,27170
521295,202010,98,64,34,66880,35530,102410
521300,202010,219,121,98,126445,102410.5,228855.5
521305,202010,37,26,11,27170,11495,38665
521308,202010,1056,815,241,855855,253935,1109790
521310,202010,1332,767,565,801515,592515,1394030
521340,202010,19,15,4,15675,4180,19855
521350,202010,123,93,30,98230,31350,129580
521370,202010,176,124,52,129580,54340,183920
521375,202010,178,91,87,96140,90915,187055
521377,202010,49,38,11,39710,11495,51205
521380,202010,1061,672,389,705376.05,407550,1112926.05
521385,202010,13,8,5,8360,5225,13585
521390,202010,101,82,19,85690,19855,105545
521400,202010,346,231,115,241395,120175,361570
521405,202010,145,79,66,82555,68970,151525
521410,202010,66,46,20,48070,21945,70015
521440,202010,195,141,54,147345,57475,204820
521450,202010,726,410,316,430540,330220,760760
521460,202010,1144,736,408,771210,426360,1197570
521470,202010,12,9,3,9405,3135,12540
521480,202010,41,28,13,29260,13585.25,42845.25
521483,202010,313,186,127,194370.5,132715,327085.5
521486,202010,281,182,99,190190,103455,293645
521487,202010,24,12,12,12540,12540,25080
521490,202010,23,12,11,12540,11495,24035
521500,202010,126,77,49,80465,51205,131670
521520,202010,45,32,13,34485,13585,48070
521523,202010,732,433,299,453530,313500,767030
521525,202010,47,30,17,31350,17765,49115
521530,202010,244,132,112,137940,117040,254980
521540,202010,33,17,16,17765,16720,34485
521550,202010,87,38,49,39710.5,51205,90915.5
521560,202010,810,550,260,575795.5,271700.75,847496.25
521565,202010,62,43,19,44935,20900,65835
521570,202010,526,348,178,363660.5,186010.25,549670.75
521580,202010,55,31,24,32395,25080,57475
521590,202010,36,17,19,17765,19855,37620
521600,202010,22,11,11,11495,11495,22990
521630,202010,245,133,112,138985,117040.25,256025.25
521640,202010,310,166,144,173470,150480,323950
521645,202010,33,17,16,17765,16720,34485
521680,202010,245,151,94,157795,98230,256025
521690,202010,3,3,0,3135,0,3135
521710,202010,1138,550,588,574750,616550,1191300
521720,202010,567,393,174,411730,181830.85,593560.85
521730,202010,655,314,341,328130.5,356345,684475.5
521740,202010,894,386,508,404415,535040.5,939455.5
521760,202010,1957,1009,948,1056563.87,995885.5,2052449.37
521770,202010,820,520,300,545490,315590,861080
521800,202010,1996,1293,703,1353276.5,738815,2092091.5
521805,202010,33,18,15,18810,15675,34485
521810,202010,84,54,30,56430,31350,87780
521830,202010,960,685,275,716870.09,287375.35,1004245.44
521839,202010,87,53,34,55385,35530,90915
521850,202010,1109,579,530,605056.11,556985.5,1162041.61
521860,202010,341,212,129,222585,134805,357390
521870,202010,75,46,29,48070,30305,78375
521878,202010,32,16,16,16720,16720,33440
521880,202010,4713,2098,2615,2195547,2745217.5,4940764.5
521890,202010,597,422,175,442174.63,182875,625049.63
521900,202010,285,232,53,244530,55385,299915
521910,202010,164,117,47,122265,49115,171380
521920,202010,45,23,22,24035,22990,47025
521925,202010,52,31,21,32395,22990,55385
521930,202010,1151,637,514,665665.5,539220,1204885.5
521935,202010,35,25,10,26125,10450,36575
521940,202010,202,98,104,102410,108680,211090
521945,202010,16,13,3,13585,3135,16720
521950,202010,9,5,4,5225,4180,9405
521960,202010,72,54,18,57475,18810,76285
521970,202010,405,257,148,269610,156750,426360
521971,202010,100,53,47,55385,49115,104500
521973,202010,34,17,17,17765,17765,35530
521975,202010,1451,721,730,755535.91,768076.47,1523612.38
521980,202010,246,167,79,175560.5,82555,258115.5
521990,202010,78,56,22,58520,22990,81510
522000,202010,289,185,104,194005.29,108680,302685.29
522005,202010,18,10,8,10450,8360,18810
522010,202010,1130,630,500,659395,524590.57,1183985.57
522015,202010,61,37,24,39710,25080,64790
522020,202010,892,518,374,541310,391875.5,933185.5
522026,202010,23,14,9,14630,9405,24035
522028,202010,15,11,4,11495,4180,15675
522040,202010,770,315,455,329175.25,476520,805695.25
522045,202010,2313,1414,899,1482856.75,941546.25,2424403.00
522050,202010,157,76,81,79420,84645,164065
522060,202010,541,338,203,353210,212135,565345
522068,202010,111,78,33,81510,35530,117040
522070,202010,10,10,0,10450,0,10450
522100,202010,39,23,16,24035,16720,40755
522108,202010,41,31,10,32395,10450,42845
522119,202010,54,30,24,31350,25080,56430
522130,202010,77,32,45,33440,48070,81510
522140,202010,4096,2134,1962,2231075.6,2059695.5,4290771.1
522145,202010,50,35,15,36575,15675,52250
522150,202010,92,68,24,71060,25080,96140
522155,202010,53,36,17,37620,17765,55385
522157,202010,7,3,4,3135,4180,7315
522160,202010,1692,1001,691,1049005.83,726275,1775280.83
522170,202010,401,270,131,282150,136895,419045
522180,202010,38,18,20,18810,20900,39710
522185,202010,2064,824,1240,865261,1299980,2165241
522190,202010,48,26,22,27170,22990,50160
522200,202010,298,177,121,184965,126445,311410
522205,202010,143,96,47,100320,49115,149435
522220,202010,147,108,39,113905,40755,154660
522230,202010,34,25,9,26125,9405,35530
530010,202010,53854,27217,26637,28503331.75,27911969,56415300.75
110001,202011,506,404,102,422276.44,106612.2,528888.64
110002,202011,2847,1765,1082,1845754.7,1134074.52,2979829.22
110003,202011,82,68,14,71084.23,14634.35,85718.58
110004,202011,2036,1341,695,1403728.84,727496.76,2131225.60
110005,202011,436,348,88,363723.17,91968.95,455692.12
110006,202011,446,342,104,357745.52,108701.07,466446.59
110007,202011,69,57,12,59576.27,12542.26,72118.53
110008,202011,240,132,108,137961.96,112877.71,250839.67
110009,202011,892,649,243,678276.04,253971.37,932247.41
110010,202011,1704,1047,657,1094287.88,687716.4,1782004.28
110011,202011,1761,1365,396,1426724.06,413915.1,1840639.16
110012,202011,4089,2362,1727,2473868.74,1808110.58,4281979.32
110013,202011,777,620,157,649070.56,164096.33,813166.89
110014,202011,374,326,48,340764.18,50174.23,390938.41
110015,202011,1381,1109,272,1160200.08,284297.78,1444497.86
110018,202011,1095,684,411,714917.1,429593.11,1144510.21
110020,202011,15538,8885,6653,9291893.21,6959617.81,16251511.02
110025,202011,643,473,170,494359.06,177674.13,672033.19
110026,202011,36,25,11,26127.71,11497.25,37624.96
110028,202011,1636,1176,460,1229165.03,481852.83,1711017.86
110029,202011,137,123,14,128567.18,14632.75,143199.93
110030,202011,2409,1603,806,1680527.65,843485.03,2524012.68
110032,202011,313,242,71,252948.86,74209.02,327157.88
110033,202011,664,484,180,505905.65,188138.91,694044.56
110034,202011,340,252,88,263389.51,91975.55,355365.06
110037,202011,98,85,13,88831.24,13585.79,102417.03
110040,202011,373,252,121,263379,126459.51,389838.51
110045,202011,931,641,290,671012.15,303117.37,974129.52
110050,202011,92,80,12,83629.17,12542.82,96171.99
110060,202011,67,40,27,41817.79,28221.13,70038.92
110070,202011,103,67,36,70022.98,37624.6,107647.58
110080,202011,484,270,214,282161.86,223644.22,505806.08
110090,202011,28,24,4,25081.1,4180,29261.1
110092,202011,100,55,45,57478.73,47028.12,104506.85
110094,202011,201,146,55,153632.62,57484.23,211116.85
110100,202011,38,28,10,29267.93,10452.95,39720.88
110110,202011,92,52,40,54349.17,41807.34,96156.51
110120,202011,69,59,10,61670.17,10452.74,72122.91
110130,202011,287,236,51,246699.64,53307.47,300007.11
110140,202011,241,170,71,178715.61,74203.92,252919.53
110143,202011,46,37,9,38666.01,9405.67,48071.68
110145,202011,27,21,6,21948.54,6272.19,28220.73
110146,202011,22,12,10,12541.62,10451.56,22993.18
110147,202011,37,26,11,27177.41,11497.53,38674.94
110148,202011,34,23,11,24036.96,11496.9,35533.86
110149,202011,309,218,91,227824.02,95099.99,322924.01
110150,202011,130,101,29,105551.93,30307.13,135859.06
110155,202011,8,8,0,8361.4,0,8361.4
110160,202011,68,55,13,57477.24,13586.76,71064.00
110170,202011,221,170,51,177694.47,53301.42,230995.89
110175,202011,66,50,16,52251.16,16720,68971.16
110180,202011,86,71,15,74201.33,15675.44,89876.77
120001,202011,187,138,49,145290.03,51223.73,196513.76
120005,202011,196,115,81,120193.04,84654.85,204847.89
120010,202011,1103,688,415,720094.2,433731.15,1153825.35
120013,202011,142,97,45,101370.91,47028.36,148399.27
120017,202011,107,60,47,62703.92,49117.02,111820.94
120020,202011,3544,2861,683,2989913.4,713776.72,3703690.12
120025,202011,545,306,239,319869.9,249841.23,569711.13
120030,202011,1067,918,149,959381.69,156767.08,1116148.77
120032,202011,36,32,4,33443.61,4180.34,37623.95
120033,202011,213,188,25,196471.85,26126.32,222598.17
120034,202011,172,128,44,133763.01,45981.78,179744.79
120035,202011,39,32,7,33441.64,7316.76,40758.40
120038,202011,421,276,145,288466.24,151542.45,440008.69
120039,202011,29,28,1,29261.51,1045,30306.51
120040,202011,14038,9597,4441,10034642.02,4645113.93,14679755.95
120042,202011,45,39,6,40756.12,6270.11,47026.23
120043,202011,11,3,8,3135.34,8360.44,11495.78
120045,202011,542,347,195,362683.53,203804.87,566488.40
120050,202011,1282,979,303,1023144.81,316656.15,1339800.96
120060,202011,1473,1209,264,1264513.95,275894.38,1540408.33
120070,202011,427,307,120,320857.01,125417.24,446274.25
120080,202011,175,108,67,113910.75,70018.41,183929.16
130002,202011,164,119,45,124361.58,47027.62,171389.20
130006,202011,103,66,37,68971.31,38665,107636.31
130008,202011,133,72,61,75241.99,63746.04,138988.03
130010,202011,148,83,65,86736.41,67926.56,154662.97
130014,202011,275,199,76,207961.35,79424.34,287385.69
130020,202011,102,63,39,65836.42,40755,106591.42
130030,202011,968,568,400,593564.21,418008.14,1011572.35
130040,202011,340,169,171,176617.65,178707.67,355325.32
130050,202011,565,293,272,306207.58,285320.29,591527.87
130060,202011,851,581,270,607159.43,282161.49,889320.92
130063,202011,601,342,259,358435.61,270655,629090.61
130068,202011,190,118,72,124360.28,75243.58,199603.86
130070,202011,1312,893,419,933269.53,437904.15,1371173.68
130080,202011,719,475,244,497427.32,254986.89,752414.21
130083,202011,71,39,32,40758.54,33443,74201.54
130090,202011,325,166,159,173470.44,167201.71,340672.15
130100,202011,1108,472,636,493284.42,664705.69,1157990.11
130110,202011,737,309,428,322917.85,447271.78,770189.63
130115,202011,162,68,94,71065.63,98241.86,169307.49
130120,202011,1633,1031,602,1078525.65,630166.48,1708692.13
130130,202011,618,423,195,442039.72,203777.91,645817.63
130140,202011,1577,1241,336,1296915.74,351156.87,1648072.61
130150,202011,415,363,52,379335.58,54340,433675.58
130160,202011,456,262,194,273808.87,202735.71,476544.58
130165,202011,42,33,9,34490.53,9406.14,43896.67
130170,202011,983,677,306,707461.2,319798.32,1027259.52
130180,202011,236,178,58,186013.91,60610.44,246624.35
130185,202011,2312,1062,1250,1109913.61,1306503.03,2416416.64
130190,202011,3420,2152,1268,2249051.73,1325239.93,3574291.66
130195,202011,278,222,56,231991.31,58520.14,290511.45
130200,202011,175,78,97,81512.27,101368.82,182881.09
130210,202011,75,37,38,38665,39710,78375
130220,202011,180,122,58,127492.2,60613.78,188105.98
130230,202011,383,249,134,260205.86,140030,400235.86
130240,202011,1310,830,480,867391.76,502678.04,1370069.80
130250,202011,4697,2998,1699,3134384.99,1775732.42,4910117.41
130255,202011,426,201,225,210045.97,235143.5,445189.47
130260,202011,57177,26816,30361,28052323.54,31764827.82,59817151.36
130270,202011,1545,1046,499,1093201.08,522530.19,1615731.27
130280,202011,122,69,53,72107.45,55385.51,127492.96
130290,202011,2113,1461,652,1527892.64,681400.86,2209293.50
130300,202011,431,303,128,316640.87,133765.93,450406.80
130310,202011,943,505,438,527730.82,459809.1,987539.92
130320,202011,523,276,247,288425.28,258118.88,546544.16
130330,202011,780,486,294,507889.72,307236.87,815126.59
130340,202011,3503,2001,1502,2092268.41,1571809.28,3664077.69
130350,202011,482,322,160,336490.34,167200.17,503690.51
130353,202011,939,402,537,420153.69,561248.45,981402.14
130356,202011,811,362,449,378302.8,470273,848575.8
130360,202011,90,67,23,70015.61,24035.89,94051.50
130370,202011,713,550,163,574751.21,170336.66,745087.87
130380,202011,683,522,161,545510.58,168250.12,713760.70
130390,202011,484,390,94,407550.88,98230.44,505781.32
130395,202011,160,38,122,39710,127490.84,167200.84
130400,202011,66,44,22,45981.85,22990.84,68972.69
130406,202011,2077,1248,829,1304255.1,866392.05,2170647.15
130410,202011,441,209,232,218406.39,242440.3,460846.69
130420,202011,2921,2372,549,2480053.35,573764.98,3053818.33
130423,202011,158,80,78,83600.95,81512.18,165113.13
130426,202011,162,83,79,86738.28,82557.61,169295.89
130430,202011,417,259,158,270658.48,165112.78,435771.26
130440,202011,203,63,140,65838.75,146309.44,212148.19
140002,202011,12,4,8,4182.16,8363.1,12545.26
140005,202011,201,122,79,127501.73,82563.93,210065.66
140010,202011,10791,6788,4003,7100330.09,4192549.22,11292879.31
140015,202011,128,56,72,58526.61,75248.18,133774.79
140017,202011,120,73,47,76306.92,49124.7,125431.62
140020,202011,473,307,166,320851.4,174548.01,495399.41
140023,202011,24,12,12,12543.72,12543.6,25087.32
140028,202011,22,12,10,12543.22,10452.68,22995.90
140030,202011,352,244,108,255026.38,112881.17,367907.55
140040,202011,62,42,20,43890,20901.29,64791.29
140045,202011,256,99,157,103467.73,165129.66,268597.39
140047,202011,395,272,123,284302.09,128563.18,412865.27
140050,202011,144,88,56,91984.97,58532.45,150517.42
140060,202011,53,36,17,37627,17766.95,55393.95
140070,202011,32,29,3,30308.89,3135.44,33444.33
150010,202011,4653,2825,1828,2954584.76,1912590.65,4867175.41
150013,202011,161,113,48,118091.08,50164.52,168255.60
150020,202011,1086,584,502,610337.02,524627.84,1134964.86
150030,202011,697,305,392,318769.46,409705.66,728475.12
150034,202011,199,122,77,127498.38,80469.79,207968.17
150040,202011,1478,842,636,880050.72,666817.22,1546867.94
150050,202011,676,377,299,393990.82,312465.99,706456.81
150060,202011,4859,3074,1785,3212813.09,1867193.12,5080006.21
150070,202011,398,201,197,210071.77,205878.5,415950.27
150080,202011,15152,7116,8036,7439177.18,8405267.26,15844444.44
150085,202011,432,268,164,280112.4,171407.96,451520.36
150090,202011,723,609,114,636478.11,119142.11,755620.22
150095,202011,369,230,139,240362.04,145259.66,385621.70
150100,202011,61,39,22,40756.49,22993.54,63750.03
150110,202011,200,104,96,108680.44,100320.34,209000.78
150120,202011,404,290,114,303093.4,119138.88,422232.28
150125,202011,47,17,30,17768.02,31354.47,49122.49
150130,202011,2016,1062,954,1109948.88,998090.07,2108038.95
150140,202011,55041,24706,30335,25833387.25,31731423.88,57564811.13
150145,202011,204,108,96,113916.07,100328.5,214244.57
150150,202011,2961,1270,1691,1328475.2,1767465.88,3095941.08
150157,202011,384,270,114,282199.99,119150.74,401350.73
150160,202011,126,96,30,100327.56,31352.62,131680.18
150170,202011,3625,2694,931,2815510.03,974040.98,3789551.01
150172,202011,340,234,106,244569.73,110787.66,355357.39
150175,202011,79,47,32,49119.65,33444.93,82564.58
150178,202011,771,504,267,527801.37,280101.85,807903.22
150180,202011,3178,1543,1635,1613757.31,1708833.6,3322590.91
150190,202011,345,215,130,224714.69,135869.53,360584.22
150195,202011,110,57,53,59569.19,55386.86,114956.05
150200,202011,196,91,105,95099.52,109730.08,204829.60
150210,202011,3135,2520,615,2633810.92,642759.07,3276569.99
150215,202011,556,353,203,370012.06,212174.72,582186.78
150220,202011,3611,2402,1209,2511493.49,1263575.52,3775069.01
150230,202011,1184,950,234,992893.5,244568.38,1237461.88
150240,202011,6350,3575,2775,3738699.49,2903604.87,6642304.36
150250,202011,53,30,23,31358.16,24037.72,55395.88
150260,202011,92,60,32,62706.52,33443.06,96149.58
150270,202011,2221,1435,786,1499889.85,822567.63,2322457.48
150275,202011,519,327,192,341770.19,200667.85,542438.04
150276,202011,107,42,65,43895.19,67932.25,111827.44
150277,202011,788,338,450,353283.41,470341.63,823625.04
150280,202011,361,236,125,246624.44,130628.99,377253.43
150285,202011,103,52,51,54343.64,53297.45,107641.09
150290,202011,1128,660,468,689785.17,489119.48,1178904.65
150293,202011,682,316,366,330282.73,382532.39,712815.12
150295,202011,509,230,279,240405.89,291626.28,532032.17
150300,202011,79,37,42,38667.89,43892.17,82560.06
150304,202011,177,105,72,109736.04,75249.55,184985.59
150307,202011,393,324,69,338623.72,72111.93,410735.65
150309,202011,565,403,162,421226.37,170369.51,591595.88
150310,202011,242,158,84,165111.54,87780,252891.54
150320,202011,1908,1328,580,1388898.07,606154.82,1995052.89
150330,202011,2031,1167,864,1220650.19,902956.05,2123606.24
150340,202011,198,130,68,135856.09,71062.37,206918.46
150345,202011,630,345,285,360551,297839.24,658390.24
150350,202011,406,315,91,329265.34,95115.2,424380.54
150360,202011,4660,2867,1793,2997694.69,1875082.31,4872777.00
150370,202011,819,556,263,581173.37,274887.09,856060.46
150375,202011,198,91,107,96146.73,111819.19,207965.92
150380,202011,1486,982,504,1028509.26,527852.36,1556361.62
150390,202011,801,465,336,486013.22,351175.27,837188.49
150400,202011,108,89,19,93008.72,19855.53,112864.25
150405,202011,1227,775,452,809991.11,472384.78,1282375.89
150410,202011,121,77,44,80471.12,45982.36,126453.48
150420,202011,7344,3955,3389,4134233.96,3544506.79,7678740.75
150430,202011,614,390,224,407616.92,234107.63,641724.55
150440,202011,439,279,160,291608.86,167227.58,458836.44
150442,202011,2320,1231,1089,1287644.38,1138177.37,2425821.75
150445,202011,543,352,191,367928.78,199634.66,567563.44
150450,202011,227,119,108,124356.84,112861.58,237218.42
150460,202011,734,548,186,572736.2,194388.2,767124.4
150470,202011,1311,782,529,817327.4,553928.13,1371255.53
150475,202011,229,175,54,183966.05,56444.36,240410.41
150480,202011,1302,902,400,942730.64,418053.16,1360783.80
150490,202011,669,396,273,413826.98,285285.54,699112.52
150495,202011,334,247,87,258115.63,90915,349030.63
150497,202011,273,188,85,196482.91,88834.92,285317.83
150500,202011,223,137,86,143179.44,89877.11,233056.55
150503,202011,1039,512,527,535114.32,550796.01,1085910.33
150506,202011,926,613,313,640685.05,327128.33,967813.38
150510,202011,1255,684,571,715920.16,597823.74,1313743.90
150520,202011,290,190,100,198551.22,104500,303051.22
150530,202011,1709,934,775,976310.97,812181.76,1788492.73
150540,202011,224,162,62,169324,64803.44,234127.44
150543,202011,826,425,401,444230.14,419141.35,863371.49
150548,202011,466,328,138,342787.39,144221.15,487008.54
150549,202011,61,42,19,43892,19856.17,63748.17
150550,202011,2922,1467,1455,1533231.32,1521715.24,3054946.56
150553,202011,3334,1871,1463,1955657.22,1530258.25,3485915.47
150555,202011,147,78,69,81518.92,72113.02,153631.94
150560,202011,31,14,17,14632.41,17766.44,32398.85
150563,202011,118,52,66,54353.82,68986.34,123340.16
150565,202011,188,113,75,118088.45,78378.03,196466.48
150570,202011,427,283,144,295741.2,150484.58,446225.78
150580,202011,1677,804,873,840244.61,912371.34,1752615.95
150590,202011,804,532,272,555979.27,284270.82,840250.09
150600,202011,472,280,192,292620.56,200656.05,493276.61
150610,202011,145,118,27,123313.76,28216.68,151530.44
150611,202011,122,82,40,85696.49,41802.38,127498.87
150613,202011,3230,1904,1326,1990162.2,1386144.24,3376306.44
150616,202011,530,301,229,314590.23,241428,556018.23
150618,202011,1339,701,638,732612.75,666776.2,1399388.95
150619,202011,394,297,97,310400.18,101380.24,411780.42
150620,202011,1262,728,534,760825.77,559117.47,1319943.24
150630,202011,315,204,111,213203.74,116008.13,329211.87
150635,202011,458,188,270,197524.85,282172.1,479696.95
150640,202011,48,24,24,25084.69,25082.61,50167.30
150650,202011,2384,1378,1006,1440286.46,1051490.91,2491777.37
150655,202011,237,177,60,184984.21,62705.2,247689.41
150658,202011,87,48,39,50171.08,40766.6,90937.68
150660,202011,539,352,187,367907.7,195438.69,563346.39
150670,202011,1068,370,698,386732.92,730614.66,1117347.58
150680,202011,10088,5234,4854,5471794.23,5073488.73,10545282.96
150690,202011,20,10,10,10452.67,10450.34,20903.01
150700,202011,480,313,167,327138.74,174551.3,501690.04
150710,202011,284,154,130,160955.3,135861.04,296816.34
150715,202011,820,507,313,529878.17,327125.18,857003.35
150720,202011,413,316,97,330260.06,101371.93,431631.99
150730,202011,1029,511,518,534131.32,541441.26,1075572.58
150740,202011,227,148,79,154678.47,82563.68,237242.15
150745,202011,748,415,333,433775.17,349111.97,782887.14
150746,202011,64,36,28,37623.06,29262.01,66885.07
150747,202011,225,171,54,178708.91,56439.91,235148.82
150750,202011,140,80,60,83617.14,62707.15,146324.29
150760,202011,1825,1184,641,1237385.8,669889.3,1907275.1
150770,202011,393,216,177,225725.58,186013.41,411738.99
150775,202011,103,49,54,51218.05,56440.67,107658.72
150780,202011,201,113,88,118095.4,91968.96,210064.36
150790,202011,876,493,383,515217.37,400255.41,915472.78
150795,202011,1517,899,618,941688.22,645876.43,1587564.65
150796,202011,349,197,152,206913,158844.02,365757.02
150797,202011,339,168,171,175589.8,178708.19,354297.99
150800,202011,1502,850,652,888319.17,681370.25,1569689.42
150803,202011,545,440,105,459822.33,109732.24,569554.57
150805,202011,206,119,87,124368.29,90925.77,215294.06
150808,202011,988,530,458,553940.4,480778.19,1034718.59
150810,202011,3233,2198,1035,2300322.8,1082715.75,3383038.55
150812,202011,439,219,220,228885.47,229934.93,458820.40
150815,202011,1050,656,394,685604.75,411757.33,1097362.08
150820,202011,1546,917,629,958441.21,657426.29,1615867.50
150830,202011,737,534,203,558086.74,212159.02,770245.76
150835,202011,209,121,88,126459.61,91967.7,218427.31
150840,202011,1374,834,540,871723.85,566521.14,1438244.99
160005,202011,62,43,19,44941.69,19859.39,64801.08
160010,202011,191,124,67,129601.88,70025.29,199627.17
160015,202011,130,80,50,83603.8,52253.91,135857.71
160020,202011,136,75,61,78381.17,63749.84,142131.01
160021,202011,57,24,33,25085.1,34492.47,59577.57
160023,202011,67,43,24,44939.69,25081.38,70021.07
160025,202011,25,12,13,12541.2,13586.32,26127.52
160027,202011,1479,839,640,876892.75,668893.24,1545785.99
160030,202011,15962,8164,7798,8536301.41,8155881.16,16692182.57
160040,202011,300,174,126,181837.45,131681,313518.45
160050,202011,720,361,359,377289.27,375188.26,752477.53
160053,202011,282,170,112,177685.42,117059.11,294744.53
160055,202011,27,18,9,18814.2,9406.77,28220.97
160060,202011,6539,3436,3103,3591287.35,3244281.42,6835568.77
160070,202011,179,103,76,107642.6,79423.1,187065.7
160080,202011,112,54,58,56432.35,60610.67,117043.02
170025,202011,27,14,13,14632.56,13587.81,28220.37
170030,202011,200,163,37,170357.86,38668.11,209025.97
170035,202011,222,106,116,110809.99,121258.99,232068.98
170040,202011,178,133,45,138985.2,47025.49,186010.69
170070,202011,323,199,124,208013.74,129599.43,337613.17
170100,202011,352,257,95,268609.02,99295.54,367904.56
170105,202011,57,46,11,48075.54,11497.36,59572.90
170110,202011,113,67,46,71064.06,48070.07,119134.13
170130,202011,69,33,36,34486.49,37620.82,72107.31
170190,202011,98,58,40,60611.2,41801.41,102412.61
170200,202011,374,253,121,264422.8,126458.53,390881.33
170210,202011,6146,3228,2918,3374567.93,3053968.73,6428536.66
170215,202011,113,50,63,52255.57,65842.38,118097.95
170220,202011,1385,1018,367,1064985.51,383561.71,1448547.22
170230,202011,150,98,52,102435.89,54354.64,156790.53
170240,202011,518,347,171,363738.63,178737.77,542476.40
170255,202011,1082,876,206,915494.37,216331.35,1131825.72
170270,202011,46,33,13,34485,13585.02,48070.02
170290,202011,115,78,37,81515.62,38666.58,120182.20
170300,202011,97,62,35,64795.93,36576.23,101372.16
170305,202011,48,37,11,38667.69,11495.78,50163.47
170307,202011,61,47,14,49125.77,14632.98,63758.75
170310,202011,118,67,51,70024.34,54346.5,124370.84
170320,202011,27,17,10,17768.78,10452.16,28220.94
170330,202011,28,25,3,26129.33,3136.3,29265.63
170360,202011,32,18,14,18814.04,14633.83,33447.87
170370,202011,102,50,52,52264.12,54354.33,106618.45
170380,202011,71,53,18,55389.63,18810.34,74199.97
170382,202011,43,36,7,37621.84,7317.82,44939.66
170384,202011,140,109,31,113907.67,32395,146302.67
170386,202011,68,26,42,27172.83,43894.95,71067.78
170388,202011,48,19,29,19857.54,30309.42,50166.96
170389,202011,26,21,5,21947.73,5226.36,27174.09
170390,202011,72,40,32,41805.61,33443.6,75249.21
170410,202011,29,25,4,26131.14,4181.1,30312.24
170460,202011,17,11,6,11498.8,6271.92,17770.72
170510,202011,36,28,8,29265.72,8361.68,37627.40
170550,202011,1545,897,648,937545.88,677293.4,1614839.28
170555,202011,110,80,30,83622.44,31357.72,114980.16
170560,202011,108,75,33,78375.04,34485.85,112860.89
170600,202011,43,17,26,17766.56,27170.46,44937.02
170610,202011,196,102,94,106619.61,99301.76,205921.37
170625,202011,35,20,15,20901.13,15679.04,36580.17
170650,202011,80,58,22,60613.27,22992.72,83605.99
170700,202011,584,437,147,456718.28,153628.46,610346.74
170710,202011,159,99,60,103489.67,62720.29,166209.96
170720,202011,90,72,18,75243.8,18811.02,94054.82
170730,202011,85,50,35,52258.97,36579.83,88838.80
170740,202011,85,59,26,61655.78,27171.37,88827.15
170755,202011,60,33,27,34489.56,28226.62,62716.18
170765,202011,142,75,67,78397.58,70031.44,148429.02
170770,202011,207,130,77,135862.95,80470.05,216333.00
170820,202011,614,406,208,424339.03,217394.27,641733.30
170825,202011,37,18,19,18811.91,19857.64,38669.55
170830,202011,84,67,17,70021.69,17765.67,87787.36
170900,202011,181,139,42,145263.62,43892.69,189156.31
170930,202011,916,489,427,511105.34,446301.92,957407.26
170950,202011,3129,1430,1699,1494670.7,1775859.8,3270530.5
170980,202011,15,10,5,10453.27,5225.69,15678.96
171050,202011,147,113,34,118088.22,35530.82,153619.04
171070,202011,41,34,7,35531.99,7315,42846.99
171090,202011,49,36,13,37621.96,13586.22,51208.18
171110,202011,22,16,6,16723,6270.19,22993.19
171150,202011,40,21,19,21945,19855,41800
171180,202011,29,15,14,15679.15,14633.67,30312.82
171190,202011,156,91,65,95111.16,67936.83,163047.99
171195,202011,65,54,11,56443.57,11498.1,67941.67
171200,202011,50,25,25,26129.63,26127.15,52256.78
171215,202011,4,3,1,3135.07,1045.89,4180.96
171240,202011,58,41,17,42845,17768.16,60613.16
171245,202011,57,48,9,50176.48,9408.5,59584.98
171250,202011,76,43,33,44936.95,34487.81,79424.76
171270,202011,16,11,5,11498.06,5227.3,16725.36
171280,202011,39,34,5,35539.91,5225.38,40765.29
171320,202011,1007,573,434,598873.02,453581.16,1052454.18
171330,202011,428,213,215,222604.87,224700.27,447305.14
171360,202011,88,61,27,64792.34,28218.79,93011.13
171370,202011,34,17,17,18814.48,17772.62,36587.10
171380,202011,130,112,18,117042.68,18810.25,135852.93
171395,202011,51,32,19,33441.09,19856.08,53297.17
171420,202011,278,181,97,189153.64,101371.35,290524.99
171430,202011,73,58,15,60619.58,15675.62,76295.20
171488,202011,177,100,77,104512.01,80470.01,184982.02
171500,202011,59,34,25,35534.63,26128.76,61663.39
171510,202011,69,45,24,47027.14,26126.92,73154.06
171515,202011,42,33,9,34491.69,9407.15,43898.84
171525,202011,29,27,2,28220.01,2090.4,30310.41
171550,202011,14,9,5,9407.16,5225.72,14632.88
171570,202011,52,26,26,27171.57,27171.53,54343.10
171575,202011,305,198,107,206928.06,111821.15,318749.21
171610,202011,1744,880,864,921877.26,903066.14,1824943.40
171620,202011,138,95,43,99285.36,44937.96,144223.32
171630,202011,56,29,27,30306.84,28215,58521.84
171650,202011,309,214,95,223674,99289.72,322963.72
171660,202011,270,151,119,157839.62,124387.66,282227.28
171665,202011,61,41,20,42848.62,20903.23,63751.85
171670,202011,432,261,171,272792.94,178715.22,451508.16
171700,202011,63,57,6,59571.36,6272.39,65843.75
171720,202011,28,10,18,10452.08,18812.67,29264.75
171750,202011,100,50,50,52255.82,52258.68,104514.50
171780,202011,70,55,15,57482.43,15675.6,73158.03
171790,202011,83,68,15,71063.14,15675,86738.14
171800,202011,32,23,9,24035.97,9405,33440.97
171820,202011,2099,1191,908,1245869.31,949010.84,2194880.15
171830,202011,33,26,7,27172.28,7315,34487.28
171840,202011,65,42,23,43896.65,24036.12,67932.77
171845,202011,30,19,11,19856.99,11496.08,31353.07
171850,202011,38,30,8,31353.13,8361.78,39714.91
171855,202011,77,59,18,61657.07,18810.32,80467.39
171865,202011,7,6,1,6270.44,1045.34,7315.78
171870,202011,32,23,9,24042.49,9406.56,33449.05
171875,202011,80,57,23,59566.25,24035.5,83601.75
171880,202011,34,22,12,22992.05,12542.76,35534.81
171884,202011,50,27,23,28215.63,24035.6,52251.23
171886,202011,131,53,78,55386.6,81515.46,136902.06
171888,202011,32,26,6,27178.83,6272.37,33451.20
171889,202011,15,10,5,10452.07,5227.08,15679.15
171890,202011,55,47,8,49120.36,8360,57480.36
171900,202011,35,25,10,26133.2,10452.12,36585.32
172000,202011,41,31,10,32402.96,10451.46,42854.42
172010,202011,53,43,10,44938.5,10451.25,55389.75
172015,202011,24,16,8,16726.5,8363.32,25089.82
172020,202011,137,87,50,90923.46,52256.52,143179.98
172025,202011,39,26,13,27171.82,13585.25,40757.07
172030,202011,42,24,18,25080.91,18811.33,43892.24
172049,202011,82,54,28,56434.55,29260.1,85694.65
172065,202011,134,87,47,91989.07,49130.55,141119.62
172080,202011,105,70,35,73154.64,36578.76,109733.40
172085,202011,29,14,15,14630.5,15675.58,30306.08
172090,202011,426,324,102,338638.84,106610.29,445249.13
172093,202011,15,13,2,13585.12,2090,15675.12
172097,202011,17,11,6,11496.16,6271.47,17767.63
172100,202011,5093,2867,2226,2997767.51,2330864.92,5328632.43
172110,202011,77,48,29,50171.92,30310.98,80482.90
172120,202011,1638,1376,262,1438213.27,273833.83,1712047.10
172125,202011,11,10,1,10451.6,1045.17,11496.77
172130,202011,24,14,10,14631.73,10453.53,25085.26
172208,202011,201,123,78,128541.88,81515.37,210057.25
172210,202011,378,182,196,190233.47,204862.07,395095.54
210005,202011,2977,1868,1109,1952482.27,1159180.47,3111662.74
210010,202011,159,90,69,94051.94,72105.6,166157.54
210015,202011,40,29,11,30308.03,11495,41803.03
210020,202011,357,200,157,209021.99,164084.15,373106.14
210030,202011,326,216,110,225771.96,114972.62,340744.58
210040,202011,140,111,29,116003.54,30307.42,146310.96
210043,202011,251,190,61,198564.87,63750.41,262315.28
210047,202011,526,317,209,331267.14,218405.83,549672.97
210050,202011,287,211,76,220497.37,79422.85,299920.22
210055,202011,49,39,10,40759.55,10452.06,51211.61
210060,202011,541,434,107,453601.83,111833.69,565435.52
210070,202011,420,320,100,334404.8,104503.85,438908.65
210080,202011,128,115,13,120181.25,13585.88,133767.13
210083,202011,295,145,150,151527.71,156750.92,308278.63
210087,202011,4,2,2,2090,2090,4180
210090,202011,442,318,124,332373.78,130647.84,463021.62
210095,202011,432,329,103,343848.34,107653.69,451502.03
210100,202011,707,550,157,574811.98,164089.74,738901.72
210110,202011,123,80,43,83603.6,44936.18,128539.78
210120,202011,5031,3933,1098,4110880.68,1148793.68,5259674.36
210125,202011,192,118,74,123323.89,77337,200660.89
210130,202011,475,270,205,282194.29,214253.02,496447.31
210135,202011,25,18,7,18818.23,7317.39,26135.62
210140,202011,4385,3412,973,3567267.26,1018033.57,4585300.83
210150,202011,376,236,140,246706.87,146340.79,393047.66
210160,202011,3287,2789,498,2914980.82,520506.29,3435487.11
210170,202011,1148,921,227,962610.13,238284.04,1200894.17
210173,202011,126,110,16,114953.16,16722.5,131675.66
210177,202011,356,201,155,210056.39,161995.89,372052.28
210180,202011,30,16,14,16720,14630.54,31350.54
210190,202011,435,289,146,302020.79,152574.09,454594.88
210193,202011,2,2,0,2090,0,2090
210197,202011,73,53,20,55386.46,20902.74,76289.20
210200,202011,607,510,97,533039.33,101388.47,634427.80
210203,202011,228,156,72,163037.91,75246.41,238284.32
210207,202011,365,301,64,314591.87,66898.18,381490.05
210210,202011,745,689,56,720048.23,58526.91,778575.14
210215,202011,75,67,8,70028.33,8360,78388.33
210220,202011,389,328,61,342835.95,63758.09,406594.04
210230,202011,314,251,63,262321.51,65838.54,328160.05
210232,202011,1380,937,443,979276.8,462985.13,1442261.93
210235,202011,170,128,42,133783.8,43896.96,177680.76
210237,202011,36,21,15,21946.85,15676.53,37623.38
210240,202011,89,76,13,79421.78,13586.65,93008.43
210250,202011,180,152,28,158843.53,29262.83,188106.36
210255,202011,352,265,87,276969.05,90919.76,367888.81
210260,202011,399,274,125,286334.68,130625.58,416960.26
210270,202011,651,436,215,456689.32,224693.9,681383.22
210275,202011,76,59,17,61657.58,17768.11,79425.69
210280,202011,1055,701,354,732605.72,369955.23,1102560.95
210290,202011,534,357,177,373087.49,184973.83,558061.32
210300,202011,5314,3347,1967,3499097.58,2055770.31,5554867.89
210310,202011,111,78,33,81512.41,34486.05,115998.46
210312,202011,115,80,35,83603.51,36576.08,120179.59
210315,202011,109,89,20,93009.3,20900.88,113910.18
210317,202011,136,101,35,105547.39,36577.35,142124.74
210320,202011,2324,1976,348,2066276.83,363700.33,2429977.16
210325,202011,140,89,51,93016.76,53304.12,146320.88
210330,202011,4596,2634,1962,2752757.9,2051505.87,4804263.77
210340,202011,1245,931,314,974078.03,328176.81,1302254.84
210350,202011,632,526,106,549740.72,110784.87,660525.59
210355,202011,144,120,24,125409.68,25084.88,150494.56
210360,202011,2234,1539,695,1608418.66,726355.01,2334773.67
210370,202011,1229,603,626,630211.92,655299.01,1285510.93
210375,202011,189,95,94,99296.47,98250.93,197547.40
210380,202011,713,546,167,570635.41,174536.45,745171.86
210390,202011,195,167,28,174519.93,29260.44,203780.37
210400,202011,396,345,51,360591.44,53304.12,413895.56
210405,202011,985,690,295,721099.43,308295.36,1029394.79
210407,202011,53,42,11,43891.54,11496.22,55387.76
210408,202011,59,52,7,54351.41,7316.95,61668.36
210409,202011,323,281,42,293677.01,43893.75,337570.76
210410,202011,442,344,98,359495.71,102416.13,461911.84
210420,202011,204,168,36,175568.01,37620.61,213188.62
210430,202011,49,34,15,35530.99,15675.44,51206.43
210440,202011,337,228,109,238303.28,113921.27,352224.55
210450,202011,141,113,28,118098.41,29262.82,147361.23
210455,202011,232,125,107,131695.4,111833.86,243529.26
210460,202011,302,203,99,212172.42,103475.78,315648.20
210462,202011,65,55,10,57482.44,10451.16,67933.60
210465,202011,145,114,31,119137.22,32396.83,151534.05
210467,202011,515,379,136,396093.12,142132.6,538225.72
210470,202011,50,43,7,44935.52,7315,52250.52
210480,202011,1267,911,356,952125.06,372086.1,1324211.16
210490,202011,204,135,69,141088.14,72111.82,213199.96
210500,202011,506,310,196,324001.31,204845.76,528847.07
210510,202011,549,437,112,456669.01,117043.72,573712.73
210515,202011,355,225,130,235142.98,135874.3,371017.28
210520,202011,400,360,40,376241.91,41806.02,418047.93
210530,202011,9408,4932,4476,5157271.96,4678655.98,9835927.94
210535,202011,131,98,33,102415.49,34489.02,136904.51
210540,202011,1516,1010,506,1055589.39,528822.43,1584411.82
210542,202011,1172,598,574,626058.6,599948.68,1226007.28
210545,202011,22,20,2,20902.46,2090,22992.46
210547,202011,127,112,15,117051.51,15677.61,132729.12
210550,202011,681,495,186,517390.49,194400.97,711791.46
210560,202011,157,138,19,144211.6,19855.77,164067.37
210565,202011,21,16,5,16725.84,5227.46,21953.30
210570,202011,1297,1051,246,1098465.44,257123.7,1355589.14
210580,202011,119,102,17,106592.52,17765.47,124357.99
210590,202011,732,605,127,632248.32,132717.1,764965.42
210592,202011,37,35,2,36577.72,2090,38667.72
210594,202011,111,93,18,97193.37,18815.48,116008.85
210596,202011,102,87,15,90920.91,15675.44,106596.35
210598,202011,137,102,35,107643.83,36580.8,144224.63
210600,202011,314,272,42,284298.71,43902.51,328201.22
210610,202011,255,240,15,250837.67,15676.11,266513.78
210620,202011,43,27,16,28215.99,16722.2,44938.19
210630,202011,73,71,2,74199.1,2090,76289.1
210632,202011,1034,731,303,763923.68,316646.2,1080569.88
210635,202011,22,19,3,19863.47,3135.99,22999.46
210637,202011,120,87,33,90918.77,34485.78,125404.55
210640,202011,594,518,76,541322.61,79420.94,620743.55
210650,202011,399,333,66,349042.02,68975.09,418017.11
210660,202011,371,294,77,307299.4,80480.79,387780.19
210663,202011,36,27,9,28217.35,9405.44,37622.79
210667,202011,102,42,60,43894.91,62707.68,106602.59
210670,202011,244,217,27,226799.97,28221.19,255021.16
210675,202011,543,292,251,305164.65,263372.72,568537.37
210680,202011,224,145,79,151541.88,82562.93,234104.81
210690,202011,623,513,110,536087.22,114951.89,651039.11
210700,202011,158,120,38,125406.96,39712.85,165119.81
210710,202011,242,154,88,160940.64,91962.17,252902.81
210720,202011,130,117,13,122267.75,13585,135852.75
210725,202011,66,58,8,60632.67,8363.08,68995.75
210730,202011,24,18,6,18812.76,6271.38,25084.14
210735,202011,292,210,82,219456.09,85691.12,305147.21
210740,202011,522,452,70,472456.38,73168.02,545624.40
210745,202011,153,114,39,119137.66,40756.47,159894.13
210750,202011,2407,1218,1189,1273054.65,1242736.19,2515790.84
210760,202011,258,198,60,206924.49,62703.85,269628.34
210770,202011,245,197,48,205933.46,50177.83,256111.29
210780,202011,440,330,110,344900.58,114964.22,459864.80
210790,202011,182,150,32,156781.1,33446.9,190228.0
210800,202011,172,130,42,135879.42,43896.77,179776.19
210805,202011,54,49,5,51205.98,5225,56430.98
210810,202011,468,381,87,398218.71,90932.8,489151.51
210820,202011,2136,1765,371,1844811.45,387775.41,2232586.86
210825,202011,153,87,66,90935.98,68986.96,159922.94
210830,202011,734,486,248,507891.83,259171.19,767063.02
210840,202011,195,139,56,145264.82,58522.52,203787.34
210845,202011,233,164,69,171387.59,72106.13,243493.72
210850,202011,752,514,238,537210.8,248737.33,785948.13
210860,202011,3671,2081,1590,2175951.36,1661730.77,3837682.13
210870,202011,429,341,88,356446.63,91985.76,448432.39
210880,202011,75,58,17,60613.65,17766.22,78379.87
210890,202011,322,279,43,291625.08,44947.27,336572.35
210900,202011,623,404,219,422272.52,229945.46,652217.98
210905,202011,64,35,29,36577.3,30307.19,66884.49
210910,202011,1947,1471,476,1537467.01,497497.94,2034964.95
210920,202011,169,63,106,65842.58,110771.91,176614.49
210923,202011,83,66,17,68972.67,17765,86737.67
210927,202011,410,191,219,199599.42,228873.39,428472.81
210930,202011,71,57,14,59568.62,14631.95,74200.57
210940,202011,87,66,21,68972.35,21945.34,90917.69
210945,202011,192,103,89,107646.43,93014.21,200660.64
210950,202011,531,386,145,403411.63,151544.82,554956.45
210955,202011,83,51,32,53299.22,33442.22,86741.44
210960,202011,2190,1092,1098,1142265.57,1148544.35,2290809.92
210970,202011,116,102,14,106597.76,14630.11,121227.87
210975,202011,81,76,5,79433.81,5226.98,84660.79
210980,202011,1093,533,560,557080.57,585266.17,1142346.74
210990,202011,4023,2650,1373,2773941.31,1434988.19,4208929.50
211000,202011,1318,1063,255,1111005.28,266515.87,1377521.15
211003,202011,981,706,275,738869.11,287399.09,1026268.20
211010,202011,495,439,56,458785.68,58525.28,517310.96
211020,202011,1433,613,820,640653.61,857018.4,1497672.01
211023,202011,34,30,4,31351.48,4180,35531.48
211027,202011,73,52,21,54341.83,21946.21,76288.04
211030,202011,370,265,105,276951.87,109739.99,386691.86
211040,202011,297,246,51,258122.58,54341.04,312463.62
211050,202011,1163,774,389,808967.8,406558.96,1215526.76
211060,202011,634,551,83,575893.65,86747.94,662641.59
211065,202011,20,17,3,17769.57,3135.21,20904.78
211070,202011,888,736,152,769283.98,158873.92,928157.90
211080,202011,86,83,3,86740.28,3135.23,89875.51
211085,202011,55,28,27,29263.83,28218.31,57482.14
211090,202011,77,65,12,67942.75,12544.78,80487.53
211100,202011,485,401,84,420164.77,87799.16,507963.93
211102,202011,251,178,73,186010,76285,262295
211105,202011,221,157,64,164076.64,66884.79,230961.43
211107,202011,129,81,48,84647.1,50160.8,134807.9
211110,202011,946,633,313,662639.55,327144.67,989784.22
211120,202011,5270,2619,2651,2738626.04,2771863.32,5510489.36
211125,202011,33,24,9,25086.83,9405.7,34492.53
211130,202011,41553,19055,22498,19929613.17,23532656.6,43462269.77
211140,202011,401,352,49,367921.61,51216.07,419137.68
211150,202011,1191,809,382,846578.26,400285.53,1246863.79
211153,202011,168,104,64,108680.86,66881.9,175562.76
211157,202011,65,51,14,53299.98,14631.63,67931.61
211160,202011,698,599,99,626016.53,103469.19,729485.72
211163,202011,1,1,0,1045,0,1045
211167,202011,10,9,1,9405.97,1045.94,10451.91
211170,202011,418,313,105,328159.02,109742.01,437901.03
211172,202011,117,80,37,83601.93,38669.12,122271.05
211174,202011,254,158,96,165110,100320,265430
211176,202011,485,362,123,378334.76,128545.81,506880.57
211178,202011,94,62,32,64795.9,33442.63,98238.53
211180,202011,211,167,44,174530.09,45986.95,220517.04
211190,202011,71,65,6,67927.99,6270,74197.99
211195,202011,34,23,11,24042.9,11499.35,35542.25
211200,202011,151,131,20,136921.74,20904.49,157826.23
211210,202011,430,319,111,334444.22,116017.34,450461.56
211220,202011,4110,2407,1703,2515829.16,1781056.18,4296885.34
211223,202011,93,90,3,94062.01,3135.18,97197.19
211227,202011,66,52,14,54345.19,14631.06,68976.25
211230,202011,737,609,128,636514.31,133787.03,770301.34
211240,202011,404,318,86,332329.81,89873.37,422203.18
211245,202011,185,92,93,96148.39,97194.72,193343.11
211250,202011,1540,1331,209,1391101.55,218437.65,1609539.20
211260,202011,801,661,140,690758.38,146300.61,837058.99
211270,202011,1961,1603,358,1675224.73,374125.81,2049350.54
211280,202011,1742,1121,621,1171613.92,649033.77,1820647.69
211285,202011,206,125,81,130631.7,84646.43,215278.13
211290,202011,715,496,219,518352.28,228869.8,747222.08
211300,202011,755,600,155,628160.66,161998.88,790159.54
211400,202011,1523,937,586,979291.63,612434.48,1591726.11
220005,202011,15,14,1,14635.23,1045.5,15680.73
220010,202011,89,69,20,72106.77,20901.82,93008.59
220020,202011,700,555,145,580025.23,151544.73,731569.96
220025,202011,110,108,2,112863.44,2090,114953.44
220027,202011,44,35,9,36577.49,9405,45982.49
220030,202011,113,91,22,95099.08,22990,118089.08
220040,202011,1244,942,302,984485.55,315620.55,1300106.10
220045,202011,33,22,11,22996.63,11497.51,34494.14
220050,202011,693,579,114,605122.3,119141.59,724263.89
220060,202011,169,149,20,155738.31,20903.59,176641.90
220070,202011,111,101,10,105556.12,10450.73,116006.85
220080,202011,16,14,2,14633.06,2090,16723.06
220090,202011,33,27,6,28215.13,6270,34485.13
220095,202011,2,1,1,1045.79,1045,2090.79
220100,202011,18,15,3,15677.33,4180.8,19858.13
220105,202011,26,24,2,25084.7,2090.54,27175.24
220110,202011,228,208,20,217368.99,20900.38,238269.37
220115,202011,36,35,1,36577.97,1045,37622.97
220117,202011,21,20,1,20902.15,1045,21947.15
220120,202011,1474,1126,348,1178866.18,365783.47,1544649.65
220130,202011,31,30,1,31352.41,1045.19,32397.60
220140,202011,106,84,22,87783.11,22993.16,110776.27
220150,202011,500,370,130,386753.18,135882.63,522635.81
220155,202011,6,6,0,6270,0,6270
220157,202011,20,16,4,16725.28,4181.07,20906.35
220160,202011,88,79,9,82559.31,9406.22,91965.53
220170,202011,34,32,2,33443.32,2090,35533.32
220173,202011,8,8,0,8360.67,0,8360.67
220177,202011,8,8,0,8361.52,0,8361.52
220180,202011,68,66,2,68972.97,2090,71062.97
220190,202011,1077,951,126,994942.49,131683.02,1126625.51
220191,202011,41,34,7,35541.62,7317.6,42859.22
220192,202011,82,79,3,82558.4,3135,85693.4
220194,202011,56,52,4,54345.23,4180.34,58525.57
220196,202011,100,84,16,87794.41,16722.78,104517.19
220198,202011,4,3,1,3135,1045,4180
220200,202011,414,342,72,358536.45,75253.42,433789.87
220202,202011,38,33,5,34494.59,5226.01,39720.60
220205,202011,52,46,6,48071.35,6270,54341.35
220207,202011,10,10,0,10453.59,0,10453.59
220208,202011,76,41,35,42849.94,36578.13,79428.07
220209,202011,32,28,4,29263.43,4181.3,33444.73
220210,202011,22,14,8,14632.77,8360.35,22993.12
220211,202011,26,24,2,25083.36,2090.6,27173.96
220213,202011,41,36,5,37628.63,5225.27,42853.90
220217,202011,41,31,10,32397.73,10450.43,42848.16
220220,202011,2194,1451,743,1516463.02,776543.27,2293006.29
220225,202011,8,3,5,3135.73,5227.48,8363.21
220230,202011,961,742,219,775471.79,228889.08,1004360.87
220240,202011,160,143,17,149444.18,17767.38,167211.56
220245,202011,32,29,3,30307.73,3135.26,33442.99
220250,202011,121,107,14,111830.05,14630.95,126461.00
220253,202011,47,40,7,41802.99,7315.5,49118.49
220255,202011,33,29,4,30306.56,4180.74,34487.30
220260,202011,704,526,178,550789.19,186040.21,736829.40
220265,202011,5,3,2,3135,2090.61,5225.61
220270,202011,766,690,76,721125.73,79427.93,800553.66
220271,202011,43,35,8,36582.99,8361.15,44944.14
220272,202011,21,21,0,21945.25,0,21945.25
220273,202011,17,15,2,15679.49,2090.89,17770.38
220275,202011,56,46,10,49115.55,10450,59565.55
220277,202011,17,14,3,14631.65,3135.25,17766.90
220280,202011,17,12,5,12541.56,5225.67,17767.23
220285,202011,43,40,3,41810.82,3135,44945.82
220290,202011,1476,1269,207,1327123.32,216350.58,1543473.90
220300,202011,36,34,2,35539.62,2090.34,37629.96
220310,202011,323,275,48,288489.74,51218.01,339707.75
220320,202011,439,407,32,425395.62,33446.97,458842.59
220323,202011,1,0,1,0,1045,1045
220325,202011,11,10,1,10452.45,1045.34,11497.79
220327,202011,9,9,0,9407.54,0,9407.54
220330,202011,232,171,61,178705.49,63750.05,242455.54
220335,202011,142,124,18,129581.39,18810.17,148391.56
220340,202011,40,27,13,28218.28,13587.65,41805.93
220342,202011,56,48,8,50172.69,8363.15,58535.84
220345,202011,81,73,8,76291.16,8360.1,84651.26
220350,202011,443,381,62,398167.61,64797.45,462965.06
220360,202011,43,31,12,32396.24,12540.6,44936.84
220370,202011,1239,1026,213,1072312.53,222610.78,1294923.31
220375,202011,19,17,2,17767.13,2090.67,19857.80
220380,202011,23,17,6,17768.68,6270,24038.68
220385,202011,13,12,1,12542.65,1045.27,13587.92
220390,202011,2327,1319,1008,1378594.99,1054594.8,2433189.79
220400,202011,34,30,4,31350.44,4180.95,35531.39
220410,202011,21,18,3,18814.98,3137.33,21952.31
220415,202011,13,11,2,11498.93,2090.97,13589.90
220420,202011,125,105,20,109747.09,20904.98,130652.07
220430,202011,129,115,14,120199.59,14631.81,134831.40
220435,202011,24,17,7,17769.66,7318.14,25087.80
220440,202011,288,245,43,256077.37,44945.3,301022.67
220450,202011,335,170,165,177687.04,172468.06,350155.10
220455,202011,52,51,1,53302.09,1045,54347.09
220460,202011,19,18,1,18814.14,1045.41,19859.55
220465,202011,95,64,31,66903.08,32404.47,99307.55
220470,202011,243,210,33,219497.25,34492.96,253990.21
220480,202011,72,64,8,66880.67,8360.34,75241.01
220490,202011,88,75,13,78375,13585,91960
220500,202011,106,90,16,94055.02,16721.05,110776.07
220510,202011,417,324,93,338640.49,97196.58,435837.07
220515,202011,22,20,2,20905.37,2090.44,22995.81
220520,202011,367,329,38,343881.06,39720.06,383601.12
220525,202011,10,7,3,7317.62,3135.74,10453.36
220527,202011,18,14,4,14635.03,4180.84,18815.87
220530,202011,33,12,21,12542.2,21946.82,34489.02
220535,202011,4,4,0,4181.14,0,4181.14
220540,202011,67,54,13,56433.43,13586.44,70019.87
220545,202011,40,27,13,28221.88,13587.01,41808.89
220550,202011,711,561,150,586344.2,156781.51,743125.71
220551,202011,13,10,3,10452.72,3135.98,13588.70
220552,202011,15,15,0,15678.02,0,15678.02
220553,202011,54,49,5,51214.7,5225.13,56439.83
220554,202011,10,7,3,7316.51,3135.47,10451.98
220555,202011,33,30,3,31357.13,3137.15,34494.28
220556,202011,41,39,2,40760.09,2090.1,42850.19
220557,202011,57,54,3,56447.78,3135.7,59583.48
220558,202011,9,4,5,4180.78,5226.11,9406.89
220559,202011,2,2,0,2091.31,0,2091.31
220560,202011,70,46,24,48072.53,25080.67,73153.20
220570,202011,740,458,282,478672.44,294711.8,773384.24
220580,202011,550,504,46,526827.13,48080.01,574907.14
220585,202011,10,9,1,9407.19,1045.74,10452.93
220590,202011,15,15,0,15677.75,0,15677.75
220595,202011,64,49,15,51209.71,15677.9,66887.61
220600,202011,19,11,8,11495.82,8361.4,19857.22
220605,202011,26,23,3,24038.11,3135.84,27173.95
220610,202011,77,65,12,67926.7,12540.6,80467.3
220620,202011,556,463,93,483918.88,97201.6,581120.48
220630,202011,5,4,1,4180.45,1045,5225.45
220635,202011,37,32,5,33449.46,5225.34,38674.80
220640,202011,105,87,18,90916.79,18810,109726.79
220650,202011,112,105,7,109731.47,7315,117046.47
220660,202011,56,45,11,47031.98,11497,58528.98
220665,202011,5,5,0,5226.22,0,5226.22
220667,202011,19,17,2,17769.66,2090.4,19860.06
220669,202011,28,25,3,26128.22,3135,29263.22
220670,202011,65,52,13,54347.28,13585.91,67933.19
220672,202011,75,52,23,54348.6,24040.74,78389.34
220675,202011,36,28,8,29269.34,8361.48,37630.82
220680,202011,43,37,6,38665,6270,44935
220690,202011,47,44,3,45980.93,3135.6,49116.53
220695,202011,34,17,17,17769.09,17769.85,35538.94
220700,202011,1708,1320,388,1380591.13,406543.48,1787134.61
220710,202011,7,5,2,5225.81,2090.77,7316.58
220720,202011,107,90,17,94052.39,17765,111817.39
220730,202011,14,14,0,14632.84,0,14632.84
220735,202011,4,0,4,0,4180,4180
220740,202011,49,45,4,47029.54,4180,51209.54
220750,202011,110,95,15,99280.46,15676.98,114957.44
220755,202011,15,14,1,14636.1,1045.6,15681.7
220760,202011,66,60,6,62704.97,6270,68974.97
220770,202011,5687,3108,2579,3250712.82,2695615.54,5946328.36
220775,202011,17,10,7,10454.67,7315.82,17770.49
220777,202011,18,17,1,17765.72,1045,18810.72
220779,202011,1,0,1,0,1045,1045
220780,202011,895,762,133,796391.3,138999.81,935391.11
220785,202011,5,1,4,1045.8,4181.82,5227.62
220790,202011,1098,864,234,904120.25,244575.85,1148696.10
220793,202011,6,6,0,6271.61,0,6271.61
220795,202011,14,12,2,12543.54,2090.44,14633.98
220800,202011,4002,3082,920,3224294.77,963637.3,4187932.07
220810,202011,65,57,8,59571.97,8360.78,67932.75
220820,202011,237,216,21,225760.52,21952.51,247713.03
220830,202011,1249,1079,170,1127709.08,177673.78,1305382.86
220840,202011,2414,1678,736,1753819.66,769258.19,2523077.85
220850,202011,56,47,9,49115.6,9405,58520.6
220855,202011,8,5,3,5226.4,3136.2,8362.6
220860,202011,12,10,2,10455.2,2090.92,12546.12
220865,202011,30,28,2,29262.45,2090,31352.45
220870,202011,72,65,7,67933.78,7316.16,75249.94
220880,202011,323,257,66,268610.2,68983.98,337594.18
220885,202011,31,28,3,29263.92,3135.8,32399.72
220887,202011,13,12,1,12543.16,1045,13588.16
220890,202011,95,83,12,86756.53,12542.53,99299.06
220900,202011,23,14,9,14634.28,9408.46,24042.74
220910,202011,51,43,8,44941.83,8361.54,53303.37
220915,202011,11,10,1,10450.15,1045,11495.15
220920,202011,48,43,5,44944.18,5226.61,50170.79
220930,202011,43,42,1,43894.59,1045,44939.59
220935,202011,15,15,0,15682.99,0,15682.99
220937,202011,33,32,1,33447.63,1045,34492.63
220940,202011,55,50,5,52252.12,5225,57477.12
220945,202011,2,2,0,2090.34,0,2090.34
220950,202011,41,33,8,34491.74,8360.67,42852.41
220955,202011,23,21,2,21948.81,2090,24038.81
220960,202011,12,11,1,11495.44,1045,12540.44
220965,202011,37,33,4,34485,4180,38665
220970,202011,61,51,10,53295.32,10450,63745.32
220975,202011,16,14,2,14636.95,2090,16726.95
220980,202011,32,30,2,31351.78,2090.86,33442.64
220985,202011,63,56,7,58521.97,7315.24,65837.21
220987,202011,29,28,1,29268.28,1045.89,30314.17
220990,202011,25,24,1,25081.09,1045,26126.09
220995,202011,19,15,4,15677.21,4181.49,19858.70
220997,202011,66,55,11,57489.68,11496.58,68986.26
221000,202011,1182,1064,118,1112020,123323.73,1235343.73
221005,202011,47,42,5,43892.6,5225.44,49118.04
221010,202011,16,12,4,12541.13,4180,16721.13
221020,202011,38,37,1,38674.53,1045.78,39720.31
221030,202011,39,31,8,32400.05,8360.78,40760.83
221035,202011,23,23,0,24042.57,0,24042.57
221037,202011,12,8,4,8362.53,4180.47,12543.00
221038,202011,27,24,3,25080,3135,28215
221039,202011,22,22,0,22990.96,0,22990.96
221040,202011,256,219,37,228914.17,38671.85,267586.02
221050,202011,236,198,38,206955.75,39715.87,246671.62
221060,202011,1856,1619,237,1693063.44,247689.72,1940753.16
221062,202011,34,34,0,35538.98,0,35538.98
221063,202011,12,8,4,8360,4180.67,12540.67
221065,202011,62,50,12,52259.92,12541.33,64801.25
221070,202011,136,119,17,124384.13,17768.17,142152.30
221080,202011,373,320,53,334458.27,55389.97,389848.24
221090,202011,22,19,3,19858.34,3135.72,22994.06
221093,202011,44,33,11,34496.16,11495.77,45991.93
221095,202011,7,7,0,7317.46,0,7317.46
221097,202011,11,9,2,9406.86,2091.2,11498.06
221100,202011,25437,15099,10338,15787664.18,10810941.59,26598605.77
221110,202011,1103,841,262,878999.93,273837.65,1152837.58
221120,202011,542,399,143,416999.43,149450.3,566449.73
221130,202011,973,783,190,818321.92,198569.72,1016891.64
221135,202011,36,31,5,32402.2,5226.76,37628.96
221140,202011,45,39,6,40760.97,6270.51,47031.48
221150,202011,11,9,2,9407.35,2090.17,11497.52
221160,202011,13,13,0,13590.26,0,13590.26
221170,202011,16,16,0,16722.64,0,16722.64
230010,202011,157,145,12,151528.55,12540.2,164068.75
230015,202011,128,103,25,107640.72,26125.01,133765.73
230020,202011,1629,1372,257,1433880.29,268598.91,1702479.20
230030,202011,1677,1204,473,1258362.04,494349.14,1752711.18
230040,202011,220,187,33,195419.88,34485.34,229905.22
230050,202011,228,168,60,175565.17,62701.71,238266.88
230060,202011,161,128,33,133761.74,34485.47,168247.21
230070,202011,306,263,43,274843.79,44936.18,319779.97
230075,202011,845,727,118,759822.09,123323.14,883145.23
230080,202011,195,167,28,174530.61,29261.09,203791.70
230090,202011,131,93,38,97192.73,39712.2,136904.93
230100,202011,2178,1240,938,1296106.4,981493.62,2277600.02
230110,202011,2912,1879,1033,1964821.4,1081715.56,3046536.96
230120,202011,1018,798,220,834007.71,230986.45,1064994.16
230125,202011,153,125,28,130631.22,29261.53,159892.75
230130,202011,477,424,53,443110.45,55388.9,498499.35
230140,202011,222,185,37,193332.35,38665.87,231998.22
230150,202011,148,113,35,118087.88,36579.28,154667.16
230160,202011,940,797,143,832906.21,149440.35,982346.56
230170,202011,608,547,61,571714.24,63752.31,635466.55
230180,202011,72,66,6,68970,6270,75240
230185,202011,403,347,56,362660.87,58526.64,421187.51
230190,202011,2346,1843,503,1926164.21,525705.33,2451869.54
230195,202011,492,427,65,446284.38,67935.26,514219.64
230200,202011,412,337,75,352213.01,78379.93,430592.94
230205,202011,390,257,133,268568.43,138987.91,407556.34
230210,202011,1361,1057,304,1105714.1,317710.66,1423424.76
230220,202011,1586,1072,514,1121463.63,537220.05,1658683.68
230230,202011,968,814,154,850724.48,160949.04,1011673.52
230240,202011,1762,1515,247,1583621.82,258147.36,1841769.18
230250,202011,1783,1469,314,1535274.37,328176.16,1863450.53
230260,202011,3257,2024,1233,2115176.43,1288552.44,3403728.87
230270,202011,1367,1096,271,1145436.6,283226.56,1428663.16
230280,202011,2756,2066,690,2159159.55,721114.24,2880273.79
230290,202011,400,357,43,373118.11,44942.64,418060.75
230300,202011,531,382,149,401291.58,155710.54,557002.12
230310,202011,413,313,100,327110.2,105550.29,432660.49
230320,202011,926,786,140,821455.38,146312.09,967767.47
230330,202011,304,244,60,254995.68,62707.16,317702.84
230340,202011,453,364,89,380444.3,93015.36,473459.66
230350,202011,3176,1999,1177,2090269.57,1230134.86,3320404.43
230360,202011,277,224,53,234110.38,55390.18,289500.56
230365,202011,137,115,22,120179.54,22991.44,143170.98
230370,202011,10179,4935,5244,5162353.22,5484497.94,10646851.16
230380,202011,482,409,73,428508.01,76292.38,504800.39
230390,202011,547,305,242,318744.52,252908.21,571652.73
230393,202011,251,206,45,215272.09,47025.23,262297.32
230395,202011,357,286,71,298941.46,74211.79,373153.25
230400,202011,618,490,128,512095.64,133774.04,645869.68
230410,202011,2679,1670,1009,1746427.55,1056680.63,2803108.18
230420,202011,6263,4121,2142,4310285.29,2239859.12,6550144.41
230423,202011,333,290,43,303076.31,44939.56,348015.87
230425,202011,428,351,77,366837.19,80476.99,447314.18
230426,202011,119,97,22,101365.79,22990,124355.79
230427,202011,74,70,4,74204.96,4180,78384.96
230428,202011,1540,759,781,793282.13,817292.84,1610574.97
230430,202011,456,369,87,385652.34,90931.57,476583.91
230435,202011,893,645,248,674076.53,259179.52,933256.05
230440,202011,89452,39635,49817,41452201.87,52117424.05,93569625.92
230445,202011,317,220,97,229934.22,102423.05,332357.27
230450,202011,565,445,120,465053.64,125403.65,590457.29
230460,202011,70,53,17,55387.55,17767.7,73155.25
230465,202011,308,250,58,261274.76,60618.12,321892.88
230470,202011,2022,1591,431,1662709.8,451473.04,2114182.84
230480,202011,154,145,9,151530.45,9406.06,160936.51
230490,202011,305,243,62,253950.78,64790.95,318741.73
230495,202011,454,333,121,349089.02,126466.43,475555.45
230500,202011,1019,749,270,782759.9,282174.68,1064934.58
230510,202011,59,46,13,48071.37,13585.84,61657.21
230520,202011,385,302,83,315617.79,86742.2,402359.99
230523,202011,2383,1481,902,1547865.89,943780.89,2491646.78
230526,202011,278,236,42,246622,43891.01,290513.01
230530,202011,688,511,177,534071.78,184997.64,719069.42
230533,202011,203,190,13,198558.58,13586.12,212144.70
230535,202011,370,275,95,287420.97,99280.51,386701.48
230540,202011,1789,1582,207,1653378.61,217385.45,1870764.06
230550,202011,3829,2452,1377,2562814.38,1439303.55,4002117.93
230560,202011,584,441,143,460905.66,149455.85,610361.51
230565,202011,222,162,60,169299.1,63750.77,233049.87
230570,202011,290,256,34,267546.18,35534.45,303080.63
230580,202011,1169,844,325,882038.83,340696.93,1222735.76
230590,202011,1003,780,223,816206.27,233056.94,1049263.21
230600,202011,242,221,21,230984.51,21949.17,252933.68
230610,202011,373,286,87,298903.96,90923.98,389827.94
230620,202011,203,171,32,178711.47,33444.63,212156.10
230625,202011,776,540,236,564358.86,246645.74,811004.60
230630,202011,1334,1034,300,1081685.25,313544.18,1395229.43
230640,202011,3783,3190,593,3336060.62,619799.76,3955860.38
230650,202011,456,391,65,408626.29,67935,476561.29
230655,202011,690,582,108,608263.4,112875.61,721139.01
230660,202011,363,299,64,312468.26,67933.23,380401.49
230670,202011,447,380,67,397160.2,71063.14,468223.34
230680,202011,205,186,19,194397.59,19857.95,214255.54
230690,202011,916,772,144,806812.64,150488.66,957301.30
230700,202011,851,714,137,746196.29,144223.21,890419.50
230710,202011,690,654,36,683520.58,37625.57,721146.15
230720,202011,156,134,22,140036.92,22991.97,163028.89
230725,202011,211,165,46,172447.39,48075.27,220522.66
230730,202011,12223,6604,5619,6909386.96,5875065,12784451.96
230740,202011,667,536,131,560205.65,136910.16,697115.81
230750,202011,832,698,134,729483,140048.16,869531.16
230760,202011,1466,1262,204,1318997.31,213209.34,1532206.65
230763,202011,328,272,56,284265.22,58524.61,342789.83
230765,202011,7605,3469,4136,3630074.04,4326286.54,7956360.58
230770,202011,5052,2568,2484,2684994.85,2598268.33,5283263.18
230780,202011,731,640,91,668871.65,95102.02,763973.67
230790,202011,288,239,49,249758.36,51205,300963.36
230800,202011,1142,817,325,853833.24,340691.14,1194524.38
230810,202011,1353,1189,164,1243727.73,171410.44,1415138.17
230820,202011,368,254,114,265451.97,119142.4,384594.37
230830,202011,950,812,138,848621.38,144229.27,992850.65
230835,202011,274,236,38,246659.18,39716.76,286375.94
230837,202011,172,144,28,150490.48,29262.54,179753.02
230840,202011,928,726,202,759780.51,211113.73,970894.24
230850,202011,1472,1268,204,1325238.9,213209.05,1538447.95
230860,202011,302,226,76,236193.08,79426.62,315619.70
230870,202011,1841,1563,278,1633526.85,290552.81,1924079.66
230880,202011,66,50,16,52253.67,16720.44,68974.11
230890,202011,538,492,46,516280.44,48074.54,564354.98
230900,202011,281,204,77,213199.68,80471.98,293671.66
230910,202011,221,174,47,181845.13,49118.66,230963.79
230920,202011,423,338,85,353238.79,88833.08,442071.87
230930,202011,984,688,296,719038.03,309357.87,1028395.90
230940,202011,857,665,192,695003.35,201704.15,896707.50
230945,202011,527,425,102,444196.22,106609.16,550805.38
230950,202011,414,358,56,374176.37,58531.61,432707.98
230960,202011,2676,1784,892,1865610.63,932323.74,2797934.37
230970,202011,1704,944,760,987696.27,794348.82,1782045.09
230980,202011,204,166,38,173492.99,39715.85,213208.84
230990,202011,136,111,25,116004.18,26126.66,142130.84
231000,202011,193,179,14,187081.72,14630.84,201712.56
231010,202011,153,112,41,117042.8,42847.39,159890.19
231020,202011,1350,930,420,973064.21,438997.19,1412061.40
231025,202011,1064,785,279,820453.6,291597.95,1112051.55
231030,202011,1100,917,183,958381.22,191264.23,1149645.45
231040,202011,140,95,45,99284.69,47027.03,146311.72
231050,202011,949,838,111,875860.14,116021.7,991881.84
231060,202011,159,133,26,138997.27,27176.08,166173.35
231070,202011,1493,1034,459,1080708.65,479710.3,1560418.95
231080,202011,264,242,22,252936.7,22992.74,275929.44
231085,202011,621,374,247,390878.67,258143.21,649021.88
231090,202011,250,200,50,209013.83,52253.65,261267.48
231095,202011,167,134,33,140032.56,34485.14,174517.70
231100,202011,146,122,24,127491.76,25080.81,152572.57
231110,202011,371,314,57,328177.68,59572.24,387749.92
231120,202011,268,229,39,239322.53,40757.79,280080.32
231123,202011,156,147,9,153622.06,9405.84,163027.90
231126,202011,334,258,76,269621.23,79428.82,349050.05
231130,202011,4758,3715,1043,3882536.08,1090103.12,4972639.20
231135,202011,211,182,29,190199.9,30307.33,220507.23
231140,202011,3084,2256,828,2359885.36,865359.6,3225244.96
231150,202011,371,351,20,366837.7,20904.27,387741.97
231160,202011,1211,957,254,1000182.12,266502.18,1266684.30
231170,202011,517,355,162,371017.38,169307.65,540325.03
231180,202011,1706,1462,244,1527998.79,255013.38,1783012.17
231190,202011,209,176,33,183922.59,34486.37,218408.96
231195,202011,213,180,33,188102.68,34486.02,222588.70
231200,202011,800,651,149,680386.05,155730.76,836116.81
231210,202011,582,488,94,509989.5,98236.18,608225.68
231220,202011,1053,769,284,803712.99,296826.5,1100539.49
231230,202011,1478,1163,315,1216484.16,329201.41,1545685.57
231240,202011,1479,1048,431,1095273.2,450444.75,1545717.95
231250,202011,111,102,9,106608.05,9405.08,116013.13
231260,202011,277,180,97,188109.14,101374.66,289483.80
231270,202011,995,804,191,840268.97,199610.16,1039879.13
231280,202011,74,58,16,61657.31,16721.26,78378.57
231290,202011,7699,4317,3382,4511816.17,3534774.98,8046591.15
231300,202011,606,561,45,587357.58,47028.41,634385.99
231310,202011,750,692,58,723274.84,60621.7,783896.54
231320,202011,590,442,148,461936.38,154675.03,616611.41
231325,202011,100,87,13,90922.47,13585,104507.47
231330,202011,1983,1539,444,1608747.89,465088.12,2073836.01
231335,202011,254,225,29,235135.58,30305.68,265441.26
231340,202011,1724,1252,472,1308514.2,493317.98,1801832.18
231350,202011,1308,1054,254,1101581.02,265476.5,1367057.52
231355,202011,436,370,66,387727.2,68974.82,456702.02
231360,202011,513,371,142,387773.16,148412.28,536185.44
231370,202011,86,75,11,78381.57,11495.36,89876.93
231375,202011,291,210,81,219478.51,84655.6,304134.11
231380,202011,496,398,98,415938.5,102415.75,518354.25
231390,202011,206,161,45,168256.92,47027.56,215284.48
231395,202011,744,466,278,487002.36,291575.49,778577.85
231400,202011,1135,940,195,982402.29,203798.86,1186201.15
231410,202011,1334,1091,243,1140230.03,253976.06,1394206.09
240010,202011,394,172,222,179773.29,232043.2,411816.49
240020,202011,2264,1838,426,1920984.83,446289.58,2367274.41
240030,202011,119,99,20,103457.52,20901.05,124358.57
240040,202011,33,33,0,34487.09,0,34487.09
240050,202011,530,453,77,473460.84,80479.15,553939.99
240060,202011,67,63,4,65838.48,4180.44,70018.92
240070,202011,221,175,46,182886.43,48071.48,230957.91
240080,202011,532,364,168,380427.69,175587.37,556015.06
240090,202011,103,92,11,96140.8,11495.21,107636.01
240100,202011,1500,1415,85,1478865.89,88835.64,1567701.53
240110,202011,1043,682,361,712820.96,377337.75,1090158.71
240120,202011,142,112,30,117048.06,31352.26,148400.32
240130,202011,283,259,24,270701.05,25082.16,295783.21
240140,202011,76,56,20,58529.15,20902.01,79431.16
240145,202011,744,661,83,690791.27,86740.43,777531.70
240150,202011,21,16,5,16721.1,5225,21946.1
240160,202011,40,34,6,35531.11,6270.69,41801.80
240165,202011,36,28,8,29265.21,8362.62,37627.83
240170,202011,113,81,32,84651.89,33441.8,118093.69
240180,202011,90,69,21,72110.43,21946.99,94057.42
240185,202011,43,40,3,41801.04,3135,44936.04
240190,202011,14,12,2,12541.32,2090.34,14631.66
240200,202011,3107,1739,1368,1818547.86,1429798.32,3248346.18
240210,202011,171,131,40,136898.03,41801.06,178699.09
240220,202011,1098,796,302,831906.13,315630.59,1147536.72
240230,202011,851,782,69,817332.75,73162.36,890495.11
240240,202011,73,53,20,55387.84,20900.25,76288.09
240250,202011,90,77,13,80477.55,13587.54,94065.09
240260,202011,1811,1331,480,1391077.3,501670.27,1892747.57
240270,202011,185,163,22,170342.73,22990,193332.73
240280,202011,46,35,11,36575,11495,48070
240290,202011,47,45,2,47026.72,2090,49116.72
240300,202011,176,95,81,99279.03,85692.23,184971.26
240310,202011,2348,1291,1057,1350301.18,1106813.64,2457114.82
240320,202011,195,182,13,190191.02,13585.5,203776.52
240325,202011,4546,2679,1867,2805305.94,1952467.71,4757773.65
240330,202011,74,69,5,72107.24,5225,77332.24
240340,202011,72,47,25,49122.4,26126.69,75249.09
240350,202011,92,80,12,84651.58,12540.2,97191.78
240360,202011,557,344,213,359555.45,222625.17,582180.62
240370,202011,52,48,4,50161.43,4180,54341.43
240375,202011,64,39,25,40762.86,26129.65,66892.51
240380,202011,232,189,43,197529.24,44939.55,242468.79
240390,202011,12,11,1,11496.08,1045.34,12541.42
240400,202011,83,74,9,77333.62,9406.84,86740.46
240410,202011,14,8,6,8360.47,6270.6,14631.07
240420,202011,1017,738,279,771272.41,291577.05,1062849.46
240430,202011,264,248,16,259207.04,16721.74,275928.78
240440,202011,120,65,55,67928.98,57478.03,125407.01
240450,202011,224,151,73,157810.03,76297.13,234107.16
240460,202011,73,57,16,59565.96,16720,76285.96
240470,202011,237,212,25,221584.46,26131.67,247716.13
240480,202011,16,14,2,14630.17,2091.44,16721.61
240485,202011,82,68,14,71064.49,14631.55,85696.04
240490,202011,44,42,2,43892.93,2090.95,45983.88
240500,202011,86,64,22,66880.84,22990,89870.84
240510,202011,43,32,11,33440.44,11495,44935.44
240520,202011,115,110,5,114968.86,5225.64,120194.50
240530,202011,57,49,8,51205.77,8361.55,59567.32
240540,202011,77,65,12,67925.44,12540.51,80465.95
240550,202011,13,12,1,12540.88,1045,13585.88
240560,202011,379,276,103,288445.29,107639.16,396084.45
240570,202011,444,284,160,296831.25,168287.33,465118.58
240580,202011,1300,1020,280,1066009.71,292625.4,1358635.11
240590,202011,31,29,2,30305.55,2090,32395.55
240600,202011,105,100,5,104501.43,5225.5,109726.93
240610,202011,518,435,83,454663.48,86751.79,541415.27
240615,202011,17,16,1,16724.86,1045.5,17770.36
240620,202011,86,83,3,86739.14,3135,89874.14
240630,202011,38,33,5,34492.25,5225.82,39718.07
240640,202011,26,21,5,21947.48,5225.23,27172.71
240650,202011,243,198,45,206925.15,47029.04,253954.19
240660,202011,111,95,16,99278.74,16720.79,115999.53
240670,202011,311,178,133,186038.61,139018.68,325057.29
240680,202011,50,37,13,38666.8,13585.77,52252.57
240690,202011,47,44,3,45989.01,3136.59,49125.60
240700,202011,187,153,34,159885,35530.87,195415.87
240710,202011,2023,1245,778,1302217.84,813092.61,2115310.45
240720,202011,1071,789,282,824572.12,295762.63,1120334.75
240725,202011,66,61,5,63748.99,5225.37,68974.36
240730,202011,149,126,23,131673.41,24035,155708.41
240740,202011,231,196,35,204855.95,36584.94,241440.89
240750,202011,53,30,23,31350,24038.12,55388.12
240760,202011,46,41,5,42845.98,5225,48070.98
240770,202011,148,116,32,121222.54,33440.9,154663.44
240780,202011,675,560,115,585269.97,120194.21,705464.18
240790,202011,42,40,2,41806.64,2090.88,43897.52
240800,202011,9318,6327,2991,6614979.3,3128372.34,9743351.64
240810,202011,20522,11046,9476,11549576.35,9906602.17,21456178.52
240820,202011,240,143,97,149453.91,101385.43,250839.34
240830,202011,1613,1324,289,1383713.19,302034.21,1685747.40
240840,202011,77,67,10,70024.82,10452.25,80477.07
240850,202011,87,77,10,80466.88,10451.61,90918.49
240860,202011,107,103,4,107638.32,4180,111818.32
240870,202011,58,50,8,52258.13,8361.44,60619.57
240880,202011,30,27,3,28216.78,3135,31351.78
240890,202011,1128,643,485,672036.57,506899.68,1178936.25
240895,202011,60,41,19,42847.6,19856.43,62704.03
240910,202011,158,140,18,146305.67,18811.35,165117.02
240920,202011,13,10,3,10452.33,3135.84,13588.17
240930,202011,411,368,43,384627.7,44944.52,429572.22
240933,202011,51,33,18,34486.79,18811.75,53298.54
240940,202011,2374,2100,274,2194689.12,286371.11,2481060.23
240950,202011,49,44,5,45985.23,5225,51210.23
240960,202011,26,22,4,22993.46,4181.14,27174.60
240970,202011,113,82,31,85691.09,32396.33,118087.42
240980,202011,201,160,41,167207.23,42849.03,210056.26
240990,202011,130,86,44,89873.1,45983.41,135856.51
241000,202011,61,57,4,59571.14,4180,63751.14
241010,202011,73,55,18,57475,18810,76285
241020,202011,114,105,9,109733.06,9407.81,119140.87
241025,202011,12,5,7,5225.53,7317.38,12542.91
241030,202011,114,90,24,94051.82,25080,119131.82
241040,202011,44,31,13,32395.34,13585.87,45981.21
241050,202011,83,75,8,78375.32,8360,86735.32
241060,202011,29,24,5,25081.74,5225.84,30307.58
241070,202011,15,15,0,15678.77,0,15678.77
241080,202011,61,54,7,56433.94,7315.98,63749.92
241090,202011,59,46,13,48079.25,13586.61,61665.86
241100,202011,72,61,11,63752.11,11496.25,75248.36
241105,202011,8,3,5,3135,5226.1,8361.1
241110,202011,49,45,4,47025.67,4180.5,51206.17
241120,202011,1483,1124,359,1174659.2,375189.11,1549848.31
241140,202011,221,183,38,191255.48,39715.15,230970.63
241142,202011,38,32,6,33443.72,6270.44,39714.16
241150,202011,1185,1038,147,1084836.74,153637.05,1238473.79
241160,202011,17,16,1,16720,1045,17765
241170,202011,45,38,7,39710,7315.29,47025.29
241180,202011,44,37,7,38674.27,7316.4,45990.67
241190,202011,38,37,1,38670.49,1045.34,39715.83
241200,202011,3990,2059,1931,2152093.63,2022481.68,4174575.31
241210,202011,66,57,9,59567.66,9406.11,68973.77
241220,202011,1432,954,478,998120.77,499584.6,1497705.37
241230,202011,248,205,43,214244.82,44943.62,259188.44
241240,202011,56,44,12,45983.32,12540.78,58524.10
241250,202011,1133,1042,91,1089042.47,95109.59,1184152.06
241255,202011,53,41,12,42847.65,12541.1,55388.75
241260,202011,682,527,155,551805.85,161990.96,713796.81
241270,202011,62,44,18,47028.07,18810,65838.07
241280,202011,95,83,12,86742.98,12541.31,99284.29
241290,202011,126,86,40,89881.77,41805.8,131687.57
241300,202011,82,56,26,58522.29,27172.02,85694.31
241310,202011,52,37,15,38666.05,15675.07,54341.12
241320,202011,29,17,12,17769.46,12541.39,30310.85
241330,202011,63,55,8,57477.31,8360.68,65837.99
241335,202011,74,66,8,68972.96,8360.95,77333.91
241340,202011,182,133,49,138991.85,51206.97,190198.82
241350,202011,62,52,10,54341.96,10450,64791.96
241355,202011,50,43,7,44940.21,7317.87,52258.08
241360,202011,50,49,1,51207.24,1045,52252.24
241370,202011,54,42,12,43890.63,12540,56430.63
241380,202011,36,32,4,33443.89,4180.53,37624.42
241390,202011,87,66,21,68970.17,21945.5,90915.67
241400,202011,220,174,46,181830.94,48070.54,229901.48
241410,202011,184,165,19,172432.22,19855.6,192287.82
241415,202011,100,82,18,86736.07,18811,105547.07
241420,202011,101,75,26,78378.83,28220.39,106599.22
241430,202011,26,24,2,25083.56,2090,27173.56
241440,202011,534,432,102,451527.09,106612.81,558139.90
241445,202011,39,34,5,35531.5,5225.84,40757.34
241450,202011,273,224,49,234106.58,51216.87,285323.45
241460,202011,142,129,13,134813.01,13585.87,148398.88
241470,202011,35,30,5,31352.61,5226.13,36578.74
241475,202011,52,49,3,51206.84,3135.47,54342.31
241480,202011,99,69,30,72109.31,31352.2,103461.51
241490,202011,10,9,1,9405.74,1045.07,10450.81
241500,202011,47,36,11,37624.45,11497.8,49122.25
250010,202011,102,87,15,90918.93,15675.46,106594.39
250020,202011,32,28,4,29261.18,4180.4,33441.58
250030,202011,879,655,224,685587.24,234113.61,919700.85
250040,202011,378,310,68,324009.12,71073.35,395082.47
250050,202011,256,209,47,218412.58,49118.43,267531.01
250053,202011,54,41,13,42851.94,13586.58,56438.52
250057,202011,1,1,0,1045,0,1045
250060,202011,584,415,169,434788.14,176639.79,611427.93
250070,202011,706,568,138,593663.52,144243.43,737906.95
250073,202011,8,8,0,8360.87,0,8360.87
250077,202011,178,133,45,138993.16,47027.97,186021.13
250080,202011,433,342,91,357442.49,95109.9,452552.39
250090,202011,225,146,79,152572.55,82556.04,235128.59
250100,202011,520,429,91,448370.84,95110.26,543481.10
250110,202011,627,475,152,496421.1,158849.03,655270.13
250115,202011,20,7,13,7316.79,13591.83,20908.62
250120,202011,120,86,34,89871.77,35534.44,125406.21
250130,202011,576,464,112,484974.21,117063.69,602037.90
250135,202011,16,9,7,9405,7315.18,16720.18
250140,202011,89,78,11,81517.87,11495,93012.87
250150,202011,594,427,167,446258.08,174530.81,620788.89
250153,202011,10,7,3,7316.39,3135,10451.39
250157,202011,32,26,6,27170.48,6270,33440.48
250160,202011,235,184,51,192306.67,53301.19,245607.86
250170,202011,62,40,22,41803.18,22990.73,64793.91
250180,202011,4355,2941,1414,3074868.15,1482105.16,4556973.31
250190,202011,839,549,290,573739.24,303079.92,876819.16
250200,202011,51,41,10,42847.16,10451.15,53298.31
250205,202011,24,20,4,20901.56,4181.15,25082.71
250210,202011,85,75,10,78375.44,10450,88825.44
250215,202011,67,54,13,56436.69,13586.41,70023.10
250220,202011,25,18,7,18811.95,7315.94,26127.89
250230,202011,77,70,7,73155.93,7316.13,80472.06
250240,202011,235,193,42,201706.45,43895.41,245601.86
250250,202011,388,331,57,345972.66,59576.48,405549.14
250260,202011,44,37,7,38665,7315.4,45980.4
250270,202011,77,55,22,57475,22990.67,80465.67
250280,202011,382,312,70,326060.06,73155.95,399216.01
250290,202011,93,85,8,88830.47,8361.43,97191.90
250300,202011,553,374,179,390872.65,187073.81,577946.46
250310,202011,51,42,9,43895.94,9405.34,53301.28
250320,202011,1966,1315,651,1376479.84,680420.66,2056900.50
250330,202011,102,86,16,89878.51,16720.71,106599.22
250340,202011,25,23,2,24036.51,2090.27,26126.78
250350,202011,169,109,60,113912.15,62704.79,176616.94
250355,202011,32,25,7,26126.51,7316.06,33442.57
250360,202011,198,164,34,171399.95,35536.77,206936.72
250370,202011,2414,1583,831,1654474.11,868554.1,2523028.21
250375,202011,12,7,5,7317.41,5225.11,12542.52
250380,202011,55,43,12,44938.57,12541.72,57480.29
250390,202011,46,35,11,36581.07,11497.5,48078.57
250400,202011,16512,8343,8169,8720997.32,8545673.03,17266670.35
250403,202011,330,264,66,275892.56,68973.25,344865.81
250407,202011,63,50,13,52251.11,13587.33,65838.44
250410,202011,30,26,4,27175.45,4180.67,31356.12
250415,202011,41,29,12,30305.31,12540,42845.31
250420,202011,43,37,6,38666.69,6270.44,44937.13
250430,202011,1445,1240,205,1296186.71,214251.77,1510438.48
250435,202011,18,13,5,13587.16,5225.34,18812.50
250440,202011,678,564,114,590486.11,119145.56,709631.67
250450,202011,85,65,20,67929.88,20900.5,88830.38
250460,202011,462,303,159,316660.5,166177.82,482838.32
250470,202011,94,64,30,66881.44,31350.14,98231.58
250480,202011,334,268,66,280120.45,68991.88,349112.33
250485,202011,2,2,0,2090,0,2090
250490,202011,227,180,47,188102.43,49118.07,237220.50
250500,202011,96,70,26,73153.31,27170.5,100323.81
250510,202011,768,604,164,631239.28,171392.79,802632.07
250520,202011,183,124,59,129586.01,61658.39,191244.40
250523,202011,121,96,25,100321.92,26126.46,126448.38
250527,202011,106,83,23,86737.06,24035.83,110772.89
250530,202011,10,6,4,6270,4180.34,10450.34
250535,202011,34,24,10,25081.84,10452.06,35533.90
250540,202011,132,102,30,106595.8,31351.04,137946.84
250550,202011,72,69,3,72106.9,3135,75241.9
250560,202011,50,36,14,37620,14630.5,52250.5
250570,202011,165,135,30,141078.55,31351.22,172429.77
250580,202011,109,84,25,87849.71,26125,113974.71
250590,202011,24,14,10,14630.44,10453.33,25083.77
250600,202011,1417,923,494,964654.77,516291.01,1480945.78
250610,202011,157,129,28,134837.36,29266.89,164104.25
250620,202011,20,16,4,16721.6,4180.44,20902.04
250625,202011,73,54,19,56450.17,19862.84,76313.01
250630,202011,3075,1958,1117,2046325.91,1168530.62,3214856.53
250640,202011,220,174,46,181856.09,48077.57,229933.66
250650,202011,30,20,10,20900.86,10451.32,31352.18
250660,202011,50,39,11,40755,11495.77,52250.77
250670,202011,62,45,17,47026.94,17765.59,64792.53
250680,202011,410,330,80,344904.94,83613.91,428518.85
250690,202011,2057,1422,635,1486119.45,664701.29,2150820.74
250700,202011,936,805,131,841296.72,136905.68,978202.40
250710,202011,432,338,94,353270.52,98252.89,451523.41
250720,202011,115,85,30,88827.68,31351.63,120179.31
250730,202011,385,322,63,336528.85,65846.47,402375.32
250740,202011,54,51,3,53297.93,3135,56432.93
250750,202011,22375,13381,8994,13993551.14,9404733.56,23398284.70
250760,202011,104,80,24,83600.83,25081.34,108682.17
250770,202011,365,236,129,246652.19,134816,381468.19
250780,202011,66,44,22,45980.42,22990.06,68970.48
250790,202011,463,302,161,315615.35,168257.93,483873.28
250800,202011,154,139,15,145256.91,15675.07,160931.98
250810,202011,75,60,15,62700.94,15675.44,78376.38
250820,202011,151,125,26,130639.49,27173.59,157813.08
250830,202011,434,291,143,304161.4,149457.69,453619.09
250840,202011,54,48,6,50166.45,6271.47,56437.92
250850,202011,55,45,10,47025.96,10450.8,57476.76
250855,202011,13,11,2,11499.19,2091.14,13590.33
250860,202011,219,150,69,156753.49,72111.07,228864.56
250870,202011,28,24,4,25081.68,4180,29261.68
250880,202011,88,64,24,66881.1,25081.51,91962.61
250890,202011,2859,2135,724,2231271.86,756661.62,2987933.48
250900,202011,50,41,9,42846.72,9405,52251.72
250905,202011,117,88,29,91961.81,30305.67,122267.48
250910,202011,1119,813,306,849670.73,319809.27,1169480.00
250915,202011,107,75,32,78383.8,33443.31,111827.11
250920,202011,140,101,39,105548.17,40755.67,146303.84
250930,202011,177,103,74,107635.44,77333.15,184968.59
250933,202011,6,4,2,4180.36,2090.88,6271.24
250937,202011,10,10,0,10450,0,10450
250939,202011,32,24,8,25083.3,8360.19,33443.49
250940,202011,109,79,30,82560.7,31353.32,113914.02
250950,202011,73,50,23,52254.19,24036.72,76290.91
250960,202011,91,51,40,53297.19,41800.73,95097.92
250970,202011,1210,853,357,892548.95,373103.69,1265652.64
250980,202011,102,66,36,70020.63,37620.51,107641.14
250990,202011,166,129,37,134805,38665,173470
251000,202011,74,66,8,68971.36,8361.04,77332.40
251010,202011,113,84,29,87783.68,30308.46,118092.14
251020,202011,76,62,14,64791.26,14630,79421.26
251030,202011,48,35,13,36577.55,13585.49,50163.04
251040,202011,55,37,18,38665.13,18810,57475.13
251050,202011,24,21,3,21945,3135.69,25080.69
251060,202011,51,40,11,41805.57,11495.75,53301.32
251065,202011,4,3,1,3135,1045.67,4180.67
251070,202011,20,16,4,16721.68,4181.15,20902.83
251080,202011,5069,2408,2661,2517699.4,2785362.76,5303062.16
251090,202011,182,156,26,163040.76,27178.25,190219.01
251100,202011,19,18,1,18812.5,1045,19857.5
251110,202011,46,37,9,38665,9405.44,48070.44
251120,202011,1854,1134,720,1185237.26,753574.87,1938812.13
251130,202011,408,333,75,348025.01,78380.69,426405.70
251140,202011,561,364,197,380423.23,205885.07,586308.30
251150,202011,344,288,56,301012.87,58527.53,359540.40
251160,202011,89,73,16,76286.44,16720,93006.44
251170,202011,101,81,20,84649.59,20901.31,105550.90
251180,202011,293,179,114,187080.26,119150.52,306230.78
251190,202011,204,133,71,138993.11,75249.59,214242.70
251200,202011,272,219,53,228894.07,55392.94,284287.01
251203,202011,33,31,2,32398.68,2090,34488.68
251207,202011,87,71,16,74196.78,16720,90916.78
251210,202011,1475,1074,401,1122440.61,419119.19,1541559.80
251220,202011,47,36,11,37625.03,11496.55,49121.58
251230,202011,594,496,98,518394.27,102425.88,620820.15
251240,202011,95,65,30,67925.81,31351.49,99277.30
251250,202011,1413,1012,401,1058731.18,419100.31,1477831.49
251260,202011,11,7,4,7318.25,4180.34,11498.59
251270,202011,316,240,76,250840.8,79431.83,330272.63
251272,202011,63,56,7,58521.18,8360.2,66881.38
251274,202011,29,22,7,22992.24,7317.18,30309.42
251275,202011,34,19,15,19857.71,15677.74,35535.45
251276,202011,16,12,4,12540.76,4180.15,16720.91
251278,202011,10,8,2,8362.69,2090.98,10453.67
251280,202011,102,97,5,101367.67,5225,106592.67
251290,202011,821,583,238,609303.25,248743.14,858046.39
251300,202011,15,12,3,12540.88,3136.04,15676.92
251310,202011,321,232,89,242482.73,93018.36,335501.09
251315,202011,33,29,4,30305.36,4180,34485.36
251320,202011,65,51,14,53299.74,14632.83,67932.57
251330,202011,80,71,9,74198.61,9406.28,83604.89
251335,202011,15,10,5,10450,5225.53,15675.53
251340,202011,745,440,305,459839.67,318758.38,778598.05
251350,202011,34,33,1,34485.83,1045,35530.83
251360,202011,84,73,11,76287.69,11495.67,87783.36
251365,202011,11,11,0,11497.93,0,11497.93
251370,202011,5560,3720,1840,3889857.7,1928240.16,5818097.86
251380,202011,46,37,9,38670.62,9406.56,48077.18
251385,202011,3,3,0,3135.94,0,3135.94
251390,202011,826,618,208,645931.42,217407.62,863339.04
251392,202011,19,11,8,11496.49,8360.94,19857.43
251394,202011,8,8,0,8361.22,0,8361.22
251396,202011,12,8,4,8360.94,4182.06,12543.00
251398,202011,18,16,2,16720.81,2090.6,18811.41
251400,202011,40,32,8,33443.4,8360.44,41803.84
251410,202011,38,32,6,33441.81,6271,39712.81
251420,202011,100,71,29,74201.08,30309.11,104510.19
251430,202011,43,40,3,41800,3135,44935
251440,202011,45,28,17,29261.05,17765,47026.05
251445,202011,51,46,5,48077.23,5225.84,53303.07
251450,202011,405,353,52,368965.24,54351.45,423316.69
251455,202011,3,2,1,2090.94,1045.5,3136.44
251460,202011,15,13,2,13585.72,2090,15675.72
251465,202011,7,4,3,4180.44,3136.55,7316.99
251470,202011,50,39,11,40755.84,11495.67,52251.51
251480,202011,26,21,5,21945.88,5225.96,27171.84
251490,202011,124,78,46,81533.04,48083.41,129616.45
251500,202011,129,105,24,109731.51,25081.19,134812.70
251510,202011,57,35,22,36578.46,22992.01,59570.47
251520,202011,30,29,1,30306.04,1045,31351.04
251530,202011,4484,3155,1329,3301364.99,1390003.56,4691368.55
251540,202011,76,64,12,66883.8,12542.57,79426.37
251550,202011,416,314,102,329226.44,106614.61,435841.05
251560,202011,24,16,8,16722.81,8361.58,25084.39
251570,202011,20,18,2,18810,2090.84,20900.84
251580,202011,136,107,29,111817.05,30305,142122.05
251590,202011,116,85,31,89024.28,32395,121419.28
251593,202011,25,15,10,15676.32,10450.85,26127.17
251597,202011,102,82,20,85692.76,20901.84,106594.60
251600,202011,1113,783,330,818331.77,344877.96,1163209.73
251610,202011,240,179,61,187072.8,63750.57,250823.37
251615,202011,9,8,1,8360.4,1045,9405.4
251620,202011,4275,2778,1497,2903331.05,1564561.48,4467892.53
251630,202011,460,338,122,353276.32,127515.53,480791.85
251640,202011,141,101,40,105562.82,41811.19,147374.01
251650,202011,277,199,78,207989.42,81521.77,289511.19
251660,202011,188,168,20,175597.52,20904.42,196501.94
251670,202011,377,295,82,308331.7,85704.88,394036.58
251675,202011,8,6,2,6270,2091.27,8361.27
251680,202011,100,88,12,91963.63,12540.89,104504.52
251690,202011,321,264,57,275927.34,59572.96,335500.30
251700,202011,286,243,43,253985.15,44945.76,298930.91
251710,202011,21,14,7,14630.44,7316.77,21947.21
251720,202011,22,15,7,15679.16,7318.06,22997.22
251740,202011,12,9,3,9407.32,3135,12542.32
260005,202011,3296,1786,1510,1867296.69,1579307.31,3446604.00
260010,202011,1635,1179,456,1233222.89,476569.51,1709792.40
260020,202011,416,360,56,376267.13,58529.67,434796.80
260030,202011,609,419,190,437938.99,198579.4,636518.39
260040,202011,815,506,309,528877.52,322947.8,851825.32
260050,202011,1154,822,332,859089.43,346976.42,1206065.85
260060,202011,381,347,34,362660.37,35536.4,398196.77
260070,202011,1352,834,518,871720.33,542493.19,1414213.52
260080,202011,728,559,169,584281.24,176637.55,760918.79
260090,202011,496,326,170,340710.43,177680.34,518390.77
260100,202011,216,151,65,157804.09,68972.35,226776.44
260105,202011,239,132,107,137946.61,111818.11,249764.72
260110,202011,2864,2089,775,2184439.86,811045.51,2995485.37
260120,202011,2848,1442,1406,1507365.46,1470536.19,2977901.65
260130,202011,167,113,54,118092.03,56432.76,174524.79
260140,202011,2119,1370,749,1432900.6,782806.98,2215707.58
260150,202011,205,132,73,137966.31,76298.39,214264.70
260160,202011,317,264,53,276961.29,55393.14,332354.43
260170,202011,3380,2014,1366,2106025.79,1427688.65,3533714.44
260180,202011,162,129,33,134815.57,34488.92,169304.49
260190,202011,2338,1576,762,1647152.76,797478,2444630.76
260200,202011,967,775,192,809976.84,200658.05,1010634.89
260210,202011,1416,1000,416,1045134.49,434782.91,1479917.40
260220,202011,687,616,71,643808.85,75249.17,719058.02
260230,202011,1202,906,296,946858.94,309353.52,1256212.46
260240,202011,221,164,57,171410.72,59572.56,230983.28
260250,202011,90,65,25,67934.8,26128.28,94063.08
260260,202011,1039,730,309,762940.21,322941.75,1085881.96
260270,202011,411,321,90,335460.33,94055.49,429515.82
260280,202011,1248,915,333,956282.41,349056.45,1305338.86
260290,202011,6561,3531,3030,3692558.81,3170091.92,6862650.73
260300,202011,948,814,134,850739.97,140046.46,990786.43
260310,202011,516,411,105,429555.82,109741.99,539297.81
260320,202011,857,627,230,655239.78,240360.51,895600.29
260330,202011,65,45,20,47026.6,20901.31,67927.91
260340,202011,75,55,20,57482.46,20901.07,78383.53
260345,202011,5512,2984,2528,3122000.32,2645462.64,5767462.96
260350,202011,487,343,144,358497.5,150502.65,509000.15
260360,202011,245,136,109,142126.12,114955.77,257081.89
260370,202011,780,470,310,491229.44,324009.36,815238.80
260380,202011,583,428,155,447338.17,162002.84,609341.01
260390,202011,289,243,46,253979.26,48080.32,302059.58
260392,202011,110,95,15,99280.2,15675.94,114956.14
260400,202011,4216,2388,1828,2495652.92,1911504.13,4407157.05
260410,202011,14785,7695,7090,8043614.73,7415483.36,15459098.09
260415,202011,139,121,18,126452.15,18810.02,145262.17
260420,202011,1722,1051,671,1098380.14,701255.86,1799636.00
260430,202011,188,173,15,180827.05,15676.92,196503.97
260440,202011,197,142,55,148412.95,57486.98,205899.93
260450,202011,429,318,111,332353.29,116018.17,448371.46
260460,202011,816,426,390,445235.54,407614.56,852850.10
260470,202011,341,210,131,219490.78,136915.64,356406.42
260480,202011,240,155,85,161977.95,88827.16,250805.11
260490,202011,212,176,36,183941.41,37623.05,221564.46
260500,202011,1116,755,361,789110.17,377316.1,1166426.27
260510,202011,775,615,160,643772.98,167213.7,810986.68
260515,202011,232,209,23,218414.98,24039.61,242454.59
260520,202011,3269,2014,1255,2105930.15,1313739.27,3419669.42
260530,202011,789,647,142,676221.23,148412.47,824633.70
260540,202011,543,426,117,445227.55,122283.1,567510.65
260545,202011,15,11,4,11497.9,4181.75,15679.65
260550,202011,326,200,126,210052.78,131673.9,341726.68
260560,202011,512,386,126,403450.52,131692.97,535143.49
260570,202011,970,784,186,819413,194390.38,1013803.38
260580,202011,248,216,32,225741.75,33442.71,259184.46
260590,202011,639,367,272,383527.35,284251.88,667779.23
260600,202011,8125,4347,3778,4544147.58,3952704.3,8496851.88
260610,202011,486,325,161,339682,168270.21,507952.21
260620,202011,3663,1898,1765,1985718.63,1844678.57,3830397.20
260630,202011,81,76,5,79420,5225,84645
260640,202011,3522,1950,1572,2040059.08,1646100.34,3686159.42
260650,202011,326,237,89,247709.29,93023.56,340732.85
260660,202011,557,358,199,374161.44,207976.5,582137.94
260670,202011,105,77,28,80466.17,29261.52,109727.69
260680,202011,3748,2067,1681,2161497.19,1761309.72,3922806.91
260690,202011,130,93,37,97196.27,38669.27,135865.54
260700,202011,306,206,100,215310.53,104527.7,319838.23
260710,202011,44,35,9,36576.27,9407.07,45983.34
260720,202011,2485,1465,1020,1533196.66,1068102.12,2601298.78
260730,202011,706,525,181,548663.33,189156.58,737819.91
260740,202011,65,58,7,60612.12,7315.8,67927.92
260750,202011,594,420,174,438976.52,181864.26,620840.78
260760,202011,658,333,325,349081.99,339680.66,688762.65
260765,202011,984,508,476,530911.34,497483.88,1028395.22
260770,202011,224,162,62,169300.57,64802.73,234103.30
260775,202011,774,438,336,457764.15,351182.4,808946.55
260780,202011,246,154,92,160930.9,96142.83,257073.73
260790,202011,14250,7238,7012,7569245.22,7335160.77,14904405.99
260795,202011,170,110,60,114951.4,62700.78,177652.18
260800,202011,290,238,52,248741.97,54344.21,303086.18
260805,202011,176,117,59,122272.24,61661.22,183933.46
260810,202011,766,659,107,688751.26,111828.63,800579.89
260820,202011,286,182,104,190200.13,108687.08,298887.21
260825,202011,217,146,71,152572.15,74197.1,226769.25
260830,202011,387,184,203,192283.33,212145.92,404429.25
260840,202011,239,175,64,182898.7,66887.1,249785.8
260845,202011,172,119,53,124357.25,55388.72,179745.97
260850,202011,440,322,118,336537.73,123321.25,459858.98
260860,202011,251,190,61,198558.14,63749.52,262307.66
260870,202011,366,274,92,286381.07,96155.48,382536.55
260875,202011,730,519,211,542449.06,222615.2,765064.26
260880,202011,1600,1012,588,1057607.27,614487.11,1672094.38
260890,202011,2350,1656,694,1730719.62,725331.58,2456051.20
260900,202011,980,692,288,723216.44,301013.95,1024230.39
260910,202011,255,203,52,212155.82,54347.89,266503.71
260915,202011,289,213,76,222586.42,79420,302006.42
260920,202011,186,98,88,102411.4,91962.06,194373.46
260930,202011,393,332,61,346999,63750.91,410749.91
260940,202011,2699,1457,1242,1522885.87,1299248.33,2822134.20
260950,202011,2012,1149,863,1200851.66,903040.06,2103891.72
260960,202011,13720,6892,6828,7205813.49,7144345.84,14350159.33
260970,202011,422,352,70,367904.87,73158.97,441063.84
260980,202011,192,171,21,178709.86,21946.49,200656.35
260990,202011,2623,2119,504,2215782.29,526772.4,2742554.69
261000,202011,4250,2554,1696,2669151.7,1772473.32,4441625.02
261010,202011,251,126,125,132720.16,130642.81,263362.97
261020,202011,602,450,152,470331.7,158859.1,629190.8
261030,202011,249,175,74,183921.63,77335.55,261257.18
261040,202011,374,324,50,338634.97,52256.95,390891.92
261050,202011,504,434,70,453603.48,73162.94,526766.42
261060,202011,1388,883,505,922844.1,530924.15,1453768.25
261070,202011,8870,4301,4569,4500644.27,4780981.05,9281625.32
261080,202011,375,287,88,299976.86,91973.94,391950.80
261090,202011,2181,1666,515,1742222,539285.51,2281507.51
261100,202011,1161,807,354,843429.1,369969.55,1213398.65
261110,202011,8686,5277,3409,5518585.4,3564042.7,9082628.1
261120,202011,261,223,38,233039.2,39712.47,272751.67
261130,202011,569,342,227,357479.69,237266.11,594745.80
261140,202011,201,125,76,130630.36,79422.23,210052.59
261150,202011,684,424,260,443124.51,271724.69,714849.20
261153,202011,69,64,5,66884.68,5225,72109.68
261160,202011,74792,36899,37893,38596688.04,39642787.2,78239475.24
261170,202011,464,345,119,360537.34,124364.22,484901.56
261180,202011,1787,1111,676,1162186.12,707551.79,1869737.91
261190,202011,623,436,187,455676.09,196478.4,652154.49
261200,202011,214,182,32,190220.71,33446.35,223667.06
261210,202011,31,27,4,28215.28,4180.28,32395.56
261220,202011,2715,1909,806,1995105.16,843432.07,2838537.23
261230,202011,335,248,87,259185.22,90922.64,350107.86
261240,202011,451,393,58,410715.42,60612.3,471327.72
261245,202011,236,194,42,202733.12,43891.88,246625.00
261247,202011,170,134,36,140047.65,37624.69,177672.34
261250,202011,3184,1550,1634,1620015.15,1708878.33,3328893.48
261255,202011,244,219,25,228861.62,26126.36,254987.98
261260,202011,848,736,112,769266.94,117060.34,886327.28
261270,202011,201,144,57,150491.95,59567.67,210059.62
261280,202011,173,142,31,148419.94,32397.41,180817.35
261290,202011,113,82,31,85690.66,32396.88,118087.54
261300,202011,1286,940,346,982408.1,361613.13,1344021.23
261310,202011,811,541,270,565435.81,282197.39,847633.20
261320,202011,571,373,198,389839.04,206943.12,596782.16
261330,202011,963,738,225,772412.75,235185.68,1007598.43
261340,202011,298,166,132,173490.97,137950.74,311441.71
261350,202011,848,600,248,627126.44,260254.73,887381.17
261360,202011,1297,843,454,880990.64,474475.04,1355465.68
261370,202011,4843,2883,1960,3013112.35,2048518.83,5061631.18
261380,202011,549,417,132,435804.13,137965.72,573769.85
261390,202011,3613,2424,1189,2534579.16,1243793.29,3778372.45
261400,202011,298,269,29,281144.97,30306.71,311451.68
261410,202011,1100,724,376,756672.97,392954.11,1149627.08
261420,202011,883,548,335,572738.72,351158.47,923897.19
261430,202011,328,297,31,310400.14,32398.05,342798.19
261440,202011,117,108,9,112872.45,9405.31,122277.76
261450,202011,2543,2032,511,2123697.31,534071.65,2657768.96
261460,202011,728,577,151,603079.2,157821.56,760900.76
261470,202011,245,195,50,203784.19,52251.73,256035.92
261480,202011,446,347,99,362669.93,103421.18,466091.11
261485,202011,352,212,140,221569.3,146319.83,367889.13
261500,202011,614,415,199,433769.97,207997.65,641767.62
261510,202011,51,32,19,33442.36,19856.45,53298.81
261520,202011,96,83,13,86749.28,13586.93,100336.21
261530,202011,4137,2624,1513,2742329.16,1582307.63,4324636.79
261540,202011,1344,789,555,824581.55,580034.95,1404616.50
261550,202011,258,124,134,129583.85,140038.22,269622.07
261560,202011,856,564,292,589498.65,305200.8,894699.45
261570,202011,405,317,88,331334.09,91980.83,423314.92
261580,202011,378,295,83,308331.26,86746.52,395077.78
261590,202011,189,152,37,158864.13,38668.04,197532.17
261600,202011,293,232,61,242484.09,63751.52,306235.61
261610,202011,88,75,13,78382.41,13586.64,91969.05
261618,202011,73,59,14,61659.99,14631.22,76291.21
261620,202011,196,122,74,127499.14,77334.42,204833.56
261630,202011,551,430,121,449418.59,126467.35,575885.94
261640,202011,6420,3359,3061,3512872.98,3201539,6714411.98
261650,202011,484,307,177,320832.92,184974.33,505807.25
270010,202011,515,456,59,477655.28,61672.02,539327.30
270020,202011,284,232,52,242478.95,54351.24,296830.19
270030,202011,8838,5700,3138,5958266.79,3280717.32,9238984.11
270040,202011,2005,1267,738,1326899.36,774428.5,2101327.86
270050,202011,153,117,36,122279.11,37625.48,159904.59
270060,202011,109,60,49,62715.23,51214.68,113929.91
270070,202011,864,631,233,659457.54,243508.59,902966.13
270080,202011,36,30,6,31352.5,6270.29,37622.79
270090,202011,23,17,6,17765,6270.55,24035.55
270100,202011,1253,842,411,879954.61,429551.58,1309506.19
270110,202011,104,86,18,89876.5,18812.36,108688.86
270120,202011,228,186,42,194398.35,43898.8,238297.15
270130,202011,266,188,78,196480.74,81524.95,278005.69
270135,202011,112,69,43,72108.35,44935,117043.35
270140,202011,1364,864,500,903212.75,522602.56,1425815.31
270150,202011,252,199,53,207988.77,55391.56,263380.33
270160,202011,501,396,105,413871.07,109745.68,523616.75
270170,202011,795,516,279,540288.12,291566.43,831854.55
270180,202011,64,50,14,52252.23,14630.71,66882.94
270190,202011,89,77,12,80473.97,12540.55,93014.52
270200,202011,108,93,15,97190.02,15675.88,112865.90
270210,202011,520,294,226,307254.83,236192.64,543447.47
270220,202011,179,140,39,147352.44,40760.14,188112.58
270230,202011,2107,1281,826,1340834.19,864286.29,2205120.48
270235,202011,693,540,153,564357.37,160948.99,725306.36
270240,202011,3010,2383,627,2491507.59,656345.44,3147853.03
270250,202011,156,114,42,119152.94,43901.55,163054.49
270255,202011,218,189,29,197506.73,30305,227811.73
270260,202011,368,299,69,312511.02,72122.18,384633.20
270270,202011,99,44,55,45983.06,57479.11,103462.17
270280,202011,239,136,103,142120.47,107635.23,249755.70
270290,202011,1150,883,267,922837.67,279058.1,1201895.77
270300,202011,322,228,94,238262.41,98231.65,336494.06
270310,202011,860,703,157,736809,164082.57,900891.57
270320,202011,826,707,119,738918.04,124373.17,863291.21
270330,202011,298,249,49,261258.99,51206.43,312465.42
270340,202011,57,44,13,45982.94,13585.04,59567.98
270350,202011,88,49,39,51209.96,40761.71,91971.67
270360,202011,67,37,30,38668.93,31350.78,70019.71
270370,202011,57,46,11,48070,11495,59565
270375,202011,72,43,29,44938.76,30308.25,75247.01
270380,202011,1016,651,365,680302.87,381431.71,1061734.58
270390,202011,186,113,73,118086.82,76286.18,194373.00
270400,202011,710,530,180,553919.48,188121.94,742041.42
270410,202011,658,482,176,503728.09,183936.18,687664.27
270420,202011,398,273,125,285317.67,130646.36,415964.03
270430,202011,32919,23633,9286,24718318.04,9711737.46,34430055.50
270440,202011,484,383,101,400915.01,105560,506475.01
270450,202011,795,450,345,470306.58,360567.64,830874.22
270460,202011,187,149,38,155732.34,39722.53,195454.87
270470,202011,1479,1025,454,1071259.89,475550.9,1546810.79
270480,202011,544,449,95,470291.02,100334.08,570625.10
270490,202011,24,19,5,19856.2,5225.44,25081.64
270500,202011,489,412,77,430608.58,80477.59,511086.17
270510,202011,811,504,307,527808.84,320859.23,848668.07
270520,202011,291,187,104,195418.2,108684.26,304102.46
270530,202011,66,59,7,61656.34,7315,68971.34
270540,202011,99,78,21,81512.03,21945.44,103457.47
270550,202011,1739,1334,405,1394153.42,423270.21,1817423.63
270560,202011,267,146,121,152599.96,126473.69,279073.65
270570,202011,523,366,157,382495.32,164083.9,546579.22
270580,202011,89,70,19,73150.17,19855.67,93005.84
270590,202011,67,54,13,56436.41,13587.7,70024.11
270600,202011,175,146,29,152608.98,30311.28,182920.26
270610,202011,232,177,55,184980.57,57480.96,242461.53
270620,202011,23,23,0,24035.88,0,24035.88
270630,202011,3753,2849,904,2978611.75,944799.19,3923410.94
270640,202011,866,644,222,673057.44,232023.81,905081.25
270642,202011,214,182,32,190205.87,33445.51,223651.38
270644,202011,258,165,93,172437.11,97201.52,269638.63
270650,202011,322,191,131,199611.15,136904.38,336515.53
270660,202011,240,200,40,209026.78,41807.33,250834.11
270670,202011,3056,2319,737,2423599.44,771295.43,3194894.87
270680,202011,433,259,174,270693.84,181859.15,452552.99
270690,202011,1178,774,404,808897.5,422220.65,1231118.15
270700,202011,27,22,5,22990.88,5225,28215.88
270710,202011,872,685,187,715914.43,195445.84,911360.27
270720,202011,238,186,52,194392.62,54349.15,248741.77
270730,202011,1850,1114,736,1164281.27,770272.39,1934553.66
270740,202011,44,31,13,32396.41,13586.2,45982.61
270750,202011,641,482,159,503724.94,166172.17,669897.11
270760,202011,291,209,82,219489.09,85703.91,305193.00
270770,202011,2750,1824,926,1906260.96,968867.34,2875128.30
270780,202011,76,48,28,50161.17,29261.87,79423.04
270790,202011,272,175,97,182904.97,101384.61,284289.58
270800,202011,2002,1609,393,1683698.21,410738.39,2094436.60
270810,202011,241,198,43,206918.99,44940.72,251859.71
270820,202011,142,97,45,101377.88,47032.52,148410.40
270830,202011,794,597,197,626081.17,206959.79,833040.96
270840,202011,1373,1048,325,1096292.49,339652.42,1435944.91
270850,202011,1495,935,560,977136.5,585251.88,1562388.38
270860,202011,2538,1684,854,1759927.56,893605.95,2653533.51
270870,202011,118,64,54,66884.11,56435.54,123319.65
270880,202011,896,703,193,735765.64,201707.93,937473.57
270890,202011,293,219,74,229909.78,77335.87,307245.65
270895,202011,51,47,4,49116.58,4180.26,53296.84
270900,202011,88,68,20,71069.19,20903.28,91972.47
270910,202011,302,246,56,257127.64,58528.53,315656.17
270915,202011,1898,1217,681,1273476.66,712792.39,1986269.05
270920,202011,471,395,76,413886.56,79432.71,493319.27
270930,202011,5945,4453,1492,4656977.3,1559386.53,6216363.83
270940,202011,2296,1797,499,1878033.67,521514.02,2399547.69
280010,202011,38,32,6,33443.44,6270.68,39714.12
280020,202011,484,415,69,433719.79,72110.32,505830.11
280030,202011,20635,13345,7290,13955933.3,7624035.48,21579968.78
280040,202011,335,219,116,228879.85,121238.02,350117.87
280050,202011,410,314,96,329212.21,100335.45,429547.66
280060,202011,353,227,126,237245.24,131688.51,368933.75
280067,202011,1074,775,299,809947.46,312490.24,1122437.70
280070,202011,123,99,24,103460.25,25081.22,128541.47
280100,202011,635,493,142,516294.04,148411.18,664705.22
280110,202011,75,70,5,73160.88,5226.22,78387.10
280120,202011,658,537,121,561206.16,126457.75,687663.91
280130,202011,1747,1147,600,1198693.94,627040.43,1825734.37
280140,202011,479,392,87,409677.97,90924.84,500602.81
280150,202011,395,283,112,295762.09,117050.26,412812.35
280160,202011,108,89,19,93012.14,19857.12,112869.26
280170,202011,401,277,124,289503.24,130640,420143.24
280190,202011,26,22,4,22991.5,4181.07,27172.57
280200,202011,30,26,4,27177.99,4181.77,31359.76
280210,202011,2931,2099,832,2194635.75,870587.2,3065222.95
280220,202011,39,31,8,32401.45,8361.47,40762.92
280230,202011,329,270,59,282196.5,61664.77,343861.27
280240,202011,121,115,6,120197.1,6271.38,126468.48
280250,202011,16,10,6,10450.59,6272.32,16722.91
280260,202011,78,71,7,74204.18,7316.01,81520.19
280270,202011,150,117,33,122270.7,34487.95,156758.65
280280,202011,197,125,72,130640.31,75247.31,205887.62
280290,202011,3346,2422,924,2530831.32,966785.28,3497616.60
280300,202011,1598,1248,350,1304347.02,365804.91,1670151.93
280310,202011,101,96,5,100329.89,5225,105554.89
280320,202011,647,457,190,477653.9,198583.29,676237.19
280330,202011,322,234,88,244575,91973.9,336548.9
280340,202011,404,326,78,340713.26,81522.1,422235.36
280350,202011,3686,2854,832,2985005.63,869582.28,3854587.91
280360,202011,482,325,157,339669.11,165135.52,504804.63
280370,202011,95,83,12,86746.24,12542.76,99289.00
280380,202011,53,41,12,42847.59,12542.12,55389.71
280390,202011,170,146,24,152578.82,25081.11,177659.93
280400,202011,355,243,112,253960.9,117050.99,371011.89
280410,202011,285,234,51,244574.33,53306.73,297881.06
280420,202011,170,143,27,149455.7,28217.13,177672.83
280430,202011,47,36,11,37625.21,11498.17,49123.38
280440,202011,698,548,150,573776.81,157815.73,731592.54
280445,202011,119,108,11,112875.49,11497.33,124372.82
280450,202011,1198,1036,162,1082760.15,169313.14,1252073.29
280460,202011,618,451,167,471374.63,174549.72,645924.35
280470,202011,182,170,12,177682.04,12543.18,190225.22
280480,202011,2709,1883,826,1968068.86,865425.35,2833494.21
280490,202011,262,247,15,258177.19,15678.31,273855.50
280500,202011,42,38,4,39716.9,4181.39,43898.29
280510,202011,140,113,27,118098.18,28219.95,146318.13
280520,202011,52,38,14,39713.13,14631.33,54344.46
280530,202011,78,49,29,51210.9,30314.62,81525.52
280540,202011,537,451,86,471334.63,89873.72,561208.35
280550,202011,735,679,56,709654.22,58524.68,768178.90
280560,202011,493,436,57,455682.98,59573.93,515256.91
280570,202011,2204,1726,478,1804867.54,499557.87,2304425.41
280580,202011,591,458,133,478684.67,139010.34,617695.01
280590,202011,212,133,79,139005.29,82567.83,221573.12
280600,202011,385,323,62,337580.06,64795.5,402375.56
280610,202011,110,84,26,87802.84,27173.95,114976.79
280620,202011,554,453,101,473416.87,105550.54,578967.41
280630,202011,152,128,24,133771.97,25081.68,158853.65
280640,202011,198,156,42,163029.86,43893.66,206923.52
280650,202011,91,58,33,60615.46,34487.92,95103.38
280660,202011,144,107,37,111832.22,38673.15,150505.37
280670,202011,1865,1168,697,1220759.1,728487.29,1949246.39
280680,202011,192,170,22,177672.02,22993.13,200665.15
280690,202011,80,71,9,74200.83,9405.55,83606.38
280700,202011,23,23,0,24038.75,0,24038.75
280710,202011,1472,1128,344,1178897.52,359528.23,1538425.75
280720,202011,116,75,41,78385.23,42850.43,121235.66
280730,202011,27,22,5,22993.2,5225.34,28218.54
280740,202011,2520,1879,641,1964839.17,669905.38,2634744.55
280750,202011,235,204,31,213245.1,32403.52,245648.62
280760,202011,785,544,241,569602.81,252925.49,822528.30
290010,202011,203,141,62,147367.2,64799.32,212166.52
290020,202011,186,167,19,174533.67,19858.63,194392.30
290030,202011,617,397,220,415962.18,229927.41,645889.59
290035,202011,132,109,23,113918.72,24036.66,137955.38
290040,202011,306,203,103,212157.21,107642.43,319799.64
290050,202011,84,64,20,66882.89,20901.01,87783.90
290060,202011,267,118,149,123315.52,155708.21,279023.73
290070,202011,5715,2753,2962,2878593.68,3097072.18,5975665.86
290080,202011,452,205,247,214251.9,258145.92,472397.82
290090,202011,385,174,211,181834.98,221547.17,403382.15
290100,202011,1646,1062,584,1111038.14,611435.7,1722473.84
290110,202011,832,484,348,505888.29,363726.5,869614.79
290115,202011,197,182,15,190216.67,15676.49,205893.16
290120,202011,768,509,259,532008.14,270690.29,802698.43
290130,202011,426,263,163,274880.95,170356.93,445237.88
290135,202011,303,231,72,241438.18,75249.98,316688.16
290140,202011,316,261,55,272806.5,57486.23,330292.73
290150,202011,138,97,41,101367.56,42846.38,144213.94
290160,202011,247,189,58,197544.72,60619.47,258164.19
290170,202011,92,66,26,68983.23,27174.65,96157.88
290180,202011,179,130,49,135872.29,51211.8,187084.09
290190,202011,439,359,80,375233.24,83616.67,458849.91
290195,202011,313,201,112,210062.08,117040.44,327102.52
290200,202011,271,222,49,232011.2,51210.28,283221.48
290205,202011,151,91,60,95112.44,62707.33,157819.77
290210,202011,1167,860,307,898877.95,321249.52,1220127.47
290220,202011,220,118,102,123344.59,106617.48,229962.07
290225,202011,284,117,167,122268.64,174526.08,296794.72
290230,202011,78,49,29,51212.11,30310.36,81522.47
290240,202011,360,131,229,136910.65,240366.71,377277.36
290250,202011,253,234,19,244588.03,19856.9,264444.93
290260,202011,326,269,57,281178.81,60630.35,341809.16
290265,202011,189,163,26,170369.54,27174.19,197543.73
290270,202011,1414,1176,238,1230236.41,249807.66,1480044.07
290280,202011,478,338,140,355388.2,146330.3,501718.5
290290,202011,1336,802,534,839210.92,559118.32,1398329.24
290300,202011,435,370,65,386738.95,67938.62,454677.57
290310,202011,300,137,163,143171.56,170346.86,313518.42
290320,202011,4010,2471,1539,2584833.15,1608576.83,4193409.98
290323,202011,190,164,26,171418.34,27177.36,198595.70
290327,202011,169,134,35,140060.69,36579.59,176640.28
290330,202011,111,56,55,58524.01,57478.94,116002.95
290340,202011,829,337,492,352239.59,514241.42,866481.01
290350,202011,636,381,255,398229.6,266517.58,664747.18
290360,202011,348,268,80,280111.02,83615.09,363726.11
290370,202011,916,386,530,404436.8,553868.85,958305.65
290380,202011,322,204,118,213216.63,123332.17,336548.80
290390,202011,2438,1519,919,1587664.99,961592.72,2549257.71
290395,202011,248,143,105,149453.55,109735.91,259189.46
290400,202011,269,201,68,211137.69,71073.16,282210.85
290405,202011,245,210,35,219463.03,36576.61,256039.64
290410,202011,623,523,100,548717.97,104511.94,653229.91
290420,202011,254,204,50,213201.3,52255.78,265457.08
290430,202011,477,311,166,325014.18,173482.01,498496.19
290440,202011,77,68,9,71061.22,9405.34,80466.56
290450,202011,201,152,49,158860.72,51214.56,210075.28
290460,202011,1953,1170,783,1222902.04,818356.79,2041258.83
290470,202011,1381,608,773,635477.43,807953.7,1443431.13
290475,202011,554,519,35,542421.09,36579.1,579000.19
290480,202011,290,164,126,171395.27,131680.53,303075.80
290485,202011,239,219,20,229915.08,20900.56,250815.64
290490,202011,1225,876,349,916576.09,364762.87,1281338.96
290500,202011,744,382,362,399265.06,380440.86,779705.92
290510,202011,227,179,48,187099.04,50169.92,237268.96
290515,202011,156,95,61,99286.96,63750.91,163037.87
290520,202011,1407,924,483,965756.9,504807.94,1470564.84
290530,202011,300,277,23,289520.17,24041.48,313561.65
290540,202011,104,55,49,57483.13,51212.38,108695.51
290550,202011,160,136,24,142123.46,25080.94,167204.40
290560,202011,3168,1375,1793,1437055.92,1877031.26,3314087.18
290570,202011,6247,3018,3229,3154597.95,3375136.82,6529734.77
290580,202011,1278,754,524,788034.65,547644.91,1335679.56
290590,202011,575,475,100,496447.99,104520.88,600968.87
290600,202011,1762,1208,554,1263682.01,580084.38,1843766.39
290610,202011,204,184,20,192333.33,20906.04,213239.37
290620,202011,357,322,35,336554.18,36579.79,373133.97
290630,202011,2004,849,1155,887328.15,1208167.88,2095496.03
290640,202011,149,120,29,125433.95,30313.23,155747.18
290650,202011,1807,838,969,875913.96,1013870.02,1889783.98
290660,202011,279,226,53,236223.5,55391.22,291614.72
290670,202011,941,486,455,507992.65,476631.97,984624.62
290680,202011,1230,991,239,1035714.32,249785.67,1285499.99
290682,202011,307,229,78,239329.77,81523.4,320853.17
290685,202011,241,158,83,165134.13,86741.56,251875.69
290687,202011,1061,682,379,713013.75,396135.27,1109149.02
290689,202011,145,77,68,80474.38,71062.96,151537.34
290690,202011,609,257,352,268615.65,367921.18,636536.83
290700,202011,245,121,124,126477.85,129614.6,256092.45
290710,202011,752,514,238,537223.04,248752.01,785975.05
290720,202011,1023,829,194,866437.08,202760.21,1069197.29
290730,202011,1173,671,502,701276.49,524645.59,1225922.08
290740,202011,18,15,3,15676.96,3135,18811.96
290750,202011,1423,636,787,664800.26,822632.29,1487432.55
290755,202011,72,65,7,67934.56,7315.78,75250.34
290760,202011,291,252,39,263408.42,40764.53,304172.95
290770,202011,189,177,12,184987.88,12541.4,197529.28
290780,202011,1120,856,264,894648.17,275922.16,1170570.33
290790,202011,364,254,110,265472.57,114974.69,380447.26
290800,202011,2473,1006,1467,1051390.97,1534285.7,2585676.67
290810,202011,464,319,145,333423.01,151548.33,484971.34
290820,202011,398,234,164,244587.37,171414.8,416002.17
290830,202011,423,302,121,315627.53,126463.99,442091.52
290840,202011,1755,1088,667,1137143.54,698148.23,1835291.77
290850,202011,845,440,405,459893.7,423320.39,883214.09
290860,202011,642,290,352,303110.4,367906.35,671016.75
290870,202011,629,448,181,468245.5,189173.74,657419.24
290880,202011,121,66,55,68975.12,57477,126452.12
290890,202011,393,264,129,275904.28,135861.16,411765.44
290900,202011,168,127,41,132723.45,42848.36,175571.81
290910,202011,386,292,94,305157.2,99280.25,404437.45
290920,202011,207,180,27,188140.11,28218.99,216359.10
290930,202011,820,623,197,651158.77,206946.2,858104.97
290940,202011,244,205,39,214239.37,40759.61,254998.98
290950,202011,156,95,61,99278.32,63745.23,163023.55
290960,202011,474,334,140,349084.44,146326.53,495410.97
290970,202011,245,213,32,223648.99,33444.69,257093.68
290980,202011,1644,1153,491,1207134.65,514214.26,1721348.91
290990,202011,388,326,62,340749.9,64802.97,405552.87
291000,202011,854,258,596,269623.71,622830.95,892454.66
291005,202011,2312,1005,1307,1051501.19,1366086.21,2417587.40
291010,202011,162,146,16,152599.72,16721.73,169321.45
291020,202011,101,81,20,84645.62,20901.04,105546.66
291030,202011,98,70,28,73156.56,29265.62,102422.18
291040,202011,612,341,271,357399.69,283198.29,640597.98
291050,202011,1449,793,656,828811.11,685610.32,1514421.43
291060,202011,1543,846,697,884217.04,728480.12,1612697.16
291070,202011,1971,1467,504,1533287.74,526770.31,2060058.05
291072,202011,7180,2663,4517,2784430.04,4725454.41,7509884.45
291075,202011,242,196,46,204830.29,48072.73,252903.02
291077,202011,59,40,19,41803.39,19856.06,61659.45
291080,202011,20341,8849,11492,9255554.26,12023202.97,21278757.23
291085,202011,299,246,53,257102.47,55393.04,312495.51
291090,202011,304,125,179,130633.01,187070.26,317703.27
291100,202011,658,201,457,210046.13,478612.7,688658.83
291110,202011,417,318,99,332394.97,103475.98,435870.95
291120,202011,2382,1194,1188,1247952.11,1242683.76,2490635.87
291125,202011,64,31,33,32400.29,34491.95,66892.24
291130,202011,199,176,23,183968.2,24041.75,208009.95
291140,202011,130,105,25,109748.97,26129.03,135878.00
291150,202011,395,148,247,154663.24,258118.81,412782.05
291160,202011,383,311,72,325062.1,75251.88,400313.98
291165,202011,44,35,9,36576.63,9406.41,45983.04
291170,202011,3162,1569,1593,1640914.46,1664955.06,3305869.52
291180,202011,1269,511,758,534101.96,793313.26,1327415.22
291185,202011,93,88,5,91968.27,5225.78,97194.05
291190,202011,1386,635,751,664740.39,784935.71,1449676.10
291200,202011,170,125,45,130649.15,47030.69,177679.84
291210,202011,2296,917,1379,958392.45,1441208.24,2399600.69
291220,202011,275,207,68,216340.19,71067.12,287407.31
291230,202011,979,337,642,352252.98,671034.84,1023287.82
291240,202011,426,397,29,414909.17,30307.38,445216.55
291250,202011,437,353,84,368926.36,87785.63,456711.99
291260,202011,60,50,10,52252.41,10450.39,62702.80
291270,202011,1160,479,681,500705.75,711833.3,1212539.05
291280,202011,352,166,186,174549.9,194393.32,368943.22
291290,202011,1719,890,829,930286.52,867565.85,1797852.37
291300,202011,231,184,47,192330.26,49125.44,241455.70
291310,202011,223,200,23,209036.92,24036.92,233073.84
291320,202011,1361,956,405,999228.31,423307.3,1422535.61
291330,202011,130,111,19,116018.42,19859.36,135877.78
291340,202011,215,127,88,132733.12,91978.23,224711.35
291345,202011,131,91,40,95106.19,41802.55,136908.74
291350,202011,1645,583,1062,609265.6,1109872.79,1719138.39
291360,202011,8375,4039,4336,4222681.88,4536183.63,8758865.51
291370,202011,1122,647,475,676255.48,496480.31,1172735.79
291380,202011,267,212,55,221551.67,58523.85,280075.52
291390,202011,3919,1711,2208,1789391.71,2309927.77,4099319.48
291400,202011,2073,1482,591,1550136.1,617729.99,2167866.09
291410,202011,193,167,26,174543.52,27171.22,201714.74
291420,202011,119,87,32,90917.32,33440.61,124357.93
291430,202011,169,92,77,97200.84,80477.7,177678.54
291440,202011,519,426,93,445242.77,97201.21,542443.98
291450,202011,928,593,335,619796.87,350132.17,969929.04
291460,202011,1868,1519,349,1587698.82,364792.1,1952490.92
291465,202011,2190,1041,1149,1088055.98,1200930.9,2288986.88
291470,202011,2863,1447,1416,1512380.94,1481031.02,2993411.96
291480,202011,11813,5214,6599,5453914.22,6900432.36,12354346.58
291490,202011,613,246,367,257100.36,383549.56,640649.92
291500,202011,379,224,155,234117.12,162015.41,396132.53
291510,202011,1215,472,743,494297.33,776457.38,1270754.71
291520,202011,949,429,520,448383.24,543486.93,991870.17
291530,202011,943,251,692,262309.04,723169.7,985478.74
291535,202011,122,100,22,104502.1,22990.84,127492.94
291540,202011,349,106,243,110789.1,255014.92,365804.02
291550,202011,1235,579,656,605138.76,685606.85,1290745.61
291560,202011,5264,2640,2624,2761235.53,2745579.91,5506815.44
291570,202011,202,105,97,109731.86,101371.14,211103.00
291580,202011,1203,741,462,774473.14,482865.67,1257338.81
291590,202011,90,37,53,38668.55,55393.86,94062.41
291600,202011,1148,568,580,593708.44,606238.79,1199947.23
291610,202011,1459,706,753,737954.71,788133.15,1526087.86
291620,202011,566,263,303,274901.25,317753.03,592654.28
291630,202011,481,149,332,155712.23,347993.85,503706.08
291640,202011,3958,2005,1953,2096659.31,2042314.19,4138973.50
291650,202011,428,289,139,302069.58,145286.37,447355.95
291660,202011,387,155,232,162000.31,242485.18,404485.49
291670,202011,226,136,90,142136.58,94056.77,236193.35
291680,202011,652,390,262,407635.33,274889.48,682524.81
291685,202011,585,326,259,340722.94,270700.81,611423.75
291690,202011,522,311,211,325050.01,220555.54,545605.55
291700,202011,978,758,220,792265.69,229927.7,1022193.39
291710,202011,1629,790,839,828816.18,876910.81,1705726.99
291720,202011,431,289,142,303068.52,148396.65,451465.17
291730,202011,933,546,387,571733.86,404484.38,976218.24
291733,202011,291,197,94,205895.89,98241.91,304137.80
291735,202011,76,57,19,59567.45,19858.26,79425.71
291740,202011,356,273,83,285349.24,86753.74,372102.98
291750,202011,2163,1399,764,1462331.23,799631.1,2261962.33
291760,202011,2950,1637,1313,1710782.02,1372182.1,3082964.12
291770,202011,779,524,255,547718.99,266536.54,814255.53
291780,202011,58,36,22,37631.92,22995.58,60627.50
291790,202011,158,80,78,83604.17,81511.28,165115.45
291800,202011,10056,4151,5905,4342785.73,6171824.42,10514610.15
291810,202011,1101,823,278,860177.22,290562.96,1150740.18
291820,202011,282,203,79,212151.61,82557.39,294709.00
291830,202011,1056,422,634,441085.53,662658.55,1103744.08
291835,202011,563,523,40,546596.43,41805.74,588402.17
291840,202011,4881,2461,2420,2575416.3,2529380.5,5104796.8
291845,202011,274,88,186,91964.05,194383.22,286347.27
291850,202011,327,289,38,302059.18,39715.67,341774.85
291855,202011,263,104,159,108684.24,166158.06,274842.30
291860,202011,171,107,64,111825.3,66884.33,178709.63
291870,202011,84,35,49,36576.04,51208.15,87784.19
291875,202011,177,164,13,171420.19,13588.7,185008.89
291880,202011,450,361,89,377332.9,93032.8,470365.7
291890,202011,246,78,168,81512.15,175568.61,257080.76
291900,202011,59,34,25,35530.17,26125,61655.17
291905,202011,126,91,35,95119.99,36585.3,131705.29
291910,202011,158,128,30,133768.26,31354.74,165123.00
291915,202011,432,383,49,400331.94,51212.3,451544.24
291920,202011,5119,2542,2577,2658119.13,2696756.84,5354875.97
291930,202011,171,101,70,105566.58,73160.85,178727.43
291940,202011,359,206,153,215312.94,159915.31,375228.25
291950,202011,1141,919,222,960554.6,232022.27,1192576.87
291955,202011,1247,743,504,777640.92,526789.83,1304430.75
291960,202011,192,138,54,144227.83,56433.4,200661.23
291970,202011,765,580,185,606199.98,193344.64,799544.62
291980,202011,1501,1327,174,1387076.46,181863.5,1568939.96
291990,202011,135,125,10,130637.13,10450.88,141088.01
291992,202011,172,89,83,93028.49,86753.8,179782.29
291995,202011,188,122,66,127505.08,68978.28,196483.36
292000,202011,395,301,94,314591.8,98246.05,412837.85
292010,202011,318,219,99,230962.87,103464.57,334427.44
292020,202011,301,221,80,230983.29,83612.56,314595.85
292030,202011,146,113,33,118097.54,34486.88,152584.42
292040,202011,629,319,310,333359.78,323957.23,657317.01
292045,202011,109,98,11,102414.38,11495.68,113910.06
292050,202011,947,689,258,720118.27,269658.13,989776.40
292060,202011,904,744,160,777608.7,167224.9,944833.6
292070,202011,61,18,43,18812.55,44939.14,63751.69
292080,202011,139,94,45,98232.07,47026.91,145258.98
292090,202011,541,187,354,195434.13,369967.15,565401.28
292100,202011,1474,622,852,650167.38,890605.99,1540773.37
292105,202011,192,170,22,177653.51,22990.85,200644.36
292110,202011,2275,824,1451,861215.02,1516502.23,2377717.25
292120,202011,696,548,148,572809.84,154690.06,727499.90
292130,202011,444,249,195,260247.15,203810.96,464058.11
292140,202011,208,169,39,176654.05,41807.29,218461.34
292145,202011,162,87,75,90924.45,78382.81,169307.26
292150,202011,1480,1207,273,1261566.15,285339.9,1546906.05
292160,202011,168,136,32,142131.79,33443.58,175575.37
292170,202011,1193,1039,154,1086991.72,160954.77,1247946.49
292180,202011,220,161,59,169324.94,61663.68,230988.62
292190,202011,161,105,56,109753.81,58530.25,168284.06
292200,202011,1350,490,860,512120.79,899849.68,1411970.47
292205,202011,124,108,16,112868.34,16720.68,129589.02
292210,202011,368,255,113,266509.97,118099.72,384609.69
292220,202011,31,22,9,22996.62,9405.6,32402.22
292225,202011,39,33,6,34493.21,6270,40763.21
292230,202011,963,762,201,796430.46,211123.29,1007553.75
292240,202011,614,442,172,461991.11,179776.92,641768.03
292250,202011,1728,1132,596,1183184.11,623975.31,1807159.42
292260,202011,408,242,166,252928.46,173489.28,426417.74
292265,202011,251,181,70,189175.17,73163.03,262338.20
292270,202011,740,338,402,353266.09,420153.54,773419.63
292273,202011,206,113,93,118098.37,97195.11,215293.48
292275,202011,174,87,87,90922.7,90922.48,181845.18
292280,202011,144,102,42,106592.82,45981.31,152574.13
292285,202011,77,63,14,65835.83,14630,80465.83
292290,202011,577,389,188,406566.89,196485.07,603051.96
292300,202011,1687,621,1066,649048.05,1114126.44,1763174.49
292303,202011,114,74,40,77332.61,41802.48,119135.09
292305,202011,116,86,30,89881.06,31353.48,121234.54
292310,202011,932,603,329,630254.15,343853.99,974108.14
292320,202011,594,452,142,472436.56,148408.9,620845.46
292330,202011,174,100,74,104509.11,77333.64,181842.75
292335,202011,281,222,59,232006.87,61659.71,293666.58
292340,202011,579,402,177,420124.32,184982.93,605107.25
292350,202011,274,148,126,154671.78,131685.4,286357.18
292360,202011,706,538,168,562320.43,175589.52,737909.95
292370,202011,740,567,173,592604.93,180804.33,773409.26
292380,202011,637,517,120,540377.69,125431.12,665808.81
292390,202011,462,187,275,195443.38,287409.29,482852.67
292400,202011,3595,2229,1366,2330785.59,1428811.01,3759596.60
292405,202011,268,177,91,184971.95,95097.8,280069.75
292410,202011,134,82,52,85694.71,54344.75,140039.46
292420,202011,296,257,39,268597.72,40759.25,309356.97
292430,202011,541,406,135,424308.73,141086.65,565395.38
292440,202011,603,513,90,536147.06,94063.53,630210.59
292450,202011,242,190,52,198576.57,54345.82,252922.39
292460,202011,549,409,140,427450.46,147357.89,574808.35
292465,202011,209,175,34,182886.88,35530.9,218417.78
292467,202011,133,80,53,83603.42,55386.05,138989.47
292470,202011,291,197,94,205877.08,98235.6,304112.68
292480,202011,362,248,114,259215.95,119152.99,378368.94
292490,202011,238,169,69,176621.85,72111.32,248733.17
292500,202011,862,378,484,396156.79,506953.5,903110.29
292510,202011,3443,1592,1851,1664972.58,1936705.15,3601677.73
292520,202011,1095,511,584,534113.2,610414.35,1144527.55
292525,202011,399,285,114,297879.03,119143.24,417022.27
292530,202011,4421,1764,2657,1844793.47,2778169.34,4622962.81
292540,202011,477,268,209,280072.58,218413.74,498486.32
292550,202011,1104,581,523,607230.79,546598.71,1153829.50
292560,202011,332,310,22,324034.76,22994.19,347028.95
292570,202011,308,240,68,250850.52,71071.61,321922.13
292575,202011,488,326,162,340751.2,170374.26,511125.46
292580,202011,992,653,339,682462.37,355334.58,1037796.95
292590,202011,562,490,72,512094.21,75243,587337.21
292593,202011,140,111,29,116005.58,30306.7,146312.28
292595,202011,203,157,46,164095.45,48077.35,212172.80
292600,202011,1250,908,342,949076.23,358495.84,1307572.07
292610,202011,133,101,32,105568.58,34494.52,140063.10
292620,202011,527,445,82,465129.73,85707.07,550836.80
292630,202011,1440,802,638,839289.67,666801.78,1506091.45
292640,202011,842,583,259,609333.06,270693.5,880026.56
292650,202011,191,159,32,166197.15,33446.69,199643.84
292660,202011,2032,1457,575,1522878.63,602061.35,2124939.98
292665,202011,148,104,44,108680.47,45981.34,154661.81
292670,202011,391,313,78,327164.12,81515.51,408679.63
292680,202011,261,194,67,202762.29,70032.12,272794.41
292690,202011,192,141,51,147355.34,53297.45,200652.79
292700,202011,974,647,327,676236.97,341777.48,1018014.45
292710,202011,116,101,15,105554.95,15677.61,121232.56
292720,202011,929,526,403,550793.86,421181.24,971975.10
292730,202011,199,93,106,97202.97,110786.47,207989.44
292740,202011,68901,33492,35409,35040749.5,37050443.19,72091192.69
292750,202011,391,277,114,289520.7,119154.99,408675.69
292760,202011,343,286,57,298904.53,59573.32,358477.85
292770,202011,830,349,481,365826.32,502732.58,868558.90
292780,202011,417,163,254,170343.2,265442.58,435785.78
292790,202011,781,396,385,413844.86,402337.82,816182.68
292800,202011,1265,753,512,786980.04,535085.3,1322065.34
292805,202011,400,124,276,129589.76,288440.58,418030.34
292810,202011,1492,847,645,885283.15,674122.64,1559405.79
292820,202011,718,602,116,629191.66,121240.92,750432.58
292830,202011,107,88,19,91979.19,19859.1,111838.29
292840,202011,690,563,127,588440.75,132729.35,721170.10
292850,202011,143,95,48,99296.82,50173.06,149469.88
292860,202011,2154,1253,901,1310783.3,941812.25,2252595.55
292870,202011,3504,2333,1171,2438458.59,1223945.33,3662403.92
292880,202011,1498,983,515,1027391.87,538259.08,1565650.95
292890,202011,519,440,79,459897.09,82569.68,542466.77
292895,202011,139,93,46,97201.64,48076.83,145278.47
292900,202011,380,273,107,285351.06,112887.55,398238.61
292905,202011,482,239,243,249812.73,253984.17,503796.90
292910,202011,466,349,117,364758.93,122281.5,487040.43
292920,202011,524,229,295,239355.99,308328.18,547684.17
292925,202011,498,457,41,477582.19,42847.93,520430.12
292930,202011,628,379,249,397162.2,260246.91,657409.11
292935,202011,286,122,164,127506.53,171397.26,298903.79
292937,202011,227,155,72,161994.81,75249.44,237244.25
292940,202011,193,149,44,155747.3,45990.19,201737.49
292950,202011,1177,588,589,615663.68,615662.14,1231325.82
292960,202011,581,410,171,428542.15,178733.28,607275.43
292970,202011,244,171,73,178739.58,76307,255046.58
292975,202011,110,64,46,66895.28,48080.66,114975.94
292980,202011,285,194,91,203796.53,96147.76,299944.29
292990,202011,1324,983,341,1027443.08,356395.04,1383838.12
293000,202011,116,80,36,83609.59,37628.45,121238.04
293010,202011,2800,1656,1144,1730927.61,1197813.72,2928741.33
293015,202011,639,519,120,543502.16,125415.08,668917.24
293020,202011,333,271,62,283254.89,64804.96,348059.85
293030,202011,604,525,79,548695.8,82566.7,631262.5
293040,202011,357,282,75,295760.96,78379.29,374140.25
293050,202011,2876,1699,1177,1776146.83,1230150.28,3006297.11
293060,202011,259,207,52,216370.41,54354.28,270724.69
293070,202011,3494,1751,1743,1830212.76,1829179.25,3659392.01
293075,202011,91,60,31,63752.01,32396.72,96148.73
293076,202011,73,53,20,55390.72,20900.67,76291.39
293077,202011,520,298,222,312511.04,232026.24,544537.28
293080,202011,437,392,45,409681.77,47029.53,456711.30
293090,202011,129,116,13,121231.32,13586.16,134817.48
293100,202011,529,368,161,385688.73,168266.4,553955.13
293105,202011,344,251,93,262311.67,97195.15,359506.82
293110,202011,165,115,50,120205.79,52257.08,172462.87
293120,202011,306,208,98,217410.26,102431.65,319841.91
293130,202011,244,168,76,175577.93,79434.15,255012.08
293135,202011,8079,3161,4918,3303896.2,5142204.99,8446101.19
293140,202011,213,132,81,137979.04,85711.04,223690.08
293150,202011,327,284,43,296820.38,44936.72,341757.10
293160,202011,426,255,171,267550.37,178707.8,446258.17
293170,202011,180,120,60,126474.85,62714.78,189189.63
293180,202011,535,377,158,394013.83,165127.8,559141.63
293190,202011,1343,927,416,969975.78,434832.3,1404808.08
293200,202011,552,485,67,506927.02,70030.57,576957.59
293210,202011,397,300,97,313544.83,101373.64,414918.47
293220,202011,2482,1052,1430,1099585.72,1495680.78,2595266.50
293230,202011,1744,644,1100,673077,1149650.77,1822727.77
293240,202011,235,216,19,225784.66,19859.12,245643.78
293245,202011,126,107,19,111824.75,19856.64,131681.39
293250,202011,733,262,471,273862.6,492317.99,766180.59
293260,202011,305,253,52,264441.93,54348.53,318790.46
293270,202011,1168,538,630,563336.7,658436.26,1221772.96
293280,202011,280,155,125,161989.08,130643.66,292632.74
293290,202011,3057,1986,1071,2075723.86,1119381.17,3195105.03
293300,202011,740,526,214,549762.38,223655.86,773418.24
293305,202011,195,153,42,159896.79,43892.23,203789.02
293310,202011,151,114,37,119149.42,38670.7,157820.12
293315,202011,167,130,37,135886.5,38673.5,174560.0
293317,202011,90,64,26,66888.58,27171.68,94060.26
293320,202011,1059,577,482,604181.92,503831.42,1108013.34
293325,202011,184,67,117,70022.25,122269.65,192291.90
293330,202011,13766,6386,7380,6675842.61,7716786.59,14392629.20
293340,202011,274,194,80,202735.53,83603.49,286339.02
293345,202011,248,202,46,211137.86,48074.92,259212.78
293350,202011,608,351,257,366884.21,268614.96,635499.17
293360,202011,1526,1091,435,1140296.49,454659.18,1594955.67
310010,202011,139,75,64,78387.5,66886.74,145274.24
310020,202011,1037,567,470,592602.83,492241.7,1084844.53
310030,202011,329,263,66,274901.23,68986.26,343887.49
310040,202011,44,29,15,30306.38,15675,45981.38
310050,202011,176,108,68,112866.89,71069.01,183935.90
310060,202011,252,173,79,180815.73,82568.3,263384.03
310070,202011,15,10,5,10451.01,5225,15676.01
310080,202011,42,26,16,27171.79,16723.03,43894.82
310090,202011,1020,533,487,558092.44,514201.27,1072293.71
310100,202011,306,224,82,234147.42,85711.74,319859.16
310110,202011,709,390,319,407618.28,334452.88,742071.16
310120,202011,382,217,165,226784.28,172446.05,399230.33
310130,202011,33,19,14,19862.25,14635.17,34497.42
310140,202011,23,10,13,10451.78,13588.11,24039.89
310150,202011,1197,810,387,846598.25,404498.43,1251096.68
310160,202011,2054,999,1055,1045178.27,1102560.86,2147739.13
310163,202011,86,48,38,51207.35,39712.6,90919.95
310170,202011,2546,1118,1428,1168446.52,1492444.28,2660890.80
310180,202011,152,56,96,58523.95,100328.82,158852.77
310190,202011,487,332,155,347000.16,162006.34,509006.50
310200,202011,486,309,177,322964.57,184996.58,507961.15
310205,202011,58,39,19,40756.97,19855.06,60612.03
310210,202011,284,228,56,238312.2,58536.64,296848.84
310220,202011,59,32,27,33447.14,28219.49,61666.63
310230,202011,279,191,88,199630.95,91971.58,291602.53
310240,202011,106,93,13,97190.12,13585.71,110775.83
310250,202011,97,80,17,83614.66,17767.85,101382.51
310260,202011,764,399,365,418068.64,381486.52,799555.16
310270,202011,268,171,97,178733.25,101388.14,280121.39
310280,202011,377,275,102,287419.68,106598.23,394017.91
310285,202011,202,149,53,155718.26,55389.99,211108.25
310290,202011,242,132,110,137960.1,117049.74,255009.84
310300,202011,154,126,28,131697.97,29266.16,160964.13
310310,202011,9,7,2,7317.74,2090.8,9408.54
310320,202011,29,10,19,10451.04,19855.5,30306.54
310330,202011,40,27,13,28217.99,13586.89,41804.88
310340,202011,1735,1141,594,1192517.42,620820.91,1813338.33
310350,202011,2787,1476,1311,1542699.7,1372245.17,2914944.87
310360,202011,41,34,7,35530,7315,42845
310370,202011,118,97,21,101376.63,21947.11,123323.74
310375,202011,104,38,66,39711.74,68973.98,108685.72
310380,202011,47,27,20,28219.77,20904.74,49124.51
310390,202011,95,63,32,65849.43,33446.3,99295.73
310400,202011,2345,1504,841,1572023.16,880100.24,2452123.40
310410,202011,126,69,57,72122.27,59575.3,131697.57
310420,202011,663,347,316,364764.24,332361.81,697126.05
310430,202011,300,186,114,194386.02,119132.02,313518.04
310440,202011,73,42,31,43890.64,32396.66,76287.30
310445,202011,79,64,15,66887.46,15676.87,82564.33
310450,202011,623,386,237,404489.71,247722.78,652212.49
310460,202011,261,184,77,192308.6,80472.74,272781.34
310470,202011,509,323,186,337573.72,194396.43,531970.15
310480,202011,81,52,29,54345.67,30307.22,84652.89
310490,202011,536,246,290,257135.37,303091.7,560227.07
310500,202011,134,53,81,55385.97,84646.88,140032.85
310510,202011,601,417,184,435836.38,192314.58,628150.96
310520,202011,137,95,42,99299.68,43896.85,143196.53
310530,202011,109,45,64,47027.22,66881.22,113908.44
310540,202011,472,271,201,283240.54,210083.19,493323.73
310550,202011,74,48,26,50166.78,27173.58,77340.36
310560,202011,2959,2034,925,2128053.64,971961.67,3100015.31
310570,202011,89,58,31,60615.97,32397.15,93013.12
310590,202011,370,236,134,246668.69,140055.92,386724.61
310600,202011,148,80,68,83611.12,71067.79,154678.91
310610,202011,57,22,35,22995.3,36581.99,59577.29
310620,202011,46982,22261,24721,23289469.52,25859447.56,49148917.08
310630,202011,652,400,252,418051.53,263369.57,681421.10
310640,202011,126,99,27,103461.43,28216.69,131678.12
310650,202011,161,143,18,149478.85,18813.64,168292.49
310660,202011,98,65,33,67928.01,34486.58,102414.59
310665,202011,61,46,15,48070.65,15676.68,63747.33
310670,202011,6715,2851,3864,2983055.24,4045681.92,7028737.16
310680,202011,56,34,22,35531.08,22991.24,58522.32
310690,202011,615,426,189,445215.53,197524.25,642739.78
310700,202011,60,39,21,40761.08,21945.78,62706.86
310710,202011,1325,898,427,938533.53,446271.75,1384805.28
310720,202011,134,35,99,36579.64,103470.01,140049.65
310730,202011,1466,1005,461,1050408.36,481841.38,1532249.74
310740,202011,973,537,436,562327.35,455715.39,1018042.74
310750,202011,238,144,94,150502.69,100330.55,250833.24
310760,202011,63,47,16,49131.36,16723.81,65855.17
310770,202011,85,42,43,43891.23,44939.51,88830.74
310780,202011,358,289,69,302066.92,72119.24,374186.16
310790,202011,103,83,20,86752.49,20903.67,107656.16
310800,202011,447,208,239,217397.98,249784.56,467182.54
310810,202011,172,122,50,127512.57,52260.88,179773.45
310820,202011,337,265,72,276989.54,75255.82,352245.36
310825,202011,192,163,29,170361.98,30309.23,200671.21
310830,202011,474,224,250,234116.58,261272.36,495388.94
310840,202011,363,214,149,223658.98,156779.92,380438.90
310850,202011,81,66,15,68975.04,15675.6,84650.64
310855,202011,397,315,82,329250.54,85704.8,414955.34
310860,202011,1573,1157,416,1209337.68,435867.06,1645204.74
310870,202011,54,44,10,45986.68,10451.91,56438.59
310880,202011,82,63,19,65835.93,19857.9,85693.83
310890,202011,307,175,132,182908.32,140038.31,322946.63
310900,202011,657,296,361,309368.3,377317.79,686686.09
310910,202011,241,161,80,168279.72,83614.57,251894.29
310920,202011,450,263,187,274903.87,195468.58,470372.45
310925,202011,32,26,6,27174.45,6270,33444.45
310930,202011,1296,823,473,860172.22,495424.88,1355597.10
310940,202011,691,340,351,355370.61,366866.96,722237.57
310945,202011,119,76,43,79425.4,44940.92,124366.32
310950,202011,227,182,45,190232.83,47032.03,237264.86
310960,202011,76,24,52,25083.84,54352.36,79436.20
310970,202011,167,103,64,107664.88,66889.7,174554.58
310980,202011,49,31,18,32397.35,18812.29,51209.64
310990,202011,163,84,79,87788.72,82558.94,170347.66
311000,202011,818,397,421,414960.63,441084.38,856045.01
311010,202011,48,41,7,42849.99,7316.31,50166.30
311020,202011,46,27,19,28222.8,19860.03,48082.83
311030,202011,386,224,162,234109.12,169304.12,403413.24
311040,202011,43,33,10,34485.11,10450,44935.11
311050,202011,476,185,291,194394.05,304120.92,498514.97
311060,202011,780,430,350,450458.58,365800.95,816259.53
311070,202011,338,148,190,154673.42,198559.53,353232.95
311080,202011,107,58,49,60618.94,51220.39,111839.33
311090,202011,336,156,180,164099.13,188130.21,352229.34
311100,202011,578,347,231,362680.31,241429.32,604109.63
311110,202011,689,482,207,503748.4,216349.65,720098.05
311115,202011,72,51,21,53298.04,21950.05,75248.09
311120,202011,1057,560,497,585309.87,519445.98,1104755.85
311130,202011,336,201,135,210099.92,141099,351198.92
311140,202011,169,90,79,94067.78,82576.39,176644.17
311150,202011,343,221,122,230986.13,127517.26,358503.39
311160,202011,710,506,204,528871.4,214262.53,743133.93
311170,202011,86,68,18,71063.16,18811.14,89874.30
311180,202011,326,216,110,225746.22,114962.28,340708.50
311190,202011,41,20,21,20901.02,21946.62,42847.64
311200,202011,326,229,97,239346.07,101379.21,340725.28
311205,202011,33,24,9,25081.66,9405,34486.66
311210,202011,43,38,5,39714.06,5225.94,44940.00
311220,202011,29,24,5,25080.29,5225,30305.29
311230,202011,1639,1073,566,1122600.9,591590.2,1714191.1
311240,202011,188,120,68,125400.45,71063.41,196463.86
311250,202011,55,21,34,21947.28,35533.7,57480.98
311260,202011,553,348,205,363705.44,214254.07,577959.51
311265,202011,120,81,39,84654.85,40760.25,125415.10
311270,202011,289,194,95,202768.05,99288.93,302056.98
311280,202011,208,96,112,100328.22,117049.71,217377.93
311290,202011,103,84,19,87795.75,19855.72,107651.47
311300,202011,580,361,219,377327.29,228887.62,606214.91
311310,202011,21,16,5,16720.78,5226.56,21947.34
311320,202011,655,487,168,508995.36,176626.82,685622.18
311330,202011,1074,785,289,822550.12,302057.94,1124608.06
311340,202011,2642,1867,775,1951385.89,812023.44,2763409.33
311350,202011,274,212,62,221582.07,64799.68,286381.75
311360,202011,175,103,72,107652.79,75250.38,182903.17
311370,202011,1229,500,729,522588.54,761919.98,1284508.52
311380,202011,7,6,1,6272.59,1045,7317.59
311390,202011,249,136,113,142145.31,119154.88,261300.19
311400,202011,136,84,52,87790.87,54346.65,142137.52
311410,202011,115,60,55,62710.21,57482.86,120193.07
311420,202011,298,163,135,170360.03,142135.64,312495.67
311430,202011,843,556,287,581128.43,299972.76,881101.19
311440,202011,458,322,136,337609.04,142150.32,479759.36
311450,202011,308,186,122,194423.02,127514.6,321937.62
311455,202011,278,192,86,200672.35,90931.03,291603.38
311460,202011,137,60,77,63755.14,80478.12,144233.26
311470,202011,25,13,12,13585,12540.51,26125.51
311480,202011,49,23,26,24036.73,27171.71,51208.44
311490,202011,13,9,4,9407.26,4180.87,13588.13
311500,202011,24,11,13,11495.5,13585.94,25081.44
311510,202011,639,435,204,455685.87,213207.3,668893.17
311520,202011,39,31,8,32395,8360.87,40755.87
311530,202011,1809,1317,492,1376547.71,514170.6,1890718.31
311535,202011,65,44,21,45993.33,21950.92,67944.25
311540,202011,33,29,4,30309.4,4180,34489.4
311545,202011,168,123,45,128543.92,47028.36,175572.28
311547,202011,36,30,6,31350.93,6270.73,37621.66
311550,202011,695,315,380,329222.75,398203.7,727426.45
311560,202011,43,28,15,29262.31,15675.34,44937.65
311570,202011,283,189,94,197541.39,98250.66,295792.05
311580,202011,343,202,141,211114.63,147356.7,358471.33
311590,202011,32,29,3,30310.28,3136.41,33446.69
311600,202011,105,83,22,86761.24,22992.76,109754.00
311610,202011,253,215,38,224711.31,39716.43,264427.74
311615,202011,89,70,19,73152.02,19856.86,93008.88
311620,202011,25,14,11,14630.67,11496.03,26126.70
311630,202011,88,74,14,77333.11,14630,91963.11
311640,202011,133,63,70,65850.83,73171.05,139021.88
311650,202011,118,79,39,82558.49,40759.55,123318.04
311660,202011,406,196,210,204851.3,219473.29,424324.59
311670,202011,151,100,51,104527.03,53308.28,157835.31
311680,202011,207,155,52,162000.47,55396.02,217396.49
311690,202011,16,12,4,12541.84,4180,16721.84
311700,202011,197,138,59,144236.05,61665.54,205901.59
311710,202011,194,131,63,136927.96,65848.2,202776.16
311720,202011,43,31,12,32400.61,12541.25,44941.86
311730,202011,562,381,181,399253.42,190219.11,589472.53
311740,202011,29,20,9,20901.81,9406.41,30308.22
311750,202011,725,484,241,505834.19,251878.23,757712.42
311760,202011,70,31,39,32402.63,40763.27,73165.90
311770,202011,386,192,194,200664.42,202747.62,403412.04
311780,202011,179,89,90,93020.71,94061.31,187082.02
311783,202011,87,78,9,81525.11,9405.97,90931.08
311787,202011,35,12,23,12541.67,24039.02,36580.69
311790,202011,259,113,146,118102.34,152591.53,270693.87
311800,202011,684,447,237,468268.94,247699.64,715968.58
311810,202011,49,39,10,40758.41,10450,51208.41
311820,202011,120,99,21,103468.33,21951.56,125419.89
311830,202011,1885,1157,728,1210327.58,760816.64,1971144.22
311840,202011,1004,553,451,577968.44,471374.98,1049343.42
311850,202011,12,8,4,8361.97,4181.87,12543.84
311860,202011,9591,4135,5456,4325189.98,5707642.69,10032832.67
311870,202011,122,65,57,67938.29,59573.96,127512.25
311880,202011,929,674,255,704497.79,266531.58,971029.37
311890,202011,199,96,103,100257.58,107663.45,207921.03
311900,202011,72,28,44,29265.87,45988.51,75254.38
311910,202011,1392,872,520,911343.39,544504.65,1455848.04
311920,202011,230,150,80,156776.83,83613.16,240389.99
311930,202011,898,509,389,531993.23,407608.45,939601.68
311940,202011,2487,1292,1195,1350446.38,1249995.51,2600441.89
311950,202011,55,39,16,40767.51,16722.27,57489.78
311960,202011,60,44,16,45991.33,16721.39,62712.72
311970,202011,24,15,9,15675.14,9405,25080.14
311980,202011,43,34,9,35532.55,10451.33,45983.88
311990,202011,38,29,9,30313.03,9406.63,39719.66
311995,202011,58,37,21,38675,21949.73,60624.73
312000,202011,25,17,8,17767.92,8360.1,26128.02
312010,202011,75,58,17,60624.45,17768.07,78392.52
312015,202011,75,56,19,58521.79,19855,78376.79
312020,202011,127,85,42,89886.64,43901.44,133788.08
312030,202011,61,45,16,47026.66,16720.5,63747.16
312040,202011,83,51,32,53297.85,33440.98,86738.83
312050,202011,203,113,90,118103.87,94058.61,212162.48
312060,202011,21,12,9,12541.66,10452.33,22993.99
312070,202011,75,48,27,50172.71,28220,78392.71
312080,202011,529,240,289,250834.41,302037.55,552871.96
312083,202011,57,38,19,39713.5,19856.58,59570.08
312087,202011,97,75,22,78384.86,22993.3,101378.16
312090,202011,3180,1885,1295,1971304.7,1353457.61,3324762.31
312100,202011,149,105,44,109510.81,45988.65,155499.46
312110,202011,119,67,52,70034.75,54351.28,124386.03
312120,202011,134,100,34,104514.5,35539.21,140053.71
312125,202011,90,51,39,53300.96,40764.23,94065.19
312130,202011,126,82,44,85708.57,45987.62,131696.19
312140,202011,136,105,31,109743.84,32398.97,142142.81
312150,202011,41,32,9,33442.39,9405,42847.39
312160,202011,1553,1015,538,1061982.88,562317.89,1624300.77
312170,202011,10,8,2,8360.26,2090.51,10450.77
312180,202011,113,69,44,72113.82,45983.81,118097.63
312190,202011,34,30,4,31353.38,4180.44,35533.82
312200,202011,751,640,111,668962.1,116018.23,784980.33
312210,202011,112,60,52,62706.22,55396.64,118102.86
312220,202011,128,98,30,102419.27,31352.21,133771.48
312230,202011,3647,1667,1980,1745563.27,2071397.16,3816960.43
312235,202011,156,104,52,109732.56,54345.68,164078.24
312240,202011,93,67,26,70032.19,27175.11,97207.30
312245,202011,188,128,60,133790.46,62715.23,196505.69
312247,202011,72,50,22,52256.98,22995.47,75252.45
312250,202011,176,84,92,87794.06,96153.88,183947.94
312260,202011,103,67,36,70016.26,37620.55,107636.81
312270,202011,132,77,55,80481.65,57486.62,137968.27
312280,202011,26,14,12,14631.23,12542.21,27173.44
312290,202011,145,104,41,108697.78,42849.6,151547.38
312300,202011,205,132,73,138998.47,76294.88,215293.35
312310,202011,61,54,7,56432.97,7315,63747.97
312320,202011,423,266,157,279041,164083.42,443124.42
312330,202011,89,78,11,81510.88,11495,93005.88
312340,202011,36,17,19,17768.39,19856.83,37625.22
312350,202011,16,9,7,9405.94,7315,16720.94
312352,202011,90,68,22,71063.71,22991,94054.71
312360,202011,579,242,337,252939.84,354291.38,607231.22
312370,202011,320,177,143,184970.99,150485.13,335456.12
312380,202011,137,91,46,96158.59,48080.51,144239.10
312385,202011,162,130,32,135877.26,33445.05,169322.31
312390,202011,294,184,110,192312.26,114973.37,307285.63
312400,202011,381,283,98,295801.83,102431.51,398233.34
312410,202011,1003,313,690,328194.92,721174.75,1049369.67
312420,202011,623,472,151,494394.04,157829.31,652223.35
312430,202011,869,633,236,661629.47,246680.35,908309.82
312440,202011,40,30,10,31350.6,10450,41800.6
312450,202011,206,131,75,136920.7,78389.68,215310.38
312460,202011,31,16,15,16721.62,15676.73,32398.35
312470,202011,44,30,14,31352.56,14630,45982.56
312480,202011,190,117,73,122296.47,76307.44,198603.91
312490,202011,269,186,83,194421.17,86754.24,281175.41
312500,202011,35,20,15,20904.97,15681.51,36586.48
312510,202011,520,200,320,209038.08,334475.28,543513.36
312520,202011,31,9,22,9407.12,22996.31,32403.43
312530,202011,45,31,14,32402.77,14632.09,47034.86
312540,202011,92,81,11,84656.09,11495.34,96151.43
312550,202011,35,28,7,29268.52,7315.37,36583.89
312560,202011,208,157,51,164084.62,53304.96,217389.58
312570,202011,429,252,177,263407.25,185003.18,448410.43
312580,202011,88,46,42,48074.57,43896.76,91971.33
312590,202011,243,194,49,202765.15,51217.1,253982.25
312595,202011,132,116,16,121239.56,16722.04,137961.60
312600,202011,66,36,30,37622.86,31353,68975.86
312610,202011,1588,804,784,840392.79,819391.39,1659784.18
312620,202011,212,152,60,158858.13,62707.48,221565.61
312630,202011,71,58,13,60612.73,14630,75242.73
312640,202011,41,12,29,12540,30306.88,42846.88
312650,202011,147,121,26,126486.37,27176.79,153663.16
312660,202011,90,63,27,66892.7,28218.91,95111.61
312670,202011,927,594,333,620798.21,348021.9,968820.11
312675,202011,28,23,5,24038.45,5225.78,29264.23
312680,202011,74,44,30,45982.45,31350.86,77333.31
312690,202011,244,125,119,130645.79,124366.22,255012.01
312695,202011,27,23,4,24038.53,4180.78,28219.31
312700,202011,225,131,94,136915.93,98244.72,235160.65
312705,202011,82,65,17,67926.8,17767.49,85694.29
312707,202011,129,89,40,93008.94,41801.01,134809.95
312710,202011,1856,990,866,1035736.18,907207.75,1942943.93
312720,202011,57,29,28,30311.67,29266.51,59578.18
312730,202011,283,164,119,173500.88,124378.4,297879.28
312733,202011,47,38,9,39713.11,9407.1,49120.21
312735,202011,22,14,8,14634.36,8362.63,22996.99
312737,202011,63,35,28,36578.4,29262.62,65841.02
312738,202011,59,40,19,41804.9,19857.11,61662.01
312740,202011,83,54,29,56440.95,30309.01,86749.96
312750,202011,89,62,27,64791.93,28215.34,93007.27
312760,202011,289,208,81,217397.07,84662.11,302059.18
312770,202011,8143,3692,4451,3864126.53,4655857.15,8519983.68
312780,202011,441,337,104,352255.35,108705.57,460960.92
312790,202011,22,16,6,16720.44,6270.39,22990.83
312800,202011,1587,1100,487,1150705.33,510040.26,1660745.59
312810,202011,367,235,132,245581.44,137947.72,383529.16
312820,202011,185,143,42,149452.8,43897.61,193350.41
312825,202011,26,17,9,17768.62,9405.4,27174.02
312830,202011,227,129,98,134840.88,102430.67,237271.55
312840,202011,156,104,52,108693.15,54345.76,163038.91
312850,202011,45,39,6,40758.81,6270.44,47029.25
312860,202011,154,95,59,99283.56,61660.67,160944.23
312870,202011,1061,549,512,574850.84,536117.06,1110967.90
312880,202011,123,87,36,90930.79,37626.53,128557.32
312890,202011,154,109,45,113937.81,47035.8,160973.61
312900,202011,191,144,47,150520.97,49129.14,199650.11
312910,202011,174,92,82,96163.29,85716.26,181879.55
312920,202011,147,84,63,87796.5,65845.4,153641.9
312930,202011,326,226,100,236228.96,104524.37,340753.33
312940,202011,121,83,38,86739.49,39711.98,126451.47
312950,202011,692,471,221,492283.07,230990.78,723273.85
312960,202011,161,120,41,125427.77,42854.9,168282.67
312965,202011,77,65,12,67933.07,12540.78,80473.85
312970,202011,274,226,48,236219.35,50169.33,286388.68
312980,202011,2460,1228,1232,1284583.43,1288685.37,2573268.80
312990,202011,45,24,21,25082.18,21945.39,47027.57
313000,202011,52,26,26,27173.44,27171.78,54345.22
313005,202011,171,133,38,138999.5,39717.33,178716.83
313010,202011,912,355,557,371023.76,582136.31,953160.07
313020,202011,199,104,95,108681.06,99275,207956.06
313030,202011,193,131,62,136915.29,64796.35,201711.64
313040,202011,77,24,53,25083.36,55387.39,80470.75
313050,202011,179,130,49,135862.81,51212.35,187075.16
313055,202011,39,29,10,30305,10450.78,40755.78
313060,202011,131,88,43,91967.51,44939.26,136906.77
313065,202011,63,44,19,45982.2,19858.51,65840.71
313070,202011,137,69,68,72119.84,71075.07,143194.91
313080,202011,38,17,21,17768.29,21947.33,39715.62
313090,202011,660,434,226,453610.06,237256.29,690866.35
313100,202011,187,63,124,65838.7,130636.81,196475.51
313110,202011,136,67,69,70024.41,72117.49,142141.90
313115,202011,209,115,94,120205.49,98248.06,218453.55
313120,202011,834,472,362,493324.61,378338.41,871663.02
313130,202011,5767,3117,2650,3262071.22,2770662.4,6032733.62
313140,202011,141,76,65,79424.33,67930.26,147354.59
313150,202011,308,240,68,250856.2,71071.7,321927.9
313160,202011,187,139,48,145301.21,50178.07,195479.28
313170,202011,1398,935,463,977274.68,483890.86,1461165.54
313180,202011,302,177,125,185012.66,130660.2,315672.86
313190,202011,744,441,303,463032.92,316696.92,779729.84
313200,202011,26,21,5,21948.51,5225.27,27173.78
313210,202011,1001,846,155,885293.76,163049.93,1048343.69
313220,202011,285,175,110,183954.24,114958.88,298913.12
313230,202011,260,197,63,205895.16,65842.96,271738.12
313240,202011,2146,1098,1048,1147589.95,1096284.33,2243874.28
313250,202011,1255,953,302,997179.16,316707.12,1313886.28
313260,202011,93,48,45,50167.83,47029.4,97197.23
313270,202011,990,572,418,597834.51,436873.82,1034708.33
313280,202011,51,43,8,44935.84,8360.67,53296.51
313290,202011,210,168,42,175580.06,43894.68,219474.74
313300,202011,347,182,165,190215.45,172440.27,362655.72
313310,202011,263,123,140,128553.52,146310.58,274864.10
313320,202011,384,283,101,295811.67,105569.91,401381.58
313330,202011,1401,852,549,890481.15,573796.18,1464277.33
313340,202011,326,232,94,242488.97,98252.21,340741.18
313350,202011,495,327,168,341757.3,175582.02,517339.32
313360,202011,140,69,71,73166.98,75253.65,148420.63
313370,202011,221,69,152,72112.06,159896.87,232008.93
313375,202011,291,173,118,180805.33,123324.02,304129.35
313380,202011,1349,701,648,733762.53,678266.14,1412028.67
313390,202011,50,46,4,48071.41,4180,52251.41
313400,202011,398,269,129,281192.01,134844.17,416036.18
313410,202011,24,14,10,14630.67,10450.2,25080.87
313420,202011,4560,2424,2136,2536669,2234468.62,4771137.62
313430,202011,142,68,74,71074.36,78390.09,149464.45
313440,202011,1407,959,448,1003419.25,468262.53,1471681.78
313450,202011,68,27,41,28215.34,42845.47,71060.81
313460,202011,386,170,216,177697.8,225771.6,403469.4
313470,202011,528,246,282,257140.81,294772.74,551913.55
313480,202011,147,107,40,111833.97,41805.54,153639.51
313490,202011,519,238,281,248761.43,294760.94,543522.37
313500,202011,26,14,12,14630.91,12541.01,27171.92
313505,202011,1021,799,222,835112.71,232031.12,1067143.83
313507,202011,101,60,41,62712.79,42851.58,105564.37
313510,202011,2834,1775,1059,1857263.07,1108944.27,2966207.34
313520,202011,3443,2678,765,2800137.82,800603.79,3600741.61
313530,202011,33,21,12,21951.13,12540.78,34491.91
313535,202011,60,47,13,49125.62,13587.24,62712.86
313540,202011,69,51,18,53300.95,18811.64,72112.59
313545,202011,110,92,18,96165.63,18813.36,114978.99
313550,202011,227,192,35,200694.79,36582.07,237276.86
313560,202011,341,163,178,170382.58,186064.58,356447.16
313570,202011,62,23,39,24039.15,40758.6,64797.75
313580,202011,1321,733,588,767133.53,614555.12,1381688.65
313590,202011,70,39,31,40765.27,32402.66,73167.93
313600,202011,672,405,267,423277.5,279055.61,702333.11
313610,202011,61,47,14,49119.6,14632.27,63751.87
313620,202011,1393,693,700,724340.47,733660.15,1458000.62
313630,202011,1610,1213,397,1268942.41,415973.49,1684915.90
313640,202011,120,73,47,76290.03,49119.21,125409.24
313650,202011,233,106,127,110792,132743.96,243535.96
313652,202011,16,16,0,16720.67,0,16720.67
313655,202011,69,46,23,48077.57,24039.15,72116.72
313657,202011,45,42,3,43901,3135.94,47036.94
313660,202011,132,89,43,93027.95,44961.24,137989.19
313665,202011,639,289,350,302071.59,365826.63,667898.22
313670,202011,10284,6969,3315,7291516.78,3466867.46,10758384.24
313680,202011,41,32,9,33445.7,9406.16,42851.86
313690,202011,141,107,34,111841.29,35533.78,147375.07
313695,202011,63,46,17,48077.99,17768.98,65846.97
313700,202011,313,252,61,263408.91,63752.94,327161.85
313710,202011,133,97,36,101387.32,37628.73,139016.05
313720,202011,1115,516,599,539340.04,626074.76,1165414.80
313730,202011,75,44,31,45986.53,32403.08,78389.61
313740,202011,149,120,29,125425.75,30309.31,155735.06
313750,202011,424,305,119,319829.29,124372.5,444201.79
313753,202011,231,172,59,179760.83,61667.92,241428.75
313760,202011,1322,480,842,502746.67,880081.34,1382828.01
313770,202011,380,272,108,284287.39,112886.15,397173.54
313780,202011,777,404,373,423271.14,390862.3,814133.44
313790,202011,28,27,1,28216.5,1045,29261.5
313800,202011,137,83,54,86754.61,56442.85,143197.46
313810,202011,76,43,33,44937.85,34486.08,79423.93
313820,202011,1312,614,698,641771.63,730516.07,1372287.70
313830,202011,58,42,16,43896.56,16723.58,60620.14
313835,202011,59,49,10,51207.23,11495.8,62703.03
313840,202011,1651,981,670,1026351.62,701279.25,1727630.87
313850,202011,205,75,130,78382.15,135873.25,214255.40
313860,202011,468,355,113,371056.93,118103.81,489160.74
313862,202011,159,105,54,110801.65,56450.28,167251.93
313865,202011,119,89,30,93007.04,31350.74,124357.78
313867,202011,51,40,11,41802.24,11495,53297.24
313868,202011,33,19,14,19858.04,14630.67,34488.71
313870,202011,115,61,54,63764.08,56442.76,120206.84
313880,202011,381,232,149,242476.27,155729.22,398205.49
313890,202011,327,170,157,177670.62,165127.64,342798.26
313900,202011,872,472,400,494360.74,418056.06,912416.80
313910,202011,147,104,43,108699.73,44941.74,153641.47
313920,202011,635,442,193,463010.91,201726.61,664737.52
313925,202011,33,28,5,29261.85,5225.03,34486.88
313930,202011,851,658,193,687784.52,201729.32,889513.84
313940,202011,1871,1150,721,1201958.77,753561.63,1955520.40
313950,202011,866,541,325,565425.81,339660.53,905086.34
313960,202011,1408,802,606,838203.8,633364.94,1471568.74
313970,202011,170,108,62,112862.57,64790.4,177652.97
313980,202011,201,129,72,135867.48,76304.12,212171.60
313990,202011,238,157,81,164091.81,84652.12,248743.93
314000,202011,891,588,303,614579.69,316698.41,931278.10
314010,202011,83,47,36,49122.66,37626.94,86749.60
314015,202011,61,15,46,15678.03,48087.2,63765.23
314020,202011,53,33,20,34492.12,20904.41,55396.53
314030,202011,76,35,41,36576.56,42845.67,79422.23
314040,202011,45,26,19,27175.69,19855.93,47031.62
314050,202011,286,169,117,176628.99,122273.78,298902.77
314053,202011,99,63,36,65845.01,37624.27,103469.28
314055,202011,300,186,114,194393.73,119150.61,313544.34
314060,202011,130,113,17,118094.96,17766.71,135861.67
314070,202011,1045,530,515,554998.96,538276.92,1093275.88
314080,202011,208,132,76,137972.96,79431.45,217404.41
314085,202011,145,97,48,101367.98,50160.67,151528.65
314090,202011,377,268,109,280100.14,113924.32,394024.46
314100,202011,508,409,99,427470.09,103468.76,530938.85
314110,202011,791,387,404,405525.41,422253.67,827779.08
314120,202011,72,44,28,45984.45,29261.97,75246.42
314130,202011,20,11,9,11495.73,9405,20900.73
314140,202011,1114,684,430,714899.59,449421.44,1164321.03
314150,202011,186,120,66,125418.76,68985.72,194404.48
314160,202011,330,249,81,260247.42,84658.71,344906.13
314170,202011,82,63,19,65848.41,19857.57,85705.98
314180,202011,730,644,86,673172.07,89894.27,763066.34
314190,202011,100,59,41,61670.53,42853.37,104523.90
314200,202011,498,339,159,354336.69,166191.04,520527.73
314210,202011,249,190,59,198585.02,61667.44,260252.46
314220,202011,301,221,80,230988.29,83612.31,314600.60
314225,202011,59,42,17,43904.7,17770.83,61675.53
314230,202011,117,52,65,54347.64,67929.29,122276.93
314240,202011,149,108,41,112885.61,42853.29,155738.90
314250,202011,52,29,23,30309.67,24037.75,54347.42
314260,202011,212,105,107,109737.3,111823.13,221560.43
314270,202011,373,289,84,302085.72,87797.92,389883.64
314280,202011,701,379,322,397118.58,336550.8,733669.38
314290,202011,539,431,108,450500.07,112882.19,563382.26
314300,202011,354,258,96,269685.58,100345.4,370030.98
314310,202011,1362,926,436,968155.61,455668.46,1423824.07
314315,202011,33,26,7,27170.2,7315,34485.2
314320,202011,590,391,199,408676.96,207993.61,616670.57
314330,202011,11108,5387,5721,5633924.76,5985493.29,11619418.05
314340,202011,603,271,332,283245.84,346990.47,630236.31
314345,202011,48,33,15,34488.98,15675,50163.98
314350,202011,183,114,69,119152.32,72111.25,191263.57
314360,202011,58,35,23,36585.69,24040.8,60626.49
314370,202011,64,42,22,43892.02,22992.04,66884.06
314380,202011,94,60,34,62703.78,35532.2,98235.98
314390,202011,3334,2121,1213,2220012.25,1268742.45,3488754.70
314400,202011,692,488,204,510087.35,213242.23,723329.58
314410,202011,485,315,170,329216.14,177664.84,506880.98
314420,202011,14,8,6,8360.84,7317.26,15678.10
314430,202011,2420,882,1538,921834.56,1608513.45,2530348.01
314435,202011,182,106,76,110780.81,79429.28,190210.09
314437,202011,28,21,7,21947.12,7315.43,29262.55
314440,202011,96,68,28,71071.24,29264.35,100335.59
314450,202011,159,110,49,114973.07,51213.54,166186.61
314460,202011,637,302,335,315640.41,350125.03,665765.44
314465,202011,95,61,34,63749.86,35533.38,99283.24
314467,202011,69,56,13,58524.43,13586.86,72111.29
314470,202011,414,206,208,215313.85,217401.75,432715.60
314480,202011,1042,484,558,505901.34,583186.03,1089087.37
314490,202011,45,30,15,31352.68,15678.97,47031.65
314500,202011,277,194,83,202765.83,86755.7,289521.53
314505,202011,110,69,41,72116.76,42848.11,114964.87
314510,202011,246,201,45,210106.27,47030.31,257136.58
314520,202011,1298,689,609,720168.23,636565.4,1356733.63
314530,202011,735,589,146,617770.46,153655.34,771425.80
314535,202011,166,97,69,101367.33,72106.22,173473.55
314537,202011,62,37,25,38673.12,26129.63,64802.75
314540,202011,16,10,6,10450.2,6271.15,16721.35
314545,202011,50,32,18,33443.17,18812.38,52255.55
314550,202011,81,41,40,42854.07,41810.98,84665.05
314560,202011,850,460,390,481801.05,407610.69,889411.74
314570,202011,21,16,5,16724.79,5225.43,21950.22
314580,202011,14,5,9,5225,9407.12,14632.12
314585,202011,26,17,9,17769.61,9405.86,27175.47
314587,202011,83,69,14,72115.18,14631.54,86746.72
314590,202011,552,391,161,408666.88,168274.44,576941.32
314600,202011,941,601,340,628152.09,355357.97,983510.06
314610,202011,940,485,455,507959.5,476616.17,984575.67
314620,202011,133,99,34,103455.77,36575.91,140031.68
314625,202011,98,71,27,74203.38,28217.08,102420.46
314630,202011,1172,621,551,649097.32,575913.69,1225011.01
314640,202011,81,52,29,54350.11,30309.58,84659.69
314650,202011,179,102,77,106615.22,80479.34,187094.56
314655,202011,61,45,16,47026.62,16722.62,63749.24
314660,202011,16,13,3,13587.1,3136.46,16723.56
314670,202011,199,152,47,158875.44,49127.21,208002.65
314675,202011,208,122,86,127515.15,89887.79,217402.94
314690,202011,595,313,282,327120.77,294725.92,621846.69
314700,202011,2258,1209,1049,1264750.13,1096450.18,2361200.31
314710,202011,1708,966,742,1009655.16,775443.3,1785098.46
314720,202011,389,230,159,240389.88,166173.68,406563.56
314730,202011,511,266,245,279051.61,258140.91,537192.52
314740,202011,725,343,382,358483.82,399250.1,757733.92
314750,202011,17,14,3,14630.83,3135,17765.83
314760,202011,346,153,193,160957.57,201726.32,362683.89
314770,202011,106,72,34,76306.74,35539.75,111846.49
314780,202011,21,8,13,8361.73,13588.34,21950.07
314790,202011,2390,1500,890,1569873.47,931146.43,2501019.90
314795,202011,46,36,10,37620.29,10451.47,48071.76
314800,202011,2925,1701,1224,1777918.97,1279238.5,3057157.47
314810,202011,1508,852,656,891593.57,685637.59,1577231.16
314820,202011,105,57,48,59573.3,50164.52,109737.82
314830,202011,211,169,42,176644.71,43898.81,220543.52
314840,202011,87,54,33,56432.95,34490.67,90923.62
314850,202011,397,195,202,203786.49,211095.17,414881.66
314860,202011,664,507,157,529898.97,164087.1,693986.07
314870,202011,1530,796,734,832993.86,768217.53,1601211.39
314875,202011,52,47,5,49117.56,5225.62,54343.18
314880,202011,44,30,14,31353.25,14632.44,45985.69
314890,202011,53,31,22,32400.77,22995.19,55395.96
314900,202011,30,23,7,24039.84,7316.27,31356.11
314910,202011,243,158,85,165143.96,88833.2,253977.16
314915,202011,135,122,13,127508.03,13587.34,141095.37
314920,202011,104,65,39,67940.86,40765.06,108705.92
314930,202011,1052,510,542,533085.15,566477.54,1099562.69
314940,202011,48,38,10,39715.95,10452.02,50167.97
314950,202011,31,22,9,22994.22,9406.49,32400.71
314960,202011,31,23,8,24042.86,8361.12,32403.98
314970,202011,148,72,76,75260.09,79441.18,154701.27
314980,202011,307,196,111,204861.25,116014.35,320875.60
314990,202011,434,234,200,244566.06,210067.77,454633.83
314995,202011,158,64,94,66882.21,98234.2,165116.41
315000,202011,79,59,20,61670.66,20903.79,82574.45
315010,202011,43,28,15,29263.86,15677.82,44941.68
315015,202011,165,131,34,136910.04,35531.38,172441.42
315020,202011,68,57,11,59567.53,11495.56,71063.09
315030,202011,106,81,25,84658.77,26126.91,110785.68
315040,202011,72,48,24,50162.1,25081.01,75243.11
315050,202011,184,107,77,111826.9,80471.47,192298.37
315053,202011,45,34,11,35531.7,11495,47026.7
315057,202011,102,79,23,82558.77,25081.01,107639.78
315060,202011,76,63,13,65856.67,13587.54,79444.21
315070,202011,104,59,45,61661.39,47028.58,108689.97
315080,202011,378,301,77,314633.08,81524.61,396157.69
315090,202011,92,54,38,56440.2,39712.76,96152.96
315100,202011,79,39,40,40760.86,41805.6,82566.46
315110,202011,269,144,125,150498.48,131683.79,282182.27
315120,202011,1727,833,894,870646.71,935457.27,1806103.98
315130,202011,344,249,95,260253.75,99295.35,359549.10
315140,202011,528,295,233,308326.91,243518.08,551844.99
315150,202011,976,461,515,481831.62,539307.54,1021139.16
315160,202011,214,105,109,109758.42,113932.58,223691.00
315170,202011,316,209,107,218444.53,111838.35,330282.88
315180,202011,3237,1342,1895,1405782.1,1986742.27,3392524.37
315190,202011,313,188,125,196510.27,130656.6,327166.87
315200,202011,1222,720,502,752505.04,524692.85,1277197.89
315210,202011,1656,942,714,986687.75,747248.02,1733935.77
315213,202011,29,17,12,17769.9,12545.08,30314.98
315217,202011,199,155,44,161983.7,45984.4,207968.1
315220,202011,1578,1181,397,1234394.22,414955.17,1649349.39
315230,202011,169,122,47,127504.46,49121.11,176625.57
315240,202011,421,270,151,282227.03,157841.36,440068.39
315250,202011,2569,1244,1325,1303336.8,1384756.97,2688093.77
315260,202011,145,82,63,85697.93,65838.51,151536.44
315270,202011,129,89,40,94060.74,41802.15,135862.89
315280,202011,642,413,229,431686.76,240421.62,672108.38
315290,202011,187,117,70,123314.28,73151.28,196465.56
315300,202011,80,58,22,60613.55,22993.35,83606.90
315310,202011,74,66,8,68970.52,8360.67,77331.19
315320,202011,158,93,65,97215.71,67937.54,165153.25
315330,202011,55,45,10,47025.71,10450.11,57475.82
315340,202011,386,280,106,292651.59,110788.02,403439.61
315350,202011,153,92,61,96150.41,63758.07,159908.48
315360,202011,85,39,46,40758.24,48072.7,88830.94
315370,202011,54,34,20,35534.18,20901.32,56435.50
315380,202011,8,8,0,8360.65,0,8360.65
315390,202011,63,18,45,18813.13,48087.33,66900.46
315400,202011,832,618,214,645904.86,224707.05,870611.91
315410,202011,332,196,136,204867.4,142150.61,347018.01
315415,202011,56,42,14,43900.96,14633.25,58534.21
315420,202011,197,143,54,149461.69,56435.21,205896.90
315430,202011,658,376,282,393005.48,295784.85,688790.33
315440,202011,95,65,30,67930.1,31352.33,99282.43
315445,202011,235,194,41,202792.87,42857.56,245650.43
315450,202011,180,135,45,141079.62,47027.07,188106.69
315460,202011,4074,1948,2126,2037175.62,2224176.55,4261352.17
315470,202011,40,16,24,16722.32,25082.6,41804.92
315480,202011,69,20,49,20903.56,51215.24,72118.80
315490,202011,687,415,272,433708.32,284267.8,717976.12
315500,202011,16,12,4,12542.47,4180.44,16722.91
315510,202011,148,99,49,103468.98,51213.46,154682.44
315520,202011,73,63,10,65837.59,10450,76287.59
315530,202011,45,24,21,25080.76,21945,47025.76
315540,202011,245,168,77,175581.66,80469.52,256051.18
315550,202011,182,145,37,151553.62,38670.76,190224.38
315560,202011,739,591,148,618803.86,154706.39,773510.25
315570,202011,312,155,157,162012.98,164101.41,326114.39
315580,202011,710,479,231,500623.91,241437.39,742061.30
315590,202011,197,100,97,104532.23,101391.64,205923.87
315600,202011,297,224,73,234128.23,76304.75,310432.98
315610,202011,102,52,50,54340.93,52250.9,106591.83
315620,202011,36,28,8,29266.05,8362.75,37628.80
315630,202011,128,85,43,88840.76,44940.37,133781.13
315640,202011,76,44,32,45981.38,33441.54,79422.92
315645,202011,46,31,15,32399.94,15677.92,48077.86
315650,202011,171,122,49,127518.56,51218.59,178737.15
315660,202011,456,199,257,209052.84,268611.49,477664.33
315670,202011,2382,1129,1253,1182214.16,1310751.63,2492965.79
315680,202011,828,585,243,611395.34,253964.64,865359.98
315690,202011,665,458,207,478703.14,216362.21,695065.35
315700,202011,1902,993,909,1037934.34,951210.6,1989144.94
315710,202011,352,103,249,107641.4,260219.73,367861.13
315720,202011,454,279,175,291605.37,182902.63,474508.00
315725,202011,185,148,37,154680.92,38669.83,193350.75
315727,202011,51,22,29,22996.87,31362.14,54359.01
315730,202011,44,41,3,42848.4,3135.4,45983.8
315733,202011,88,59,29,61662.82,30305.87,91968.69
315737,202011,50,37,13,38674.49,13586.73,52261.22
315740,202011,32,25,7,26126.83,7315.11,33441.94
315750,202011,158,117,41,122298.85,42857.43,165156.28
315760,202011,38,28,10,29261.98,10450.97,39712.95
315765,202011,116,67,49,70032.11,51216.36,121248.47
315770,202011,223,140,83,146319.09,86744.32,233063.41
315780,202011,3513,1738,1775,1819713.6,1856120.13,3675833.73
315790,202011,234,182,52,190222.68,54346.08,244568.76
315800,202011,300,206,94,216357.46,98249.72,314607.18
315810,202011,92,56,36,58528.87,37625.75,96154.62
315820,202011,749,542,207,567577.27,217408.57,784985.84
315830,202011,124,80,44,83614.18,45989.4,129603.58
315840,202011,86,56,30,58520.89,31351.04,89871.93
315850,202011,259,182,77,190237.33,81536.09,271773.42
315860,202011,15,6,9,6270.88,9405.34,15676.22
315870,202011,39,30,9,31354.58,9407.79,40762.37
315880,202011,104,66,38,68979.63,39717.44,108697.07
315890,202011,87,65,22,67930.12,22992.83,90922.95
315895,202011,423,275,148,287448.91,154692.9,442141.81
315900,202011,67,31,36,32399.71,37623.07,70022.78
315910,202011,41,24,17,25081.13,17765,42846.13
315920,202011,160,107,53,111840.43,55391.75,167232.18
315930,202011,53,19,34,19855.14,35537.69,55392.83
315935,202011,130,102,28,106609.31,29265.17,135874.48
315940,202011,101,74,27,77338.26,28217.54,105555.80
315950,202011,36,29,7,30308.79,7316.23,37625.02
315960,202011,534,253,281,264422.57,293687,558109.57
315970,202011,35,28,7,29264.07,7315,36579.07
315980,202011,669,333,336,348042.11,351172.46,699214.57
315990,202011,254,147,107,153651.41,111836.89,265488.30
316000,202011,47,30,17,31354.73,17766.24,49120.97
316010,202011,77,66,11,68982.99,11498.61,80481.60
316020,202011,116,99,17,103459.18,17765,121224.18
316030,202011,378,209,169,218464.09,176640.89,395104.98
316040,202011,526,216,310,225755.29,323999.49,549754.78
316045,202011,51,45,6,47026.78,6270.94,53297.72
316050,202011,17,13,4,13585.8,4180,17765.8
316060,202011,94,62,32,65841.65,33444.45,99286.10
316070,202011,1082,690,392,721142.51,410743.6,1131886.11
316080,202011,96,64,32,66976.73,33440.47,100417.20
316090,202011,42,21,21,21945.95,21947.58,43893.53
316095,202011,97,77,20,80475.32,20903.26,101378.58
316100,202011,311,176,135,183945.06,141091,325036.06
316105,202011,40,25,15,26129.85,15677.39,41807.24
316110,202011,1869,1475,394,1543782.42,412867.86,1956650.28
316120,202011,79,56,23,58528.09,24035.93,82564.02
316130,202011,124,91,33,95116.55,34493.27,129609.82
316140,202011,30,19,11,19855.2,11496.45,31351.65
316150,202011,205,142,63,148407.46,65843.85,214251.31
316160,202011,79,45,34,47036.46,35541.77,82578.23
316165,202011,65,46,19,48076.86,19857.81,67934.67
316170,202011,184,121,63,126469.36,65849.28,192318.64
316180,202011,200,84,116,88841.83,121236.5,210078.33
316190,202011,133,96,37,100330.94,38667.2,138998.14
316200,202011,666,363,303,379386.31,316668.78,696055.09
316210,202011,777,512,265,536358,276977.32,813335.32
316220,202011,121,80,41,83602.77,42848.35,126451.12
316225,202011,28,15,13,15677.71,13587.2,29264.91
316230,202011,35,20,15,20902.44,15675,36577.44
316240,202011,649,520,129,543511.74,134831.77,678343.51
316245,202011,127,109,18,113928.04,18811.93,132739.97
316250,202011,1525,1030,495,1076561.24,518361.58,1594922.82
316255,202011,122,96,26,100337.34,27173.41,127510.75
316257,202011,179,93,86,97198.69,89897.54,187096.23
316260,202011,196,137,59,143195.64,61668.79,204864.43
316265,202011,27,18,9,18814.23,9408.59,28222.82
316270,202011,683,478,205,500678.54,214286.23,714964.77
316280,202011,542,334,208,349114.05,218450.53,567564.58
316290,202011,750,492,258,514203.32,269646.94,783850.26
316292,202011,514,200,314,209046.1,328199.25,537245.35
316294,202011,100,61,39,63760.13,40765.4,104525.53
316295,202011,308,131,177,136917.6,184994.52,321912.12
316300,202011,112,73,39,76287.09,40755.2,117042.29
316310,202011,28,14,14,14630.34,14631.58,29261.92
316320,202011,51,26,25,27172.08,26126.43,53298.51
316330,202011,164,111,53,117061.52,55394.68,172456.20
316340,202011,133,88,45,91963.11,47028.83,138991.94
316350,202011,195,137,58,143187.83,60619.87,203807.70
316360,202011,24,15,9,15676.76,9406.51,25083.27
316370,202011,1127,565,562,590525.15,587371.88,1177897.03
316380,202011,119,87,32,90931.47,33449.24,124380.71
316390,202011,113,81,32,84661.33,33446.81,118108.14
316400,202011,133,103,30,107664.57,31357.86,139022.43
316410,202011,304,220,84,229915.05,87785.87,317700.92
316420,202011,201,134,67,140053.7,70029.47,210083.17
316430,202011,153,81,72,84652.45,75241.69,159894.14
316440,202011,88,42,46,43903.04,48081.38,91984.42
316443,202011,40,38,2,39717.06,2090,41807.06
316447,202011,52,40,12,41803.57,12540.91,54344.48
316450,202011,222,169,53,176628.94,55394.29,232023.23
316460,202011,77,26,51,27172.48,53300.37,80472.85
316470,202011,1668,1216,452,1272012.83,472377.93,1744390.76
316480,202011,11,8,3,8360.4,3135,11495.4
316490,202011,19,6,13,6270.2,13585.88,19856.08
316500,202011,151,102,49,106614.45,51211.28,157825.73
316510,202011,153,116,37,121240.06,38669.87,159909.93
316520,202011,191,116,75,121230.51,78388.13,199618.64
316530,202011,162,104,58,108714.04,60625.2,169339.24
316540,202011,143,74,69,77349.06,72112.82,149461.88
316550,202011,137,87,50,90930.84,52256.04,143186.88
316553,202011,298,134,164,140045.2,172445.53,312490.73
316555,202011,43,38,5,39715.12,5225.44,44940.56
316556,202011,12,9,3,9407.08,3135.44,12542.52
316557,202011,23,19,4,19855.91,4180,24035.91
316560,202011,66,46,20,48072.13,20901.46,68973.59
316570,202011,216,196,20,204870.68,20904.36,225775.04
316580,202011,20,14,6,14631.81,6270.61,20902.42
316590,202011,100,83,17,86747.92,17768.2,104516.12
316600,202011,174,142,32,148404.99,33441.61,181846.60
316610,202011,66,49,17,51208.67,17765,68973.67
316620,202011,137,102,35,106600.49,36578.52,143179.01
316630,202011,40,31,9,32398.98,9405.55,41804.53
316640,202011,22,14,8,14630,8360,22990
316650,202011,70,57,13,59565,13585,73150
316660,202011,8,3,5,3135,5226.14,8361.14
316670,202011,440,150,290,156774.53,303095.31,459869.84
316680,202011,158,110,48,116014.04,50168.04,166182.08
316690,202011,184,114,70,119141.9,74197.79,193339.69
316695,202011,62,52,10,54340.82,10450.45,64791.27
316700,202011,17,11,6,11496.24,6270.11,17766.35
316710,202011,773,577,196,603068.08,204857.32,807925.40
316720,202011,5016,2423,2593,2534584.59,2713046.84,5247631.43
316730,202011,17,16,1,16725.79,1045,17770.79
316740,202011,139,89,50,93012.84,52255.33,145268.17
316750,202011,17,10,7,10452.5,7315.95,17768.45
316760,202011,324,259,65,270725.32,67936.74,338662.06
316770,202011,154,82,72,85694.76,75245.87,160940.63
316780,202011,66,41,25,42850.81,26127.93,68978.74
316790,202011,55,39,16,40757.87,16721.52,57479.39
316800,202011,1757,1093,664,1143441.16,695087.47,1838528.63
316805,202011,24,18,6,18811.81,6270.67,25082.48
316810,202011,65,40,25,41812.23,26132.27,67944.50
316820,202011,41,21,20,21946.65,20900.78,42847.43
316830,202011,98,43,55,44945.11,57493.03,102438.14
316840,202011,524,303,221,316702.32,230987.22,547689.54
316850,202011,328,221,107,230987.06,111833.59,342820.65
316860,202011,5916,2603,3313,2720727.93,3463552.75,6184280.68
316870,202011,1528,971,557,1015977.63,582122.3,1598099.93
316880,202011,128,61,67,63755.46,70023.33,133778.79
316890,202011,238,163,75,170368.91,78395.01,248763.92
316900,202011,416,290,126,303079.65,131685.13,434764.78
316905,202011,20,10,10,10451.87,10450.94,20902.81
316910,202011,70,29,41,30308.05,42847.12,73155.17
316920,202011,140,109,31,113923.29,32399.48,146322.77
316930,202011,1893,964,929,1007517.24,970892.73,1978409.97
316935,202011,910,546,364,570653.3,381483.38,952136.68
316940,202011,1096,618,478,646948.25,499587.17,1146535.42
316950,202011,179,87,92,90935.26,96162.31,187097.57
316960,202011,1094,606,488,634423.73,512147.25,1146570.98
316970,202011,654,515,139,538281.53,145292.13,683573.66
316980,202011,73,40,33,41804.64,34487.87,76292.51
316990,202011,2149,1427,722,1493506.81,755643.49,2249150.30
317000,202011,332,254,78,265492.95,82570.36,348063.31
317005,202011,235,164,71,171416.24,74209.05,245625.29
317010,202011,6373,3506,2867,3666649.26,3000686.62,6667335.88
317020,202011,15949,6976,8973,7295561.63,9385317.24,16680878.87
317030,202011,82,31,51,32399.77,53299.42,85699.19
317040,202011,3040,1898,1142,1984819.01,1194687.31,3179506.32
317043,202011,71,51,20,54357.49,20906.35,75263.84
317047,202011,35,18,17,18810.93,17766.18,36577.11
317050,202011,157,121,36,126465.01,37627.02,164092.03
317052,202011,134,102,32,106606.43,33441.56,140047.99
317057,202011,169,130,39,136907.61,40757.36,177664.97
317060,202011,62,38,24,39711.53,25082.19,64793.72
317065,202011,50,39,11,40759.13,11495.32,52254.45
317070,202011,1960,902,1058,943838.55,1106753.38,2050591.93
317075,202011,101,54,47,56437.66,49119.52,105557.18
317080,202011,905,463,442,483940.12,463002.96,946943.08
317090,202011,665,522,143,545603.12,149457.72,695060.84
317100,202011,420,316,104,330263.61,109743.57,440007.18
317103,202011,103,82,21,85696.74,21946.76,107643.50
317107,202011,44,38,6,39710.92,6270,45980.92
317110,202011,116,51,65,53309.24,67942.82,121252.06
317115,202011,40,36,4,37623.39,4180.34,41803.73
317120,202011,1930,919,1011,961623.56,1057789.05,2019412.61
317130,202011,1950,1296,654,1354582.4,683496.07,2038078.47
317140,202011,9,8,1,8360.7,1045,9405.7
317150,202011,263,156,107,163038.25,111820.37,274858.62
317160,202011,314,236,78,246675.81,81525.94,328201.75
317170,202011,217,147,70,153641.47,73155.59,226797.06
317180,202011,443,301,142,314599.62,148410.39,463010.01
317190,202011,264,186,78,194389.88,81516.39,275906.27
317200,202011,821,571,250,596795.85,262358.23,859154.08
317210,202011,184,101,83,105560.06,86745.03,192305.09
317220,202011,24,13,11,13587.53,11496.95,25084.48
320010,202011,604,433,171,452617.42,179790.55,632407.97
320013,202011,122,86,36,89894.6,37629.77,127524.37
320016,202011,262,165,97,172472.96,101386.03,273858.99
320020,202011,712,415,297,433776.79,311496.51,745273.30
320030,202011,152,107,45,111840.54,47033.32,158873.86
320035,202011,139,100,39,104517.65,40761.4,145279.05
320040,202011,493,249,244,260264.76,255043.74,515308.50
320050,202011,105,76,29,79448.57,30318.16,109766.73
320060,202011,1680,788,892,825772.54,932398.99,1758171.53
320070,202011,97,60,37,62716.34,38670.51,101386.85
320080,202011,799,459,340,479798.1,355403.29,835201.39
320090,202011,1250,827,423,865447.72,442136.52,1307584.24
320100,202011,325,187,138,195472.64,144256.94,339729.58
320110,202011,126,80,46,83626.11,48085.75,131711.86
320115,202011,112,92,20,96164.3,20905.39,117069.69
320120,202011,3525,1861,1664,1946177.12,1740261.03,3686438.15
320130,202011,7460,3362,4098,3518359.68,4289762.18,7808121.86
320140,202011,438,288,150,302080.29,156788.97,458869.26
320150,202011,2055,1154,901,1206201,944912.78,2151113.78
320160,202011,660,294,366,307294.86,382534.67,689829.53
320170,202011,111,87,24,90937.67,25088.38,116026.05
320180,202011,56,32,24,33447.3,25089.23,58536.53
320190,202011,240,153,87,160976.88,90938.03,251914.91
320200,202011,57,42,15,43901.14,15678.56,59579.70
320210,202011,901,492,409,514274.68,428566.6,942841.28
320220,202011,294,102,192,106609.01,201708.38,308317.39
320225,202011,84,66,18,68989.58,18815.25,87804.83
320230,202011,621,386,235,403499.29,245635.79,649135.08
320240,202011,3325,1582,1743,1655599.29,1821836.87,3477436.16
320245,202011,473,320,153,334486.34,159921.55,494407.89
320250,202011,223,113,110,119163.89,114985.16,234149.05
320255,202011,136,105,31,109754.41,32405.91,142160.32
320260,202011,223,141,82,147373.3,85704.94,233078.24
320265,202011,154,117,37,122289.67,38672.01,160961.68
320270,202011,152,119,33,124393.63,34495.44,158889.07
320280,202011,1116,629,487,657442.37,509017.09,1166459.46
320290,202011,56,48,8,50178,8362.86,58540.86
320300,202011,586,404,182,422278.81,190232.84,612511.65
320305,202011,673,355,318,371074.63,332393.98,703468.61
320310,202011,197,111,86,116022.9,89887.2,205910.1
320313,202011,337,160,177,167240.27,185015.23,352255.50
320316,202011,109,83,26,86762.3,27176.86,113939.16
320320,202011,3396,1511,1885,1580427.29,1971327.86,3551755.15
320330,202011,260,194,66,202745.41,68978.26,271723.67
320332,202011,760,460,300,481900.71,314643.94,796544.65
320334,202011,241,141,100,147383.45,104521.63,251905.08
320335,202011,150,101,49,105580.94,51222.48,156803.42
320340,202011,556,384,172,402438.37,179787.92,582226.29
320350,202011,1015,429,586,448403.33,612517.65,1060920.98
320360,202011,164,88,76,91975.38,79429.37,171404.75
320370,202011,241,178,63,186051.65,65847.02,251898.67
320380,202011,282,194,88,202772.78,91971.44,294744.22
320390,202011,1157,689,468,722288.33,489187.7,1211476.03
320400,202011,312,226,86,236241.12,89895.23,326136.35
320405,202011,951,390,561,407662.47,586401.71,994064.18
320410,202011,956,487,469,509051.26,491264.56,1000315.82
320420,202011,509,242,267,252954.71,279085.9,532040.61
320425,202011,188,100,88,104519.25,91974.76,196494.01
320430,202011,398,214,184,224736.4,192332.96,417069.36
320435,202011,159,105,54,109752.85,56443.23,166196.08
320440,202011,195,111,84,117077.57,87811.08,204888.65
320450,202011,129,70,59,73177.39,61671.32,134848.71
320455,202011,251,204,47,213244.29,49131.21,262375.50
320460,202011,276,166,110,173508.12,114975.37,288483.49
320465,202011,114,77,37,80482.18,38675.09,119157.27
320470,202011,696,417,279,435867.71,291635.95,727503.66
320480,202011,199,128,71,133787.74,74211.27,207999.01
320490,202011,3085,1510,1575,1579364.6,1646285.97,3225650.57
320495,202011,112,69,43,72119.55,44949.94,117069.49
320500,202011,9603,4664,4939,4881503.72,5169982.19,10051485.91
320501,202011,537,271,266,283274.67,278054.35,561329.02
320503,202011,291,203,88,212197.22,91978.83,304176.05
320506,202011,265,186,79,194402.94,82566.47,276969.41
320510,202011,1047,466,581,487114.58,608342.79,1095457.37
320515,202011,86,65,21,67946.16,21950.88,89897.04
320517,202011,217,152,65,158891.38,67941.32,226832.70
320520,202011,7000,2980,4020,3116897.67,4204009.43,7320907.10
320530,202011,6198,3045,3153,3184205.68,3302935.93,6487141.61
330010,202011,3095,1550,1545,1621183.07,1615926.61,3237109.68
330015,202011,165,68,97,71070.94,101376.85,172447.79
330020,202011,3736,1541,2195,1610710.81,2294317.86,3905028.67
330022,202011,251,128,123,134829.27,129607.71,264436.98
330023,202011,659,215,444,224714.45,464059.54,688773.99
330025,202011,582,110,472,114966.81,494402.29,609369.10
330030,202011,1907,1189,718,1242732.12,750457.97,1993190.09
330040,202011,2444,1228,1216,1283512.61,1270988.6,2554501.21
330045,202011,9067,2724,6343,2847072.59,6636101.97,9483174.56
330050,202011,887,563,324,588444.48,339691.26,928135.74
330060,202011,1016,601,415,628184.79,434797.65,1062982.44
330070,202011,3742,1327,2415,1388044.61,2530522.39,3918567.00
330080,202011,1589,690,899,721201.14,941733.46,1662934.60
330090,202011,390,229,161,239364.73,168281.1,407645.83
330093,202011,260,113,147,118107.99,153641.53,271749.52
330095,202011,76,44,32,45989.77,33444.41,79434.18
330100,202011,9909,4916,4993,5143525.24,5225040.3,10368565.54
330110,202011,472,196,276,205902.62,288475.47,494378.09
330115,202011,523,277,246,290568.78,257120.65,547689.43
330120,202011,383,193,190,201725.46,198591.38,400316.84
330130,202011,1559,380,1179,398236.04,1236628.44,1634864.48
330140,202011,611,319,292,333405.8,305184.96,638590.76
330150,202011,518,295,223,308324.54,233083.04,541407.58
330160,202011,210,123,87,128554.25,91973.87,220528.12
330170,202011,27123,9038,18085,9454290.24,18917106.75,28371396.99
330180,202011,236,139,97,145270.28,101377.99,246648.27
330185,202011,970,342,628,357456.8,657509.02,1014965.82
330187,202011,394,117,277,122285.32,290562.45,412847.77
330190,202011,5837,2202,3635,2307854.98,3803574.01,6111428.99
330200,202011,4714,1393,3321,1459186.84,3474525.83,4933712.67
330205,202011,439,249,190,260252.25,199633.8,459886.05
330210,202011,958,583,375,610397.04,391966.42,1002363.46
330220,202011,2697,1590,1107,1663005.63,1157076.51,2820082.14
330225,202011,569,287,282,299961.06,294750.18,594711.24
330227,202011,2432,725,1707,759848.22,1789479.39,2549327.61
330230,202011,255,144,111,150503.99,116014.57,266518.56
330240,202011,3818,1867,1951,1953569.35,2041363.35,3994932.70
330245,202011,150,65,85,67933.34,88839.86,156773.20
330250,202011,6676,3324,3352,3476539.22,3509890.39,6986429.61
330260,202011,599,152,447,158868.25,467197.84,626066.09
330270,202011,3616,1201,2415,1256388.77,2528462.11,3784850.88
330280,202011,450,286,164,298932.43,171414.4,470346.83
330285,202011,7002,2150,4852,2247403.12,5078170.92,7325574.04
330290,202011,660,236,424,246657.94,444203.39,690861.33
330300,202011,764,492,272,514369.09,285347.71,799716.80
330310,202011,444,243,201,253983.88,210090.19,464074.07
330320,202011,8072,2919,5153,3053287.09,5391651.12,8444938.21
330330,202011,9098,3369,5729,3524481.92,5996372.83,9520854.75
330340,202011,2662,1551,1111,1621120.32,1163289.46,2784409.78
330350,202011,18673,6986,11687,7309304.05,12226002.17,19535306.22
330360,202011,2228,1062,1166,1114258.47,1218798.78,2333057.25
330370,202011,1014,503,511,526791.72,534135.99,1060927.71
330380,202011,903,373,530,389850.3,554996.27,944846.57
330385,202011,635,322,313,336536.55,328169.21,664705.76
330390,202011,5624,2934,2690,3069830.92,2813760.71,5883591.63
330395,202011,310,183,127,191267.54,132731.99,323999.53
330400,202011,717,377,340,395098.55,355359.62,750458.17
330410,202011,507,365,142,381514.93,148430.99,529945.92
330411,202011,259,137,122,143189.05,127508.21,270697.26
330412,202011,235,94,141,99289.67,147365.9,246655.57
330414,202011,5356,2132,3224,2230566.12,3372951.23,5603517.35
330415,202011,608,264,344,276984.3,359554.72,636539.02
330420,202011,2222,1115,1107,1166400.2,1158056.59,2324456.79
330430,202011,1775,792,983,828902.65,1029514.59,1858417.24
330440,202011,294,135,159,141092.01,166177.13,307269.14
330450,202011,120,53,67,55394.11,70027.82,125421.93
330452,202011,2072,893,1179,935459.03,1232277.97,2167737.00
330455,202011,113434,39012,74422,40807155.75,77857489.93,118664645.68
330460,202011,254,110,144,114973.74,150518.27,265492.01
330470,202011,1222,665,557,696100.04,582182.29,1278282.33
330475,202011,1544,408,1136,426447.09,1188416.18,1614863.27
330480,202011,817,430,387,449430.03,405555.64,854985.67
330490,202011,14773,4665,10108,4882207.34,10588893.52,15471100.86
330500,202011,1416,605,811,632366.92,848725.97,1481092.89
330510,202011,10897,3702,7195,3877887.66,7533039.81,11410927.47
330513,202011,97,49,48,51209.95,50162.89,101372.84
330515,202011,799,329,470,343893.28,492342.95,836236.23
330520,202011,2511,872,1639,911473.55,1714237.6,2625711.15
330530,202011,203,113,90,118105.74,94068.56,212174.30
330540,202011,365,180,185,188134.01,193369.7,381503.71
330550,202011,2970,1014,1956,1059868.72,2046571.42,3106440.14
330555,202011,802,312,490,326090.38,512136.51,838226.89
330560,202011,701,226,475,236236.53,496508.63,732745.16
330570,202011,270,195,75,203821.83,78390.6,282212.43
330575,202011,795,283,512,295813.38,535166.2,830979.58
330580,202011,3397,1878,1519,1963925.98,1588743.19,3552669.17
330590,202011,280,145,135,151554.39,142151.3,293705.69
330600,202011,1192,739,453,772416.15,473489.35,1245905.50
330610,202011,1583,845,738,884227.57,771347.96,1655575.53
330615,202011,219,168,51,175593.7,53308.5,228902.2
330620,202011,1087,416,671,434828.3,702446.42,1137274.72
330630,202011,4109,2523,1586,2642209.71,1657619.7,4299829.41
350010,202011,578,381,197,401358.11,209036.58,610394.69
350020,202011,53,21,32,21949.51,33446.1,55395.61
350030,202011,513,318,195,332380.33,205907.69,538288.02
350040,202011,126,52,74,54348.23,77341.95,131690.18
350050,202011,313,164,149,171407.77,155721.17,327128.94
350055,202011,98,49,49,51213.39,51209.86,102423.25
350060,202011,88,32,56,33445.08,58524.72,91969.80
350070,202011,781,456,325,477673.88,339712.54,817386.42
350075,202011,74,48,26,50167.68,27174.51,77342.19
350080,202011,60,27,33,28221.6,34493.75,62715.35
350090,202011,82,47,35,49124.35,36579.68,85704.03
350100,202011,284,174,110,181850.87,114963.37,296814.24
350110,202011,62,44,18,45993.09,18812.88,64805.97
350115,202011,138,88,50,93023.53,52260.23,145283.76
350120,202011,105,66,39,70029.24,40765.09,110794.33
350130,202011,369,162,207,170380.5,216368.36,386748.86
350140,202011,41,25,16,27172.89,16722.77,43895.66
350150,202011,72,56,16,58526.12,16721.71,75247.83
350160,202011,2413,940,1473,982508.73,1543630.74,2526139.47
350170,202011,384,220,164,233079.64,171413.85,404493.49
350180,202011,165,93,72,97197.06,76295.09,173492.15
350190,202011,988,512,476,536241.93,497474.41,1033716.34
350200,202011,68,23,45,24036.57,47027.85,71064.42
350210,202011,1302,720,582,755682.82,610400.28,1366083.10
350220,202011,655,539,116,564394.82,121238.19,685633.01
350230,202011,76,49,27,51210.08,28219.31,79429.39
350240,202011,59,42,17,43898.6,17770.38,61668.98
350250,202011,1168,552,616,576978.28,643874.78,1220853.06
350260,202011,95,68,27,71071.37,28216.76,99288.13
350270,202011,890,594,296,621869.68,309379.21,931248.89
350275,202011,291,122,169,127518.68,176649.49,304168.17
350280,202011,4560,2299,2261,2403981.2,2364025.36,4768006.56
350290,202011,462,206,256,215313.42,267570.49,482883.91
350300,202011,52,26,26,27176.28,27173.67,54349.95
350310,202011,81,51,30,53303.48,31354.21,84657.69
350315,202011,57,27,30,28217.1,31351.31,59568.41
350320,202011,3319,1605,1714,1679647.56,1793446.79,3473094.35
350330,202011,1667,885,782,927088.86,818345.51,1745434.37
350335,202011,16,11,5,11496.34,5227.39,16723.73
350340,202011,122,52,70,55402.36,73168.6,128570.96
350350,202011,92,46,46,48083.53,48076.24,96159.77
350360,202011,108,70,38,73170.54,40761.5,113932.04
350370,202011,85,49,36,51216.8,37625.04,88841.84
350380,202011,780,327,453,342830,473456.32,816286.32
350390,202011,1612,599,1013,627126.28,1061918.62,1689044.90
350395,202011,23,19,4,19862.58,4180.37,24042.95
350400,202011,1683,837,846,876914.14,887285.53,1764199.67
350410,202011,2745,1160,1585,1213514.31,1659735.7,2873250.01
350420,202011,253,150,103,156778.01,107655.61,264433.62
350430,202011,72,41,31,42852.69,32402.1,75254.79
350440,202011,152,109,43,113930.6,44944.78,158875.38
350450,202011,1672,973,699,1019069.39,731560.84,1750630.23
350460,202011,393,129,264,136939.62,276999.72,413939.34
350470,202011,19,10,9,10450.57,9406.8,19857.37
350480,202011,179,96,83,100341,86750.12,187091.12
350490,202011,237,112,125,117068.14,130651.47,247719.61
350500,202011,53,21,32,21946.62,33441.57,55388.19
350510,202011,167,107,60,111835.1,62710.14,174545.24
350520,202011,450,228,222,238313.25,232031.65,470344.90
350530,202011,436,200,236,209044.91,246674.34,455719.25
350535,202011,81,62,19,64807.86,19860.45,84668.31
350540,202011,372,189,183,197543.55,191272.66,388816.21
350550,202011,2672,1547,1125,1621151.88,1176832.45,2797984.33
350560,202011,605,414,191,432697.69,199626.53,632324.22
350570,202011,4167,1688,2479,1766474.58,2594172.11,4360646.69
350580,202011,368,178,190,186041.94,198579.31,384621.25
350590,202011,917,492,425,514211.43,444198.2,958409.63
350600,202011,6073,2874,3199,3008110.32,3346488.3,6354598.62
350610,202011,1500,774,726,808993.42,758757.7,1567751.12
350620,202011,28,18,10,18811.78,10452.16,29263.94
350630,202011,249,138,111,144232.62,116010.67,260243.29
350635,202011,972,378,594,396131.01,621892.58,1018023.59
350640,202011,118,90,28,94061.32,29264.74,123326.06
350650,202011,1873,1247,626,1304432.8,655297.65,1959730.45
350660,202011,745,306,439,319837.95,463025.44,782863.39
350670,202011,305,150,155,157802.74,161979.15,319781.89
350680,202011,174,89,85,93027.28,88844.92,181872.20
350690,202011,195,94,101,98249.31,106606.01,204855.32
350700,202011,797,377,420,394039.96,438978.1,833018.06
350710,202011,388,141,247,147373.61,258164.91,405538.52
350715,202011,53,43,10,44938.31,10452.12,55390.43
350720,202011,19,13,6,13588.88,6272.97,19861.85
350730,202011,45,28,17,29262.88,17765.11,47027.99
350740,202011,216,123,93,129596.4,97200.82,226797.22
350745,202011,22,9,13,10453.47,13587.76,24041.23
350750,202011,2210,1358,852,1420441.64,891475.11,2311916.75
350760,202011,3747,1579,2168,1651545.25,2269004.28,3920549.53
350770,202011,57,40,17,41803.45,17765.33,59568.78
350775,202011,41,29,12,30311.39,12541.55,42852.94
350780,202011,423,214,209,223664.89,218452.64,442117.53
350790,202011,361,150,211,156779.46,222628.73,379408.19
350800,202011,479,275,204,287424.76,213214.57,500639.33
350810,202011,521,414,107,432714.1,111835.09,544549.19
350820,202011,92,53,39,55386.3,40756.62,96142.92
350830,202011,78,40,38,41807.83,40759.54,82567.37
350840,202011,762,299,463,313564.61,486024.12,799588.73
350850,202011,1736,941,795,984604.92,830912.1,1815517.02
350860,202011,603,335,268,350163.79,280134.37,630298.16
350870,202011,433,283,150,295780.58,157814.9,453595.48
350880,202011,287,159,128,167239.67,133794.67,301034.34
350890,202011,41,25,16,26131.5,16724.86,42856.36
350900,202011,1472,456,1016,477663.75,1064047.3,1541711.05
350910,202011,27,15,12,15677.74,12541.75,28219.49
350920,202011,706,360,346,378353.03,361623.75,739976.78
350925,202011,1203,643,560,672063.59,585322.05,1257385.64
350930,202011,101,61,40,63757.36,41806.16,105563.52
350940,202011,723,397,326,414954.09,342831.11,757785.20
350945,202011,108,78,30,81525.64,31359.49,112885.13
350950,202011,16403,7560,8843,7909051.48,9255715.08,17164766.56
350960,202011,1431,625,806,654306.65,843473.59,1497780.24
350970,202011,1086,557,529,583120.09,554004.77,1137124.86
350980,202011,99,65,34,67936.56,35536.76,103473.32
350990,202011,371,134,237,140050.49,247696.36,387746.85
350995,202011,36,16,20,16721.24,20904.65,37625.89
351000,202011,637,431,206,450469.5,215317.25,665786.75
351010,202011,53,32,21,33445.08,21947.37,55392.45
351015,202011,49,34,15,35538.89,15676.39,51215.28
351020,202011,1571,942,629,984541.48,658456.18,1642997.66
351030,202011,338,213,125,222609.05,130632.11,353241.16
351040,202011,903,458,445,478691.16,466148.75,944839.91
351050,202011,3314,1489,1825,1558478.45,1909563.81,3468042.26
351060,202011,5331,2014,3317,2106222.31,3469796.01,5576018.32
351070,202011,403,257,146,268635.71,152610.99,421246.70
351080,202011,712,516,196,539295.02,205894.07,745189.09
351090,202011,53,24,29,25083.19,30308.92,55392.11
351100,202011,436,245,191,256085.64,199638.83,455724.47
351110,202011,2040,960,1080,1005495.64,1130828.37,2136324.01
351120,202011,66,34,32,36581.59,33445.05,70026.64
351130,202011,184,59,125,61666.32,130651.12,192317.44
351140,202011,321,211,110,220531.36,114967.32,335498.68
351150,202011,439,227,212,237253.7,222614.4,459868.1
351160,202011,282,183,99,191270.77,103468.33,294739.10
351170,202011,186,97,89,102140.08,93013.93,195154.01
351190,202011,87,61,26,63752.46,27172.37,90924.83
351200,202011,361,236,125,246655.62,130649.62,377305.24
351210,202011,112,52,60,55398.11,62707.38,118105.49
351220,202011,533,315,218,330277.22,228886.65,559163.87
351230,202011,264,182,82,190218.48,85704.66,275923.14
351240,202011,241,113,128,118099.74,133778.99,251878.73
351250,202011,80,57,23,59577.46,24040.41,83617.87
351260,202011,151,110,41,114952.48,42847.19,157799.67
351270,202011,44,18,26,18812.11,27172.5,45984.61
351280,202011,1018,460,558,480784.45,583214.41,1063998.86
351290,202011,234,100,134,104509.44,140042.44,244551.88
351300,202011,3745,1624,2121,1701597.91,2220057.78,3921655.69
351310,202011,739,364,375,381497.45,391982.72,773480.17
351320,202011,114,65,49,67941.88,51217.11,119158.99
351330,202011,38,25,13,26130.38,13586.24,39716.62
351340,202011,1250,728,522,764043.85,546598.59,1310642.44
351350,202011,2365,1353,1012,1415327.92,1057696.55,2473024.47
351360,202011,782,372,410,389872,428555.9,818427.9
351370,202011,378,190,188,199627.65,198573,398200.65
351380,202011,8977,3974,5003,4158019.89,5236214.6,9394234.49
351385,202011,25,17,8,17771.59,8362.72,26134.31
351390,202011,279,210,69,219491.5,72114.22,291605.72
351400,202011,66,41,25,42845.68,26128.7,68974.38
351410,202011,427,268,159,280117,166185.11,446302.11
351420,202011,71,52,19,54343.1,19855.78,74198.88
351430,202011,70,39,31,40763.57,32398.44,73162.01
351440,202011,776,539,237,563354.87,247717.71,811072.58
351450,202011,268,130,138,135876.3,144238.38,280114.68
351460,202011,129,57,72,59579.6,75251.19,134830.79
351470,202011,141,79,62,82566.21,64799.27,147365.48
351480,202011,489,282,207,294722.76,216337.46,511060.22
351490,202011,289,107,182,111822.32,191253.31,303075.63
351492,202011,26,19,7,19858.98,7315.5,27174.48
351495,202011,26,18,8,18812.85,8360.99,27173.84
351500,202011,3526,1453,2073,1519726.51,2167700.87,3687427.38
351510,202011,1964,738,1226,772379.75,1283452.41,2055832.16
351512,202011,17,13,4,13585.88,4180,17765.88
351515,202011,181,103,78,107657.7,82569.65,190227.35
351518,202011,724,457,267,477709.91,279081.93,756791.84
351519,202011,78,46,32,48078.91,33446.76,81525.67
351520,202011,147,90,57,94070.52,59590.06,153660.58
351530,202011,24,14,10,14630.4,10450.3,25080.7
351535,202011,133,81,52,84662.57,54353.65,139016.22
351540,202011,466,331,135,345957.61,141100.79,487058.40
351550,202011,1404,818,586,854971.23,612435.26,1467406.49
351560,202011,70,39,31,40758.36,33444.26,74202.62
351565,202011,11,7,4,7315.96,4181.95,11497.91
351570,202011,2712,1296,1416,1354666.19,1482193.87,2836860.06
351580,202011,39,34,5,35534.85,5226.38,40761.23
351590,202011,57,36,21,37628.63,21947.7,59576.33
351600,202011,187,132,55,137963.3,57487.5,195450.8
351610,202011,47,22,25,22992.83,26129.7,49122.53
351620,202011,5834,3231,2603,3380162.02,2722574.17,6102736.19
351630,202011,2857,1387,1470,1450793.21,1537517.85,2988311.06
351640,202011,2022,905,1117,947999.73,1168551.39,2116551.12
351650,202011,28,24,4,25085.84,4181.52,29267.36
351660,202011,134,86,48,89883.09,50165.06,140048.15
351670,202011,708,439,269,459874.69,282190.36,742065.05
351680,202011,65,56,9,58522.28,9406.96,67929.24
351685,202011,14,10,4,10450.72,4180.67,14631.39
351690,202011,300,204,96,213225.8,100338.37,313564.17
351700,202011,163,110,53,114967.58,55391.27,170358.85
351710,202011,70,45,25,47036.57,26131.21,73167.78
351720,202011,130,74,56,77341.92,58524.04,135865.96
351730,202011,107,66,41,68975.76,42846.05,111821.81
351740,202011,720,457,263,478682.43,274889.79,753572.22
351750,202011,355,143,212,149468.67,222631.8,372100.47
351760,202011,756,577,179,604126.76,188130.04,792256.80
351770,202011,306,255,51,266511.45,53308.67,319820.12
351780,202011,164,97,67,101380.4,70020.56,171400.96
351790,202011,250,130,120,135870.17,125423.25,261293.42
351800,202011,39,25,14,26128.67,14630.44,40759.11
351810,202011,118,81,37,84663.36,39718.34,124381.70
351820,202011,811,584,227,610391.3,237262.5,847653.8
351830,202011,545,187,358,196496.34,374178.92,570675.26
351840,202011,1923,909,1014,951140.76,1059769.33,2010910.09
351850,202011,230,164,66,171419.98,68981.52,240401.50
351860,202011,647,449,198,470336.45,206949.89,677286.34
351870,202011,5554,2559,2995,2675741.73,3134547.89,5810289.62
351880,202011,19596,7825,11771,8183923.28,12316002.17,20499925.45
351885,202011,83,50,33,53304.86,34489.83,87794.69
351890,202011,69,55,14,57479.69,14632.02,72111.71
351900,202011,232,130,102,135880.61,106606.66,242487.27
351905,202011,82,32,50,33443.45,52255.39,85698.84
351907,202011,3472,1402,2070,1466449.62,2167628.69,3634078.31
351910,202011,177,72,105,75256.97,109752.91,185009.88
351920,202011,115,62,53,64796.41,55390.56,120186.97
351925,202011,87,57,30,59577.77,31358.86,90936.63
351930,202011,393,253,140,264444.18,146331.69,410775.87
351940,202011,241,103,138,107650.7,144232.42,251883.12
351950,202011,138,74,64,77343.44,66894.89,144238.33
351960,202011,922,454,468,474832.63,489162.24,963994.87
351970,202011,1921,995,926,1041033.83,972047.96,2013081.79
351980,202011,161,73,88,76299.75,91979.05,168278.80
351990,202011,259,168,91,175580.23,95109.93,270690.16
352000,202011,338,217,121,227852.19,126470.73,354322.92
352010,202011,387,239,148,249801.35,154701.43,404502.78
352020,202011,182,70,112,73156.16,118092.6,191248.76
352030,202011,1099,549,550,573806.82,574845.51,1148652.33
352040,202011,566,237,329,247713.25,344926.8,592640.05
352042,202011,286,80,206,83615.4,215323.02,298938.42
352044,202011,359,219,140,228913.51,146336.81,375250.32
352050,202011,3206,1223,1983,1279340.28,2073550.92,3352891.20
352060,202011,102,61,41,63753.72,42851.43,106605.15
352070,202011,90,68,22,71073.91,22991.96,94065.87
352080,202011,64,41,23,42851.03,24043.07,66894.10
352090,202011,157,102,55,106607.92,57479.1,164087.02
352100,202011,284,137,147,144238.35,153643.29,297881.64
352110,202011,116,36,80,37625.1,83607.52,121232.62
352115,202011,60,21,39,21947.59,40760.05,62707.64
352120,202011,80,53,27,55390.75,28222.52,83613.27
352130,202011,221,184,37,193359.36,38668.33,232027.69
352140,202011,184,86,98,89879.3,102426.33,192305.63
352150,202011,116,60,56,62714.6,58535.79,121250.39
352160,202011,135,87,48,90925.91,50166.05,141091.96
352170,202011,388,262,126,273830.76,131685.85,405516.61
352180,202011,628,391,237,410764.79,247719.54,658484.33
352190,202011,243,100,143,104521.1,149455.01,253976.11
352200,202011,29,14,15,14633.24,15678.94,30312.18
352210,202011,4162,1680,2482,1757020.34,2600399.62,4357419.96
352215,202011,62,35,27,36578.56,28216.31,64794.87
352220,202011,6678,2476,4202,2593337.64,4397535.83,6990873.47
352230,202011,3316,2132,1184,2230506.45,1238474.05,3468980.50
352240,202011,2520,1436,1084,1500871.21,1136136,2637007.21
352250,202011,2788,1323,1465,1383889.6,1533217.3,2917106.9
352260,202011,993,522,471,547693.89,496496.11,1044190.00
352265,202011,56,27,29,28219.05,30307.28,58526.33
352270,202011,390,222,168,232034.07,175599.3,407633.37
352280,202011,460,276,184,288449.33,193339.35,481788.68
352290,202011,174,102,72,106616.2,75255.05,181871.25
352300,202011,96,66,30,68978.81,31353.82,100332.63
352310,202011,6445,2820,3625,2948724.7,3791592.08,6740316.78
352320,202011,1042,544,498,568585.98,521553.13,1090139.11
352330,202011,523,256,267,267538.32,279033.51,546571.83
352340,202011,1336,602,734,630283.22,767203.36,1397486.58
352350,202011,337,198,139,206957.36,145297.45,352254.81
352360,202011,220,97,123,101374.54,128547.64,229922.18
352370,202011,106,69,37,72117.88,38673.48,110791.36
352380,202011,110,72,38,75254.31,39716.24,114970.55
352390,202011,2501,1077,1424,1127814.51,1489312.31,2617126.82
352400,202011,499,216,283,225750.4,295779.28,521529.68
352410,202011,872,603,269,630236.87,281161.97,911398.84
352420,202011,97,67,30,70021.06,31354.97,101376.03
352430,202011,1751,795,956,832996.05,1001264.75,1834260.80
352440,202011,3221,1565,1656,1638862.26,1730744.1,3369606.36
352450,202011,199,160,39,167252.02,41812.59,209064.61
352460,202011,624,313,311,327146.42,325062.09,652208.51
352470,202011,650,224,426,234121.83,445239.8,679361.63
352480,202011,1418,778,640,813154.08,668911.77,1482065.85
352490,202011,68,23,45,24046.49,47040.57,71087.06
352500,202011,1233,517,716,541431.39,749411.66,1290843.05
352510,202011,709,375,334,391956.25,352236.88,744193.13
352520,202011,710,324,386,338799.8,403450.1,742249.9
352530,202011,1753,909,844,951174.93,883137.93,1834312.86
352540,202011,74,46,28,49123.54,29265.75,78389.29
352550,202011,191,114,77,119151.69,80472.73,199624.42
352560,202011,50,39,11,40761.35,11497.7,52259.05
352570,202011,697,341,356,356414.04,372093.23,728507.27
352580,202011,57,44,13,45987.83,13588.19,59576.02
352585,202011,20,6,14,6270.58,14633.52,20904.10
352590,202011,4372,2154,2218,2259836,2321328.15,4581164.15
352600,202011,349,249,100,260253.65,104523.98,364777.63
352610,202011,937,425,512,444199.7,535136.22,979335.92
352620,202011,1032,392,640,410785.89,669997.9,1080783.79
352630,202011,177,64,113,66893.02,118104.21,184997.23
352640,202011,514,339,175,354328.41,182917.38,537245.79
352650,202011,81,61,20,63750.53,20902.69,84653.22
352660,202011,62,37,25,38674.02,26127.85,64801.87
352670,202011,1684,883,801,923965.6,839203.15,1763168.75
352680,202011,915,568,347,593689.75,362711.42,956401.17
352690,202011,4516,2005,2511,2101984.76,2626442.27,4728427.03
352700,202011,106,62,44,64807.75,45988.64,110796.39
352710,202011,1405,732,673,765075.37,703329.45,1468404.82
352720,202011,1375,618,757,646999.36,791243.41,1438242.77
352725,202011,22,17,5,17770.08,5225.82,22995.90
352730,202011,383,188,195,197547.47,203818.42,401365.89
352740,202011,409,262,147,273840.02,154697.46,428537.48
352750,202011,18,12,6,12544.43,6270.67,18815.10
352760,202011,182,116,66,121238.21,68977.81,190216.02
352770,202011,90,66,24,68980.28,25081.68,94061.96
352780,202011,81,42,39,43893.6,40757.68,84651.28
352790,202011,26,20,6,20903.68,6271.7,27175.38
352800,202011,236,177,59,185002.4,61666.93,246669.33
352810,202011,155,97,58,101393.13,61670.79,163063.92
352820,202011,50,40,10,41804.56,10452.13,52256.69
352830,202011,76,51,25,53307.93,26129.54,79437.47
352840,202011,655,315,340,329265.28,355392.22,684657.50
352850,202011,1574,504,1070,527796.08,1119352.27,1647148.35
352860,202011,118,76,42,79438.98,43899.46,123338.44
352870,202011,46,30,16,31356.83,16725.56,48082.39
352880,202011,179,116,63,121239.82,65849.98,187089.80
352885,202011,31,21,10,21951.84,10451.19,32403.03
352890,202011,55,37,18,38672.02,18815.06,57487.08
352900,202011,4730,2271,2459,2376793.12,2573094.86,4949887.98
352910,202011,39,31,8,32398.29,8360.78,40759.07
352920,202011,651,390,261,408677.59,274893.63,683571.22
352930,202011,1234,589,645,615612.01,675165.72,1290777.73
352940,202011,6119,2478,3641,2594208.87,3813852.29,6408061.16
352950,202011,110,37,73,38670.42,76293.28,114963.70
352960,202011,60,37,23,38669.65,24037,62706.65
352965,202011,17,8,9,8361.43,9405.64,17767.07
352970,202011,520,397,123,415995.87,128570.7,544566.57
352980,202011,156,85,71,88848.56,75254.25,164102.81
352990,202011,981,453,528,473469.63,551899.78,1025369.41
353000,202011,58,24,34,25084.2,35537.68,60621.88
353010,202011,545,335,210,351196.47,219494.4,570690.87
353020,202011,302,220,82,229937.91,85709.19,315647.10
353030,202011,1265,569,696,594707.66,727460.82,1322168.48
353040,202011,92,56,36,58530.39,38669.96,97200.35
353050,202011,1303,841,462,880086.05,483895.24,1363981.29
353060,202011,8426,3582,4844,3750428.45,5065689.04,8816117.49
353070,202011,1761,1061,700,1110030.4,731395.6,1841426.0
353080,202011,1275,683,592,714928.56,619757.85,1334686.41
353090,202011,60,31,29,32396.35,30306.59,62702.94
353100,202011,48,38,10,39715.14,10451.32,50166.46
353110,202011,2091,638,1453,666834.09,1520866.79,2187700.88
353120,202011,97,48,49,50170.31,51211.24,101381.55
353130,202011,854,423,431,443154.46,451503.83,894658.29
353140,202011,552,225,327,235165.98,341780.32,576946.30
353150,202011,331,188,143,196494.96,149460.15,345955.11
353160,202011,94,73,21,76299.71,21950,98249.71
353170,202011,220,68,152,71072.23,160959.88,232032.11
353180,202011,1085,485,600,506900.85,628148.92,1135049.77
353190,202011,489,355,134,371039.02,140051.85,511090.87
353200,202011,221,105,116,109742.83,121229.95,230972.78
353205,202011,19,12,7,12541.12,7315.5,19856.62
353210,202011,70,39,31,40761.67,32398.64,73160.31
353215,202011,42,23,19,24037.93,19857.16,43895.09
353220,202011,75,42,33,43895.58,34488.78,78384.36
353230,202011,155,58,97,60615.79,102423.42,163039.21
353240,202011,322,163,159,170360.8,166185.34,336546.14
353250,202011,207,102,105,106608.17,109753.31,216361.48
353260,202011,461,315,146,329271.57,153651.4,482922.97
353270,202011,73,54,19,56440.89,19857.72,76298.61
353280,202011,99,47,52,49124.45,54352.46,103476.91
353282,202011,130,91,39,95107.31,40760.71,135868.02
353284,202011,24,17,7,17767.19,7315.85,25083.04
353286,202011,2,0,2,0,2090,2090
353290,202011,79,45,34,47033.3,36579.52,83612.82
353300,202011,445,233,212,244574.11,222629.46,467203.57
353310,202011,49,41,8,42848.54,8361.75,51210.29
353320,202011,39,22,17,22995.6,17766.33,40761.93
353325,202011,49,29,20,30309.67,21949.61,52259.28
353330,202011,59,41,18,42851.42,18810.34,61661.76
353340,202011,645,228,417,238303.89,438995.83,677299.72
353350,202011,899,431,468,452573.57,491266.88,943840.45
353360,202011,102,81,21,84657.05,21950.54,106607.59
353370,202011,111,64,47,66891.63,49124.97,116016.60
353380,202011,33,18,15,18811.99,15675.11,34487.10
353390,202011,1113,525,588,548723.01,614582.9,1163305.91
353400,202011,43,23,20,24039.6,20902.36,44941.96
353410,202011,109,64,45,66886.88,47029.84,113916.72
353420,202011,59,23,36,24035.44,37621.34,61656.78
353430,202011,574,384,190,402398.06,198580.83,600978.89
353440,202011,11185,4828,6357,5052572.47,6652273.33,11704845.80
353450,202011,56,29,27,30312.62,28222.87,58535.49
353460,202011,601,322,279,336532.41,291601.29,628133.70
353470,202011,2154,1107,1047,1157046.39,1095287.02,2252333.41
353475,202011,248,166,82,173490.29,85707.91,259198.20
353480,202011,184,152,32,158858.94,33443.3,192302.24
353490,202011,238,141,97,147364,101381.51,248745.51
353500,202011,204,119,85,124378.43,89887.98,214266.41
353510,202011,98,65,33,68979.01,34488.48,103467.49
353520,202011,204,144,60,150508.59,62708.35,213216.94
353530,202011,462,243,219,253989.65,229960.62,483950.27
353540,202011,387,254,133,265473.44,139017.91,404491.35
353550,202011,710,460,250,480788.82,262348.63,743137.45
353560,202011,587,234,353,244577.57,368960.62,613538.19
353570,202011,66,37,29,38671.76,30312.14,68983.90
353580,202011,347,251,96,262337.15,100333.49,362670.64
353590,202011,82,60,22,62706.6,22992.73,85699.33
353600,202011,273,160,113,167223.14,118096.23,285319.37
353610,202011,128,69,59,72112.05,61667.51,133779.56
353620,202011,627,326,301,340730.13,314601.34,655331.47
353625,202011,50,26,24,27174.98,25083.77,52258.75
353630,202011,232,166,66,173495.03,68977.52,242472.55
353640,202011,128,83,45,86747.29,47033.37,133780.66
353650,202011,938,349,589,365797.61,616624.68,982422.29
353657,202011,24,18,6,18812.18,6271.01,25083.19
353660,202011,270,142,128,149455.88,133780.28,283236.16
353670,202011,759,446,313,467203.93,327145.32,794349.25
353680,202011,107,80,27,83608.31,28215.71,111824.02
353690,202011,38,29,9,30312.45,9408.16,39720.61
353700,202011,275,192,83,201722.85,86748.81,288471.66
353710,202011,472,216,256,225776.16,267580.08,493356.24
353715,202011,49,33,16,34492.97,16723.31,51216.28
353720,202011,345,152,193,158880.48,201733.03,360613.51
353730,202011,1088,665,423,695033.3,442098.85,1137132.15
353740,202011,612,335,277,351173.62,290560.99,641734.61
353750,202011,77,45,32,47034.19,33446.16,80480.35
353760,202011,3004,1119,1885,1172725.41,1973336.59,3146062.00
353770,202011,86,69,17,72119.48,17766.4,89885.88
353780,202011,1249,584,665,612464.54,695052.59,1307517.13
353790,202011,501,304,197,318789.56,206948.27,525737.83
353800,202011,3436,1636,1800,1709990.51,1884374.9,3594365.41
353810,202011,232,129,103,134836.73,107656.26,242492.99
353820,202011,211,92,119,96153.24,124362.47,220515.71
353830,202011,53,46,7,48079.48,7316.21,55395.69
353850,202011,171,81,90,84659.07,94067.68,178726.75
353860,202011,512,220,292,229938.81,305181.8,535120.61
353870,202011,5368,2675,2693,2804293.26,2819748.28,5624041.54
353880,202011,682,464,218,484969.57,227842.28,712811.85
353890,202011,543,317,226,331363.82,236234.19,567598.01
353900,202011,133,70,63,73162.84,65842.49,139005.33
353910,202011,176,76,100,79435.93,104514.64,183950.57
353920,202011,423,237,186,248747.22,194398.53,443145.75
353930,202011,1015,597,418,625013.46,438950.71,1063964.17
353940,202011,192,94,98,98245.27,102425.36,200670.63
353950,202011,500,308,192,322950.35,200674.09,523624.44
353960,202011,76,61,15,63756.06,15678,79434.06
353970,202011,44,29,15,30314.23,15681.71,45995.94
353980,202011,1695,769,926,805873.72,968913.72,1774787.44
353990,202011,72,43,29,44946.53,30309.74,75256.27
354000,202011,384,181,203,189166.91,212164.38,401331.29
354010,202011,89,50,39,52266.46,40765.3,93031.76
354020,202011,508,321,187,335506.3,195460.27,530966.57
354025,202011,38,33,5,34491.5,5225.74,39717.24
354030,202011,51,31,20,32401.56,20903.88,53305.44
354040,202011,98,74,24,77343.19,25082.57,102425.76
354050,202011,172,98,74,102422.39,77339.41,179761.80
354060,202011,759,364,395,380447.41,414948.87,795396.28
354070,202011,907,514,393,537220.54,410762.34,947982.88
354075,202011,184,84,100,87797.4,104522.03,192319.43
354080,202011,313,132,181,137962.72,189177.16,327139.88
354085,202011,21,13,8,13588.84,8362.24,21951.08
354090,202011,285,166,119,173413.26,124372.69,297785.95
354100,202011,5532,2219,3313,2320339.29,3464754.53,5785093.82
354105,202011,95,44,51,45984.55,53298.42,99282.97
354110,202011,46,22,24,22997.15,25088.94,48086.09
354120,202011,140,98,42,102431.2,43898.24,146329.44
354130,202011,717,446,271,466160.7,283251.77,749412.47
354140,202011,3177,1454,1723,1523876.07,1801770.85,3325646.92
354150,202011,637,378,259,395084.73,270697.64,665782.37
354160,202011,644,408,236,426450.13,246669.06,673119.19
354165,202011,17,14,3,14633.98,3135,17768.98
354170,202011,168,115,53,121237.41,55394.51,176631.92
354180,202011,57,34,23,35534.63,24039.81,59574.44
354190,202011,188,78,110,81521.01,114960.47,196481.48
354200,202011,110,58,52,60621.7,54357.62,114979.32
354210,202011,59,22,37,22996.74,38667.39,61664.13
354220,202011,653,413,240,431662.57,250845.39,682507.96
354230,202011,167,70,97,73163.06,101389.36,174552.42
354240,202011,338,217,121,226793.55,126469.74,353263.29
354250,202011,82,51,31,53304.69,32398.17,85702.86
354260,202011,2088,984,1104,1028471.45,1154959.27,2183430.72
354270,202011,86,63,23,65839.52,24036.11,89875.63
354280,202011,45,22,23,22994.92,24038.98,47033.90
354290,202011,142,99,43,103477.57,44942.39,148419.96
354300,202011,370,258,112,269677.39,117064.43,386741.82
354310,202011,89,68,21,71075.18,21950.87,93026.05
354320,202011,200,99,101,103473.48,105558.42,209031.90
354323,202011,10,9,1,9407.15,1045.27,10452.42
354325,202011,116,66,50,68973.3,52251.92,121225.22
354330,202011,2416,805,1611,842344.81,1689002.16,2531346.97
354340,202011,10292,4854,5438,5080581.52,5689822.16,10770403.68
354350,202011,138,89,49,93008.87,51209.02,144217.89
354360,202011,67,36,31,37623.95,32399.13,70023.08
354370,202011,239,125,114,130648.55,120194.87,250843.42
354380,202011,178,110,68,114973.15,71071.39,186044.54
354390,202011,2669,957,1712,1000248.85,1793483.68,2793732.53
354400,202011,305,166,139,173500.98,145281.81,318782.79
354410,202011,612,290,322,303117.29,336556.77,639674.06
354420,202011,268,172,96,179778.65,100344.36,280123.01
354425,202011,309,181,128,189224.53,133788.06,323012.59
354430,202011,182,103,79,107650.16,82568.52,190218.68
354440,202011,33,25,8,26131.14,8360,34491.14
354450,202011,51,33,18,34489.75,18813.16,53302.91
354460,202011,101,57,44,59574.02,45987.55,105561.57
354470,202011,34,18,16,18813.66,16727.56,35541.22
354480,202011,113,62,51,64800.05,53297.96,118098.01
354490,202011,142,87,55,90929.05,57481.08,148410.13
354500,202011,391,183,208,191260.6,217382.15,408642.75
354510,202011,91,62,29,64797.77,30309.98,95107.75
354515,202011,36,11,25,11496.88,26129.23,37626.11
354520,202011,1596,678,918,709557.71,960445.85,1670003.56
354530,202011,783,387,396,404484.58,414927.84,819412.42
354540,202011,264,140,124,147377.97,129605.67,276983.64
354550,202011,36,23,13,24036.42,13586.68,37623.10
354560,202011,149,77,72,80472.27,76290.33,156762.60
354570,202011,130,88,42,91970.8,43893.4,135864.2
354580,202011,1843,859,984,900967.62,1030532.51,1931500.13
354600,202011,257,135,122,142153.06,127511.4,269664.46
354610,202011,73,62,11,64803.76,11499.29,76303.05
354620,202011,63,16,47,16722.24,49120.36,65842.60
354625,202011,15,9,6,9406.85,6272.25,15679.10
354630,202011,293,188,105,196498.65,110795.04,307293.69
354640,202011,797,501,296,524671.21,309372.69,834043.90
354650,202011,67,39,28,40758.67,29262.48,70021.15
354660,202011,784,580,204,606226.61,213227.2,819453.81
354670,202011,236,89,147,93019.98,153633.26,246653.24
354680,202011,1272,463,809,483913.64,846580.48,1330494.12
354690,202011,83,56,27,58528.8,28217.69,86746.49
354700,202011,68,48,20,50164.41,20901.04,71065.45
354710,202011,47,33,14,34489.96,14632.42,49122.38
354720,202011,20,19,1,19858.03,1045.67,20903.70
354730,202011,1736,720,1016,753630.92,1064081.47,1817712.39
354740,202011,75,50,25,52252.61,26126.15,78378.76
354750,202011,417,240,177,250825.02,184993.85,435818.87
354760,202011,459,275,184,287443.07,193366.47,480809.54
354765,202011,10,5,5,5226.57,5227.6,10454.17
354770,202011,349,228,121,239340.6,126463.61,365804.21
354780,202011,8174,3190,4984,3337348.14,5215209.13,8552557.27
354790,202011,95,53,42,55390.01,43892.82,99282.83
354800,202011,448,241,207,251890.05,218452.74,470342.79
354805,202011,92,42,50,43895.32,52264.24,96159.56
354810,202011,103,61,42,63752.1,43893.2,107645.3
354820,202011,208,81,127,84666.68,132747.65,217414.33
354830,202011,43,22,21,22990.4,21950.49,44940.89
354840,202011,55,38,17,39713.33,17765.88,57479.21
354850,202011,4480,1954,2526,2044438.84,2644200.58,4688639.42
354860,202011,329,158,171,165130.66,178731.46,343862.12
354870,202011,11969,5297,6672,5542123.58,6983761.62,12525885.20
354880,202011,2746,1010,1736,1057818.19,1817639.42,2875457.61
354890,202011,2915,1552,1363,1622152.53,1427626.95,3049779.48
354900,202011,61,41,20,42851.51,20901.68,63753.19
354910,202011,1249,636,613,665824.18,640620.88,1306445.06
354920,202011,40,32,8,33443.39,8360.87,41804.26
354925,202011,15,7,8,7315,8361.41,15676.41
354930,202011,36,32,4,33448.94,4180.88,37629.82
354940,202011,793,573,220,599147.92,229952.74,829100.66
354950,202011,200,129,71,134820.6,74207.33,209027.93
354960,202011,146,55,91,57490.18,95121.07,152611.25
354970,202011,981,646,335,676242.77,350109.18,1026351.95
354980,202011,8755,3117,5638,3259959.62,5901846.15,9161805.77
354990,202011,9378,4235,5143,4431643.7,5381403.37,9813047.07
354995,202011,545,176,369,183958.64,385698.43,569657.07
355000,202011,462,158,304,166183.68,318789.72,484973.40
355010,202011,592,362,230,379425.78,240410.43,619836.21
355020,202011,771,481,290,502736.55,304146.16,806882.71
355030,202011,207844,79005,128839,82671234.5,134818923.39,217490157.89
355040,202011,781,351,430,366843.58,450448.22,817291.80
355050,202011,155,92,63,96152.48,65843.21,161995.69
355060,202011,1629,806,823,843530.11,861178.79,1704708.90
355070,202011,1453,685,768,717006.75,803774.78,1520781.53
355080,202011,193,119,74,124373.76,77342.13,201715.89
355090,202011,286,166,120,173500.28,125426.07,298926.35
355100,202011,5014,2367,2647,2475997.67,2771735.22,5247732.89
355110,202011,238,160,78,167230.01,81524.42,248754.43
355120,202011,57,37,20,38671.03,20902.21,59573.24
355130,202011,45,25,20,26131.47,20903.58,47035.05
355140,202011,181,110,71,114961.04,74200.24,189161.28
355150,202011,665,388,277,405546.7,290563.84,696110.54
355160,202011,468,222,246,232039.81,258157.76,490197.57
355170,202011,2033,1054,979,1102691.52,1024242.49,2126934.01
355180,202011,678,284,394,296833.61,412853.06,709686.67
355190,202011,208,139,69,146317.94,73162.3,219480.24
355200,202011,111,63,48,65838.43,50163.16,116001.59
355210,202011,692,386,306,403458.12,319841.19,723299.31
355220,202011,7192,3626,3566,3795226.89,3735368.04,7530594.93
355230,202011,99,60,39,62708.03,40760.9,103468.93
355240,202011,4434,1816,2618,1902308.53,2741331.62,4643640.15
355250,202011,5829,2564,3265,2682127.48,3417517.36,6099644.84
355255,202011,50,28,22,29263.3,22991.79,52255.09
355260,202011,180,112,68,117063.28,71073.54,188136.82
355270,202011,167,106,61,110790.04,63754.56,174544.60
355280,202011,6413,2472,3941,2588072.2,4122533.69,6710605.89
355290,202011,78,62,16,65840.7,16723.63,82564.33
355300,202011,195,115,80,120197.19,83604.95,203802.14
355310,202011,112,60,52,62705.24,54347.19,117052.43
355320,202011,88,46,42,48076.31,43896.26,91972.57
355330,202011,279,161,118,168271.57,123328.74,291600.31
355340,202011,1472,512,960,535141.17,1003519.55,1538660.72
355350,202011,143,68,75,71066.5,78378.81,149445.31
355360,202011,168,110,58,114975.24,60625.39,175600.63
355365,202011,20,16,4,16724.38,4180.88,20905.26
355370,202011,1035,612,423,639653.77,443137.78,1082791.55
355380,202011,827,518,309,541415.61,324037.47,865453.08
355385,202011,73,50,23,52255.34,24038.6,76293.94
355390,202011,109,60,49,62710.34,51214.65,113924.99
355395,202011,197,109,88,113928.31,91981.87,205910.18
355400,202011,1693,999,694,1046162.11,725288.01,1771450.12
355410,202011,4877,2265,2612,2370517.63,2733978.04,5104495.67
355420,202011,48,33,15,34488.08,16722.86,51210.94
355430,202011,385,236,149,246660.38,155742.3,402402.68
355440,202011,86,49,37,51209.17,38668.72,89877.89
355450,202011,456,223,233,233072.07,243518.67,476590.74
355460,202011,64,48,16,50168.7,16722.26,66890.96
355465,202011,45,26,19,27172.83,19857.47,47030.30
355470,202011,174,71,103,74206.38,107649.72,181856.10
355475,202011,11,7,4,7315.91,4180,11495.91
355480,202011,528,212,316,221583.06,330276.53,551859.59
355490,202011,116,81,35,84668.06,36584.73,121252.79
355495,202011,64,24,40,25082.29,41803.22,66885.51
355500,202011,1564,862,702,901969.89,734746.45,1636716.34
355510,202011,271,198,73,206952.38,76299.17,283251.55
355520,202011,31,23,8,24037.92,8360.32,32398.24
355530,202011,20,12,8,12541.01,8360,20901.01
355535,202011,74,34,40,35539.02,41807.84,77346.86
355540,202011,2476,967,1509,1010903.72,1578351.76,2589255.48
355550,202011,60,38,22,39713.41,22994.76,62708.17
355560,202011,249,116,133,121241.77,139014.87,260256.64
355570,202011,23,15,8,15678.53,8360.34,24038.87
355580,202011,244,174,70,181870.29,73166.05,255036.34
355590,202011,17,11,6,11498.45,6271.89,17770.34
355600,202011,270,137,133,143201.65,139003.94,282205.59
355610,202011,225,150,75,156782.56,78391.87,235174.43
355620,202011,1326,585,741,611459.61,774472.53,1385932.14
355630,202011,427,313,114,327150.6,121241.99,448392.59
355635,202011,111,52,59,54348.04,61666.56,116014.60
355640,202011,555,313,242,327137.93,252934.86,580072.79
355645,202011,853,332,521,347015.24,544549.21,891564.45
355650,202011,1953,824,1129,865498.11,1182034.68,2047532.79
355660,202011,244,129,115,136915.17,122289.88,259205.05
355670,202011,577,237,340,248739.53,355344.28,604083.81
355680,202011,207,115,92,120200.02,96160.06,216360.08
355690,202011,90,41,49,42855.22,51219.64,94074.86
355695,202011,18,12,6,12540.72,6270,18810.72
355700,202011,1136,586,550,612482.73,574812.78,1187295.51
355710,202011,2225,1198,1027,1254236.21,1075421.64,2329657.85
355715,202011,15,13,2,13586.97,2090.4,15677.37
355720,202011,231,139,92,146321.19,96155.2,242476.39
355730,202011,99,58,41,60622.97,42855.47,103478.44
410010,202011,132,108,24,112887.48,25088.28,137975.76
410020,202011,113,87,26,90948.73,27177.79,118126.52
410030,202011,166,94,72,98253.58,75259.45,173513.03
410040,202011,1200,589,611,616621.95,640659.81,1257281.76
410045,202011,38,29,9,30310.93,9406.44,39717.37
410050,202011,471,264,207,275928.03,216351.25,492279.28
410060,202011,282,208,74,217394.6,77336.96,294731.56
410070,202011,293,244,49,255025.44,51214.71,306240.15
410080,202011,172,105,67,109742.59,70029.08,179771.67
410090,202011,78,68,10,72119.92,10452.6,82572.52
410100,202011,289,201,88,210061.78,91964.56,302026.34
410105,202011,47,29,18,30307.6,18810.87,49118.47
410110,202011,336,200,136,209029.05,143191.66,352220.71
410115,202011,35,24,11,25082.32,11495.67,36577.99
410120,202011,421,206,215,215303.75,224706.56,440010.31
410130,202011,50,31,19,32402.71,19858.02,52260.73
410140,202011,3135,1483,1652,1554154.33,1727686.49,3281840.82
410150,202011,2674,1034,1640,1080691.72,1715098.93,2795790.65
410160,202011,512,315,197,330276.35,205891.82,536168.17
410165,202011,58,37,21,38670.42,21948.17,60618.59
410170,202011,176,112,64,117053.22,66887.81,183941.03
410180,202011,2243,1243,1000,1302320.7,1046230.36,2348551.06
410185,202011,32,28,4,29265.79,4180.45,33446.24
410190,202011,494,313,181,327116.68,189163.38,516280.06
410200,202011,945,676,269,706533.37,281139.47,987672.84
410210,202011,611,306,305,319816.34,318781.96,638598.30
410220,202011,44,20,24,20900.48,25080.23,45980.71
410230,202011,145,68,77,71068.55,80470,151538.55
410240,202011,741,477,264,499625.58,275927.8,775553.38
410250,202011,377,270,107,282188.79,111834.25,394023.04
410260,202011,301,166,135,173508.17,141111.03,314619.20
410270,202011,28,21,7,21945.94,7315.67,29261.61
410275,202011,54,42,12,43895.41,12541.67,56437.08
410280,202011,321,183,138,192316.48,144235.19,336551.67
410290,202011,251,152,99,158860.34,103465.77,262326.11
410300,202011,79,57,22,59578.71,22994.81,82573.52
410302,202011,20,13,7,13586.31,7315,20901.31
410304,202011,37,25,12,26128.15,12540.8,38668.95
410305,202011,219,110,109,114959.22,113914.54,228873.76
410310,202011,213,125,88,130645.1,91971.64,222616.74
410315,202011,48,34,14,35535.31,14632.04,50167.35
410320,202011,138,96,42,100329.53,43894.66,144224.19
410322,202011,33,22,11,22992.93,11495.97,34488.90
410330,202011,181,123,58,128571.49,60623.5,189194.99
410335,202011,105,59,46,61657.78,48071.68,109729.46
410337,202011,44,33,11,35532.83,11495.2,47028.03
410340,202011,40,33,7,34487.78,7315.56,41803.34
410345,202011,203,114,89,120195.46,93018.34,213213.80
410347,202011,46,35,11,36582.86,11495.85,48078.71
410350,202011,235,141,94,147371.39,98244.72,245616.11
410360,202011,466,291,175,304151.63,182907.3,487058.93
410370,202011,2319,966,1353,1011739.37,1414176.07,2425915.44
410380,202011,209,131,78,136930.73,81528.57,218459.30
410390,202011,387,266,121,278014.44,127505.18,405519.62
410395,202011,35,21,14,21949.01,14638.21,36587.22
410400,202011,840,375,465,391951.85,486040.38,877992.23
410405,202011,89,66,23,70027.7,24040.47,94068.17
410410,202011,31,22,9,22995.4,9407.31,32402.71
410420,202011,1682,790,892,825600.72,934390.11,1759990.83
410425,202011,176,70,106,73169.94,110792.33,183962.27
410430,202011,2302,1255,1047,1312703.07,1094294.48,2406997.55
410440,202011,377,274,103,286382.58,107654.37,394036.95
410442,202011,362,236,126,246658.89,131691.64,378350.53
410445,202011,424,301,123,315621.31,129596.85,445218.16
410450,202011,398,196,202,204845.58,211109.37,415954.95
410460,202011,515,261,254,274859.73,265460.22,540319.95
410465,202011,228,134,94,140045.83,98241.01,238286.84
410470,202011,248,148,100,154690.18,104508.33,259198.51
410480,202011,6233,2962,3271,3102069.48,3423024.91,6525094.39
410490,202011,1416,851,565,890548.92,591598.58,1482147.50
410500,202011,268,150,118,156771.38,123319.77,280091.15
410510,202011,166,122,44,128555.09,45990.79,174545.88
410520,202011,250,187,63,195447.47,65849.69,261297.16
410530,202011,303,105,198,109734.95,206924.68,316659.63
410540,202011,324,235,89,245604.8,93015.15,338619.95
410550,202011,1690,714,976,747298.46,1020085.42,1767383.88
410560,202011,149,103,46,107647.97,48074.16,155722.13
410570,202011,430,288,142,303088.14,148411.75,451499.89
410580,202011,3472,1483,1989,1553197.67,2079958.86,3633156.53
410590,202011,398,265,133,276947.17,139006.99,415954.16
410600,202011,195,167,28,174529.43,29263.35,203792.78
410610,202011,51,42,9,43894.21,9405,53299.21
410620,202011,246,164,82,171415,85706.61,257121.61
410630,202011,432,240,192,250824.93,200661.05,451485.98
410640,202011,1019,645,374,674108.08,390885.08,1064993.16
410645,202011,109,78,31,81525.96,32402.02,113927.98
410650,202011,356,230,126,240380.76,131683.38,372064.14
410655,202011,89,63,26,65839.47,27175.17,93014.64
410657,202011,28,10,18,10452.34,18810.74,29263.08
410660,202011,602,414,188,433736.8,196493.35,630230.15
410670,202011,74,62,12,64803.56,12542.18,77345.74
410680,202011,214,169,45,176635.66,47036.25,223671.91
410685,202011,18,11,7,11497,7316.15,18813.15
410690,202011,28535,11926,16609,12475495.37,17370991.65,29846487.02
410700,202011,322,237,85,247715.39,88841.31,336556.70
410710,202011,129,102,27,106600.76,28219.13,134819.89
410712,202011,38,27,11,28217.98,11498.35,39716.33
410715,202011,85,62,23,64799.46,24036.58,88836.04
410720,202011,684,381,303,398193.88,316666.5,714860.38
410725,202011,180,130,50,135871.73,52255.11,188126.84
410730,202011,97,47,50,49120.27,52257.76,101378.03
410740,202011,106,76,30,79429.33,31356.03,110785.36
410750,202011,264,173,91,182267.27,95102.86,277370.13
410752,202011,25,15,10,15678.18,10450.4,26128.58
410753,202011,57,23,34,24040.41,35535.97,59576.38
410754,202011,50,26,24,27174.84,25080.78,52255.62
410755,202011,85,50,35,52254.72,36575.67,88830.39
410760,202011,764,415,349,433740.05,364769.68,798509.73
410765,202011,1791,811,980,847678.6,1025389.54,1873068.14
410770,202011,111,84,27,87795.02,28219.69,116014.71
410773,202011,58,41,17,42849.03,17766.72,60615.75
410775,202011,184,136,48,142152.36,50170.81,192323.17
410780,202011,88,48,40,50163.94,41801.7,91965.64
410785,202011,55,42,13,43893.97,13586.13,57480.10
410790,202011,81,36,45,37625.36,47028.93,84654.29
410800,202011,283,174,109,181862.3,116019.43,297881.73
410810,202011,24,16,8,16721.46,8360.44,25081.90
410820,202011,173,126,47,131695.6,49127.42,180823.02
410830,202011,8553,3660,4893,3827478.05,5118419.1,8945897.15
410832,202011,104,71,33,74203.16,34490.89,108694.05
410840,202011,1466,784,682,819401.21,712774.77,1532175.98
410845,202011,52,32,20,33442.84,20903.22,54346.06
410850,202011,186,134,52,140064.85,54352.61,194417.46
410855,202011,62,50,12,52259.14,12542.49,64801.63
410860,202011,750,403,347,421177.86,363696.15,784874.01
410865,202011,101,74,27,77352.34,28218.82,105571.16
410870,202011,156,133,23,139015.79,24039.87,163055.66
410880,202011,1124,562,562,587384.37,588455.06,1175839.43
410890,202011,89,63,26,65841.5,27170.14,93011.64
410895,202011,73,54,19,56437.72,19860.75,76298.47
410900,202011,23,17,6,17771.12,6270.44,24041.56
410910,202011,17,13,4,13588.56,4180.47,17769.03
410920,202011,36,25,11,26131.7,11497.21,37628.91
410930,202011,531,328,203,342810.35,212160.77,554971.12
410940,202011,4408,2425,1983,2542837.02,2075761.95,4618598.97
410950,202011,106,76,30,79437.62,31358.59,110796.21
410960,202011,836,341,495,356406.77,517360.53,873767.30
410965,202011,64,44,20,45985.77,20902.45,66888.22
410970,202011,627,442,185,461979.34,193359.37,655338.71
410975,202011,125,76,49,79429.4,51212.6,130642.0
410980,202011,1632,723,909,755640.99,951119.97,1706760.96
410990,202011,271,189,82,197524.45,85703.52,283227.97
411000,202011,67,40,27,41809.1,28222.83,70031.93
411005,202011,29,24,5,25081.63,5225.44,30307.07
411007,202011,259,151,108,157800.95,112864.74,270665.69
411010,202011,610,408,202,426436.37,212170.78,638607.15
411020,202011,287,193,94,201721.22,98248.46,299969.68
411030,202011,18,10,8,10451.73,8361.35,18813.08
411040,202011,55,37,18,38671.92,18816.19,57488.11
411050,202011,208,159,49,166197.99,51216.87,217414.86
411060,202011,519,349,170,364760.16,177678.34,542438.50
411065,202011,52,45,7,47028.72,7315.67,54344.39
411070,202011,1257,748,509,781790.67,531992.77,1313783.44
411080,202011,241,171,70,178713.84,73154.83,251868.67
411090,202011,97,75,22,78393.47,22994.55,101388.02
411095,202011,284,109,175,113922.91,183948.9,297871.81
411100,202011,116,95,21,99288.43,21945.59,121234.02
411110,202011,133,81,52,84654.29,54347.92,139002.21
411120,202011,215,145,70,151544.61,73159.41,224704.02
411125,202011,243,103,140,107646.25,146333.77,253980.02
411130,202011,131,111,20,116011.95,20900.8,136912.75
411140,202011,214,139,75,145269.67,78381.58,223651.25
411150,202011,1238,804,434,840277.85,454622.07,1294899.92
411155,202011,117,80,37,83611.01,38670.96,122281.97
411160,202011,25,11,14,11495.49,14631.14,26126.63
411170,202011,53,47,6,49117.78,6270.73,55388.51
411180,202011,969,635,334,664718.15,349077.06,1013795.21
411190,202011,333,191,142,199622,148407.64,348029.64
411200,202011,667,403,264,421221.31,275918.97,697140.28
411210,202011,689,362,327,378336.75,341752.2,720088.95
411220,202011,159,112,47,117064.8,49126.46,166191.26
411230,202011,40,33,7,34488.91,7317.56,41806.47
411240,202011,118,74,44,77344.4,45988.48,123332.88
411250,202011,434,314,120,328154.9,125411.35,453566.25
411260,202011,16,11,5,11496.73,5226.24,16722.97
411270,202011,270,144,126,150513.68,131702.07,282215.75
411275,202011,179,157,22,164094.39,22993.4,187087.79
411280,202011,212,148,64,154686.32,66891.18,221577.50
411290,202011,63,48,15,51208.59,15678.22,66886.81
411295,202011,138,108,30,112883.57,31353.9,144237.47
411300,202011,81,35,46,36577.63,48076.87,84654.50
411310,202011,89,68,21,71068.24,21946.87,93015.11
411320,202011,790,519,271,542447.16,283227.96,825675.12
411325,202011,64,43,21,44938.63,21945.84,66884.47
411330,202011,911,580,331,607222.15,346983.68,954205.83
411340,202011,29,18,11,18814.61,11496.46,30311.07
411342,202011,64,48,16,50168.46,16722.92,66891.38
411345,202011,118,59,59,61666.28,61665.87,123332.15
411350,202011,480,363,117,380455.39,123332.17,503787.56
411360,202011,54,35,19,36584.82,19860.08,56444.90
411370,202011,14225,5703,8522,5971121.87,8915512.88,14886634.75
411373,202011,171,119,52,124371.17,54346.1,178717.27
411375,202011,80,63,17,65842.42,17766.61,83609.03
411380,202011,85,61,24,63763.87,25088.89,88852.76
411390,202011,131,78,53,81525.89,55391.82,136917.71
411400,202011,384,275,109,288465.33,113913.99,402379.32
411410,202011,454,221,233,230983.6,243519.11,474502.71
411420,202011,992,429,563,449420.12,588451.71,1037871.83
411430,202011,469,267,202,279093.21,211142.19,490235.40
411435,202011,32,20,12,20902.4,12542.9,33445.3
411440,202011,461,361,100,377272.16,105555.8,482827.96
411450,202011,427,360,67,376249.57,70023.64,446273.21
411460,202011,772,283,489,298015.96,512143.65,810159.61
411470,202011,91,63,28,65843.58,29260.11,95103.69
411480,202011,670,367,303,383578.34,316683.76,700262.10
411490,202011,288,184,104,192318.17,108704.76,301022.93
411500,202011,100,82,18,85701.23,18811.95,104513.18
411510,202011,217,175,42,182885.11,43892.1,226777.21
411520,202011,6055,2242,3813,2347456.5,3989405.44,6336861.94
411530,202011,129,87,42,90918.61,43891.77,134810.38
411535,202011,52,20,32,20905.02,33446.4,54351.42
411540,202011,353,241,112,251864.08,117043.5,368907.58
411545,202011,56,40,16,41801.84,16720.61,58522.45
411550,202011,84,64,20,66885.59,20903.7,87789.29
411560,202011,397,166,231,173493.04,241424.92,414917.96
411570,202011,862,301,561,314609.45,586343.46,900952.91
411573,202011,24,15,9,15678.74,9406.45,25085.19
411575,202011,295,185,110,193341.7,114956.95,308298.65
411580,202011,1269,454,815,474489.9,851783.68,1326273.58
411585,202011,76,37,39,38676.54,40765.69,79442.23
411590,202011,20,13,7,13586.38,7316.78,20903.16
411600,202011,24,10,14,10454.1,14634.46,25088.56
411605,202011,238,97,141,101381.54,147368.07,248749.61
411610,202011,207,133,74,139010.65,77344.83,216355.48
411620,202011,371,199,172,209037.52,180806.71,389844.23
411630,202011,57,38,19,39711.56,19857.39,59568.95
411640,202011,33,23,10,24036.66,10452.17,34488.83
411650,202011,12,7,5,7315.83,5226.34,12542.17
411660,202011,38,25,13,26125.6,13587.1,39712.7
411670,202011,239,174,65,181854.72,67938.79,249793.51
411680,202011,164,135,29,141094.05,30310.31,171404.36
411690,202011,580,309,271,322951.38,284280.47,607231.85
411695,202011,63,45,18,47029.99,18811.46,65841.45
411700,202011,144,115,29,120200.56,30312.34,150512.90
411705,202011,106,70,36,73164.96,37628.56,110793.52
411710,202011,296,198,98,206928.11,102421.8,309349.91
411720,202011,133,88,45,91969.44,47028.96,138998.40
411721,202011,70,58,12,60615.21,12540.87,73156.08
411722,202011,104,44,60,45985.77,62712.96,108698.73
411725,202011,153,115,38,120186.98,39713.68,159900.66
411727,202011,86,66,20,68977.28,20902.07,89879.35
411729,202011,40,32,8,33442.91,8360.84,41803.75
411730,202011,558,349,209,365806.23,218435.62,584241.85
411740,202011,38,22,16,22991.71,16720,39711.71
411745,202011,68,49,19,51206.76,19855.8,71062.56
411750,202011,852,372,480,388811.09,501700.8,890511.89
411760,202011,1181,868,313,907199.76,327142.13,1234341.89
411770,202011,458,300,158,314608.3,166193.6,480801.9
411780,202011,349,226,123,236200.73,128552.53,364753.26
411790,202011,526,292,234,305200.58,244570.74,549771.32
411800,202011,159,118,41,123343.01,42849.43,166192.44
411810,202011,176,132,44,137961.95,45987.13,183949.08
411820,202011,2225,958,1267,1002348.12,1327389.8,2329737.92
411830,202011,10,9,1,9405.84,1045.48,10451.32
411840,202011,2028,1233,795,1289713.06,830902.63,2120615.69
411845,202011,54,19,35,19856.55,36576.12,56432.67
411850,202011,1222,669,553,701293.07,579035.43,1280328.50
411860,202011,48,31,17,32403.35,17768.65,50172.00
411870,202011,73,47,26,49117.61,27172.37,76289.98
411880,202011,422,267,155,279056.49,161996.21,441052.70
411885,202011,104,68,36,71065.68,37626.56,108692.24
411890,202011,306,197,109,205900.11,113924.68,319824.79
411900,202011,80,61,19,63760.76,19858.51,83619.27
411910,202011,181,141,40,147377.54,41806.94,189184.48
411915,202011,2209,889,1320,931253.33,1380691.9,2311945.23
411920,202011,121,96,25,100347.81,26129.99,126477.80
411925,202011,12,7,5,7316.55,5226.24,12542.79
411930,202011,807,578,229,606291.17,239357.99,845649.16
411940,202011,586,395,191,412849.35,200665.43,613514.78
411950,202011,1028,482,546,503799.31,570689.43,1074488.74
411960,202011,1065,707,358,738877.02,374135.72,1113012.74
411965,202011,18,12,6,12543.79,6272.27,18816.06
411970,202011,86,76,10,80474.15,10451.08,90925.23
411980,202011,169,107,62,111837.04,64799.02,176636.06
411990,202011,5126,2892,2234,3025885.28,2335065.71,5360950.99
411995,202011,521,166,355,173505.84,371038.11,544543.95
412000,202011,321,204,117,213207.92,122288.12,335496.04
412010,202011,45,28,17,29265.92,17769.96,47035.88
412015,202011,42,30,12,31356.95,12542.3,43899.25
412020,202011,31,24,7,25086.66,7315.84,32402.50
412030,202011,45,43,2,44945,2090.61,47035.61
412033,202011,54,29,25,30308.03,26126.17,56434.20
412035,202011,73,44,29,45985.55,30307.09,76292.64
412040,202011,44,25,19,26128,19855.64,45983.64
412050,202011,204,154,50,160958.15,53299.86,214258.01
412060,202011,786,573,213,600460.55,222622.78,823083.33
412065,202011,52,32,20,33443.13,20901.92,54345.05
412070,202011,162,109,53,113926.27,56439.77,170366.04
412080,202011,295,145,150,151542.13,157826.28,309368.41
412085,202011,38,16,22,16722.43,22993.09,39715.52
412090,202011,807,510,297,533020.53,310407.6,843428.13
412100,202011,246,207,39,216355.58,40763.84,257119.42
412110,202011,69,54,15,56435.81,15677.44,72113.25
412120,202011,329,195,134,203810.92,140045.3,343856.22
412125,202011,80,50,30,52251.96,31353.75,83605.71
412130,202011,37,23,14,24041.3,14630.11,38671.41
412135,202011,29,16,13,16722.44,13587.53,30309.97
412140,202011,354,227,127,237237.46,133777.72,371015.18
412150,202011,252,166,86,173499.52,89882.03,263381.55
412160,202011,89,51,38,53300.51,39713.03,93013.54
412170,202011,694,473,221,494393.24,230979.71,725372.95
412175,202011,36,25,11,26130.09,11498.91,37629.00
412180,202011,193,146,47,152592.55,49120.3,201712.85
412190,202011,327,259,68,270717.62,72116.71,342834.33
412200,202011,183,119,64,124365.01,66887.04,191252.05
412210,202011,73,56,17,58527.6,17769.62,76297.22
412215,202011,233,166,67,173796.95,71068.48,244865.43
412217,202011,65,52,13,54345.77,13586.58,67932.35
412220,202011,841,586,255,613551.74,266525.62,880077.36
412230,202011,322,197,125,205899.18,130654.16,336553.34
412240,202011,1341,653,688,683552.16,719098.52,1402650.68
412250,202011,409,251,158,262337.3,165130.49,427467.79
412260,202011,110,78,32,82569.76,33442.93,116012.69
412265,202011,178,137,41,143179.29,42846.11,186025.40
412270,202011,86,60,26,62712.73,27174.21,89886.94
412280,202011,90,72,18,75241.77,18811.45,94053.22
412290,202011,93,64,29,66889.28,30307.11,97196.39
412300,202011,211,141,70,147359.68,73156.31,220515.99
412310,202011,50,42,8,43898.14,8360.28,52258.42
412320,202011,98,80,18,83622.96,18813.57,102436.53
412330,202011,185,156,29,163045.14,30307.72,193352.86
412340,202011,158,111,47,116009.25,49119.58,165128.83
412350,202011,626,306,320,319791.78,334434.31,654226.09
412360,202011,26,22,4,22993.62,4180.34,27173.96
412370,202011,162,140,22,146324.57,22991.93,169316.50
412380,202011,256,194,62,202762.86,64798.01,267560.87
412382,202011,56,32,24,33443.1,25082.41,58525.51
412385,202011,151,105,46,110782.17,48077.19,158859.36
412390,202011,278,209,69,219487.87,72114.53,291602.40
412395,202011,70,58,12,60613.74,12540.68,73154.42
412400,202011,95,64,31,66887.61,32397.58,99285.19
412402,202011,229,114,115,119140.08,120191.53,239331.61
412405,202011,872,304,568,317711.1,593597.74,911308.84
412410,202011,971,591,380,617712.67,397166.87,1014879.54
412420,202011,13,12,1,12541.8,1045,13586.8
412430,202011,21,17,4,17769.2,4181.69,21950.89
412440,202011,613,327,286,342801.2,298895.26,641696.46
412450,202011,76,66,10,68981.12,10451.63,79432.75
412460,202011,93,72,21,76295.22,21946.83,98242.05
412470,202011,215,171,44,178737.31,45990.08,224727.39
412480,202011,146,105,41,109737.19,42849.25,152586.44
412490,202011,158,139,19,145272.56,19856.21,165128.77
412500,202011,432,351,81,366858.6,85701.76,452560.36
412510,202011,176,143,33,149475.32,34493.36,183968.68
412520,202011,92,62,30,64802.64,31352.82,96155.46
412530,202011,104,55,49,57481.62,51207.22,108688.84
412535,202011,91,67,24,70028.05,25082.97,95111.02
412540,202011,83,39,44,40756.46,45982.89,86739.35
412545,202011,88,59,29,61665.73,30307.7,91973.43
412550,202011,3829,1589,2240,1660816.8,2344416.65,4005233.45
412555,202011,11,7,4,7316.62,4180.91,11497.53
412560,202011,622,432,190,452559.27,198578.27,651137.54
412570,202011,759,383,376,400300.96,394014.85,794315.81
412575,202011,91,63,28,65846.85,29266.35,95113.20
412580,202011,178,119,59,124390.34,61664.63,186054.97
412590,202011,35,30,5,31354.83,5226.37,36581.20
412600,202011,172,125,47,130641.43,49124.36,179765.79
412610,202011,35,16,19,16720.63,19855.57,36576.20
412620,202011,144,121,23,126479.79,24040.85,150520.64
412625,202011,2134,1103,1031,1153868.14,1077564.82,2231432.96
412627,202011,68,50,18,52263.96,18813.79,71077.75
412630,202011,401,266,135,278039.98,142157.34,420197.32
412635,202011,65,18,47,18811.96,49117.5,67929.46
412640,202011,103,73,30,76301.32,31355.53,107656.85
412650,202011,328,214,114,223673.55,119148.55,342822.10
412660,202011,466,279,187,291598.57,195441.09,487039.66
412665,202011,44,40,4,41805.12,4180.91,45986.03
412667,202011,299,199,100,208002.09,104513.94,312516.03
412670,202011,62,50,12,52257.6,12540.94,64798.54
412680,202011,297,229,68,241436.98,71073.43,312510.41
412690,202011,109,70,39,73158.98,40761.07,113920.05
412700,202011,164,110,54,114960.63,56433.54,171394.17
412710,202011,1377,816,561,852887.3,588431.08,1441318.38
412720,202011,228,140,88,146322.54,91972.56,238295.10
412730,202011,189,160,29,167214.16,30306.85,197521.01
412740,202011,422,220,202,229946.21,212177.05,442123.26
412750,202011,427,241,186,251895.45,194395.12,446290.57
412760,202011,288,146,142,152599.47,148418.36,301017.83
412770,202011,2138,1183,955,1239561.35,1001253.29,2240814.64
412780,202011,137,106,31,110796.7,32402.16,143198.86
412785,202011,285,136,149,142137.95,155715.9,297853.85
412788,202011,38,23,15,24042.21,15679.15,39721.36
412790,202011,121,102,19,106614.75,19861.31,126476.06
412795,202011,151,106,45,110791.95,47037.82,157829.77
412796,202011,313,202,111,211377.14,115998.05,327375.19
412800,202011,628,371,257,387746.58,268595.74,656342.32
412810,202011,2952,1586,1366,1661786.5,1429773.36,3091559.86
412820,202011,929,573,356,598917.36,372089.88,971007.24
412830,202011,14,11,3,11496.89,3135.96,14632.85
412840,202011,236,165,71,172445.69,74202.45,246648.14
412850,202011,743,478,265,499597.53,276959.57,776557.10
412853,202011,172,85,87,88835.3,90925.34,179760.64
412855,202011,182,96,86,100340.27,89887.1,190227.37
412860,202011,93,63,30,65855.5,31355.89,97211.39
412862,202011,57,36,21,37626.73,21945.78,59572.51
412863,202011,7,5,2,5226.5,2090.96,7317.46
412865,202011,46,33,13,34489.28,13586.61,48075.89
412870,202011,109,67,42,71069.67,43899.47,114969.14
412880,202011,91,65,26,68984.09,27173.93,96158.02
420005,202011,41,37,4,38667.77,4180,42847.77
420010,202011,362,231,131,241427.43,136906.78,378334.21
420020,202011,80,67,13,70026.01,13585.67,83611.68
420030,202011,23,20,3,20903.98,3135,24038.98
420040,202011,103,80,23,83616.51,24039.85,107656.36
420050,202011,57,35,22,36582.25,22993.16,59575.41
420055,202011,19,19,0,19861.39,0,19861.39
420060,202011,29,23,6,24042.7,6272.75,30315.45
420070,202011,101,84,17,87796.46,17767.95,105564.41
420075,202011,11,11,0,11495.47,0,11495.47
420080,202011,43,38,5,39717.17,5225.54,44942.71
420090,202011,34,30,4,31354.68,4181.36,35536.04
420100,202011,149,127,22,132746.18,22995.21,155741.39
420110,202011,19,19,0,19858.11,0,19858.11
420120,202011,58,41,17,42855.56,17768.59,60624.15
420125,202011,78,60,18,62707.48,18811.44,81518.92
420127,202011,32,26,6,27171.74,6270.5,33442.24
420130,202011,436,266,170,279050.02,177677.39,456727.41
420140,202011,1295,718,577,752528.93,604136.81,1356665.74
420150,202011,45,37,8,38673.52,8360.94,47034.46
420160,202011,32,30,2,31355.29,2090.84,33446.13
420165,202011,16,11,5,11496.89,5225.61,16722.50
420170,202011,76,49,27,51212.23,28215.63,79427.86
420180,202011,21,18,3,18811.68,3135.8,21947.48
420190,202011,26,23,3,24041.29,3135.63,27176.92
420195,202011,131,63,68,65858.4,71082.63,136941.03
420200,202011,1246,547,699,572760.38,731638.26,1304398.64
420205,202011,89,47,42,49124,43897.44,93021.44
420207,202011,120,66,54,68989.27,56445.34,125434.61
420208,202011,19,15,4,15675.72,4180.4,19856.12
420209,202011,18,15,3,15675.56,3135.07,18810.63
420210,202011,509,236,273,246649.05,285314.39,531963.44
420213,202011,43,35,8,36581.89,8360.8,44942.69
420215,202011,27,24,3,25086.95,3136.42,28223.37
420220,202011,62,40,22,42853.72,22995.44,65849.16
420230,202011,830,468,362,489168.04,380479,869647.04
420240,202011,2212,1434,778,1500808.22,814141.17,2314949.39
420243,202011,41,31,10,32399.06,10452.93,42851.99
420245,202011,161,83,78,86745.7,81523.27,168268.97
420250,202011,62,41,21,42856.77,21949.92,64806.69
420253,202011,29,23,6,24038.87,6272.43,30311.30
420257,202011,13,10,3,10450.87,3135.4,13586.27
420260,202011,99,82,17,85704.44,17768.68,103473.12
420270,202011,30,25,5,26127.48,5225.5,31352.98
420280,202011,287,217,70,226817.58,73163.53,299981.11
420285,202011,22,13,9,13586.69,9406.6,22993.29
420287,202011,49,32,17,33447.24,17768.23,51215.47
420290,202011,970,665,305,695009.77,319810.19,1014819.96
420300,202011,1431,1124,307,1175866.67,321913.25,1497779.92
420310,202011,50,33,17,34488.98,17766.77,52255.75
420315,202011,36,28,8,29267.81,8362.15,37629.96
420320,202011,940,453,487,474524.93,509012.49,983537.42
420325,202011,1,0,1,0,1045,1045
420330,202011,120,78,42,81532.58,43898.09,125430.67
420340,202011,165,110,55,114971.46,58527.33,173498.79
420350,202011,260,182,78,190216.67,81519.64,271736.31
420360,202011,722,550,172,574875.06,179779.04,754654.10
420370,202011,118,69,49,72118.37,51219.15,123337.52
420380,202011,1183,821,362,858083.63,378356.68,1236440.31
420390,202011,240,169,71,176629.01,75248.23,251877.24
420395,202011,192,137,55,144237.36,57486.38,201723.74
420400,202011,244,187,57,195443.43,59572.46,255015.89
420410,202011,59,44,15,45987.54,15676.32,61663.86
420415,202011,35,29,6,30306.67,6270.86,36577.53
420417,202011,49,37,12,38672.86,12543.39,51216.25
420419,202011,11,11,0,11498.62,0,11498.62
420420,202011,2839,1739,1100,1821717.18,1149685.92,2971403.10
420425,202011,69,56,13,58531.33,13587.3,72118.63
420430,202011,1151,817,334,853864.62,349061.16,1202925.78
420435,202011,15,13,2,13590.09,2090.11,15680.20
420440,202011,101,71,30,74207.59,31354.5,105562.09
420445,202011,27,26,1,27175.41,1045,28220.41
420450,202011,76,38,38,39713.83,39713.93,79427.76
420455,202011,207,157,50,164094.62,52262.84,216357.46
420460,202011,2326,1488,838,1555207.79,875861.91,2431069.70
420470,202011,99,73,26,76298.39,27175.41,103473.80
420475,202011,7,7,0,7315,0,7315
420480,202011,839,627,212,658458.01,221578.14,880036.15
420490,202011,101,75,26,78390.13,27174.85,105564.98
420500,202011,450,236,214,246655.11,223655.35,470310.46
420510,202011,20,18,2,18811.9,2090,20901.9
420515,202011,27,17,10,17769.76,10451.31,28221.07
420517,202011,9,9,0,9407.85,0,9407.85
420519,202011,0,,,,,0.0
420520,202011,67,51,16,53309.08,16725.68,70034.76
420530,202011,157,105,52,109736.07,54349.24,164085.31
420535,202011,19,17,2,17766.3,2090,19856.3
420540,202011,5521,3297,2224,3450549.26,2327706.99,5778256.25
420543,202011,32,30,2,31353.85,2090.99,33444.84
420545,202011,204,146,58,152593.02,60620.36,213213.38
420550,202011,852,701,151,733713.64,157819.65,891533.29
420555,202011,38,27,11,28220.73,11499.92,39720.65
420560,202011,61,51,10,53303.75,10451.46,63755.21
420570,202011,160,91,69,95116.13,72121.95,167238.08
420580,202011,278,132,146,137968.31,152606.45,290574.76
420590,202011,509,346,163,361600.29,170343.73,531944.02
420600,202011,117,64,53,66893.02,55395.2,122288.22
420610,202011,40,36,4,37628.05,4181.01,41809.06
420620,202011,88,68,20,71073.95,20903.61,91977.56
420630,202011,150,102,48,106605.45,50167.89,156773.34
420640,202011,83,74,9,77339.7,9406.72,86746.42
420650,202011,242,122,120,127509.35,125424.12,252933.47
420660,202011,49,39,10,40760.41,10452.1,51212.51
420665,202011,34,25,9,26129.86,9406.69,35536.55
420670,202011,293,226,67,236236.02,70032.4,306268.42
420675,202011,11,10,1,10450,1045,11495
420680,202011,37,27,10,28220.49,10451.47,38671.96
420690,202011,176,136,40,142140.23,41804.36,183944.59
420700,202011,683,460,223,480783.39,233081.73,713865.12
420710,202011,144,78,66,81521.78,68980.6,150502.38
420720,202011,110,89,21,93021.44,21948.26,114969.70
420730,202011,613,379,234,396138.46,245629.66,641768.12
420740,202011,50,49,1,52255.4,1045,53300.4
420750,202011,485,329,156,344898.53,164084.47,508983.00
420757,202011,16,14,2,14633.83,2090,16723.83
420760,202011,39,31,8,32401,8360.88,40761.88
420765,202011,80,60,20,62707.11,20902.36,83609.47
420768,202011,48,42,6,43902.87,6270.47,50173.34
420770,202011,71,62,9,64800.89,9405.11,74206.00
420775,202011,41,37,4,38669.66,4180,42849.66
420780,202011,220,173,47,180826.66,49123.44,229950.10
420785,202011,12,9,3,9408.58,3135,12543.58
420790,202011,164,135,29,141098.71,30311.9,171410.61
420800,202011,65,49,16,51212.24,16720.34,67932.58
420810,202011,256,210,46,219491.74,48076.76,267568.50
420820,202011,2375,1342,1033,1402591.15,1080710.12,2483301.27
420830,202011,624,327,297,342831.02,312507.53,655338.55
420840,202011,152,107,45,112869,47029.18,159898.18
420845,202011,412,175,237,182897.69,247708.22,430605.91
420850,202011,257,188,69,196477.62,72111.61,268589.23
420860,202011,55,46,9,48079.5,9405.32,57484.82
420870,202011,127,88,39,91973,40760.56,132733.56
420880,202011,180,114,66,120201.93,68982.63,189184.56
420890,202011,933,464,469,484950.9,491205.17,976156.07
420895,202011,9,9,0,9406.83,0,9406.83
420900,202011,404,318,86,332375.74,89881.41,422257.15
420910,202011,5824,3195,2629,3343502.71,2749805.61,6093308.32
420915,202011,61,57,4,59581.22,4180.5,63761.72
420917,202011,22,15,7,15677.86,7316.58,22994.44
420920,202011,22,15,7,15678.2,7316.39,22994.59
420930,202011,2767,1711,1056,1788677.75,1104805.67,2893483.42
420940,202011,590,433,157,452586.82,164111.54,616698.36
420945,202011,9,7,2,7316.06,2090,9406.06
420950,202011,55,47,8,49121.99,8361.32,57483.31
420960,202011,109,87,22,91978.98,22995.41,114974.39
420970,202011,282,228,54,238327.82,57488.57,295816.39
420980,202011,24,23,1,24038.26,1045,25083.26
420985,202011,56,50,6,52254.76,6270.32,58525.08
420990,202011,82,58,24,60618.18,25087.22,85705.40
421000,202011,43,25,18,26126.59,18812.08,44938.67
421003,202011,49,33,16,34494.69,16723.18,51217.87
421005,202011,7,4,3,4181.54,3136.34,7317.88
421010,202011,774,514,260,541418.16,272796.38,814214.54
421020,202011,25,20,5,20906.17,5225.95,26132.12
421030,202011,117,98,19,102441.89,19859.58,122301.47
421040,202011,72,54,18,56443.03,18818.11,75261.14
421050,202011,351,245,106,256040.84,110776.84,366817.68
421055,202011,21,16,5,16722.97,5225.44,21948.41
421060,202011,89,50,39,52255.29,40760.18,93015.47
421070,202011,50,43,7,44944.73,7316.59,52261.32
421080,202011,34,30,4,31358.06,4181.36,35539.42
421085,202011,22,17,5,17770.5,5226.79,22997.29
421090,202011,36,28,8,29264.95,8361.35,37626.30
421100,202011,125,91,34,95112,35534.52,130646.52
421105,202011,189,152,37,158864.64,38670.86,197535.50
421110,202011,108,85,23,88844.69,24040.24,112884.93
421120,202011,168,122,46,128548.5,48080.3,176628.8
421125,202011,17,12,5,12541.18,5225.46,17766.64
421130,202011,830,516,314,539303.46,328184.12,867487.58
421140,202011,32,22,10,22992.58,10453.83,33446.41
421145,202011,42,34,8,35534.75,8360.74,43895.49
421150,202011,100,71,29,74214.16,30313.67,104527.83
421160,202011,66,45,21,47030.98,21947.48,68978.46
421165,202011,16,14,2,14631.44,2090.17,16721.61
421170,202011,183,154,29,161089.5,30312.75,191402.25
421175,202011,162,110,52,114973.36,54349.43,169322.79
421180,202011,46,32,14,33446.95,14635.06,48082.01
421185,202011,18,14,4,14632.91,4180.27,18813.18
421187,202011,1,0,1,0,1045,1045
421189,202011,46,31,15,32399.68,15677.49,48077.17
421190,202011,1704,1058,646,1105869.6,676264.74,1782134.34
421200,202011,93,69,24,72115.98,25083.37,97199.35
421205,202011,28,19,9,19859.58,9406.25,29265.83
421210,202011,173,117,56,122286.33,58530.36,180816.69
421220,202011,272,208,64,217390.41,66890.64,284281.05
421223,202011,45,36,9,37626.17,9405.78,47031.95
421225,202011,70,45,25,47035.45,26134.31,73169.76
421227,202011,85,67,18,70019.4,18810.8,88830.2
421230,202011,57,42,15,43899.25,15679.3,59578.55
421240,202011,17,17,0,17770.02,0,17770.02
421250,202011,368,212,156,223669.52,163049.24,386718.76
421260,202011,24,20,4,20904.21,4180.49,25084.70
421265,202011,2,2,0,2090.56,1045,3135.56
421270,202011,48,42,6,43898.2,6270.22,50168.42
421280,202011,351,184,167,192315.44,174552.58,366868.02
421290,202011,327,216,111,225744.05,116004.87,341748.92
421300,202011,23,19,4,19858.6,4180,24038.6
421310,202011,46,33,13,34490.32,13588.51,48078.83
421315,202011,30,18,12,18814.38,12541.2,31355.58
421320,202011,128,82,46,85701.51,48075.71,133777.22
421330,202011,113,80,33,83614.37,34492.46,118106.83
421335,202011,39,27,12,28217.88,12540.74,40758.62
421340,202011,238,155,83,162004.67,86749.21,248753.88
421350,202011,187,106,81,111845.93,84662.74,196508.67
421360,202011,651,471,180,493327.04,188137.06,681464.10
421370,202011,195,148,47,154687.93,49120.59,203808.52
421380,202011,134,104,30,108705.93,31358.27,140064.20
421390,202011,18,12,6,12540.01,6270,18810.01
421400,202011,119,104,15,109731.96,15676.23,125408.19
421410,202011,17,15,2,15678.57,2090,17768.57
421415,202011,19,18,1,18814.07,1045,19859.07
421420,202011,128,105,23,109734.12,24036.08,133770.20
421430,202011,17,13,4,13590.41,4180,17770.41
421440,202011,56,48,8,50169.28,8361.96,58531.24
421450,202011,92,76,16,79433.35,16724.42,96157.77
421460,202011,63,50,13,52262.13,13587.22,65849.35
421470,202011,68,41,27,42856.64,29266.7,72123.34
421480,202011,722,551,171,576886.11,178706.99,755593.10
421490,202011,23,22,1,22994.92,1045,24039.92
421500,202011,487,311,176,326098.68,184990.74,511089.42
421505,202011,24,17,7,17769.35,7315.88,25085.23
421507,202011,32,25,7,26129.39,7315.55,33444.94
421510,202011,72,47,25,49127.35,26128.26,75255.61
421520,202011,56,47,9,49122.92,9407.57,58530.49
421530,202011,48,41,7,42852.96,7315.68,50168.64
421535,202011,25,23,2,24044.93,2090,26134.93
421540,202011,52,44,8,45988.36,8360.07,54348.43
421545,202011,103,74,29,77351.93,30309.6,107661.53
421550,202011,284,204,80,213233.92,83617.85,296851.77
421555,202011,19,16,3,16726.08,3135.92,19862.00
421560,202011,9,8,1,8361.51,1045.4,9406.91
421565,202011,120,81,39,84663.01,40764.8,125427.81
421567,202011,31,24,7,25084.96,7315,32399.96
421568,202011,33,29,4,30306.59,4180.67,34487.26
421569,202011,11,11,0,11496.87,0,11496.87
421570,202011,201,138,63,145286.28,65846.15,211132.43
421575,202011,28,23,5,24037.79,5225.44,29263.23
421580,202011,724,428,296,448437.92,309361.81,757799.73
421590,202011,21,19,2,19860.03,2090.02,21950.05
421600,202011,155,101,54,105552.66,56433.61,161986.27
421605,202011,106,73,33,76293.7,34489.18,110782.88
421610,202011,181,137,44,143181.76,45987.33,189169.09
421620,202011,1022,596,426,623969.64,446296.35,1070265.99
421625,202011,20,17,3,17767.2,3135.23,20902.43
421630,202011,307,191,116,200681.9,121247.08,321928.98
421635,202011,18,9,9,9407.42,9408.12,18815.54
421640,202011,101,84,17,87804.46,17768.86,105573.32
421650,202011,295,173,122,180828.38,127517.55,308345.93
421660,202011,2251,1338,913,1398486.26,954301.03,2352787.29
421670,202011,181,131,50,136907.65,52251.49,189159.14
421680,202011,177,161,16,168273.88,16722.4,184996.28
421690,202011,340,239,101,250840.72,105564.13,356404.85
421700,202011,53,36,17,37625.36,17766.92,55392.28
421710,202011,25,23,2,24038.2,2090,26128.2
421715,202011,5,4,1,4180.44,1045,5225.44
421720,202011,626,437,189,456716.29,197521.87,654238.16
421725,202011,17,6,11,6272.33,11497.23,17769.56
421730,202011,33,24,9,25085.39,9409.16,34494.55
421740,202011,91,32,59,33445.49,61658.26,95103.75
421750,202011,206,153,53,159900.53,55391.22,215291.75
421755,202011,23,21,2,21947.84,2090.44,24038.28
421760,202011,101,67,34,70025.09,35537.57,105562.66
421770,202011,659,405,254,425400.01,267572.99,692973.00
421775,202011,27,16,11,16723.97,11497.66,28221.63
421780,202011,190,146,44,152588.38,45982.45,198570.83
421790,202011,148,126,22,131687.47,22993.45,154680.92
421795,202011,17,14,3,14633.02,3135,17768.02
421800,202011,515,322,193,338673.18,201726.65,540399.83
421810,202011,68,54,14,56440.45,14632.82,71073.27
421820,202011,306,199,107,209033.57,111826.6,320860.17
421825,202011,141,120,21,125428.51,21949.67,147378.18
421830,202011,139,88,51,93028.03,53304.53,146332.56
421835,202011,7,4,3,4180.99,3135.04,7316.03
421840,202011,46,41,5,42853.04,5227.37,48080.41
421850,202011,80,67,13,70029.53,13588.71,83618.24
421860,202011,40,31,9,32401.72,9405.48,41807.20
421870,202011,1018,757,261,793307.62,272795.36,1066102.98
421875,202011,54,44,10,45989.78,10450.89,56440.67
421880,202011,170,119,51,124366.75,53298.79,177665.54
421885,202011,22,17,5,17767.45,5225.34,22992.79
421890,202011,134,93,41,97205.45,42857.23,140062.68
421895,202011,45,40,5,41808.22,5226.41,47034.63
421900,202011,154,120,34,125435.88,35540.84,160976.72
421910,202011,64,36,28,37627.02,29264.66,66891.68
421915,202011,30,24,6,25083.98,6270.8,31354.78
421917,202011,37,28,9,29262.67,9405.44,38668.11
421920,202011,39,35,4,36584.56,4180,40764.56
421930,202011,656,526,130,551860.97,136921.66,688782.63
421935,202011,52,45,7,47031.05,7316.98,54348.03
421940,202011,44,37,7,38669.17,7315.44,45984.61
421950,202011,872,583,289,610359.64,302054.63,912414.27
421960,202011,45,40,5,41805.45,5225,47030.45
421970,202011,343,221,122,230975.38,127506.94,358482.32
421985,202011,20,12,8,12544.1,8363.55,20907.65
422000,202011,0,,,,,0.0
430003,202011,196,54,142,56465.5,148391.05,204856.55
430005,202011,36,23,13,24037.93,14630.67,38668.60
430010,202011,269,196,73,204830.91,76287.57,281118.48
430020,202011,142,93,49,97198.6,51210.3,148408.9
430030,202011,123,98,25,102420.59,26126.99,128547.58
430040,202011,2915,1715,1200,1792306,1256190.08,3048496.08
430045,202011,65,54,11,56430,11495.74,67925.74
430047,202011,7,7,0,7315,0,7315
430050,202011,79,64,15,66885,15675,82560
430055,202011,11,10,1,10450.34,1045,11495.34
430057,202011,5,4,1,4180,1045,5225
430060,202011,3701,2135,1566,2235590.74,1642992.37,3878583.11
430063,202011,55,50,5,52252.24,5225.23,57477.47
430064,202011,154,123,31,128537.47,32395,160932.47
430066,202011,5,2,3,2090.4,3135.6,5226.0
430070,202011,42,29,13,30306.32,14631.07,44937.39
430080,202011,69,45,24,47028.58,25080.75,72109.33
430085,202011,29,10,19,10451.1,19857.76,30308.86
430087,202011,30,18,12,18813.63,12543.68,31357.31
430090,202011,71,64,7,66882.27,7315,74197.27
430100,202011,126,84,42,87787.01,43893.46,131680.47
430105,202011,151,85,66,88846.23,70027.58,158873.81
430107,202011,18,12,6,12543.7,6271.96,18815.66
430110,202011,457,256,201,267539.58,210053.66,477593.24
430120,202011,160,148,12,154666.65,12540.91,167207.56
430130,202011,798,485,313,507906.99,329190.36,837097.35
430140,202011,124,115,9,120185.4,9405.4,129590.8
430150,202011,109,69,40,72111.76,41800.44,113912.20
430155,202011,33,28,5,29264.53,5225,34489.53
430160,202011,3608,2107,1501,2204141.26,1570801.2,3774942.46
430163,202011,356,153,203,159898.13,212149.15,372047.28
430165,202011,30,20,10,20900,10450,31350
430170,202011,88,73,15,76288.52,15675,91963.52
430175,202011,74,58,16,60610.79,16720,77330.79
430180,202011,105,86,19,89877.69,19855,109732.69
430185,202011,29,18,11,18810,11495,30305
430187,202011,78,36,42,37621.63,43890.14,81511.77
430190,202011,217,118,99,123319.89,103462.86,226782.75
430192,202011,13,11,2,11496.12,2090.31,13586.43
430195,202011,16,10,6,10450,6270,16720
430200,202011,164,141,23,147361.81,24038.44,171400.25
430205,202011,20,20,0,20900.67,0,20900.67
430210,202011,669,512,157,537160.35,164072.39,701232.74
430215,202011,11,10,1,10450,1045,11495
430220,202011,75,51,24,53298.27,25080,78378.27
430222,202011,13,6,7,6270,7315.67,13585.67
430223,202011,15,8,7,8360,7315,15675
430225,202011,2,1,1,1045,1045,2090
430230,202011,305,180,125,188117.71,130631.42,318749.13
430235,202011,53,41,12,42850.14,12540.34,55390.48
430237,202011,28,21,7,21946.15,7315.34,29261.49
430240,202011,120,79,41,82557.49,42845.46,125402.95
430245,202011,71,58,13,60614.91,13586.95,74201.86
430250,202011,181,106,75,110777.37,78375,189152.37
430258,202011,8,7,1,7316.37,1045,8361.37
430260,202011,31,27,4,28217.13,4180,32397.13
430265,202011,38,32,6,33441.91,6270.17,39712.08
430270,202011,516,386,130,404456.78,135863.72,540320.50
430280,202011,1040,624,416,653155.72,434739.46,1087895.18
430290,202011,401,218,183,227824.94,191243.66,419068.60
430300,202011,2113,1162,951,1216523.56,995995.79,2212519.35
430310,202011,2019,1003,1016,1052454.4,1062904.27,2115358.67
430320,202011,54,46,8,48070,8360,56430
430330,202011,99,87,12,90922.09,12540,103462.09
430340,202011,72,57,15,59569.82,15675.34,75245.16
430350,202011,1658,1116,542,1166308.22,566429.51,1732737.73
430355,202011,21,19,2,19856.04,2090,21946.04
430360,202011,85,43,42,44935.8,43890.56,88826.36
430367,202011,34,25,9,26126.38,9405.84,35532.22
430370,202011,53,48,5,50161.03,5225,55386.03
430380,202011,124,96,28,100327.72,29260.8,129588.52
430390,202011,588,368,220,384610.18,229936.45,614546.63
430400,202011,257,184,73,192286.03,76287.7,268573.73
430410,202011,54,43,11,44935.67,11495.44,56431.11
430420,202011,503,324,179,339659.46,187068.15,526727.61
430430,202011,55,54,1,55740.21,1045,56785.21
430435,202011,151,112,39,117045.63,40757.13,157802.76
430440,202011,483,316,167,330253.3,175571.83,505825.13
430450,202011,1142,940,202,985532.17,211115.27,1196647.44
430460,202011,5304,2746,2558,2874080.32,2676526.77,5550607.09
430461,202011,16,15,1,15675,1045,16720
430462,202011,7,3,4,3136.37,4180.99,7317.36
430463,202011,1116,595,521,621852.31,545560.49,1167412.80
430465,202011,24,13,11,13586.43,11495.08,25081.51
430466,202011,647,453,194,475524.48,202745.29,678269.77
430467,202011,107,58,49,60612.57,51207.03,111819.60
430468,202011,116,69,47,72112.26,49117.74,121230.00
430469,202011,21,16,5,16725.68,5226.01,21951.69
430470,202011,1149,639,510,668109.97,537171.48,1205281.45
430471,202011,54,36,18,37625.75,18812.86,56438.61
430480,202011,102,66,36,70016.69,38666.35,108683.04
430485,202011,7,7,0,7315.97,0,7315.97
430490,202011,73,59,14,61659.09,14630.45,76289.54
430495,202011,34,25,9,26126.27,9405.84,35532.11
430500,202011,188,126,62,132720.33,64791.82,197512.15
430510,202011,3440,2202,1238,2304402.2,1294835.22,3599237.42
430511,202011,16,16,0,16721.93,0,16721.93
430512,202011,153,106,47,110779.42,50166.82,160946.24
430513,202011,54,44,10,45982.94,10450,56432.94
430515,202011,28,26,2,27170.34,2090,29260.34
430517,202011,169,146,23,152576.7,24035.67,176612.37
430520,202011,337,233,104,244544.9,108688.87,353233.77
430530,202011,84,47,37,49116.32,38667.73,87784.05
430535,202011,440,299,141,312483.09,148401.17,460884.26
430537,202011,10,10,0,10451.07,0,10451.07
430540,202011,82,57,25,59565.34,26125,85690.34
430543,202011,360,112,248,117044.22,259185.19,376229.41
430544,202011,43,40,3,41811.71,3136.07,44947.78
430545,202011,380,185,195,194389.48,203801.79,398191.27
430550,202011,41,33,8,34487.29,8361.43,42848.72
430558,202011,2,2,0,2090,0,2090
430560,202011,55,29,26,30305,27170,57475
430570,202011,106,41,65,42850.79,67925.88,110776.67
430580,202011,131,105,26,109728.37,27171.3,136899.67
430583,202011,13,13,0,13585.62,0,13585.62
430585,202011,10,5,5,5225,5225,10450
430587,202011,15,7,8,7315,9406.81,16721.81
430590,202011,142,116,26,121225.01,27172.73,148397.74
430593,202011,2,2,0,2090,0,2090
430595,202011,17,14,3,14630.99,3135,17765.99
430597,202011,43,22,21,22992.23,21947.75,44939.98
430600,202011,214,158,56,166162.51,59565,225727.51
430605,202011,157,97,60,101367.83,62700,164067.83
430607,202011,25,20,5,20903.19,5225.5,26128.69
430610,202011,1639,759,880,794255.96,919644.57,1713900.53
430613,202011,3,3,0,3135.67,0,3135.67
430620,202011,110,77,33,80465.88,34486.76,114952.64
430630,202011,46,40,6,41803.33,6270,48073.33
430632,202011,32,27,5,28215.68,5225,33440.68
430635,202011,35,31,4,32395.68,4180,36575.68
430637,202011,63,30,33,31350.74,34485,65835.74
430640,202011,181,97,84,101373.4,88838.1,190211.5
430642,202011,21,17,4,17765.17,4180.4,21945.57
430645,202011,33,27,6,28215.67,6270,34485.67
430650,202011,241,198,43,206944.88,45981.17,252926.05
430655,202011,2,2,0,2090.26,0,2090.26
430660,202011,980,485,495,506884.19,517332.75,1024216.94
430670,202011,78,52,26,54340.78,27170.54,81511.32
430673,202011,70,42,28,43892.61,29260.27,73152.88
430675,202011,11,9,2,9405.79,2090.58,11496.37
430676,202011,526,311,215,325027.56,224699.08,549726.64
430680,202011,230,158,72,165126.7,75244.55,240371.25
430690,202011,526,323,203,338618.2,212152.95,550771.15
430692,202011,9,7,2,7316.18,2090.54,9406.72
430693,202011,138,88,50,91966.23,52253.97,144220.20
430695,202011,64,53,11,55385.12,11495,66880.12
430697,202011,58,36,22,37621.16,22990.71,60611.87
430700,202011,1470,1013,457,1059728.72,478655.37,1538384.09
430705,202011,26,23,3,24035.11,3135,27170.11
430710,202011,251,159,92,166161.4,96140,262301.4
430720,202011,108,93,15,97186.66,15675,112861.66
430730,202011,139,119,20,124359.15,20900,145259.15
430740,202011,74,51,23,53298.14,24035.12,77333.26
430745,202011,30,23,7,24036.58,7315,31351.58
430750,202011,327,218,109,227816.36,113907.24,341723.60
430755,202011,88,46,42,49118.61,43892.93,93011.54
430760,202011,386,212,174,221567.74,181903.14,403470.88
430770,202011,1492,773,719,809991.85,753552.64,1563544.49
430780,202011,300,188,112,196464.02,117043.58,313507.60
430781,202011,25,21,4,21949.22,4180.34,26129.56
430783,202011,61,50,11,52250.67,11495,63745.67
430786,202011,5,3,2,3135,2090,5225
430790,202011,517,339,178,354281.6,186024.88,540306.48
430800,202011,151,121,30,127498.09,31351.17,158849.26
430805,202011,42,35,7,36578.41,7315,43893.41
430807,202011,44,23,21,24035.61,21945,45980.61
430810,202011,74,44,30,45982.4,31350.54,77332.94
430820,202011,143,84,59,87784.99,61655.64,149440.63
430825,202011,10,8,2,8360.59,2090,10450.59
430830,202011,237,218,19,227822.14,19855.95,247678.09
430840,202011,128,84,44,87787.93,45982.01,133769.94
430843,202011,5,3,2,3135.44,2090,5225.44
430845,202011,73,40,33,41801.44,34485,76286.44
430850,202011,582,417,165,436830.39,172431.65,609262.04
430860,202011,156,99,57,103459.03,59567.36,163026.39
430865,202011,74,40,34,41801.87,35530.64,77332.51
430870,202011,83,68,15,71067.55,15675.45,86743.00
430880,202011,153,111,42,116001.73,43892.93,159894.66
430885,202011,11,9,2,9405.45,2090,11495.45
430890,202011,338,202,136,211095.65,142121.82,353217.47
430900,202011,512,355,157,372035.16,164068.33,536103.49
430905,202011,124,52,72,54340.37,75241.92,129582.29
430910,202011,279,157,122,164088.44,128546.07,292634.51
430912,202011,6,5,1,5225,1045.34,6270.34
430915,202011,34,30,4,31350.54,4180,35530.54
430920,202011,4334,2290,2044,2396530.07,2138400.12,4534930.19
430925,202011,5,4,1,4180,1045,5225
430930,202011,2075,1194,881,1248940.9,920764.77,2169705.67
430940,202011,254,166,88,174529.32,93010.06,267539.38
430950,202011,158,129,29,134813.27,30305.55,165118.82
430955,202011,24,13,11,13585.34,11495,25080.34
430957,202011,17,15,2,15677,2090,17767
430960,202011,245,163,82,170341.1,85691.18,256032.28
430965,202011,112,71,41,74196.65,42846.34,117042.99
430970,202011,88,72,16,75241.31,16720.68,91961.99
430975,202011,43,38,5,39711.55,5225.34,44936.89
430980,202011,46,28,18,29262.57,18811.45,48074.02
430990,202011,100,77,23,80467.23,24035,104502.23
430995,202011,113,107,6,111818.92,6270.4,118089.32
431000,202011,292,140,152,146314.41,159891.24,306205.65
431010,202011,348,195,153,203797.72,159905.73,363703.45
431020,202011,1854,1063,791,1110940.45,827706.45,1938646.90
431030,202011,38,31,7,32397.05,7315,39712.05
431033,202011,401,190,211,199621.72,221572.72,421194.44
431036,202011,11,6,5,6270.73,5225,11495.73
431040,202011,142,87,55,90919.38,57477.88,148397.26
431041,202011,40,26,14,27171.01,14630.87,41801.88
431043,202011,43,26,17,27172.1,17765.39,44937.49
431046,202011,11,8,3,8360.78,3135.44,11496.22
431050,202011,197,124,73,129588.64,76285.88,205874.52
431053,202011,65,39,26,41803.62,27174.08,68977.70
431055,202011,63,43,20,44936.67,20900.08,65836.75
431057,202011,18,18,0,18810.09,0,18810.09
431060,202011,1608,1047,561,1095205.23,586267.54,1681472.77
431065,202011,17,11,6,11495.81,6270,17765.81
431070,202011,66,61,5,63746.44,5225,68971.44
431075,202011,7,7,0,7317.75,0,7317.75
431080,202011,135,80,55,83607.41,57478.71,141086.12
431085,202011,34,31,3,32397.17,3135,35532.17
431087,202011,16,14,2,14630.27,2090,16720.27
431090,202011,55,43,12,44935,12540,57475
431100,202011,1217,728,489,760817.8,511049.61,1271867.41
431110,202011,227,138,89,145270.41,93009.49,238279.90
431112,202011,26,16,10,16723.62,10452.1,27175.72
431113,202011,35,25,10,26126.41,10450,36576.41
431115,202011,159,110,49,114957.91,51205.61,166163.52
431120,202011,601,358,243,374132.08,253949.47,628081.55
431123,202011,3,2,1,2090.74,1045.77,3136.51
431125,202011,94,84,10,87781.01,10450.34,98231.35
431127,202011,10,5,5,5225,5225.67,10450.67
431130,202011,700,457,243,477588.56,253943.57,731532.13
431140,202011,742,511,231,534029.22,242454.75,776483.97
431142,202011,25,21,4,21950.7,4181.27,26131.97
431150,202011,190,143,47,150492.16,49116.51,199608.67
431160,202011,47,44,3,45981.94,3135,49116.94
431162,202011,5,4,1,4181.21,1045,5226.21
431164,202011,6,6,0,6270,0,6270
431170,202011,105,83,22,86740.04,22990,109730.04
431171,202011,67,40,27,41800.66,28215,70015.66
431173,202011,1,1,0,1045.93,0,1045.93
431175,202011,197,99,98,103459.35,102414.44,205873.79
431177,202011,83,60,23,62710.72,24037.37,86748.09
431179,202011,13,11,2,11496.5,2090.78,13587.28
431180,202011,430,261,169,272755.54,176611.6,449367.14
431190,202011,79,60,19,62704.49,19855,82559.49
431198,202011,74,54,20,56432.67,20900.67,77333.34
431200,202011,20,16,4,16720,4180,20900
431205,202011,21,20,1,20900.67,1045,21945.67
431210,202011,95,60,35,62703.91,36578.16,99282.07
431213,202011,30,26,4,27174.48,4182.18,31356.66
431215,202011,22,19,3,19855.34,3135,22990.34
431217,202011,5,4,1,4181.53,1045,5226.53
431220,202011,65,56,9,58521.85,9405.34,67927.19
431225,202011,154,99,55,103455,57475.34,160930.34
431230,202011,98,85,13,88827.23,13585,102412.23
431235,202011,7,7,0,7315,0,7315
431237,202011,18,14,4,14631.43,4180.2,18811.63
431238,202011,11,7,4,7315.86,4180.78,11496.64
431240,202011,1015,633,382,661566.33,401327.55,1062893.88
431242,202011,39,38,1,39712.63,1045,40757.63
431244,202011,14,10,4,10453.27,4180.27,14633.54
431245,202011,52,38,14,39711.43,14631.34,54342.77
431247,202011,11,6,5,6270,5225.5,11495.5
431250,202011,278,142,136,148405.76,142136.32,290542.08
431260,202011,59,47,12,49116.18,12540,61656.18
431261,202011,18,11,7,11495,7315.34,18810.34
431262,202011,15,14,1,14630.24,1045,15675.24
431265,202011,148,79,69,82557.43,72106.22,154663.65
431267,202011,17,14,3,14632.42,3135.66,17768.08
431270,202011,322,262,60,273807.45,62704.46,336511.91
431275,202011,39,36,3,37622.76,3135,40757.76
431280,202011,21,17,4,17765.97,4180,21945.97
431290,202011,23,20,3,20901.18,3135,24036.18
431295,202011,2,2,0,2090.34,0,2090.34
431300,202011,22,20,2,20900.38,2090,22990.38
431301,202011,5,5,0,5225.34,0,5225.34
431303,202011,61,39,22,40757.77,22990.88,63748.65
431306,202011,241,129,112,134627.98,118088.18,252716.16
431308,202011,8,6,2,6270,2090,8360
431310,202011,62,51,11,53297.64,11495,64792.64
431320,202011,154,93,61,97190.69,63745.83,160936.52
431330,202011,181,111,70,116003,73152.35,189155.35
431333,202011,24,19,5,19857.41,5225.33,25082.74
431335,202011,9,5,4,5225,4180.44,9405.44
431337,202011,357,157,200,164075.49,209011.87,373087.36
431339,202011,20,18,2,18811.18,2090,20901.18
431340,202011,3035,1652,1383,1726485.6,1448512.07,3174997.67
431342,202011,36,24,12,25081.73,12540.6,37622.33
431344,202011,18,18,0,18810.6,0,18810.6
431346,202011,5,5,0,5225,0,5225
431349,202011,35,31,4,32395,4180,36575
431350,202011,925,530,395,553936.91,413885.62,967822.53
431360,202011,50,42,8,43890,8360,52250
431365,202011,340,152,188,158862.39,197517.43,356379.82
431370,202011,1207,689,518,721090.79,542378.64,1263469.43
431380,202011,95,83,12,86742.58,12540,99282.58
431390,202011,503,266,237,279032.25,247720.86,526753.11
431395,202011,299,127,172,132727.39,179753.63,312481.02
431400,202011,46,30,16,31352.79,16720,48072.79
431402,202011,106,76,30,79426.78,31350.44,110777.22
431403,202011,23,14,9,14630.41,9406.51,24036.92
431405,202011,679,374,305,390868.85,318763.21,709632.06
431406,202011,30,25,5,26128.87,5225,31353.87
431407,202011,53,41,12,42845.55,12540.44,55385.99
431410,202011,3365,2051,1314,2146659.23,1374306.82,3520966.05
431413,202011,15,12,3,12541.78,3135.36,15677.14
431415,202011,65,49,16,51214.91,16723.16,67938.07
431417,202011,25,12,13,12540,13585,26125
431420,202011,321,218,103,227833.38,107643.91,335477.29
431430,202011,53,23,30,24035.11,31350.44,55385.55
431440,202011,8872,6137,2735,6421225.07,2863699.52,9284924.59
431442,202011,28,13,15,13585.72,15676.27,29261.99
431445,202011,26,24,2,25080,2090,27170
431446,202011,5,4,1,4180.33,1045,5225.33
431447,202011,85,59,26,61658.95,27170,88828.95
431449,202011,51,43,8,44935.1,8360.67,53295.77
431450,202011,412,273,139,285295.05,145256.38,430551.43
431454,202011,8,3,5,3135,5226.43,8361.43
431455,202011,51,40,11,42855.36,11496.69,54352.05
431460,202011,510,353,157,368926.58,164078.09,533004.67
431470,202011,115,87,28,90920.35,29262.23,120182.58
431475,202011,10,8,2,8360.47,2090.79,10451.26
431477,202011,36,23,13,24035.14,13585.17,37620.31
431478,202011,9,8,1,8360.96,1045,9405.96
431480,202011,519,310,209,325027.2,218426.07,543453.27
431490,202011,28471,15835,12636,16565564.78,13224338.84,29789903.62
431500,202011,78,64,14,66884.11,14630.54,81514.65
431505,202011,25,15,10,15675.98,10450.77,26126.75
431507,202011,9,7,2,7317.53,2090,9407.53
431510,202011,258,181,77,189153.6,80466.11,269619.71
431513,202011,24,21,3,21947.5,3135.11,25082.61
431514,202011,5,4,1,4180,1045,5225
431515,202011,81,67,14,70018.28,14630,84648.28
431517,202011,7,3,4,3135.84,4180.5,7316.34
431520,202011,40,36,4,37622.13,4180,41802.13
431530,202011,1450,653,797,682418.68,832900.61,1515319.29
431531,202011,24,23,1,24037.38,1045,25082.38
431532,202011,33,24,9,25080.55,9405,34485.55
431535,202011,27,15,12,15678.26,12540.4,28218.66
431540,202011,140,120,20,125402.46,20900.68,146303.14
431545,202011,14,12,2,12542.91,2090,14632.91
431550,202011,345,190,155,198571.55,161986.7,360558.25
431555,202011,12,12,0,12540,0,12540
431560,202011,4514,3082,1432,3226283.99,1496627.93,4722911.92
431570,202011,813,423,390,442079.13,407586.05,849665.18
431575,202011,44,24,20,25081.41,20901.55,45982.96
431580,202011,93,61,32,63746.43,33440.14,97186.57
431590,202011,138,117,21,122267.09,21945.5,144212.59
431595,202011,19,15,4,15678.65,4180.96,19859.61
431600,202011,244,142,102,148405.4,106596.34,255001.74
431610,202011,115,84,31,87787.29,32395.67,120182.96
431620,202011,43,36,7,37622.32,7315,44937.32
431630,202011,129,106,23,110773.05,24035.84,134808.89
431640,202011,1337,841,496,878898.47,518350.31,1397248.78
431642,202011,36,34,2,35530,2090,37620
431643,202011,46,21,25,21946.25,26130.64,48076.89
431645,202011,309,184,125,192284.92,131672.01,323956.93
431647,202011,9,8,1,8360.34,1045,9405.34
431650,202011,35,23,12,24035.88,12541.6,36577.48
431660,202011,282,177,105,184970.83,109726.82,294697.65
431670,202011,226,102,124,106594.57,129581.78,236176.35
431673,202011,7,7,0,7315.95,0,7315.95
431675,202011,26,21,5,21946.28,5225,27171.28
431680,202011,1124,828,296,868486.83,309356.58,1177843.41
431690,202011,4737,2822,1915,2951395.86,2002421.35,4953817.21
431695,202011,22,16,6,16721.01,6270,22991.01
431697,202011,1,0,1,0,1045.44,1045.44
431700,202011,181,139,42,145259.01,43890.75,189149.76
431710,202011,3993,1735,2258,1815354.72,2360942.12,4176296.84
431720,202011,1325,812,513,849109.4,537160.88,1386270.28
431725,202011,2,1,1,1045,1045.67,2090.67
431730,202011,1161,784,377,819390.33,394021.06,1213411.39
431740,202011,1352,660,692,689751.7,723186.44,1412938.14
431750,202011,1825,1184,641,1239483.52,669909.13,1909392.65
431755,202011,6,5,1,5225.4,1045.49,6270.89
431760,202011,1032,649,383,678315.71,400304.72,1078620.43
431770,202011,412,294,118,307241.86,123311.93,430553.79
431775,202011,26,19,7,19858.7,7315.34,27174.04
431780,202011,541,323,218,337537.95,227810.46,565348.41
431790,202011,163,125,38,131678.02,39710.89,171388.91
431795,202011,12,10,2,10450,2090,12540
431800,202011,3185,1661,1524,1735918.41,1593815.01,3329733.42
431805,202011,21,19,2,19855,2090,21945
431810,202011,598,393,205,410718.24,214233.55,624951.79
431820,202011,325,192,133,200649.27,140031.7,340680.97
431830,202011,2290,1370,920,1431732.98,962520.53,2394253.51
431840,202011,481,318,163,334429.57,170348.28,504777.85
431842,202011,32,26,6,27170,6270,33440
431843,202011,12,9,3,9405.4,3135.47,12540.87
431844,202011,19,15,4,15675,4180,19855
431845,202011,27,25,2,26125.4,2090.44,28215.84
431846,202011,26,22,4,22991.52,4180,27171.52
431848,202011,10,8,2,8360.57,2090,10450.57
431849,202011,7,6,1,6270.8,1045,7315.8
431850,202011,780,630,150,660514.85,156767.54,817282.39
431860,202011,113,77,36,81514.72,38665.44,120180.16
431861,202011,6,2,4,2090.36,4180.78,6271.14
431862,202011,56,37,19,38666.51,19857.69,58524.20
431870,202011,3503,2004,1499,2095514.21,1568749.49,3664263.70
431880,202011,927,673,254,703330,265441.71,968771.71
431890,202011,1322,785,537,820368.69,561185.2,1381553.89
431900,202011,179,125,54,130628.92,56430.84,187059.76
431910,202011,52,38,14,39710.8,14632.05,54342.85
431912,202011,42,26,16,27171.19,16720.6,43891.79
431915,202011,122,94,28,98230.44,29260.8,127491.24
431920,202011,159,114,45,119138.02,47025.44,166163.46
431930,202011,79,66,13,68973.07,13585,82558.07
431935,202011,3,3,0,3135,0,3135
431936,202011,9,8,1,8360.5,1045,9405.5
431937,202011,19,14,5,14631.26,5225.17,19856.43
431940,202011,456,304,152,318745.72,158848.54,477594.26
431950,202011,490,311,179,325046.13,187086.4,512132.53
431960,202011,729,394,335,411768.38,350085.44,761853.82
431970,202011,70,63,7,65840.54,7316.11,73156.65
431971,202011,3,3,0,3135,0,3135
431973,202011,21,17,4,17767.58,4180,21947.58
431975,202011,9,8,1,8360,1045,9405
431980,202011,210,130,80,135855.99,83603.9,219459.89
431990,202011,1127,604,523,632255.16,548728.03,1180983.19
432000,202011,1741,910,831,952129.13,868534.69,1820663.82
432010,202011,272,186,86,195420.33,89872.5,285292.83
432020,202011,171,141,30,147354.23,31350,178704.23
432023,202011,17,14,3,14630,3135.19,17765.19
432026,202011,67,60,7,62703.26,7315.32,70018.58
432030,202011,66,33,33,34485,34485.86,68970.86
432032,202011,19,15,4,15676.49,4180.67,19857.16
432035,202011,55,44,11,45983.21,11495.72,57478.93
432040,202011,95,66,29,68974.9,30305.78,99280.68
432045,202011,5,4,1,4180.34,1045,5225.34
432050,202011,81,48,33,50165.49,35530.51,85696.00
432055,202011,125,92,33,96145.51,34486.43,130631.94
432057,202011,8,6,2,6270.58,2090,8360.58
432060,202011,34,31,3,32397.63,3135,35532.63
432065,202011,32,28,4,30305,4180,34485
432067,202011,88,79,9,82556.8,9405,91961.8
432070,202011,385,297,88,310657.53,91967.68,402625.21
432080,202011,817,567,250,593623.09,261266.73,854889.82
432085,202011,9,7,2,7315.21,2090,9405.21
432090,202011,263,174,89,181841.3,94053.05,275894.35
432100,202011,170,111,59,117044.35,61657.34,178701.69
432110,202011,549,365,184,381453.5,194378.61,575832.11
432120,202011,961,549,412,573745.08,430573.7,1004318.78
432130,202011,477,340,137,355331.93,143176.26,498508.19
432132,202011,24,21,3,21945.67,3135,25080.67
432135,202011,83,67,16,70019.98,16720.67,86740.65
432140,202011,272,210,62,219457.07,64791.77,284248.84
432143,202011,211,131,80,136906.74,83606.1,220512.84
432145,202011,274,188,86,196472.52,89871.78,286344.30
432146,202011,13,12,1,12541.55,1045,13586.55
432147,202011,114,60,54,62700,56430,119130
432149,202011,16,10,6,10451.06,6270.27,16721.33
432150,202011,881,538,343,562298.48,359530.99,921829.47
432160,202011,1513,761,752,796375.42,788018.15,1584393.57
432162,202011,4,3,1,3135,1045,4180
432163,202011,19,14,5,14630,5225,19855
432166,202011,123,90,33,94334.04,34491.38,128825.42
432170,202011,230,116,114,121231.67,120183.21,241414.88
432180,202011,546,333,213,347992.06,222591.43,570583.49
432183,202011,8,8,0,8362.69,0,8362.69
432185,202011,76,66,10,68977.16,10450.81,79427.97
432190,202011,473,274,199,286339.45,207960.41,494299.86
432195,202011,88,73,15,76286.45,15675.44,91961.89
432200,202011,401,251,150,262313.28,156756.5,419069.78
432210,202011,117,73,44,76288.72,45981.11,122269.83
432215,202011,40,36,4,37624.03,4180,41804.03
432218,202011,21,20,1,20901.97,1045,21946.97
432220,202011,654,340,314,355323.92,329189.23,684513.15
432225,202011,14,9,5,9407.21,5225,14632.21
432230,202011,135,90,45,94057.69,47025.44,141083.13
432232,202011,12,11,1,11495,1045,12540
432234,202011,4,3,1,3135,1045.8,4180.8
432235,202011,3,2,1,2090,1045,3135
432237,202011,26,16,10,16722.57,10450,27172.57
432240,202011,4283,2382,1901,2491540.68,1987813.08,4479353.76
432250,202011,1110,715,395,747216.39,412787.61,1160004.00
432252,202011,45,43,2,44935.94,2090,47025.94
432253,202011,59,48,11,50166.12,11497.8,61663.92
432254,202011,25,11,14,11495.4,14630,26125.4
432255,202011,14,12,2,12540.78,2090.67,14631.45
432260,202011,814,637,177,666738.86,186015.53,852754.39
432270,202011,235,178,57,186040.39,59578.4,245618.79
432280,202011,140,105,35,109733.87,36577.58,146311.45
432285,202011,2,2,0,2090,0,2090
432290,202011,65,56,9,58522,9405,67927
432300,202011,4664,2520,2144,2637870.21,2244977.23,4882847.44
432310,202011,130,105,25,109729.9,26125.44,135855.34
432320,202011,22,17,5,17765,5225,22990
432330,202011,15,10,5,11495.02,5225,16720.02
432335,202011,8,6,2,6270.67,2090,8360.67
432340,202011,39,33,6,34486.04,6270,40756.04
432345,202011,105,68,37,72108.44,38666.34,110774.78
432350,202011,21,20,1,20900,1045,21945
432360,202011,5,4,1,4181.04,1045,5226.04
432370,202011,22,21,1,21947.05,1045,22992.05
432375,202011,31,28,3,29261.73,3135,32396.73
432377,202011,8,8,0,8360.22,0,8360.22
432380,202011,174,75,99,78384.92,104508.64,182893.56
500020,202011,245,131,114,136923.8,119152.05,256075.85
500025,202011,140,69,71,72112.48,74199.33,146311.81
500060,202011,1450,906,544,947966.63,568577.82,1516544.45
500070,202011,782,370,412,386713.44,430602.62,817316.06
500080,202011,131,104,27,108699.58,28221.93,136921.51
500085,202011,133,109,24,113918.9,25082.08,139000.98
500090,202011,359,161,198,168269.3,206935.5,375204.8
500100,202011,711,372,339,388813.22,355365.61,744178.83
500110,202011,2262,1055,1207,1104775.76,1261592.81,2366368.57
500124,202011,262,143,119,149454.18,125414.7,274868.88
500150,202011,343,133,210,139016.14,221601,360617.14
500190,202011,519,354,165,370008.8,172460.07,542468.87
500200,202011,191,163,28,170365.74,29263.03,199628.77
500210,202011,1581,533,1048,557065.05,1095330.55,1652395.60
500215,202011,242,136,106,142154.55,110790.33,252944.88
500220,202011,729,475,254,496477.7,265487.77,761965.47
500230,202011,235,144,91,150510.93,95115.54,245626.47
500240,202011,655,450,205,471373.71,214264.53,685638.24
500260,202011,588,225,363,235173.86,379391.89,614565.75
500270,202011,29980,12731,17249,13318454.32,18045689.73,31364144.05
500280,202011,202,68,134,71065.58,140032.53,211098.11
500290,202011,1163,700,463,731636.24,484962.8,1216599.04
500295,202011,437,281,156,294749.01,163052.5,457801.51
500310,202011,78,24,54,25081.52,56433.86,81515.38
500315,202011,758,437,321,457719.75,335459.19,793178.94
500320,202011,3583,1761,1822,1840591.09,1904340.31,3744931.40
500325,202011,927,497,430,519482.48,450502.58,969985.06
500330,202011,1487,702,785,734772.46,822559.98,1557332.44
500345,202011,303,230,73,240389.2,76298.74,316687.94
500348,202011,257,148,109,154680.16,113919.59,268599.75
500350,202011,120,55,65,57486.18,67937.35,125423.53
500370,202011,5602,2477,3125,2593142.05,3266279.33,5859421.38
500375,202011,344,246,98,257113.9,102428.53,359542.43
500380,202011,591,332,259,348054.04,271742.28,619796.32
500390,202011,74,36,38,37621.97,39713.42,77335.39
500400,202011,219,139,80,145279.71,83615.67,228895.38
500410,202011,538,219,319,229948.41,333432.7,563381.11
500430,202011,528,373,155,389827.98,161999.01,551826.99
500440,202011,195,100,95,104511.56,99288.33,203799.89
500450,202011,397,169,228,176633.24,238292.5,414925.74
500460,202011,269,144,125,150508.09,130648.92,281157.01
500470,202011,428,333,95,349090.02,99289.83,448379.85
500480,202011,103,62,41,64798.35,42852.48,107650.83
500490,202011,103,44,59,47033.55,61662.28,108695.83
500500,202011,1423,514,909,537229.99,950094.5,1487324.49
500510,202011,42,35,7,36585.06,7317.88,43902.94
500515,202011,102,70,32,73164.67,33448.26,106612.93
500520,202011,307,165,142,172456.37,148414.51,320870.88
500525,202011,90,49,41,51213.24,42851.26,94064.50
500540,202011,882,380,502,397189.44,524701.66,921891.10
500560,202011,931,518,413,541397.91,432701.12,974099.03
500568,202011,980,554,426,579025.64,445259.33,1024284.97
500570,202011,1196,692,504,724286.1,526774.28,1251060.38
500580,202011,330,166,164,173512.48,171415.81,344928.29
500600,202011,335,162,173,169333.55,180817.21,350150.76
500620,202011,906,639,267,668915.23,279072.12,947987.35
500625,202011,78,62,16,64794.69,16721.89,81516.58
500627,202011,19,10,9,10453.91,9407.05,19860.96
500630,202011,1575,875,700,916655.15,731652.36,1648307.51
500635,202011,520,310,210,323958.41,219453.01,543411.42
500640,202011,373,200,173,209045.51,180832.3,389877.81
500660,202011,5531,2006,3525,2098727.01,3684443.57,5783170.58
500690,202011,602,209,393,218442.02,410730.97,629172.99
500710,202011,403,204,199,213216.74,208001.41,421218.15
500720,202011,927,534,393,558130.89,410762.47,968893.36
500730,202011,188,114,74,119172.03,77354.07,196526.10
500740,202011,887,368,519,385677.48,542443.75,928121.23
500750,202011,145,45,100,47030.79,104508.19,151538.98
500755,202011,122,89,33,93035.56,34493.09,127528.65
500769,202011,743,405,338,423305.44,353267.96,776573.40
500770,202011,415,215,200,225762.27,209029.07,434791.34
500780,202011,150,101,49,105575.52,51217.7,156793.22
500790,202011,1069,537,532,561288.52,556057.86,1117346.38
500793,202011,272,143,129,149462.97,134829.54,284292.51
500795,202011,178,121,57,127503.13,59574.53,187077.66
500797,202011,49,35,14,36576.71,14630.05,51206.76
500800,202011,437,193,244,201712.69,256051.79,457764.48
500830,202011,2215,1234,981,1291883.53,1031630.62,2323514.15
500840,202011,135,100,35,104527.98,36582.3,141110.28
510010,202011,171,88,83,91962.65,86736.53,178699.18
510020,202011,507,215,292,224715.32,305185.73,529901.05
510025,202011,1675,956,719,999214.16,753577.59,1752791.75
510030,202011,670,346,324,361662.34,338671.52,700333.86
510035,202011,126,62,64,64793.02,66886.19,131679.21
510040,202011,402,183,219,191262.31,228880.88,420143.19
510050,202011,396,216,180,226815.68,189183.83,415999.51
510060,202011,119,59,60,61662.61,62704.84,124367.45
510080,202011,229,89,140,93013.12,146306.3,239319.42
510100,202011,65,28,37,29262.77,39715.43,68978.20
510120,202011,33,21,12,21950.85,12542.15,34493.00
510125,202011,384,238,146,249787.76,152590.07,402377.83
510130,202011,538,310,228,323982.87,238284.55,562267.42
510140,202011,427,124,303,129608.09,316683.35,446291.44
510160,202011,110,36,74,37624.51,77349.34,114973.85
510170,202011,790,481,309,503765.16,324003.58,827768.74
510180,202011,2916,1368,1548,1429822.98,1621042.7,3050865.68
510185,202011,20,9,11,9408.72,11496.91,20905.63
510190,202011,232,82,150,85697.35,156762.94,242460.29
510250,202011,2581,1528,1053,1596996.58,1100545.91,2697542.49
510260,202011,173,126,47,131709.28,49130.7,180839.98
510263,202011,460,254,206,266524.57,215302.98,481827.55
510267,202011,665,371,294,387767.6,307288.3,695055.9
510268,202011,63,29,34,30309.28,35535.06,65844.34
510269,202011,76,33,43,34488.15,44938.37,79426.52
510270,202011,386,195,191,203803.19,200660.47,404463.66
510279,202011,217,164,53,171402.04,55391.11,226793.15
510285,202011,187,75,112,78382.71,118097.88,196480.59
510300,202011,513,269,244,281163.94,255037.77,536201.71
510305,202011,202,95,107,101374.47,111822.91,213197.38
510310,202011,107,54,53,56432.93,55387.81,111820.74
510320,202011,848,532,316,556056.65,331336.63,887393.28
510325,202011,416,173,243,180796.96,253953.8,434750.76
510330,202011,427,237,190,247714.88,199620.4,447335.28
510335,202011,640,362,278,378353.07,290558.08,668911.15
510336,202011,57,40,17,41801.74,17767.64,59569.38
510337,202011,107,45,62,47029.51,64793.52,111823.03
510340,202011,17207,7777,9430,8140277.38,9866886.35,18007163.73
510343,202011,62,43,19,44935.47,19855.03,64790.50
510345,202011,161,104,57,108695.52,59573.36,168268.88
510350,202011,653,354,299,369991.33,312494.62,682485.95
510360,202011,203,124,79,129604.3,82568.56,212172.86
510370,202011,155,72,83,75240.47,86739.05,161979.52
510380,202011,85,63,22,65835.67,22990.48,88826.15
510385,202011,62,27,35,28216.48,36575.33,64791.81
510390,202011,107,47,60,49119.76,63750.29,112870.05
510395,202011,45,32,13,33441.37,13585.2,47026.57
510410,202011,710,459,251,480802.24,262350.07,743152.31
510420,202011,557,270,287,282181.58,299941.27,582122.85
510450,202011,50,25,25,26125.44,26126.24,52251.68
510452,202011,51,24,27,25083.11,28217.5,53300.61
510454,202011,53,24,29,25082.36,30306.7,55389.06
510455,202011,138,79,59,82566.43,61660.5,144226.93
510460,202011,178,82,96,85710.97,100336.91,186047.88
510480,202011,713,419,294,437943.01,308337.83,746280.84
510490,202011,347,174,173,181849.23,180803.67,362652.90
510500,202011,238,180,58,188113.99,60615.44,248729.43
510510,202011,783,458,325,479743.44,339681.91,819425.35
510515,202011,1225,636,589,667852.18,621863.95,1289716.13
510517,202011,257,112,145,117056.26,151544.27,268600.53
510520,202011,224,147,77,153645.31,81524.26,235169.57
510523,202011,102,79,23,82556.53,25080.5,107637.03
510525,202011,803,478,325,499585.58,340719.38,840304.96
510530,202011,20,14,6,14631.04,6270.94,20901.98
510550,202011,244,111,133,116023.38,139013.93,255037.31
510558,202011,286,140,146,146310.52,152575.21,298885.73
510560,202011,415,243,172,253993.87,179775.5,433769.37
510562,202011,637,464,173,488130.71,180818.86,668949.57
510590,202011,747,386,361,404462.79,378346.22,782809.01
510600,202011,234,122,112,127509.59,117055.55,244565.14
510610,202011,207,84,123,87786.89,128557.16,216344.05
510615,202011,180,83,97,86744.8,104511.68,191256.48
510617,202011,18,9,9,9405.71,9406.48,18812.19
510618,202011,120,57,63,59569.97,65841.84,125411.81
510619,202011,93,65,28,67935.29,29263.46,97198.75
510620,202011,166,95,71,99278.42,74196.69,173475.11
510621,202011,175,111,64,116007.75,66884.38,182892.13
510622,202011,493,298,195,311477.51,204856.4,516333.91
510623,202011,323,222,101,232019.87,105554.68,337574.55
510624,202011,95,47,48,49121.6,50166.23,99287.83
510625,202011,520,325,195,339714.19,204866.33,544580.52
510626,202011,109,68,41,71069.41,42848.01,113917.42
510627,202011,75,52,23,54345.56,24037.88,78383.44
510628,202011,152,90,62,94063.98,64791.86,158855.84
510629,202011,270,160,110,167208.12,114971.78,282179.90
510630,202011,433,223,210,233069.13,219482.65,452551.78
510631,202011,12,3,9,3135.2,9406.16,12541.36
510637,202011,349,199,150,207988.15,157828.23,365816.38
510642,202011,999,528,471,551853.28,492284.39,1044137.67
510645,202011,2,0,2,0,2090.67,2090.67
510650,202011,1383,906,477,947011.9,498560.62,1445572.52
510665,202011,82,35,47,36586.52,49128.31,85714.83
510670,202011,59,33,26,34489.31,27170.56,61659.87
510675,202011,1148,734,414,768250.61,433777.89,1202028.50
510677,202011,343,177,166,184996.94,173489.03,358485.97
510680,202011,106,60,46,62717.7,48080.4,110798.1
510682,202011,204,104,100,108682.23,104503.94,213186.17
510685,202011,54,40,14,41805.36,14631.66,56437.02
510700,202011,572,330,242,344950.89,252957.64,597908.53
510704,202011,1153,601,552,629273.44,578019.27,1207292.71
510706,202011,133,66,67,68976.25,70024.84,139001.09
510710,202011,390,278,112,290565.35,117056.49,407621.84
510715,202011,58,40,18,41803.16,18810.67,60613.83
510718,202011,215,109,106,113923.43,110789.13,224712.56
510719,202011,41,17,24,17766.27,25085.82,42852.09
510720,202011,186,128,58,133785.18,60622.59,194407.77
510724,202011,85,33,52,34486.48,54343.31,88829.79
510726,202011,52,27,25,28216.92,26131.47,54348.39
510729,202011,55,21,34,21947.83,35532.47,57480.30
510730,202011,480,264,216,275912.56,225745,501657.56
510735,202011,113,46,67,48072.27,70018.12,118090.39
510740,202011,19,10,9,10453.99,9407.81,19861.80
510757,202011,25,19,6,19858.95,6270.62,26129.57
510760,202011,7180,3675,3505,3843168.01,3666560.54,7509728.55
510770,202011,676,319,357,333410.5,373124.71,706535.21
510774,202011,16,5,11,5226.21,11496.23,16722.44
510775,202011,108,81,27,84650.22,28215,112865.22
510776,202011,27,10,17,10451.12,17767.6,28218.72
510777,202011,194,82,112,85690,117040.24,202730.24
510779,202011,52,24,28,25085.79,29263.88,54349.67
510780,202011,283,158,125,165154.91,130650.66,295805.57
510785,202011,385,207,178,217391.47,186025.55,403417.02
510787,202011,192,92,100,96162.42,106608.64,202771.06
510788,202011,5,1,4,1045,4180.58,5225.58
510790,202011,2496,1312,1184,1373400.01,1237467.64,2610867.65
510792,202011,1146,643,503,672059.68,525731.64,1197791.32
510794,202011,113,61,52,63752.82,54346.84,118099.66
510795,202011,2304,1343,961,1403590.12,1005428.02,2409018.14
510800,202011,175,104,71,108694.34,74201.87,182896.21
510805,202011,182,120,62,125411.81,64795.8,190207.61
510810,202011,97,43,54,44939.23,56434.73,101373.96
510820,202011,240,119,121,124391.01,126477.53,250868.54
510830,202011,72,41,31,42847.31,32396.13,75243.44
510835,202011,14,9,5,9405.67,5225.61,14631.28
510840,202011,9073,4307,4766,4506064.23,4987915.93,9493980.16
510850,202011,219,89,130,93011.12,135859.71,228870.83
510860,202011,370,167,203,174526.6,212148.43,386675.03
510880,202011,70,51,19,53297.87,19855,73152.87
510885,202011,71,39,32,40757.35,33442.81,74200.16
510890,202011,64,36,28,37623.23,29261.77,66885.00
510895,202011,170,100,70,104517.29,73157.31,177674.60
520005,202011,127,53,74,55391.03,77339.03,132730.06
520010,202011,283,127,156,132742.37,163064.35,295806.72
520013,202011,715,463,252,483918.41,263382.38,747300.79
520015,202011,52,38,14,39712.28,14631.5,54343.78
520017,202011,87,49,38,51214.65,39718.87,90933.52
520020,202011,18,10,8,10452.8,8361.33,18814.13
520025,202011,2326,1205,1121,1259544.94,1174902.86,2434447.80
520030,202011,805,428,377,447353.99,396132.33,843486.32
520050,202011,69,48,21,50161.79,21949.25,72111.04
520055,202011,57,36,21,37622.9,21946.58,59569.48
520060,202011,174,114,60,119159.27,62714.92,181874.19
520080,202011,585,424,161,443133.22,168265.82,611399.04
520082,202011,19,14,5,14632.72,5226.22,19858.94
520085,202011,90,66,24,68975.43,25082.59,94058.02
520090,202011,90,61,29,63748.85,30308.99,94057.84
520110,202011,9259,3953,5306,4136002.13,5549153.22,9685155.35
520120,202011,12,7,5,7315.6,5225.68,12541.28
520130,202011,803,559,244,584224.59,255019.71,839244.30
520140,202011,11962,6614,5348,6923824.4,5593129.26,12516953.66
520145,202011,53,32,21,33444.53,21946.67,55391.20
520150,202011,161,127,34,132740.38,35538.73,168279.11
520160,202011,41,30,11,31355.29,11496.63,42851.92
520170,202011,250,144,106,150528.52,110804.86,261333.38
520180,202011,167,79,88,82562.16,91972.83,174534.99
520215,202011,206,139,67,145271.6,70021.74,215293.34
520235,202011,82,64,18,66883.8,18810.11,85693.91
520250,202011,128,72,56,75249.71,58525.63,133775.34
520260,202011,114,72,42,75256.82,43901.31,119158.13
520280,202011,45,31,14,32396.42,14632.24,47028.66
520310,202011,40,27,13,28217.31,13585.65,41802.96
520320,202011,180,112,68,117057.81,71068.24,188126.05
520330,202011,785,418,367,436913.18,383642.64,820555.82
520340,202011,359,214,145,223673.92,151553.25,375227.17
520350,202011,509,238,271,248748.02,283246.82,531994.84
520355,202011,86,50,36,52258.04,37628.8,89886.84
520357,202011,25,18,7,18810.43,7315,26125.43
520360,202011,2,2,0,2090.29,0,2090.29
520380,202011,132,72,60,75243.5,62702.32,137945.82
520390,202011,255,107,148,111849.13,154698.3,266547.43
520393,202011,18,13,5,13586.49,5225.67,18812.16
520396,202011,76,49,27,51205.56,28217.6,79423.16
520400,202011,196,115,81,120201.7,85707.16,205908.86
520410,202011,197,96,101,100339.81,105558.32,205898.13
520420,202011,20,13,7,13585.91,7315.64,20901.55
520425,202011,284,141,143,147380.65,150517.35,297898.00
520430,202011,487,241,246,251975.16,257093.16,509068.32
520440,202011,700,506,194,528871.34,203811.97,732683.31
520450,202011,1981,847,1134,885274.78,1186290.75,2071565.53
520455,202011,59,33,26,34494.29,27178.82,61673.11
520460,202011,37,22,15,22995.6,15677.17,38672.77
520465,202011,32,27,5,28217.55,5225.03,33442.58
520470,202011,430,280,150,292657.94,156776.46,449434.40
520480,202011,77,46,31,48085.11,32406.56,80491.67
520485,202011,111,40,71,41806.52,76296.53,118103.05
520490,202011,412,306,106,319828.7,110797.46,430626.16
520495,202011,162,99,63,103462.43,65838.35,169300.78
520500,202011,185,147,38,153646.22,39716.08,193362.30
520505,202011,189,109,80,113911.89,83602.66,197514.55
520510,202011,1794,844,950,882158.97,992949.86,1875108.83
520520,202011,43,30,13,31352.97,13586.72,44939.69
520530,202011,223,170,53,177708.92,55400.61,233109.53
520540,202011,585,400,185,418073.91,193354.47,611428.38
520545,202011,136,79,57,82578.84,59582.84,142161.68
520547,202011,59,33,26,34492.16,27178.5,61670.66
520549,202011,1210,559,651,584263.26,680425.77,1264689.03
520551,202011,308,166,142,173500.18,148415.73,321915.91
520552,202011,36,24,12,25084.15,12542.07,37626.22
520570,202011,14,8,6,8360,6270,14630
520580,202011,275,170,105,178733.42,109743.42,288476.84
520590,202011,147,90,57,94066.79,59573.64,153640.43
520620,202011,1134,526,608,549783.77,636530.31,1186314.08
520630,202011,39,22,17,22990.78,17765,40755.78
520640,202011,388,226,162,236210.52,169311.19,405521.71
520650,202011,65,36,29,37620.93,30306.55,67927.48
520660,202011,44,23,21,24037.39,21948.14,45985.53
520670,202011,37,31,6,32396.77,6270.84,38667.61
520680,202011,50,33,17,34497.56,17770.24,52267.80
520690,202011,42,11,31,11497.39,32398.95,43896.34
520710,202011,32,29,3,30305.59,3135.44,33441.03
520725,202011,205,150,55,156782.29,57487.83,214270.12
520735,202011,56,36,20,37621.17,20902.49,58523.66
520740,202011,425,204,221,213211.98,230979.75,444191.73
520750,202011,34,25,9,26125.54,9405,35530.54
520753,202011,65,45,20,47028.39,20901.17,67929.56
520760,202011,100,67,33,70036.83,34494.43,104531.26
520780,202011,286,208,78,217401.08,81521.69,298922.77
520790,202011,157,91,66,95097.14,68972.47,164069.61
520800,202011,3402,1836,1566,1921153.06,1637873.24,3559026.30
520810,202011,149,116,33,121235.81,34490.99,155726.80
520815,202011,5,4,1,4181.38,1045,5226.38
520830,202011,147,100,47,104521.93,49127.58,153649.51
520840,202011,346,232,114,242454.43,119135.83,361590.26
520850,202011,101,60,41,62717.48,42854.83,105572.31
520860,202011,1745,1127,618,1177911.47,645911.74,1823823.21
520870,202011,31715,14845,16870,15527786.83,17640147.88,33167934.71
520880,202011,1160,613,547,640712.92,571731.64,1212444.56
520890,202011,794,484,310,505852.06,325053.65,830905.71
520910,202011,979,521,458,544565.19,478727.82,1023293.01
520915,202011,97,74,23,77355.21,24041.95,101397.16
520920,202011,424,201,223,210089.18,233082.1,443171.28
520929,202011,18,16,2,16724.1,2090.44,18814.54
520940,202011,73,49,24,51210.82,25084.23,76295.05
520945,202011,18,12,6,12540,6270.84,18810.84
520960,202011,45,29,16,30307.72,16720.05,47027.77
520970,202011,342,206,136,215304.68,142146.11,357450.79
520980,202011,96,70,26,73150.6,27170.43,100321.03
520990,202011,450,309,141,322943.91,147358.37,470302.28
520993,202011,122,57,65,59580.75,67947.39,127528.14
520995,202011,248,140,108,146331.18,112883.24,259214.42
521000,202011,1554,900,654,940701.34,683575.96,1624277.30
521010,202011,678,333,345,348039.16,360596.69,708635.85
521015,202011,14,9,5,9407.86,5225.66,14633.52
521020,202011,1421,1006,415,1052496.63,433759.62,1486256.25
521030,202011,56,37,19,38667.48,19855.61,58523.09
521040,202011,946,606,340,633371.87,357457.95,990829.82
521056,202011,50,33,17,34488.45,17766.33,52254.78
521060,202011,130,85,45,88843.87,47034.9,135878.77
521080,202011,411,318,93,332397.75,98254.7,430652.45
521090,202011,554,360,194,377295.32,202763.96,580059.28
521100,202011,274,206,68,215300.48,71071.07,286371.55
521120,202011,1057,747,310,782824.55,323998.39,1106822.94
521130,202011,353,251,102,262346.76,106616.55,368963.31
521140,202011,175,99,76,103474.35,79437.5,182911.85
521150,202011,2627,1136,1491,1188400.53,1560524.49,2748925.02
521160,202011,26,14,12,14630.99,12543.13,27174.12
521170,202011,216,120,96,125411.41,100332.47,225743.88
521180,202011,1176,750,426,784980.3,445290.13,1230270.43
521190,202011,2519,1061,1458,1108967.01,1524966.76,2633933.77
521200,202011,55,41,14,42845.98,14630.5,57476.48
521205,202011,11,8,3,8360,3135,11495
521210,202011,122,72,50,75261.15,52269.13,127530.28
521220,202011,762,532,230,557080.76,240386.17,797466.93
521225,202011,31,21,10,21953.95,10452.22,32406.17
521230,202011,107,70,37,73169.71,38673.63,111843.34
521250,202011,6168,3479,2689,3638610.45,2813886.99,6452497.44
521260,202011,29,14,15,14630.2,15675.5,30305.7
521270,202011,144,111,33,115999.96,34486.67,150486.63
521280,202011,427,262,165,273826.91,173504.38,447331.29
521290,202011,26,14,12,14631.87,12542.03,27173.90
521295,202011,97,63,34,65849.16,35536.21,101385.37
521300,202011,220,121,99,126469.74,103470.54,229940.28
521305,202011,37,26,11,27176.34,11497.22,38673.56
521308,202011,1053,813,240,849730.15,250843.88,1100574.03
521310,202011,1327,767,560,802783.84,586397.45,1389181.29
521340,202011,17,14,3,14631.32,3135.44,17766.76
521350,202011,123,93,30,97201.93,31356.81,128558.74
521370,202011,177,125,52,130638.83,54346.28,184985.11
521375,202011,177,91,86,95117.45,89891.81,185009.26
521377,202011,49,38,11,39717.02,11497.55,51214.57
521380,202011,1058,669,389,699249.3,407636.56,1106885.86
521385,202011,13,8,5,8360.73,5225.47,13586.20
521390,202011,102,82,20,85703.33,20902.85,106606.18
521400,202011,349,232,117,242467.98,122277.08,364745.06
521405,202011,146,80,66,83610.72,68978.29,152589.01
521410,202011,65,46,19,48073.2,19856.99,67930.19
521440,202011,195,141,54,147386.07,56448.25,203834.32
521450,202011,730,408,322,426438,336562.67,763000.67
521460,202011,1148,739,409,773420.49,428540.74,1201961.23
521470,202011,12,9,3,9406.44,3135.44,12541.88
521480,202011,41,28,13,29268.63,13589.5,42858.13
521483,202011,312,186,126,194397.24,131693.8,326091.04
521486,202011,283,184,99,192296.89,103465.68,295762.57
521487,202011,23,11,12,11497.07,12541.24,24038.31
521490,202011,23,12,11,12540.44,11496.01,24036.45
521500,202011,128,77,51,80486.32,53308.75,133795.07
521520,202011,46,32,14,33444.23,14631.95,48076.18
521523,202011,735,434,301,453587.26,314575.92,768163.18
521525,202011,48,30,18,31350,18810.34,50160.34
521530,202011,243,132,111,139011.11,116013.4,255024.51
521540,202011,33,17,16,17766.43,16721.65,34488.08
521550,202011,88,38,50,39717.75,52258.48,91976.23
521560,202011,810,551,259,575914.02,271749.26,847663.28
521565,202011,62,43,19,44936.08,19855,64791.08
521570,202011,528,350,178,365822.87,186042.34,551865.21
521580,202011,54,30,24,31355,25083.97,56438.97
521590,202011,37,17,20,17765.48,20901.18,38666.66
521600,202011,21,11,10,11495,10450.78,21945.78
521630,202011,248,135,113,141106.26,118120.23,259226.49
521640,202011,306,165,141,172444.03,148410.59,320854.62
521645,202011,33,17,16,17767.83,16722.1,34489.93
521680,202011,244,150,94,156773.57,98243.42,255016.99
521690,202011,2,2,0,2090,0,2090
521710,202011,1140,550,590,574830.33,617691.03,1192521.36
521720,202011,566,392,174,410746.2,181858.61,592604.81
521730,202011,655,313,342,327136.73,357455.91,684592.64
521740,202011,890,382,508,399255.35,532001.34,931256.69
521760,202011,1962,1013,949,1058873.14,992968.32,2051841.46
521770,202011,820,520,300,543460.37,314585.47,858045.84
521800,202011,1991,1290,701,1349276.33,732645.13,2081921.46
521805,202011,33,18,15,18813.66,15676.57,34490.23
521810,202011,83,53,30,55399.74,31358.13,86757.87
521830,202011,957,682,275,713864.07,287433.66,1001297.73
521839,202011,88,54,34,56436.23,35534.56,91970.79
521850,202011,1109,576,533,603119.63,557129.7,1160249.33
521860,202011,340,211,129,220535.12,134832.14,355367.26
521870,202011,74,46,28,48074.56,29261.97,77336.53
521878,202011,32,16,16,16721.27,16721.5,33442.77
521880,202011,4730,2104,2626,2199183.42,2746900.19,4946083.61
521890,202011,596,420,176,438970,183944.16,622914.16
521900,202011,285,232,53,242461.67,55391.83,297853.50
521910,202011,157,112,45,117071.87,47041.59,164113.46
521920,202011,45,23,22,24037.9,22997.36,47035.26
521925,202011,52,31,21,32399.83,21946.57,54346.40
521930,202011,1149,638,511,667898.6,535148.83,1203047.43
521935,202011,34,24,10,25088.66,10452.29,35540.95
521940,202011,203,97,106,101383.95,110789.92,212173.87
521945,202011,17,13,4,13587.1,4180.5,17767.6
521950,202011,9,5,4,5225.59,4180,9405.59
521960,202011,72,54,18,56430,18810.44,75240.44
521970,202011,404,256,148,267550.75,154672.69,422223.44
521971,202011,99,53,46,55389.22,48074.56,103463.78
521973,202011,34,17,17,17767.31,17766.76,35534.07
521975,202011,1454,721,733,753603.93,766145.84,1519749.77
521980,202011,243,166,77,174542.27,80476.9,255019.17
521990,202011,78,56,22,58533.82,22993.88,81527.70
522000,202011,294,187,107,195088.96,111840.42,306929.38
522005,202011,18,10,8,10451.05,8361.02,18812.07
522010,202011,1135,631,504,659511.49,527819.14,1187330.63
522015,202011,61,37,24,38668.8,25080.89,63749.69
522020,202011,887,512,375,537199.15,391916.06,929115.21
522026,202011,23,14,9,14630.91,9405.44,24036.35
522028,202011,15,11,4,11497.26,4181.38,15678.64
522040,202011,775,315,460,329253.49,480826.18,810079.67
522045,202011,2311,1408,903,1471706.12,945989.46,2417695.58
522050,202011,160,78,82,81530.89,85705.19,167236.08
522060,202011,542,337,205,352215.21,214258.12,566473.33
522068,202011,110,78,32,81514.55,33441.58,114956.13
522070,202011,11,10,1,10450.44,1045,11495.44
522100,202011,38,22,16,22993.08,16720.2,39713.28
522108,202011,40,31,9,32400.27,9406.91,41807.18
522119,202011,55,31,24,32395.81,25080,57475.81
522130,202011,76,30,46,32405.94,48085.72,80491.66
522140,202011,4076,2107,1969,2202197.72,2061105.67,4263303.39
522145,202011,50,35,15,36577.11,15678.61,52255.72
522150,202011,94,68,26,71065.35,27171.31,98236.66
522155,202011,53,36,17,37621.77,17767.94,55389.71
522157,202011,7,3,4,3135.21,4180,7315.21
522160,202011,1690,998,692,1045197.96,724334.54,1769532.50
522170,202011,401,271,130,283238.99,135875.07,419114.06
522180,202011,38,18,20,18816.14,20903.06,39719.20
522185,202011,2090,834,1256,872088.92,1312860.21,2184949.13
522190,202011,49,26,23,27174.03,24037.76,51211.79
522200,202011,298,177,121,184991.84,126461.39,311453.23
522205,202011,140,93,47,97207.3,49126.7,146334.0
522220,202011,146,107,39,111823.21,40756.67,152579.88
522230,202011,34,25,9,26128.57,9407.46,35536.03
530010,202011,53877,27200,26677,28454450.85,27907802.36,56362253.21
110001,202012,505,403,102,423225,106590,529815
110002,202012,2848,1769,1079,1850697.21,1128600.5,2979297.71
110003,202012,81,68,13,71060,13585,84645
110004,202012,2032,1334,698,1395076.5,729410,2124486.5
110005,202012,439,351,88,366795.5,91960,458755.5
110006,202012,443,338,105,355300.5,109725,465025.5
110007,202012,69,57,12,59565,12540,72105
110008,202012,241,131,110,136895,114950,251845
110009,202012,904,660,244,689700.5,254980,944680.5
110010,202012,1695,1033,662,1081575.84,691790,1773365.84
110011,202012,1753,1359,394,1421200,412775,1833975
110012,202012,4095,2370,1725,2476650,1805760.5,4282410.5
110013,202012,772,615,157,642675,164065,806740
110014,202012,373,325,48,340252.5,50160,390412.5
110015,202012,1374,1100,274,1151592.05,286330,1437922.05
110018,202012,1088,676,412,707465,430540,1138005
110020,202012,15532,8870,6662,9279608.68,6967017.6,16246626.28
110025,202012,647,474,173,495330.5,180785.29,676115.79
110026,202012,35,25,10,26125,10450,36575
110028,202012,1631,1172,459,1224740.85,480701.5,1705442.35
110029,202012,135,121,14,126445,14630,141075
110030,202012,2405,1606,799,1679148.22,836001.35,2515149.57
110032,202012,317,246,71,257070,74195,331265
110033,202012,666,484,182,505780,190190,695970
110034,202012,334,246,88,257070.67,91960,349030.67
110037,202012,98,85,13,88825,13585,102410
110040,202012,371,249,122,260205,127490,387695
110045,202012,934,640,294,668801,308275.1,977076.1
110050,202012,92,80,12,83600.5,12540,96140.5
110060,202012,68,40,28,41800,29260,71060
110070,202012,103,67,36,70015,37620,107635
110080,202012,489,272,217,284240.5,226765,511005.5
110090,202012,28,24,4,25080,4180,29260
110092,202012,103,58,45,60610,47025,107635
110094,202012,200,144,56,150480,58520,209000
110100,202012,39,27,12,28215,12540,40755
110110,202012,93,51,42,53295,43890,97185
110120,202012,70,60,10,62700,10450,73150
110130,202012,285,234,51,244530.5,53295,297825.5
110140,202012,238,167,71,174515.5,74195,248710.5
110143,202012,45,36,9,37620,9405,47025
110145,202012,27,21,6,21945,6270,28215
110146,202012,22,12,10,12540,10450,22990
110147,202012,38,26,12,27170,12540,39710
110148,202012,34,23,11,24035,11495,35530
110149,202012,313,220,93,230945,97185,328130
110150,202012,129,99,30,103455,32395,135850
110155,202012,9,9,0,9405,0,9405
110160,202012,68,55,13,57475,13585,71060
110170,202012,221,169,52,176605,54340,230945
110175,202012,66,50,16,52250,16720,68970
110180,202012,87,72,15,75240,15675,90915
120001,202012,185,136,49,142120,51205,193325
120005,202012,194,114,80,119130.93,83600,202730.93
120010,202012,1101,684,417,714780.72,435765,1150545.72
120013,202012,139,95,44,99275.56,45980,145255.56
120017,202012,107,60,47,62700,49115,111815
120020,202012,3534,2849,685,2977206.18,715825.5,3693031.68
120025,202012,537,304,233,317680.77,243485,561165.77
120030,202012,1058,911,147,954086.36,154660,1108746.36
120032,202012,35,31,4,32395,4180,36575
120033,202012,212,187,25,195415,26125,221540
120034,202012,168,124,44,130625,45980,176605
120035,202012,38,31,7,32395,7315,39710
120038,202012,420,275,145,287375,152570,439945
120039,202012,29,28,1,29260,1045,30305
120040,202012,13938,9525,4413,9964428.49,4618900,14583328.49
120042,202012,44,38,6,39710,6270,45980
120043,202012,11,3,8,3135,8360,11495
120045,202012,538,343,195,358435,204820,563255
120050,202012,1273,972,301,1015740.69,314545,1330285.69
120060,202012,1465,1200,265,1254000,276925,1530925
120070,202012,422,305,117,318725.82,122265,440990.82
120080,202012,174,107,67,111815,70015,181830
130002,202012,163,116,47,121220,49115,170335
130006,202012,100,63,37,65835,38665,104500
130008,202012,132,71,61,74195,63745,137940
130010,202012,150,83,67,86735,70015,156750
130014,202012,273,197,76,205865,79420,285285
130020,202012,98,59,39,61655,40755,102410
130030,202012,971,570,401,595650,419045,1014695
130040,202012,336,165,171,173470,178695,352165
130050,202012,567,293,274,306185,287375,593560
130060,202012,841,572,269,597740,281105,878845
130063,202012,596,337,259,352165,270655,622820
130068,202012,186,113,73,118085,76285,194370
130070,202012,1300,884,416,923780.5,435765,1359545.5
130080,202012,720,478,242,499510,252890,752400
130083,202012,72,39,33,40755,34485,75240
130090,202012,321,164,157,171380,164065,335445
130100,202012,1102,466,636,486970,664620,1151590
130110,202012,736,311,425,324995,444125,769120
130115,202012,159,68,91,71060,95095,166155
130120,202012,1624,1016,608,1062765,635360,1698125
130130,202012,611,418,193,436810,201685,638495
130140,202012,1568,1232,336,1287440,351120,1638560
130150,202012,416,364,52,380380,54340,434720
130160,202012,451,257,194,268565,202730,471295
130165,202012,39,30,9,31350,9405,40755
130170,202012,1012,707,305,738782.95,318725.65,1057508.60
130180,202012,232,173,59,180785,61655,242440
130185,202012,2296,1056,1240,1103520,1296845.5,2400365.5
130190,202012,3409,2137,1272,2233165.5,1330285,3563450.5
130195,202012,277,219,58,228855,60610,289465
130200,202012,176,79,97,82555,101365,183920
130210,202012,75,37,38,38665,39710,78375
130220,202012,174,117,57,122265,59565,181830
130230,202012,382,248,134,259160,140030,399190
130240,202012,1306,826,480,864215,501600,1365815
130250,202012,4702,2994,1708,3128730.5,1785905,4914635.5
130255,202012,430,205,225,214225,235125,449350
130260,202012,57194,26813,30381,28037277.23,31779723,59817000.23
130270,202012,1552,1050,502,1097344.05,525635,1622979.05
130280,202012,121,68,53,71060,55385,126445
130290,202012,2091,1431,660,1495395,689700,2185095
130300,202012,428,299,129,312455,134805,447260
130310,202012,943,500,443,522500,462935,985435
130320,202012,521,275,246,287375,257070,544445
130330,202012,781,488,293,509960,307230,817190
130340,202012,3481,1981,1500,2070146,1569590.5,3639736.5
130350,202012,481,321,160,335445,167200,502645
130353,202012,934,401,533,419045,558030,977075
130356,202012,812,361,451,377245.5,471295,848540.5
130360,202012,90,67,23,70015,24035,94050
130370,202012,700,537,163,561165,170335,731500
130380,202012,678,518,160,541310,167200,708510
130390,202012,478,384,94,401280,98230,499510
130395,202012,158,37,121,38665,127490,166155
130400,202012,66,44,22,45980,22990,68970
130406,202012,2068,1235,833,1290575.5,871530,2162105.5
130410,202012,437,209,228,218405,240350,458755
130420,202012,2916,2363,553,2469335.75,577885,3047220.75
130423,202012,155,78,77,81510,80465,161975
130426,202012,156,77,79,80465,82555,163020
130430,202012,421,258,163,269610,170335,439945
130440,202012,200,59,141,61655,147345,209000
140002,202012,14,4,10,4180,10450,14630
140005,202012,199,121,78,126445,81510,207955
140010,202012,10833,6801,4032,7111232.18,4217622.81,11328854.99
140015,202012,130,58,72,60610,75240,135850
140017,202012,123,75,48,78375,50160,128535
140020,202012,470,304,166,317680,173470,491150
140023,202012,31,16,15,16720.35,15675,32395.35
140028,202012,22,12,10,12540,10450,22990
140030,202012,351,243,108,253935,112860,366795
140040,202012,60,42,18,43890,18810,62700
140045,202012,264,101,163,105545,170335,275880
140047,202012,392,267,125,279015.5,130625,409640.5
140050,202012,142,86,56,89870,58520,148390
140060,202012,56,39,17,40755,17765,58520
140070,202012,31,28,3,29260,3135,32395
150010,202012,4670,2831,1839,2959441,1921755.5,4881196.5
150013,202012,160,113,47,119130,49115,168245
150020,202012,1089,580,509,606100,531905,1138005
150030,202012,700,309,391,322906,408595,731501
150034,202012,200,122,78,127490,81510,209000
150040,202012,1473,832,641,869440,669845,1539285
150050,202012,674,375,299,391875,312455,704330
150060,202012,4877,3087,1790,3226873.5,1870982.63,5097856.13
150070,202012,399,200,199,209000.5,207955,416955.5
150080,202012,15265,7195,8070,7522959.2,8438379.5,15961338.7
150085,202012,432,268,164,281105,171380,452485
150090,202012,709,595,114,621775,119130,740905
150095,202012,367,228,139,238260,145255,383515
150100,202012,61,38,23,39710,24035,63745
150110,202012,200,104,96,108680,100320,209000
150120,202012,405,290,115,303050,120175,423225
150125,202012,49,17,32,17765,33440.5,51205.5
150130,202012,2027,1059,968,1106655,1011560,2118215
150140,202012,55225,24743,30482,25863763.2,31866237.21,57730000.41
150145,202012,208,111,97,115995,101365,217360
150150,202012,2969,1275,1694,1332375.5,1771276.5,3103652.0
150157,202012,381,267,114,279015.5,119130,398145.5
150160,202012,127,98,29,102410,30305,132715
150170,202012,3620,2685,935,2805825,978120,3783945
150172,202012,338,234,104,244530,109725,354255
150175,202012,79,48,31,50160,32395,82555
150178,202012,766,499,267,523545,280060,803605
150180,202012,3187,1546,1641,1616615.25,1714845.5,3331460.75
150190,202012,343,213,130,222585.5,135850,358435.5
150195,202012,109,56,53,58520,55385,113905
150200,202012,195,91,104,95095,108680,203775
150210,202012,3142,2519,623,2632355,651035,3283390
150215,202012,559,354,205,369930.5,214225,584155.5
150220,202012,3607,2394,1213,2503821.32,1268630.6,3772451.92
150230,202012,1188,952,236,994840.37,246620,1241460.37
150240,202012,6370,3590,2780,3753641.35,2905100,6658741.35
150250,202012,54,30,24,31350.5,25080,56430.5
150260,202012,92,60,32,62700,33440,96140
150270,202012,2208,1423,785,1490170,822415.5,2312585.5
150275,202012,523,329,194,343805,202730,546535
150276,202012,108,42,66,43890,68970,112860
150277,202012,785,337,448,352165,468160,820325
150280,202012,363,238,125,248710.5,130625,379335.5
150285,202012,106,53,53,55385,55217.8,110602.8
150290,202012,1131,660,471,689700,492195,1181895
150293,202012,691,320,371,335445,387695,723140
150295,202012,508,232,276,242440,288420,530860
150300,202012,82,38,44,39710,45980,85690
150304,202012,175,104,71,108680,74195,182875
150307,202012,393,324,69,338580,72105,410685
150309,202012,564,403,161,421135,168245,589380
150310,202012,243,156,87,163020,90915,253935
150320,202012,1895,1315,580,1374175,606100.5,1980275.5
150330,202012,2022,1155,867,1206975,906015,2112990
150340,202012,196,129,67,134805,71060,205865
150345,202012,629,345,284,360525,296780,657305
150350,202012,408,315,93,329175,97185,426360
150360,202012,4661,2859,1802,2988700.75,1883090,4871790.75
150370,202012,826,561,265,587290.5,276925,864215.5
150375,202012,197,89,108,93005,112860,205865
150380,202012,1486,980,506,1024100,528770,1552870
150390,202012,799,463,336,483835.5,352165,836000.5
150400,202012,108,89,19,93005,19855,112860
150405,202012,1223,774,449,808830.3,469205,1278035.3
150410,202012,120,76,44,79420,45980,125400
150420,202012,7370,3958,3412,4137326.5,3567630.5,7704957.0
150430,202012,606,384,222,401280,231990,633270
150440,202012,436,276,160,288420,167200,455620
150442,202012,2329,1236,1093,1291621,1142185,2433806
150445,202012,545,353,192,368885.5,200640,569525.5
150450,202012,224,117,107,122265,111815,234080
150460,202012,734,545,189,570570,197505,768075
150470,202012,1303,774,529,810920,552805,1363725
150475,202012,232,175,57,182875,59565,242440
150480,202012,1297,899,398,940500,416955,1357455
150490,202012,666,394,272,411730,285285,697015
150495,202012,332,244,88,254980,91960,346940
150497,202012,272,188,84,196460,87780,284240
150500,202012,222,135,87,141075,90915,231990
150503,202012,1044,516,528,539220.5,551761,1090981.5
150506,202012,926,615,311,642675,326040,968715
150510,202012,1257,684,573,714780.5,598785,1313565.5
150520,202012,293,193,100,201685.5,104500,306185.5
150530,202012,1712,933,779,974985.25,814055.39,1789040.64
150540,202012,224,163,61,170335,63745,234080
150543,202012,826,420,406,438900,425315,864215
150548,202012,466,327,139,341715,145255,486970
150549,202012,61,42,19,43890,19855,63745
150550,202012,2924,1465,1459,1530925.25,1528835,3059760.25
150553,202012,3341,1871,1470,1955197,1536150,3491347
150555,202012,145,77,68,80465,71060,151525
150560,202012,37,16,21,16720,21945,38665
150563,202012,117,52,65,54340,67925,122265
150565,202012,192,117,75,122265,78375,200640
150570,202012,425,280,145,292600,151525,444125
150580,202012,1676,802,874,839135,914375,1753510
150590,202012,800,528,272,551760,284240,836000
150600,202012,472,280,192,292600,200640,493240
150610,202012,147,119,28,124355,29260,153615
150611,202012,122,81,41,85690,42845,128535
150613,202012,3231,1895,1336,1981320,1396120.5,3377440.5
150616,202012,531,299,232,312455,242440,554895
150618,202012,1339,699,640,730455,668800,1399255
150619,202012,395,297,98,310365,102410,412775
150620,202012,1262,730,532,762850,555940,1318790
150630,202012,319,206,113,215270.5,118085,333355.5
150635,202012,454,185,269,193325,281105,474430
150640,202012,48,24,24,25080,25080,50160
150650,202012,2387,1376,1011,1437920.5,1056495.5,2494416.0
150655,202012,238,177,61,184965,63745,248710
150658,202012,87,50,37,52250,38665,90915
150660,202012,538,350,188,365750,197505,563255
150670,202012,1073,372,701,388740,732545,1121285
150680,202012,10121,5254,4867,5493567.19,5094375,10587942.19
150690,202012,20,10,10,10450,10450,20900
150700,202012,483,315,168,329175,175560,504735
150710,202012,286,155,131,161975,136895,298870
150715,202012,826,511,315,533995,329175,863170
150720,202012,416,317,99,331265.5,103455.5,434721.0
150730,202012,1031,510,521,532950,544445,1077395
150740,202012,228,149,79,155705,82555,238260
150745,202012,746,411,335,429495,350075,779570
150746,202012,66,36,30,37620,31350,68970
150747,202012,224,171,53,179740,55385,235125
150750,202012,138,77,61,80465,63745,144210
150760,202012,1812,1172,640,1224740.62,669845,1894585.62
150770,202012,387,212,175,222585,182875,405460
150775,202012,104,48,56,50160,58520,108680
150780,202012,200,111,89,115995,93005,209000
150790,202012,877,496,381,518320,398145,916465
150795,202012,1524,903,621,944680,648945,1593625
150796,202012,352,200,152,209000,158840,367840
150797,202012,338,162,176,169290,183920,353210
150800,202012,1499,846,653,884070,683430,1567500
150803,202012,533,428,105,447260,109725,556985
150805,202012,205,119,86,124355,89870,214225
150808,202012,990,530,460,553850,480700,1034550
150810,202012,3230,2188,1042,2287506.64,1088890.5,3376397.14
150812,202012,442,219,223,228855,233035,461890
150815,202012,1056,658,398,687611,415910,1103521
150820,202012,1542,908,634,949905,662530,1612435
150830,202012,730,529,201,552805,210045,762850
150835,202012,210,123,87,128535.5,90915,219450.5
150840,202012,1373,830,543,868395,567435,1435830
160005,202012,63,44,19,45980,19855,65835
160010,202012,188,120,68,125400,71060,196460
160015,202012,130,79,51,82555,53295,135850
160020,202012,133,73,60,76285,62700,138985
160021,202012,61,26,35,27170,36575,63745
160023,202012,68,44,24,45980,25080,71060
160025,202012,24,11,13,11495,13585,25080
160027,202012,1477,838,639,875710.25,668800,1544510.25
160030,202012,15924,8123,7801,8491673.6,8156225.5,16647899.1
160040,202012,298,171,127,178695,133760,312455
160050,202012,721,361,360,377245,376200,753445
160053,202012,282,169,113,176605,118085,294690
160055,202012,25,16,9,16720,9405,26125
160060,202012,6529,3421,3108,3574946.06,3247860.5,6822806.56
160070,202012,176,99,77,103455,80465,183920
160080,202012,112,54,58,56430,60610,117040
170025,202012,27,14,13,14630,13585,28215
170030,202012,198,161,37,168245.62,38665,206910.62
170035,202012,221,104,117,108680,122265,230945
170040,202012,177,132,45,137940,47025,184965
170070,202012,324,199,125,207955,130625,338580
170100,202012,352,257,95,268565,99275,367840
170105,202012,56,45,11,47025,11495,58520
170110,202012,111,65,46,67925,48070,115995
170130,202012,70,33,37,34485,38665,73150
170190,202012,99,59,40,61655,41800,103455
170200,202012,372,253,119,264385,124355,388740
170210,202012,6141,3214,2927,3359425.88,3063940.5,6423366.38
170215,202012,113,49,64,51205,66880,118085
170220,202012,1382,1009,373,1054405,389785.62,1444190.62
170230,202012,149,96,53,100320,55385,155705
170240,202012,512,342,170,357390,177650,535040
170255,202012,1077,871,206,910195,215270,1125465
170270,202012,45,32,13,33440,13585,47025
170290,202012,113,75,38,78375,39710,118085
170300,202012,98,61,37,63745,38665,102410
170305,202012,47,36,11,37620,11495,49115
170307,202012,61,47,14,49115,14630,63745
170310,202012,114,63,51,65835,53295,119130
170320,202012,26,16,10,16720,10450,27170
170330,202012,28,25,3,26125,3135,29260
170360,202012,32,18,14,18810,14630,33440
170370,202012,103,51,52,53295,54340,107635
170380,202012,69,52,17,54340,18810,73150
170382,202012,43,36,7,37620,7315,44935
170384,202012,141,110,31,114950,32395,147345
170386,202012,64,22,42,22990,43890,66880
170388,202012,48,19,29,19855,30305,50160
170389,202012,27,21,6,21945,6270,28215
170390,202012,72,40,32,41800,33440,75240
170410,202012,27,23,4,24035,4180,28215
170460,202012,17,11,6,11495,6270,17765
170510,202012,37,29,8,30305,8360,38665
170550,202012,1538,892,646,932140.5,675070,1607210.5
170555,202012,110,80,30,83600,31350,114950
170560,202012,105,74,31,77330,32395,109725
170600,202012,42,16,26,16720,27170,43890
170610,202012,196,101,95,105545,99275.5,204820.5
170625,202012,35,20,15,20900,15675,36575
170650,202012,78,56,22,58520,22990,81510
170700,202012,585,435,150,454575.25,156750,611325.25
170710,202012,155,95,60,99275,62700,161975
170720,202012,88,70,18,73150,18810,91960
170730,202012,84,49,35,52250,36575,88825
170740,202012,83,57,26,59565,27170,86735
170755,202012,60,33,27,34485,28215,62700
170765,202012,142,75,67,78375,70015,148390
170770,202012,206,128,78,133760.02,81510,215270.02
170820,202012,613,403,210,421135,219450.5,640585.5
170825,202012,36,18,18,18810,18810,37620
170830,202012,84,67,17,70015,17765,87780
170900,202012,177,135,42,141075,43890,184965
170930,202012,914,487,427,508915.8,446215.5,955131.3
170950,202012,3130,1428,1702,1495395.5,1779635.88,3275031.38
170980,202012,15,10,5,10450,5225,15675
171050,202012,147,114,33,119130,34485,153615
171070,202012,42,34,8,35530,8360,43890
171090,202012,48,35,13,36575,13585,50160
171110,202012,22,16,6,16720,6270,22990
171150,202012,40,21,19,21945,19855,41800
171180,202012,28,14,14,14630,14630,29260
171190,202012,155,90,65,94050,67925,161975
171195,202012,63,53,10,55385,10450,65835
171200,202012,50,25,25,26125,26125,52250
171215,202012,4,3,1,3135,1045,4180
171240,202012,57,40,17,42845,17765,60610
171245,202012,58,49,9,51205,9405,60610
171250,202012,76,43,33,44935,34485,79420
171270,202012,15,11,4,11495,4180,15675
171280,202012,38,33,5,34485,5225,39710
171320,202012,1004,573,431,599830.5,450395,1050225.5
171330,202012,432,215,217,224675,226765,451440
171360,202012,88,61,27,63745,28215,91960
171370,202012,33,16,17,16720,17765,34485
171380,202012,128,110,18,114950,18810,133760
171395,202012,50,32,18,33440,19855,53295
171420,202012,277,180,97,188100.5,101365,289465.5
171430,202012,73,58,15,60610,15675,76285
171488,202012,178,98,80,102410,83600,186010
171500,202012,58,33,25,34485,26125,60610
171510,202012,69,45,24,47025,25080,72105
171515,202012,42,33,9,34485,9405,43890
171525,202012,29,27,2,28215,2090,30305
171550,202012,14,9,5,9405,5225,14630
171570,202012,52,26,26,27170,27170,54340
171575,202012,305,198,107,206910,111815,318725
171610,202012,1751,886,865,925870,904970,1830840
171620,202012,138,94,44,98230,45980,144210
171630,202012,56,29,27,30305,28215,58520
171650,202012,311,216,95,225720,100320,326040
171660,202012,270,151,119,157795,124355.5,282150.5
171665,202012,62,42,20,43890,20900,64790
171670,202012,429,260,169,271700.25,176605,448305.25
171700,202012,62,56,6,58520,6270,64790
171720,202012,28,10,18,10450,18810,29260
171750,202012,100,50,50,52250,52250,104500
171780,202012,70,55,15,57475,15675,73150
171790,202012,83,68,15,71060,15675,86735
171800,202012,32,23,9,24035,9405,33440
171820,202012,2093,1187,906,1240415.46,946770.5,2187185.96
171830,202012,33,26,7,27170,7315,34485
171840,202012,66,43,23,44935,24035,68970
171845,202012,29,18,11,18810,11495,30305
171850,202012,39,31,8,32395,8360,40755
171855,202012,76,58,18,60610,18810,79420
171865,202012,7,6,1,6270,1045,7315
171870,202012,33,22,11,22990,11495,34485
171875,202012,79,56,23,58520,24035,82555
171880,202012,36,22,14,22990,14630,37620
171884,202012,50,27,23,28215,24035,52250
171886,202012,132,54,78,56430,81510,137940
171888,202012,31,25,6,26125,6270,32395
171889,202012,13,8,5,8360,5225,13585
171890,202012,55,47,8,49115,8360,57475
171900,202012,35,25,10,26125,10450,36575
172000,202012,39,30,9,31350,9405,40755
172010,202012,53,44,9,45980,9405,55385
172015,202012,24,16,8,16720.45,8360,25080.45
172020,202012,139,87,52,90915,54340,145255
172025,202012,39,26,13,27170,13585,40755
172030,202012,43,24,19,25080,19855,44935
172049,202012,82,53,29,55385,30305,85690
172065,202012,133,87,46,90915,48070,138985
172080,202012,104,68,36,71060,37620,108680
172085,202012,29,14,15,14630,15675,30305
172090,202012,425,323,102,337535.03,106590,444125.03
172093,202012,15,13,2,13585,2090,15675
172097,202012,18,11,7,11495,7315,18810
172100,202012,5101,2864,2237,2997095.58,2339755.7,5336851.28
172110,202012,75,47,28,49115,29260,78375
172120,202012,1638,1369,269,1431652.45,281105,1712757.45
172125,202012,11,10,1,10450,1045,11495
172130,202012,24,14,10,14630,10450,25080
172208,202012,203,122,81,128535,84645,213180
172210,202012,374,179,195,187055,203775,390830
210005,202012,2963,1862,1101,1946835.15,1151594,3098429.15
210010,202012,155,88,67,91960,70015,161975
210015,202012,40,29,11,30305,11495,41800
210020,202012,363,203,160,212135,167200,379335
210030,202012,329,215,114,224675,119130,343805
210040,202012,139,110,29,114950,30305,145255
210043,202012,250,189,61,197505,63745,261250
210047,202012,529,319,210,333355,219450,552805
210050,202012,286,210,76,219450,79420,298870
210055,202012,49,39,10,40755,10450,51205
210060,202012,531,422,109,440990,113905,554895
210070,202012,420,320,100,334400,104500,438900
210080,202012,127,114,13,119130,13585,132715
210083,202012,292,142,150,148390,156750,305140
210087,202012,2,1,1,1045,1045,2090
210090,202012,444,318,126,332310,131670,463980
210095,202012,429,327,102,341715,106590,448305
210100,202012,704,547,157,571615,166155,737770
210110,202012,124,78,46,81510,48070,129580
210120,202012,4966,3890,1076,4066098.35,1124420.12,5190518.47
210125,202012,186,115,71,120175,75240,195415
210130,202012,472,269,203,281105,212135,493240
210135,202012,25,18,7,18810,7315,26125
210140,202012,4374,3402,972,3556135.44,1015740,4571875.44
210150,202012,377,237,140,247665,146300,393965
210160,202012,3275,2780,495,2905101.36,518320,3423421.36
210170,202012,1142,912,230,953040,240350,1193390
210173,202012,125,109,16,113905,16720,130625
210177,202012,355,200,155,209000,161975,370975
210180,202012,30,16,14,16720,14630,31350
210190,202012,435,287,148,299915,155705,455620
210193,202012,3,2,1,2090,1045,3135
210197,202012,73,53,20,55385,20900,76285
210200,202012,606,509,97,531905,101365,633270
210203,202012,225,153,72,159885,75240,235125
210207,202012,362,298,64,311410,66880,378290
210210,202012,743,687,56,717915,58520,776435
210215,202012,74,66,8,68970,8360,77330
210220,202012,384,323,61,337535,63745,401280
210230,202012,315,251,64,262295,66880,329175
210232,202012,1373,931,442,972895,461890,1434785
210235,202012,170,128,42,133760,43890,177650
210237,202012,36,21,15,21945,15675,37620
210240,202012,92,76,16,79420,16720,96140
210250,202012,181,153,28,159885,29260,189145
210255,202012,350,264,86,275880,89870,365750
210260,202012,395,271,124,283195,129580,412775
210270,202012,646,432,214,451440,223630,675070
210275,202012,76,59,17,61655,17765,79420
210280,202012,1052,696,356,727320.7,372020,1099340.7
210290,202012,532,355,177,370975,184965,555940
210300,202012,5288,3333,1955,3484031.96,2042975,5527006.96
210310,202012,109,76,33,79420,34485,113905
210312,202012,115,80,35,83600,36575,120175
210315,202012,107,88,19,91960,19855,111815
210317,202012,135,100,35,104500,36575,141075
210320,202012,2312,1964,348,2053425,363660,2417085
210325,202012,139,87,52,90915.5,54340.5,145256.0
210330,202012,4587,2634,1953,2754620.75,2040885,4795505.75
210340,202012,1238,926,312,967670,326040.5,1293710.5
210350,202012,635,530,105,553850,109725,663575
210355,202012,146,122,24,127490,25080,152570
210360,202012,2225,1530,695,1599895,726275,2326170
210370,202012,1228,602,626,629090,654170,1283260
210375,202012,188,94,94,98230,98230,196460
210380,202012,716,549,167,573705,174515,748220
210390,202012,192,164,28,171380,29260,200640
210400,202012,390,340,50,355300,52250,407550
210405,202012,985,688,297,720005,310365,1030370
210407,202012,53,42,11,43890,11495,55385
210408,202012,59,52,7,54340,7315,61655
210409,202012,321,280,41,293645,42845,336490
210410,202012,442,345,97,360594.66,101365,461959.66
210420,202012,204,167,37,174515,38665,213180
210430,202012,49,34,15,35530,15675,51205
210440,202012,339,228,111,238260,115995,354255
210450,202012,140,112,28,117040,29260,146300
210455,202012,230,121,109,126445.5,113905,240350.5
210460,202012,304,205,99,214225,103455,317680
210462,202012,68,57,11,59565,11495,71060
210465,202012,140,109,31,113905,32395,146300
210467,202012,514,375,139,392920,145255,538175
210470,202012,50,43,7,44935,7315,52250
210480,202012,1265,905,360,945725,376200.62,1321925.62
210490,202012,202,134,68,140030,71060,211090
210500,202012,507,311,196,324995,204820,529815
210510,202012,546,435,111,454575,115995,570570
210515,202012,358,224,134,234080,140030,374110
210520,202012,400,360,40,376200,41800,418000
210530,202012,9398,4920,4478,5141404.8,4682648.54,9824053.34
210535,202012,130,98,32,102410,33440,135850
210540,202012,1506,999,507,1043955,529815,1573770
210542,202012,1159,588,571,615505,596696,1212201
210545,202012,22,20,2,20900,2090,22990
210547,202012,129,114,15,119130,15675,134805
210550,202012,676,490,186,512050.6,194370,706420.6
210560,202012,156,137,19,143165,19855,163020
210565,202012,21,16,5,16720,5225,21945
210570,202012,1274,1029,245,1075305.11,257070,1332375.11
210580,202012,117,100,17,104500,17765,122265
210590,202012,727,601,126,628045,131670,759715
210592,202012,37,35,2,36575,2090,38665
210594,202012,111,92,19,96140,19855,115995
210596,202012,103,88,15,91960,15675,107635
210598,202012,135,100,35,104500,36575,141075
210600,202012,311,269,42,281105,43890,324995
210610,202012,258,243,15,253935,15675,269610
210620,202012,44,28,16,29260,16720,45980
210630,202012,73,70,3,73150,3135,76285
210632,202012,1030,730,300,762850,313500,1076350
210635,202012,22,19,3,19855,3135,22990
210637,202012,122,87,35,90915,36575,127490
210640,202012,586,510,76,532950,79420,612370
210650,202012,398,332,66,346940,68970,415910
210660,202012,372,293,79,307230,82555,389785
210663,202012,37,27,10,28215,10450,38665
210667,202012,102,41,61,42845,63745,106590
210670,202012,242,215,27,224675,28215,252890
210675,202012,546,289,257,302005,268565,570570
210680,202012,221,144,77,150480,80465,230945
210690,202012,622,512,110,535040,114950,649990
210700,202012,158,119,39,124355,40755,165110
210710,202012,240,153,87,159885,90915,250800
210720,202012,129,116,13,121220,13585,134805
210725,202012,65,56,9,58520,9405,67925
210730,202012,24,18,6,18810,6270,25080
210735,202012,293,211,82,220495,85690.5,306185.5
210740,202012,521,449,72,469205,75240,544445
210745,202012,153,114,39,119130,40755,159885
210750,202012,2421,1223,1198,1278035.25,1251911,2529946.25
210760,202012,255,195,60,203775,62700,266475
210770,202012,243,195,48,203775,50160,253935
210780,202012,432,322,110,336490,114950,451440
210790,202012,183,151,32,157795,33440,191235
210800,202012,170,128,42,133760,43890,177650
210805,202012,53,48,5,50160,5225,55385
210810,202012,461,374,87,390830,90915,481745
210820,202012,2128,1755,373,1833975.9,389785,2223760.9
210825,202012,153,86,67,89870,70015,159885
210830,202012,730,486,244,507870,254980,762850
210840,202012,193,137,56,143165,58520,201685
210845,202012,230,161,69,168245,72105,240350
210850,202012,751,513,238,536085,248710,784795
210860,202012,3590,2051,1539,2143295.25,1608255,3751550.25
210870,202012,428,341,87,356345,90915,447260
210880,202012,75,58,17,60610,17765,78375
210890,202012,320,278,42,290510,43890,334400
210900,202012,622,404,218,422180,227810,649990
210905,202012,63,34,29,35530,30305,65835
210910,202012,1953,1474,479,1540331.06,501600,2041931.06
210920,202012,168,63,105,65835,109725,175560
210923,202012,84,67,17,70015,17765,87780
210927,202012,408,190,218,198550,227810,426360
210930,202012,68,54,14,56430,14630,71060
210940,202012,85,66,19,68970,19855,88825
210945,202012,192,103,89,107635,93005,200640
210950,202012,529,384,145,401280,151525,552805
210955,202012,81,49,32,51205,33440,84645
210960,202012,2183,1088,1095,1136960,1146365,2283325
210970,202012,116,102,14,106590,14630,121220
210975,202012,82,77,5,80465,5225,85690
210980,202012,1090,533,557,556985,582065.5,1139050.5
210990,202012,3996,2649,1347,2770295,1408660,4178955
211000,202012,1316,1059,257,1106655.5,268565,1375220.5
211003,202012,976,704,272,735680,284240,1019920
211010,202012,488,432,56,451440,58520,509960
211020,202012,1430,612,818,639540,854810,1494350
211023,202012,36,31,5,32395,5225,37620
211027,202012,74,53,21,55385,21945,77330
211030,202012,366,261,105,272745,109725,382470
211040,202012,294,243,51,253935.5,53295,307230.5
211050,202012,1153,761,392,795245,409640.5,1204885.5
211060,202012,631,549,82,573706,85690.46,659396.46
211065,202012,20,17,3,17765,3135,20900
211070,202012,887,735,152,768076.15,158840,926916.15
211080,202012,83,80,3,83600,3135,86735
211085,202012,55,28,27,29260,28215,57475
211090,202012,78,66,12,68970,12540,81510
211100,202012,481,397,84,414865,87780.5,502645.5
211102,202012,248,175,73,182875,76285,259160
211105,202012,221,157,64,164065,66880,230945
211107,202012,127,79,48,82555,50160,132715
211110,202012,937,625,312,654170,326040,980210
211120,202012,5264,2622,2642,2741036.05,2760890.4,5501926.45
211125,202012,33,24,9,25080,9405,34485
211130,202012,41481,19005,22476,19864412.26,23491602.75,43356015.01
211140,202012,397,348,49,363660,51205,414865
211150,202012,1179,796,383,832865,400235.5,1233100.5
211153,202012,170,105,65,109725,68970,178695
211157,202012,65,51,14,53295,14630,67925
211160,202012,694,596,98,622820,102410,725230
211163,202012,1,1,0,1045,0,1045
211167,202012,10,9,1,9405,1045,10450
211170,202012,415,310,105,323950,109725,433675
211172,202012,117,80,37,83600,38665,122265
211174,202012,255,158,97,165110,101365,266475
211176,202012,478,355,123,370975.5,128535,499510.5
211178,202012,94,62,32,64790,33440,98230
211180,202012,213,168,45,175560,47025,222585
211190,202012,71,65,6,67925,6270,74195
211195,202012,34,23,11,24035,11495,35530
211200,202012,150,131,19,136895,19855,156750
211210,202012,427,317,110,331265,114950,446215
211220,202012,4103,2408,1695,2517408.07,1772321,4289729.07
211223,202012,92,89,3,93005,3135,96140
211227,202012,66,52,14,54340,14630,68970
211230,202012,735,605,130,632225,135850,768075
211240,202012,401,315,86,330220,89870,420090
211245,202012,186,92,94,96140,98230,194370
211250,202012,1528,1322,206,1382535,215270,1597805
211260,202012,797,658,139,687610,145255,832865
211270,202012,1953,1598,355,1670955.5,370975.5,2041931.0
211280,202012,1739,1111,628,1160995,656260,1817255
211285,202012,206,125,81,130625,84645,215270
211290,202012,712,497,215,519365,224675,744040
211300,202012,749,594,155,620730,161975,782705
211400,202012,1519,938,581,980210,607145,1587355
220005,202012,17,15,2,15675,2090,17765
220010,202012,90,70,20,73150,20900,94050
220020,202012,690,549,141,574750,148390,723140
220025,202012,107,105,2,109725,2090,111815
220027,202012,43,34,9,35530,9405,44935
220030,202012,115,92,23,96140,24035,120175
220040,202012,1242,939,303,981255,316635.5,1297890.5
220045,202012,32,21,11,21945,11495,33440
220050,202012,690,574,116,599830.61,121220,721050.61
220060,202012,171,150,21,156750,21945,178695
220070,202012,111,101,10,105545,10450,115995
220080,202012,16,14,2,14630,2090,16720
220090,202012,32,26,6,27170,6270,33440
220095,202012,2,1,1,1045,1045,2090
220100,202012,18,15,3,15675,3135,18810
220105,202012,26,24,2,25080.5,2090,27170.5
220110,202012,229,209,20,218405,20900,239305
220115,202012,36,35,1,36575,1045,37620
220117,202012,21,20,1,20900,1045,21945
220120,202012,1464,1119,345,1169355,360525,1529880
220130,202012,31,30,1,31350,1045,32395
220140,202012,107,85,22,88825,22990,111815
220150,202012,497,368,129,384560,134805,519365
220155,202012,6,6,0,6270,0,6270
220157,202012,20,16,4,16720,4180,20900
220160,202012,89,79,10,82555,10450,93005
220170,202012,33,31,2,32395,2090,34485
220173,202012,9,9,0,9405,0,9405
220177,202012,8,7,1,7315,1045,8360
220180,202012,66,64,2,66880,2090,68970
220190,202012,1073,947,126,989615,131670,1121285
220191,202012,43,35,8,36575,8360,44935
220192,202012,84,81,3,85690,3135,88825
220194,202012,56,52,4,54340,4180,58520
220196,202012,98,82,16,85690,16720,102410
220198,202012,3,2,1,2090,1045,3135
220200,202012,415,342,73,357390.25,76285,433675.25
220202,202012,38,33,5,34485,5225,39710
220205,202012,53,47,6,49115,6270,55385
220207,202012,12,12,0,12540,0,12540
220208,202012,76,41,35,42845,36575,79420
220209,202012,32,28,4,29260,4180,33440
220210,202012,20,13,7,13585,7315,20900
220211,202012,26,24,2,25080,2090,27170
220213,202012,40,35,5,36575,5225.5,41800.5
220217,202012,39,29,10,30305,10450,40755
220220,202012,2191,1452,739,1517340,774345.5,2291685.5
220225,202012,8,3,5,3135,5225,8360
220230,202012,959,739,220,772255,229900,1002155
220240,202012,158,140,18,146300,18810,165110
220245,202012,34,30,4,31350.97,4180,35530.97
220250,202012,121,107,14,111815,14630,126445
220253,202012,47,40,7,41800,7315,49115
220255,202012,31,27,4,28215,4180,32395
220260,202012,698,524,174,547580,181830,729410
220265,202012,5,3,2,3135,2090,5225
220270,202012,761,685,76,715825,79420,795245
220271,202012,43,35,8,36575,8360,44935
220272,202012,22,21,1,21945,1045,22990
220273,202012,17,15,2,15675,2090,17765
220275,202012,57,46,11,48070,11495,59565
220277,202012,18,13,5,13585,5225,18810
220280,202012,17,12,5,12540,5225,17765
220285,202012,41,39,2,40755,2090,42845
220290,202012,1462,1258,204,1314611,213180.25,1527791.25
220300,202012,36,34,2,35530,2090,37620
220310,202012,324,275,49,287375,51205,338580
220320,202012,439,405,34,423225.5,35530,458755.5
220323,202012,1,0,1,0,1045,1045
220325,202012,11,10,1,10450,1045,11495
220327,202012,9,9,0,9405,0,9405
220330,202012,229,168,61,175560,63745,239305
220335,202012,141,123,18,128535,18810,147345
220340,202012,39,27,12,28215,12540,40755
220342,202012,55,47,8,49115,8360,57475
220345,202012,81,73,8,76285,8360,84645
220350,202012,444,382,62,399190,64790,463980
220360,202012,43,31,12,32395,12540,44935
220370,202012,1232,1020,212,1065900,221540,1287440
220375,202012,19,17,2,17765,2090,19855
220380,202012,23,17,6,17765,6270,24035
220385,202012,13,12,1,12540,1045,13585
220390,202012,2332,1321,1011,1381490.6,1057541.25,2439031.85
220400,202012,33,29,4,30305,4180,34485
220410,202012,21,18,3,18810,3135,21945
220415,202012,13,11,2,11495,2090,13585
220420,202012,125,105,20,109725,20900,130625
220430,202012,129,115,14,120175,14630,134805
220435,202012,24,17,7,17765,7315,25080
220440,202012,279,237,42,249755,43890,293645
220450,202012,335,169,166,176605,173470,350075
220455,202012,51,50,1,52250,1045,53295
220460,202012,20,18,2,18810,2090,20900
220465,202012,92,61,31,63745,32395,96140
220470,202012,243,210,33,219450,34485,253935
220480,202012,72,65,7,67925,7315,75240
220490,202012,87,74,13,77330,13585,90915
220500,202012,107,91,16,95095,16720,111815
220510,202012,417,323,94,337535,98230,435765
220515,202012,21,19,2,19855,2090,21945
220520,202012,365,327,38,341715.85,39710,381425.85
220525,202012,10,7,3,7315,3135,10450
220527,202012,18,14,4,14630,4180,18810
220530,202012,33,12,21,12540,21945,34485
220535,202012,4,4,0,4180,0,4180
220540,202012,69,56,13,58520,13585,72105
220545,202012,39,26,13,27170,13585,40755
220550,202012,711,560,151,585200,157795,742995
220551,202012,13,10,3,10450,3135,13585
220552,202012,16,16,0,16720,0,16720
220553,202012,54,48,6,50160,6270,56430
220554,202012,11,8,3,8360,3135,11495
220555,202012,35,31,4,32395,4180,36575
220556,202012,40,38,2,39710,2090,41800
220557,202012,58,54,4,56430,4180,60610
220558,202012,8,3,5,3135,5225,8360
220559,202012,2,2,0,2090,0,2090
220560,202012,70,46,24,48070,25080,73150
220570,202012,732,452,280,472340.5,292600,764940.5
220580,202012,539,493,46,515185,48070,563255
220585,202012,10,9,1,9405,1045,10450
220590,202012,14,14,0,14630,0,14630
220595,202012,64,48,16,50160,16720,66880
220600,202012,19,11,8,11495,8360,19855
220605,202012,24,21,3,21945,3135,25080
220610,202012,77,65,12,67925,12540,80465
220620,202012,553,460,93,480700,97185,577885
220630,202012,5,4,1,4180,1045,5225
220635,202012,36,31,5,32395,5225,37620
220640,202012,106,88,18,91960,18810,110770
220650,202012,112,105,7,109725,7315,117040
220660,202012,56,45,11,47025,11495,58520
220665,202012,5,5,0,5225,0,5225
220667,202012,19,17,2,17765,2090,19855
220669,202012,26,23,3,24035,3135,27170
220670,202012,65,52,13,54340,13585,67925
220672,202012,77,54,23,56430,24035,80465
220675,202012,36,28,8,29260,8360,37620
220680,202012,43,37,6,38665,6270,44935
220690,202012,47,44,3,45980,3135,49115
220695,202012,33,16,17,16720,17765,34485
220700,202012,1698,1310,388,1368950.5,405460,1774410.5
220710,202012,6,4,2,4180,2090,6270
220720,202012,108,91,17,95095,17765,112860
220730,202012,14,14,0,14630,0,14630
220735,202012,5,1,4,1045,4180,5225
220740,202012,47,43,4,44935,4180,49115
220750,202012,111,95,16,99275,16720,115995
220755,202012,14,13,1,13585,1045,14630
220760,202012,65,59,6,61655,6270,67925
220770,202012,5684,3093,2591,3233232.01,2707595.5,5940827.51
220775,202012,17,10,7,10450,7315,17765
220777,202012,19,18,1,18810,1045,19855
220779,202012,1,0,1,0,1045,1045
220780,202012,889,757,132,791065,138985.5,930050.5
220785,202012,5,1,4,1045,4180,5225
220790,202012,1098,863,235,901835.05,245575,1147410.05
220793,202012,6,6,0,6270,0,6270
220795,202012,13,11,2,11495,2090,13585
220800,202012,4003,3075,928,3213375.75,969760,4183135.75
220810,202012,65,56,9,58520.5,9405,67925.5
220820,202012,237,216,21,225720,21945,247665
220830,202012,1248,1077,171,1128600,178695,1307295
220840,202012,2402,1667,735,1743063.09,769120.95,2512184.04
220850,202012,60,51,9,53295,9405,62700
220855,202012,8,5,3,5225,3135,8360
220860,202012,13,10,3,10450,3135,13585
220865,202012,29,27,2,28215,2090,30305
220870,202012,76,69,7,72105,7315,79420
220880,202012,321,255,66,266475,68970,335445
220885,202012,31,28,3,29260,3135,32395
220887,202012,13,12,1,12540,1045,13585
220890,202012,94,82,12,85690,12540,98230
220900,202012,23,14,9,14630,9405,24035
220910,202012,51,42,9,43890,9405,53295
220915,202012,10,9,1,9405,1045,10450
220920,202012,47,42,5,43890,5225,49115
220930,202012,44,43,1,44935,1045,45980
220935,202012,15,15,0,15675,0,15675
220937,202012,33,32,1,33440,1045,34485
220940,202012,55,50,5,52250,5225,57475
220945,202012,2,2,0,2090,0,2090
220950,202012,41,32,9,33440,9405,42845
220955,202012,22,20,2,20900,2090,22990
220960,202012,16,15,1,15675,1045,16720
220965,202012,37,33,4,34485,4180,38665
220970,202012,61,52,9,54340,9405,63745
220975,202012,15,13,2,13585,2090,15675
220980,202012,32,30,2,31350,2090,33440
220985,202012,62,55,7,57475,7315,64790
220987,202012,30,29,1,30305,1045,31350
220990,202012,27,26,1,27170,1045,28215
220995,202012,18,15,3,15675,3135,18810
220997,202012,65,54,11,56430,11495,67925
221000,202012,1179,1062,117,1110835,122265,1233100
221005,202012,45,41,4,42845,4180,47025
221010,202012,16,12,4,12540,4180,16720
221020,202012,36,35,1,36575,1045,37620
221030,202012,38,30,8,31350,8360,39710
221035,202012,22,22,0,22990,0,22990
221037,202012,12,8,4,8360,4180,12540
221038,202012,27,24,3,25080,3135,28215
221039,202012,22,22,0,22990,0,22990
221040,202012,257,218,39,227810,40755,268565
221050,202012,236,197,39,205865,40755,246620
221060,202012,1860,1620,240,1692900,250800,1943700
221062,202012,34,34,0,35530,0,35530
221063,202012,11,7,4,7315,4180,11495
221065,202012,61,48,13,50160,13585,63745
221070,202012,136,118,18,123310,18810,142120
221080,202012,372,319,53,333355,55385,388740
221090,202012,22,18,4,18810,4180,22990
221093,202012,44,33,11,34485,11495,45980
221095,202012,6,6,0,6270,0,6270
221097,202012,13,11,2,11495,2090,13585
221100,202012,25466,15089,10377,15775325.65,10851281.45,26626607.10
221110,202012,1103,839,264,876755.5,275880,1152635.5
221120,202012,541,397,144,415910.5,150480,566390.5
221130,202012,967,777,190,811965,198550,1010515
221135,202012,36,31,5,32395,5225,37620
221140,202012,44,38,6,39710,6270,45980
221150,202012,10,8,2,8360,2090,10450
221160,202012,13,13,0,13585,0,13585
221170,202012,15,15,0,15675,0,15675
230010,202012,149,137,12,143165,12540,155705
230015,202012,129,104,25,108680,26125,134805
230020,202012,1620,1361,259,1422245.5,270655,1692900.5
230030,202012,1673,1201,472,1255046,493240,1748286
230040,202012,219,185,34,193325,35530,228855
230050,202012,225,165,60,172425,62700,235125
230060,202012,159,126,33,132715,34485,167200
230070,202012,302,259,43,270655,44935,315590
230075,202012,840,723,117,755536.5,122265,877801.5
230080,202012,195,166,29,173470,30305,203775
230090,202012,131,94,37,98230,38665,136895
230100,202012,2177,1236,941,1291621.5,983345,2274966.5
230110,202012,2892,1861,1031,1946835.5,1077395.68,3024231.18
230120,202012,1011,791,220,826595,230945,1057540
230125,202012,151,123,28,128535,29260,157795
230130,202012,472,418,54,436810,56430,493240
230140,202012,220,183,37,191235,38665,229900
230150,202012,147,112,35,117040,36575,153615
230160,202012,942,796,146,831820,152570,984390
230170,202012,606,545,61,569525.5,63745,633270.5
230180,202012,72,66,6,68970,6270,75240
230185,202012,404,346,58,362615.5,60610,423225.5
230190,202012,2370,1854,516,1938475.15,539220,2477695.15
230195,202012,490,425,65,444125.5,67925,512050.5
230200,202012,417,338,79,353210,82555,435765
230205,202012,390,257,133,268565,138985,407550
230210,202012,1355,1049,306,1096205.88,319770,1415975.88
230220,202012,1578,1062,516,1110835,539220,1650055
230230,202012,961,806,155,843315,161975.5,1005290.5
230240,202012,1742,1494,248,1563583.75,259160,1822743.75
230250,202012,1765,1446,319,1513160,334400.5,1847560.5
230260,202012,3258,2025,1233,2116125,1289530,3405655
230270,202012,1367,1091,276,1141141.88,288420.5,1429562.38
230280,202012,2729,2041,688,2138070,720005.5,2858075.5
230290,202012,400,358,42,374110.72,43890,418000.72
230300,202012,527,379,148,396055,154660,550715
230310,202012,413,313,100,327085,104500,431585
230320,202012,928,786,142,821371,148390,969761
230330,202012,306,245,61,256025,63745,319770
230340,202012,449,361,88,377245,91960,469205
230350,202012,3183,2001,1182,2093135,1237280,3330415
230360,202012,279,221,58,230945,60610,291555
230365,202012,132,110,22,114950,22990,137940
230370,202012,10224,4955,5269,5180069.42,5511331.5,10691400.92
230380,202012,484,411,73,429495.5,76285,505780.5
230390,202012,550,304,246,317680,257070.5,574750.5
230393,202012,253,208,45,217360,47025,264385
230395,202012,353,282,71,294691.2,74195,368886.2
230400,202012,614,488,126,511005,132715,643720
230410,202012,2663,1656,1007,1732610.97,1053360.5,2785971.47
230420,202012,6288,4140,2148,4327348.54,2245705.2,6573053.74
230423,202012,333,290,43,303050,44935,347985
230425,202012,420,342,78,357390.85,81510,438900.85
230426,202012,117,95,22,99275,22990,122265
230427,202012,73,69,4,72105,4180,76285
230428,202012,1541,760,781,795245.5,816145,1611390.5
230430,202012,457,372,85,388740,88825,477565
230435,202012,873,627,246,655215,257070.77,912285.77
230440,202012,89658,39645,50013,41455066.81,52311673.8,93766740.61
230445,202012,313,216,97,225720,101365,327085
230450,202012,561,441,120,460845,125400,586245
230460,202012,70,52,18,54340,18810,73150
230465,202012,302,244,58,254980,60610,315590
230470,202012,2022,1591,431,1663640,451440.25,2115080.25
230480,202012,153,144,9,150480,9405,159885
230490,202012,297,236,61,246620,63745,310365
230495,202012,458,336,122,351120.5,127490,478610.5
230500,202012,1018,748,270,781660,282150,1063810
230510,202012,57,44,13,45980,14630,60610
230520,202012,384,302,82,315590.53,85690,401280.53
230523,202012,2393,1485,908,1551826.75,949906.01,2501732.76
230526,202012,277,236,41,246620,42845,289465
230530,202012,680,503,177,525635,184965,710600
230533,202012,205,190,15,198550,15675,214225
230535,202012,372,276,96,288420,100320,388740
230540,202012,1787,1582,205,1653190,214225,1867415
230550,202012,3835,2449,1386,2560635.44,1448370,4009005.44
230560,202012,577,434,143,453530,149435,602965
230565,202012,223,163,60,170335,62700,233035
230570,202012,290,255,35,266475,36575,303050
230580,202012,1166,839,327,876755,341715,1218470
230590,202012,998,775,223,810920.25,233035,1043955.25
230600,202012,241,220,21,229900,21945,251845
230610,202012,371,283,88,295735,91960,387695
230620,202012,201,170,31,177650.5,32395,210045.5
230625,202012,777,537,240,561165.75,250800,811965.75
230630,202012,1335,1031,304,1077395,317680,1395075
230640,202012,3802,3201,601,3345046,628046.25,3973092.25
230650,202012,456,390,66,407550,68970,476520
230655,202012,688,580,108,606100,112860,718960
230660,202012,361,296,65,309320,67925,377245
230670,202012,447,379,68,396055,71060,467115
230680,202012,204,184,20,192280,20900,213180
230690,202012,911,767,144,801515,150480,951995
230700,202012,851,713,138,745085,144210.5,889295.5
230710,202012,688,651,37,681340,38665,720005
230720,202012,150,128,22,133760,22990,156750
230725,202012,210,163,47,170335,49115,219450
230730,202012,12266,6593,5673,6893802.05,5932468.37,12826270.42
230740,202012,669,536,133,560120.5,138985,699105.5
230750,202012,831,696,135,727320,141075,868395
230760,202012,1457,1249,208,1305205.5,217360,1522565.5
230763,202012,329,271,58,283195,60610,343805
230765,202012,7623,3467,4156,3624061.01,4346156.75,7970217.76
230770,202012,5028,2548,2480,2662662.25,2591600.5,5254262.75
230780,202012,723,631,92,659395.5,96140,755535.5
230790,202012,288,239,49,249755,51205,300960
230800,202012,1139,813,326,849585,340670,1190255
230810,202012,1358,1194,164,1247730,171380,1419110
230820,202012,367,251,116,262295.5,121220,383515.5
230830,202012,956,813,143,849585,149435,999020
230835,202012,274,234,40,244530,41800,286330
230837,202012,172,144,28,150480,29260,179740
230840,202012,926,721,205,753445.5,214225.5,967671.0
230850,202012,1481,1275,206,1332375,215270,1547645
230860,202012,302,226,76,236170,79420,315590
230870,202012,1823,1544,279,1613480,291555,1905035
230880,202012,64,48,16,50160,16720,66880
230890,202012,529,482,47,503690,49115,552805
230900,202012,281,203,78,212135,81510.31,293645.31
230910,202012,221,172,49,179740,51205,230945
230920,202012,424,337,87,352165,90915,443080
230930,202012,983,684,299,714780,312455,1027235
230940,202012,855,662,193,692835,201685,894520
230945,202012,527,423,104,442035,108680,550715
230950,202012,412,357,55,374110,57475,431585
230960,202012,2681,1785,896,1866370.5,936320.5,2802691.0
230970,202012,1701,939,762,981255,796290,1777545
230980,202012,204,167,37,174515,38665,213180
230990,202012,136,111,25,115995,26125,142120
231000,202012,190,176,14,183920,14630,198550
231010,202012,150,109,41,113905,42845,156750
231020,202012,1353,931,422,973940.25,440990,1414930.25
231025,202012,1062,781,281,816145.5,294690.5,1110836.0
231030,202012,1093,910,183,950950.4,191235,1142185.4
231040,202012,144,95,49,99275,51205,150480
231050,202012,935,825,110,863170.54,114950,978120.54
231060,202012,156,131,25,136895,26125,163020
231070,202012,1488,1030,458,1076350.75,478610,1554960.75
231080,202012,263,240,23,250800,24035,274835
231085,202012,624,375,249,392921,260205,653126
231090,202012,250,200,50,209000,52250,261250
231095,202012,169,135,34,141075,35530,176605
231100,202012,148,124,24,129580,25080,154660
231110,202012,369,312,57,326040,59565,385605
231120,202012,268,229,39,239305,40755,280060
231123,202012,154,145,9,151525,9405,160930
231126,202012,332,256,76,267520,79420,346940
231130,202012,4763,3714,1049,3881131.3,1097250.5,4978381.8
231135,202012,210,181,29,189145,30305,219450
231140,202012,3080,2249,831,2350206,868395,3218601
231150,202012,366,345,21,360525,21945,382470
231160,202012,1204,950,254,992750.5,265430,1258180.5
231170,202012,515,354,161,369930,168245,538175
231180,202012,1706,1460,246,1525700,258115,1783815
231190,202012,205,172,33,180785,34485,215270
231195,202012,212,178,34,186010,35530,221540
231200,202012,797,651,146,680295,152570,832865
231210,202012,577,483,94,505780,98230,604010
231220,202012,1047,762,285,796291.7,297825,1094116.7
231230,202012,1469,1152,317,1203840,332310,1536150
231240,202012,1470,1036,434,1083665,453530,1537195
231250,202012,107,99,8,103455,8360,111815
231260,202012,274,178,96,186010,100320,286330
231270,202012,997,802,195,838091.65,203775,1041866.65
231280,202012,75,57,18,59565,18810,78375
231290,202012,7700,4303,3397,4496636,3550910.94,8047546.94
231300,202012,604,558,46,583110,48070,631180
231310,202012,735,675,60,705376.06,62700,768076.06
231320,202012,588,439,149,459801.5,155705,615506.5
231325,202012,102,88,14,91960,14630.5,106590.5
231330,202012,1976,1532,444,1601204.4,463980,2065184.4
231335,202012,251,221,30,230945,31350,262295
231340,202012,1724,1245,479,1303115,500555,1803670
231350,202012,1298,1044,254,1092025,265431.5,1357456.5
231355,202012,429,362,67,378290,70015,448305
231360,202012,512,369,143,385605.86,149435,535040.86
231370,202012,87,76,11,79420,11495,90915
231375,202012,289,208,81,217360,84645,302005
231380,202012,494,395,99,412775,103455,516230
231390,202012,205,159,46,166155,48070,214225
231395,202012,739,462,277,482790,290510,773300
231400,202012,1127,931,196,973940.25,204820.5,1178760.75
231410,202012,1328,1084,244,1132780,254980,1387760
240010,202012,393,168,225,175560.67,235125,410685.67
240020,202012,2256,1830,426,1912351.46,445170,2357521.46
240030,202012,120,100,20,104500,20900,125400
240040,202012,33,33,0,34485,0,34485
240050,202012,520,444,76,463980,79420,543400
240060,202012,66,62,4,64790,4180,68970
240070,202012,220,173,47,180785,49115,229900
240080,202012,528,358,170,374110,177650.01,551760.01
240090,202012,96,85,11,88825,11495,100320
240100,202012,1492,1403,89,1468225.37,93005,1561230.37
240110,202012,1025,663,362,693881,378290.75,1072171.75
240120,202012,141,110,31,115995,32395,148390
240130,202012,281,259,22,270655,22990,293645
240140,202012,78,57,21,59565.5,21945,81510.5
240145,202012,741,655,86,684475,89870,774345
240150,202012,21,16,5,16720,5225,21945
240160,202012,41,34,7,35530,7315,42845
240165,202012,36,28,8,29260.25,8360,37620.25
240170,202012,116,81,35,84645,36575,121220
240180,202012,90,69,21,72105,21945,94050
240185,202012,44,41,3,42845,3135,45980
240190,202012,14,12,2,12540,2090,14630
240200,202012,3111,1743,1368,1821437,1430640.83,3252077.83
240210,202012,172,132,40,137940,41800,179740
240220,202012,1101,794,307,829730.75,321093.66,1150824.41
240230,202012,849,780,69,815100.75,72105,887205.75
240240,202012,72,53,19,55385,19855,75240
240250,202012,92,79,13,82555,13585,96140
240260,202012,1815,1329,486,1390895.5,507870,1898765.5
240270,202012,185,163,22,170335,22990,193325
240280,202012,46,35,11,36575,11495,48070
240290,202012,47,44,3,45980,3135,49115
240300,202012,179,95,84,99275,87780,187055
240310,202012,2362,1291,1071,1349096.73,1119195.85,2468292.58
240320,202012,192,179,13,187055,13585,200640
240325,202012,4556,2683,1873,2804782.79,1958330.7,4763113.49
240330,202012,74,68,6,71060,6270,77330
240340,202012,72,46,26,48070,27170,75240
240350,202012,92,80,12,83600,12540,96140
240360,202012,555,338,217,353210,226765.5,579975.5
240370,202012,52,48,4,50160,4180,54340
240375,202012,63,38,25,39710,26125,65835
240380,202012,231,188,43,196460,44935.5,241395.5
240390,202012,12,11,1,11495,1045,12540
240400,202012,82,73,9,76285,9405,85690
240410,202012,14,8,6,8360,6270,14630
240420,202012,1019,738,281,771210,295735,1066945
240430,202012,264,247,17,259160,17765,276925
240440,202012,124,68,56,71060,58520,129580
240450,202012,229,155,74,161975.5,77330,239305.5
240460,202012,72,56,16,58520,16720,75240
240470,202012,233,208,25,217360,26125,243485
240480,202012,17,15,2,15675,2090,17765
240485,202012,80,66,14,68970,14630,83600
240490,202012,44,42,2,43890,2090,45980
240500,202012,86,64,22,66880,22990,89870
240510,202012,43,32,11,33440,11495,44935
240520,202012,113,108,5,112860,5225,118085
240530,202012,56,48,8,50160,8360,58520
240540,202012,77,65,12,67925,12540,80465
240550,202012,13,12,1,12540,1045,13585
240560,202012,379,276,103,288420.5,107635,396055.5
240570,202012,445,282,163,294690,170335.5,465025.5
240580,202012,1289,1009,280,1054405.25,292600,1347005.25
240590,202012,30,28,2,29260,2090,31350
240600,202012,102,97,5,101365,5225,106590
240610,202012,515,431,84,450395.5,87780,538175.5
240615,202012,17,16,1,16720,1045,17765
240620,202012,87,84,3,87780,3135,90915
240630,202012,39,34,5,35530,5225,40755
240640,202012,27,21,6,21945,6270,28215
240650,202012,245,201,44,210045,45980,256025
240660,202012,113,96,17,100320,17765,118085
240670,202012,308,174,134,181830.75,140030,321860.75
240680,202012,50,37,13,38665,13585,52250
240690,202012,47,44,3,45980,3135,49115
240700,202012,185,152,33,158840,34485,193325
240710,202012,2024,1242,782,1297891.75,817190,2115081.75
240720,202012,1064,780,284,815100,296780,1111880
240725,202012,68,63,5,65835,5225,71060
240730,202012,149,126,23,131670,24035,155705
240740,202012,230,195,35,203775,36575.85,240350.85
240750,202012,52,29,23,30305,24035,54340
240760,202012,46,41,5,42845,5225,48070
240770,202012,146,113,33,118085,34485,152570
240780,202012,677,561,116,587290,121220,708510
240790,202012,42,40,2,41800,2090,43890
240800,202012,9302,6302,3000,6591870.3,3138137.75,9730008.05
240810,202012,20567,11024,9543,11525248.78,9979753.9,21505002.68
240820,202012,241,143,98,149435.09,102410,251845.09
240830,202012,1605,1315,290,1376265.75,303398.33,1679664.08
240840,202012,77,67,10,70015,10450,80465
240850,202012,86,77,9,80465,9405,89870
240860,202012,102,98,4,102410,4180,106590
240870,202012,58,50,8,52250.5,8360,60610.5
240880,202012,30,27,3,28215,3135,31350
240890,202012,1124,633,491,662530,513095,1175625
240895,202012,60,41,19,42845,19855,62700
240910,202012,158,139,19,146300,19855,166155
240920,202012,13,10,3,10450,3135,13585
240930,202012,408,365,43,381425,44935,426360
240933,202012,50,33,17,34485,17765,52250
240940,202012,2358,2086,272,2180915.45,284240,2465155.45
240950,202012,49,44,5,45980,5225,51205
240960,202012,25,21,4,21945,4180,26125
240970,202012,114,82,32,85690,33440,119130
240980,202012,197,157,40,164065,41800,205865
240990,202012,130,86,44,89870,45980,135850
241000,202012,61,57,4,59565,4180,63745
241010,202012,75,55,20,57475,20900,78375
241020,202012,113,104,9,108680,9405,118085
241025,202012,12,5,7,5225,7315,12540
241030,202012,114,90,24,94050,25080,119130
241040,202012,44,31,13,32395,13585,45980
241050,202012,82,74,8,77330,8360,85690
241060,202012,29,24,5,25080,5225,30305
241070,202012,15,15,0,15675,0,15675
241080,202012,61,54,7,56430,7315,63745
241090,202012,58,46,12,48070,12540,60610
241100,202012,71,60,11,62700,11495,74195
241105,202012,8,3,5,3135,5225,8360
241110,202012,49,45,4,47025,4180,51205
241120,202012,1477,1118,359,1168310.5,375155,1543465.5
241140,202012,222,184,38,192280.5,39710,231990.5
241142,202012,38,32,6,33440,6270,39710
241150,202012,1186,1038,148,1085755,154660,1240415
241160,202012,17,16,1,16720,1045,17765
241170,202012,46,39,7,40755,7315,48070
241180,202012,44,37,7,38665,7315,45980
241190,202012,36,35,1,36575,1045,37620
241200,202012,3970,2043,1927,2137026.39,2014760,4151786.39
241210,202012,67,58,9,60610,9405,70015
241220,202012,1429,949,480,992751.6,501600,1494351.6
241230,202012,246,203,43,212135,44935,257070
241240,202012,53,42,11,43890,11495,55385
241250,202012,1101,1008,93,1055450,97185,1152635
241255,202012,52,40,12,41800,12540,54340
241260,202012,687,529,158,554895.5,165110,720005.5
241270,202012,64,44,20,45980,20900.48,66880.48
241280,202012,95,83,12,86735,12540,99275
241290,202012,127,87,40,90915,41800,132715
241300,202012,82,56,26,58520,27170,85690
241310,202012,52,37,15,38665,15675,54340
241320,202012,29,17,12,17765,12540,30305
241330,202012,63,55,8,57475,8360,65835
241335,202012,73,65,8,67925,8360,76285
241340,202012,184,135,49,141075.5,51205,192280.5
241350,202012,61,51,10,53295,10450,63745
241355,202012,49,42,7,43890,7315,51205
241360,202012,48,47,1,49115,1045,50160
241370,202012,55,43,12,44935,12540,57475
241380,202012,36,32,4,33440,4180,37620
241390,202012,84,64,20,66880,20900,87780
241400,202012,218,173,45,180785,47025,227810
241410,202012,182,164,18,171380,18810,190190
241415,202012,102,83,19,86735,19855,106590
241420,202012,100,76,24,79420.5,25080,104500.5
241430,202012,26,24,2,25080,2090,27170
241440,202012,531,431,100,451440,104500,555940
241445,202012,39,34,5,35530,5225,40755
241450,202012,270,221,49,230945,51205,282150
241460,202012,141,128,13,133760.25,13585,147345.25
241470,202012,36,31,5,32395,5225,37620
241475,202012,52,49,3,51205,3135,54340
241480,202012,101,71,30,74195,31350,105545
241490,202012,11,10,1,10450,1045,11495
241500,202012,48,37,11,38665,11495,50160
250010,202012,100,85,15,88825,15675,104500
250020,202012,30,26,4,28215,4180,32395
250030,202012,890,662,228,691790,238260,930050
250040,202012,370,302,68,315590,71060,386650
250050,202012,256,209,47,218405,49115,267520
250053,202012,55,41,14,42845,14630,57475
250057,202012,1,1,0,1045,0,1045
250060,202012,586,413,173,431585,180785,612370
250070,202012,705,565,140,590425.1,146300,736725.1
250073,202012,8,8,0,8360,0,8360
250077,202012,177,133,44,138985,45980,184965
250080,202012,431,341,90,356345.8,94050,450395.8
250090,202012,225,146,79,152570,82555,235125
250100,202012,517,426,91,446215,95095,541310
250110,202012,627,473,154,494285,160930,655215
250115,202012,21,8,13,8360,13585,21945
250120,202012,120,87,33,90915,34485,125400
250130,202012,572,460,112,480700.5,117040,597740.5
250135,202012,16,9,7,9405,7315,16720
250140,202012,86,76,10,79420,10450,89870
250150,202012,590,422,168,440990,175560,616550
250153,202012,11,8,3,8360,3135,11495
250157,202012,31,25,6,26125,6270,32395
250160,202012,235,185,50,193325,52250,245575
250170,202012,65,42,23,43890,24035,67925
250180,202012,4346,2926,1420,3059760.3,1484945,4544705.3
250190,202012,833,545,288,569525.5,300960.25,870485.75
250200,202012,48,39,9,40755,9405,50160
250205,202012,23,20,3,20900,3135,24035
250210,202012,86,75,11,78375,11495,89870
250215,202012,67,54,13,56430,13585,70015
250220,202012,25,18,7,18810,7315,26125
250230,202012,76,68,8,71060,8360,79420
250240,202012,229,187,42,195415,44935,240350
250250,202012,385,327,58,342028.5,60610,402638.5
250260,202012,43,36,7,37620,7315,44935
250270,202012,78,56,22,58520,22990,81510
250280,202012,375,305,70,318725,73150,391875
250290,202012,92,83,9,86735,9405,96140
250300,202012,552,371,181,387695,189145,576840
250310,202012,51,42,9,43890,9405,53295
250320,202012,1959,1309,650,1367905.85,680295.9,2048201.75
250330,202012,100,84,16,87780,16720,104500
250340,202012,26,24,2,25080,2090,27170
250350,202012,172,111,61,115995,64790,180785
250355,202012,31,24,7,25080,7315,32395
250360,202012,198,162,36,169290,37620,206910
250370,202012,2398,1564,834,1638560,872575,2511135
250375,202012,12,7,5,7315,5225,12540
250380,202012,54,42,12,43890,12540,56430
250390,202012,45,34,11,35530,11495,47025
250400,202012,16486,8295,8191,8671398.49,8572416.81,17243815.30
250403,202012,332,266,66,277970,68970,346940
250407,202012,64,51,13,53295,13585,66880
250410,202012,30,26,4,27170,4180,31350
250415,202012,41,29,12,30305,12540,42845
250420,202012,43,37,6,38665,6270,44935
250430,202012,1439,1237,202,1292926.25,211090,1504016.25
250435,202012,19,14,5,14630,5225,19855
250440,202012,676,561,115,587290,120175,707465
250450,202012,86,65,21,67925,21945,89870
250460,202012,467,303,164,316635,171380,488015
250470,202012,94,64,30,66880,31350,98230
250480,202012,330,264,66,275880,68970,344850
250485,202012,3,3,0,3135,0,3135
250490,202012,228,181,47,190190,49115,239305
250500,202012,97,71,26,74195,27170,101365
250510,202012,766,602,164,629090,171380,800470
250520,202012,179,120,59,125400,61655,187055
250523,202012,121,96,25,100320,26125,126445
250527,202012,104,80,24,83600,25080,108680
250530,202012,10,6,4,6270,4180,10450
250535,202012,33,24,9,25080,9405,34485
250540,202012,132,102,30,106590,31350,137940
250550,202012,72,69,3,72105,3135,75240
250560,202012,48,35,13,36575,13585,50160
250570,202012,164,134,30,140030,31350,171380
250580,202012,107,83,24,86802,25080,111882
250590,202012,24,14,10,14630,10450,25080
250600,202012,1415,916,499,957221.46,521455,1478676.46
250610,202012,161,131,30,136895,31350.5,168245.5
250620,202012,20,16,4,16720,4180,20900
250625,202012,72,53,19,55385,19855,75240
250630,202012,3089,1964,1125,2052381.68,1175625,3228006.68
250640,202012,221,175,46,182875,48070,230945
250650,202012,30,20,10,20900,10450,31350
250660,202012,50,38,12,39710,12540,52250
250670,202012,62,45,17,47025,17765,64790
250680,202012,410,329,81,343805,84645,428450
250690,202012,2063,1424,639,1488080.96,668800,2156880.96
250700,202012,929,800,129,836000.25,134805,970805.25
250710,202012,429,331,98,345895,102410,448305
250720,202012,110,79,31,82555,32395,114950
250730,202012,386,322,64,336490,66880,403370
250740,202012,52,48,4,50160,4180,54340
250750,202012,22383,13350,9033,13955870.28,9448892,23404762.28
250760,202012,106,82,24,85690,25080,110770
250770,202012,365,237,128,247665.6,133760,381425.6
250780,202012,68,44,24,45980,25080,71060
250790,202012,466,304,162,317680,169290,486970
250800,202012,154,139,15,145255,15675,160930
250810,202012,75,60,15,62700,15675,78375
250820,202012,151,125,26,130625,27170,157795
250830,202012,436,289,147,302005.5,153615,455620.5
250840,202012,55,49,6,51205,6270,57475
250850,202012,56,46,10,48070,10450,58520
250855,202012,14,12,2,12540,2090,14630
250860,202012,219,150,69,156750,72105,228855
250870,202012,29,25,4,26125,4180,30305
250880,202012,88,64,24,66880,25080,91960
250890,202012,2834,2100,734,2194500,768075,2962575
250900,202012,51,42,9,43890,9405,53295
250905,202012,117,88,29,91960,30305,122265
250910,202012,1110,805,305,841225,318725,1159950
250915,202012,104,75,29,78375,30305,108680
250920,202012,141,102,39,106590,40755,147345
250930,202012,178,103,75,107635,78375,186010
250933,202012,6,4,2,4180,2090,6270
250937,202012,10,10,0,10450,0,10450
250939,202012,30,22,8,22990,8360,31350
250940,202012,103,74,29,77330,30305,107635
250950,202012,70,47,23,49115,24035,73150
250960,202012,92,52,40,54340,41800,96140
250970,202012,1209,851,358,889295,374110,1263405
250980,202012,103,67,36,70015,37620,107635
250990,202012,166,129,37,134805,38665,173470
251000,202012,73,66,7,68970,7315,76285
251010,202012,112,83,29,86735,30305,117040
251020,202012,78,63,15,65835,15675,81510
251030,202012,48,35,13,36575,13585,50160
251040,202012,56,38,18,39710,18810,58520
251050,202012,24,21,3,21945,3135,25080
251060,202012,50,40,10,41800,11495,53295
251065,202012,4,3,1,3135,1045,4180
251070,202012,20,16,4,16720,4180,20900
251080,202012,5061,2391,2670,2500685.75,2791197.14,5291882.89
251090,202012,178,151,27,157795,28215,186010
251100,202012,19,18,1,18810,1045,19855
251110,202012,47,37,10,38665,10450,49115
251120,202012,1859,1128,731,1178762.25,763895.2,1942657.45
251130,202012,407,331,76,345895,79420,425315
251140,202012,556,357,199,373065,207955,581020
251150,202012,347,290,57,303050,59565,362615
251160,202012,90,74,16,77330,16720,94050
251170,202012,101,81,20,84645,20900,105545
251180,202012,290,175,115,182875,120175,303050
251190,202012,203,133,70,138985,73150,212135
251200,202012,270,217,53,226765,55385,282150
251203,202012,33,31,2,32395,2090,34485
251207,202012,87,71,16,74195,16720,90915
251210,202012,1458,1059,399,1107700,416955,1524655
251220,202012,47,36,11,37620,11495,49115
251230,202012,592,493,99,515185,103455,618640
251240,202012,98,68,30,71060,31350,102410
251250,202012,1412,1015,397,1060675.75,415910.75,1476586.50
251260,202012,12,7,5,7315,5225,12540
251270,202012,318,242,76,252890,79420,332310
251272,202012,62,56,6,58520,6270,64790
251274,202012,29,22,7,22990,7315,30305
251275,202012,35,20,15,20900,15675,36575
251276,202012,17,13,4,13585,4180,17765
251278,202012,9,7,2,7315,2090,9405
251280,202012,104,98,6,102410,6270,108680
251290,202012,829,584,245,610280,256025,866305
251300,202012,15,12,3,12540,3135,15675
251310,202012,305,217,88,226765,91960,318725
251315,202012,33,29,4,30305,4180,34485
251320,202012,64,49,15,52250,15675,67925
251330,202012,77,68,9,71060,9405,80465
251335,202012,15,10,5,10450,5225,15675
251340,202012,744,438,306,457710,319770,777480
251350,202012,35,34,1,35530,1045,36575
251360,202012,84,73,11,76285,11495,87780
251365,202012,11,11,0,11495,0,11495
251370,202012,5555,3713,1842,3883220.65,1925935.65,5809156.30
251380,202012,46,37,9,38665,9405,48070
251385,202012,2,2,0,2090,0,2090
251390,202012,818,609,209,636405,218405.5,854810.5
251392,202012,18,10,8,10450,8360,18810
251394,202012,8,8,0,8360,0,8360
251396,202012,11,7,4,7315,4180,11495
251398,202012,18,16,2,16720,2090,18810
251400,202012,40,32,8,33440,8360,41800
251410,202012,38,32,6,33440,6270,39710
251420,202012,102,73,29,76285,30305,106590
251430,202012,43,40,3,41800,3135,44935
251440,202012,44,26,18,27170,18810,45980
251445,202012,51,45,6,47025.25,6270,53295.25
251450,202012,405,351,54,366795,56430,423225
251455,202012,4,2,2,2090,2090,4180
251460,202012,16,14,2,14630,2090,16720
251465,202012,7,4,3,4180,3135,7315
251470,202012,50,39,11,40755,11495,52250
251480,202012,26,21,5,21945,5225,27170
251490,202012,124,78,46,81510,48070.5,129580.5
251500,202012,130,105,25,109725,26125,135850
251510,202012,59,36,23,37620,24035,61655
251520,202012,29,28,1,29260,1045,30305
251530,202012,4488,3158,1330,3300110.5,1389850,4689960.5
251540,202012,78,66,12,68970,12540,81510
251550,202012,409,306,103,319770,107635.25,427405.25
251560,202012,24,16,8,16720,8360,25080
251570,202012,20,18,2,18810,2090,20900
251580,202012,134,105,29,109725,30305,140030
251590,202012,113,82,31,85887.5,32395,118282.5
251593,202012,24,14,10,14630,10450,25080
251597,202012,102,82,20,85690,20900,106590
251600,202012,1104,772,332,806740.5,346940,1153680.5
251610,202012,241,179,62,187055,65835,252890
251615,202012,9,8,1,9405,1045,10450
251620,202012,4268,2765,1503,2889427.1,1570636.5,4460063.6
251630,202012,461,340,121,355300,127490,482790
251640,202012,140,101,39,105545,40755,146300
251650,202012,277,198,79,206910.75,82555,289465.75
251660,202012,186,166,20,173470,20900,194370
251670,202012,372,290,82,303050,85690,388740
251675,202012,8,6,2,6270,2090,8360
251680,202012,98,86,12,89870,12540,102410
251690,202012,320,263,57,274835,59565,334400
251700,202012,289,246,43,257070.9,44935,302005.9
251710,202012,21,14,7,14630,7315,21945
251720,202012,21,14,7,14630,7315.5,21945.5
251740,202012,11,8,3,8360,3135,11495
260005,202012,3312,1785,1527,1865929.99,1595715,3461644.99
260010,202012,1633,1175,458,1228920.55,480700.6,1709621.15
260020,202012,411,356,55,373065,57475,430540
260030,202012,607,419,188,437855,196460,634315
260040,202012,809,502,307,524590,321860,846450
260050,202012,1147,815,332,851675,346941,1198616
260060,202012,378,343,35,358435,36575,395010
260070,202012,1348,830,518,867350.5,543400.3,1410750.8
260080,202012,728,558,170,583110,177650,760760
260090,202012,494,326,168,340670,175560,516230
260100,202012,216,151,65,157795,67925,225720
260105,202012,241,134,107,140030,111815,251845
260110,202012,2853,2081,772,2176735.5,807785.5,2984521.0
260120,202012,2867,1444,1423,1510304.3,1487035.75,2997340.05
260130,202012,170,116,54,121220,56430,177650
260140,202012,2114,1366,748,1428516.8,782705,2211221.8
260150,202012,206,132,74,137940,77330,215270
260160,202012,314,259,55,270655,57475,328130
260170,202012,3369,1997,1372,2087911.45,1436876,3524787.45
260180,202012,160,127,33,132715,34485,167200
260190,202012,2333,1564,769,1635425,804650,2440075
260200,202012,966,773,193,807785.29,201685.5,1009470.79
260210,202012,1398,983,415,1027235,433675,1460910
260220,202012,686,615,71,642675.5,74195,716870.5
260230,202012,1204,904,300,944680,313500,1258180
260240,202012,215,159,56,166155,58520,224675
260250,202012,89,64,25,66880,26125,93005
260260,202012,1041,727,314,760760,328130,1088890
260270,202012,409,320,89,334400,93005,427405
260280,202012,1224,895,329,935275,344850.5,1280125.5
260290,202012,6547,3501,3046,3660638.15,3184117.46,6844755.61
260300,202012,949,814,135,850630.5,141075,991705.5
260310,202012,515,410,105,428450,109725,538175
260320,202012,859,628,231,656260,241395,897655
260330,202012,65,45,20,47025,20900,67925
260340,202012,74,55,19,57475,19855,77330
260345,202012,5495,2961,2534,3095293.18,2650120,5745413.18
260350,202012,483,339,144,354255.5,150480,504735.5
260360,202012,245,136,109,142120,114950,257070
260370,202012,780,475,305,496375.25,319770,816145.25
260380,202012,582,427,155,446215,161975.47,608190.47
260390,202012,288,242,46,252890,48070,300960
260392,202012,109,94,15,98230,15675,113905
260400,202012,4221,2390,1831,2498596.22,1914440.5,4413036.72
260410,202012,14762,7683,7079,8031873.09,7404871.17,15436744.26
260415,202012,139,121,18,126445,18810,145255
260420,202012,1722,1049,673,1096206.77,703285,1799491.77
260430,202012,186,171,15,178695.35,15675,194370.35
260440,202012,197,141,56,147345,58520,205865
260450,202012,430,317,113,331265.96,118085,449350.96
260460,202012,812,423,389,443080,406505,849585
260470,202012,340,209,131,218405,136895.5,355300.5
260480,202012,242,155,87,161975,90915,252890
260490,202012,209,173,36,180785,37620,218405
260500,202012,1116,754,362,787930,379335,1167265
260510,202012,770,611,159,638495,166155,804650
260515,202012,231,209,22,219450,22990,242440
260520,202012,3269,2010,1259,2101496.5,1315656.45,3417152.95
260530,202012,791,647,144,676115,150480,826595
260540,202012,545,428,117,447260,122265,569525
260545,202012,15,11,4,11495,4180,15675
260550,202012,326,200,126,209000,131670,340670
260560,202012,508,382,126,399190.5,131670,530860.5
260570,202012,969,778,191,813010,199595,1012605
260580,202012,247,214,33,223630,34485,258115
260590,202012,628,361,267,377245,279015,656260
260600,202012,8141,4345,3796,4541573.87,3968910.5,8510484.37
260610,202012,489,326,163,340670,170335,511005
260620,202012,3676,1894,1782,1979231.65,1864280.58,3843512.23
260630,202012,79,74,5,77330,5225,82555
260640,202012,3507,1934,1573,2021030.8,1644830,3665860.8
260650,202012,322,233,89,243485,93005,336490
260660,202012,557,354,203,369930,212135,582065
260670,202012,103,75,28,78375,29260,107635
260680,202012,3755,2060,1695,2154790.22,1772320.5,3927110.72
260690,202012,126,89,37,93005,38665,131670
260700,202012,309,207,102,216315,106590,322905
260710,202012,44,35,9,36575,9405,45980
260720,202012,2482,1456,1026,1523611,1073215,2596826
260730,202012,704,525,179,548625,188100,736725
260740,202012,65,58,7,60610,7315,67925
260750,202012,586,415,171,434720,178695,613415
260760,202012,668,338,330,353210.23,344850,698060.23
260765,202012,984,506,478,528770,499510,1028280
260770,202012,222,162,60,169272,62700.5,231972.5
260775,202012,772,433,339,453531.25,354255,807786.25
260780,202012,242,152,90,159885,94050,253935
260790,202012,14280,7225,7055,7553264.65,7377701.5,14930966.15
260795,202012,168,109,59,113905,62700,176605
260800,202012,290,237,53,247665.5,55385,303050.5
260805,202012,175,116,59,121220,62700,183920
260810,202012,768,655,113,684475,118085,802560
260820,202012,286,181,105,189145.85,109725,298870.85
260825,202012,215,143,72,149435,75240,224675
260830,202012,342,181,161,190190,168245,358435
260840,202012,240,175,65,182875,67925,250800
260845,202012,169,116,53,122265,55385,177650
260850,202012,438,321,117,335445,122265,457710
260860,202012,251,190,61,198550,63745,262295
260870,202012,369,277,92,289465.79,96140,385605.79
260875,202012,728,515,213,538175,222585,760760
260880,202012,1599,1012,587,1059630,614460,1674090
260890,202012,2350,1655,695,1731566,727320,2458886
260900,202012,982,693,289,724185,302005,1026190
260910,202012,255,201,54,210045,56430,266475
260915,202012,290,213,77,222585,80465,303050
260920,202012,187,99,88,103455,91960,195415
260930,202012,388,327,61,341715,64790,406505
260940,202012,2696,1449,1247,1516296.4,1303115.5,2819411.9
260950,202012,2017,1146,871,1197570.75,910195,2107765.75
260960,202012,13742,6884,6858,7196922.35,7180197.87,14377120.22
260970,202012,419,348,71,363660,74195,437855
260980,202012,191,170,21,177650,21945,199595
260990,202012,2625,2116,509,2211221.35,532950,2744171.35
261000,202012,4230,2536,1694,2650120.75,1771275,4421395.75
261010,202012,250,123,127,128535,132715,261250
261020,202012,601,448,153,468160.99,159885,628045.99
261030,202012,250,175,75,182875,78375,261250
261040,202012,367,318,49,332310,51205,383515
261050,202012,508,436,72,455620,75240,530860
261060,202012,1385,874,511,913330.25,533995,1447325.25
261070,202012,8887,4296,4591,4490368.65,4799687.87,9290056.52
261080,202012,374,285,89,297825,93005,390830
261090,202012,2179,1660,519,1734704.7,542355.83,2277060.53
261100,202012,1167,810,357,846450.75,373065,1219515.75
261110,202012,8733,5309,3424,5552087.3,3581216,9133303.3
261120,202012,260,222,38,231990,39710,271700
261130,202012,570,342,228,357390,238260.55,595650.55
261140,202012,203,126,77,131670,80465,212135
261150,202012,686,425,261,444125.03,272745,716870.03
261153,202012,69,64,5,66880,5225,72105
261160,202012,74811,36780,38031,38463431.28,39773754.61,78237185.89
261170,202012,469,348,121,363660,126445,490105
261180,202012,1784,1108,676,1158905,706420,1865325
261190,202012,620,435,185,454576.4,193325,647901.4
261200,202012,215,182,33,190190,34485,224675
261210,202012,32,28,4,29260,4180,33440
261220,202012,2721,1910,811,1996996.12,847495,2844491.12
261230,202012,334,246,88,257070,91960,349030
261240,202012,450,393,57,410685,60610,471295
261245,202012,235,194,41,202730,42845,245575
261247,202012,171,134,37,140030,39710,179740
261250,202012,3201,1554,1647,1623930.5,1721115,3345045.5
261255,202012,243,218,25,227810,26125,253935
261260,202012,847,733,114,765985.06,119130,885115.06
261270,202012,201,144,57,150480,59565,210045
261280,202012,173,140,33,146300,34485,180785
261290,202012,113,82,31,85690,32395,118085
261300,202012,1279,935,344,978120,359480,1337600
261310,202012,802,537,265,561165,277970,839135
261320,202012,570,370,200,386650,209000,595650
261330,202012,956,733,223,765985,233035.29,999020.29
261340,202012,299,167,132,174515,137940,312455
261350,202012,851,599,252,625956,263340,889296
261360,202012,1283,828,455,866305,475475,1341780
261370,202012,4844,2873,1971,3002286.5,2060741,5063027.5
261380,202012,553,420,133,438900.69,138985.5,577886.19
261390,202012,3599,2412,1187,2523676,1240415.75,3764091.75
261400,202012,296,266,30,277970,31350,309320
261410,202012,1094,718,376,751355,392920,1144275
261420,202012,886,548,338,572660.55,354255,926915.55
261430,202012,324,293,31,306185,32395,338580
261440,202012,116,107,9,112860,9405,122265
261450,202012,2534,2021,513,2111946.25,536085.78,2648032.03
261460,202012,712,560,152,586245.85,159885,746130.85
261470,202012,241,191,50,199595.5,52250,251845.5
261480,202012,448,347,101,363660,105497.97,469157.97
261485,202012,359,215,144,224675,150480,375155
261500,202012,614,414,200,432630.86,209000,641630.86
261510,202012,51,32,19,33440,19855,53295
261520,202012,95,81,14,84645,14630,99275
261530,202012,4124,2614,1510,2732676.23,1580040.25,4312716.48
261540,202012,1346,785,561,820325,586245,1406570
261550,202012,254,121,133,126445,140030,266475
261560,202012,852,559,293,585201.75,307230.5,892432.25
261570,202012,400,312,88,326040,91960,418000
261580,202012,375,291,84,304095,87780,391875
261590,202012,186,149,37,155705,38665,194370
261600,202012,289,230,59,240350,61655,302005
261610,202012,86,73,13,76285,13585,89870
261618,202012,72,58,14,60610,14630,75240
261620,202012,197,124,73,129580,76285,205865
261630,202012,548,430,118,449350,123310,572660
261640,202012,6441,3359,3082,3511203.09,3225915.75,6737118.84
261650,202012,486,306,180,319770,188100,507870
270010,202012,515,455,60,475475,62700,538175
270020,202012,283,231,52,241395,54340,295735
270030,202012,8815,5672,3143,5930483.28,3286526,9217009.28
270040,202012,2022,1279,743,1336557,776435.5,2112992.5
270050,202012,157,120,37,125400,38665,164065
270060,202012,108,59,49,61655,51205,112860
270070,202012,860,628,232,657305,242440,899745
270080,202012,37,31,6,32395,6270,38665
270090,202012,23,17,6,17765,6270,24035
270100,202012,1248,838,410,875850.58,428450,1304300.58
270110,202012,103,85,18,88825,18810,107635
270120,202012,224,183,41,191235,42845,234080
270130,202012,274,192,82,200640,86735,287375
270135,202012,112,69,43,72105,44935,117040
270140,202012,1356,859,497,898700.5,520410,1419110.5
270150,202012,251,198,53,206910,55385,262295
270160,202012,501,396,105,413820,109725,523545
270170,202012,795,517,278,540265,290510,830775
270180,202012,54,41,13,42845,13585,56430
270190,202012,89,77,12,80465,12540,93005
270200,202012,107,92,15,96140,15675,111815
270210,202012,524,299,225,312455,235125.5,547580.5
270220,202012,176,138,38,144210,39710.8,183920.8
270230,202012,2115,1283,832,1342827.1,869440,2212267.1
270235,202012,685,535,150,559075,156750,715825
270240,202012,2984,2361,623,2469510.58,651035.5,3120546.08
270250,202012,157,115,42,120175,43890,164065
270255,202012,217,188,29,196460,30305,226765
270260,202012,361,293,68,307230,71060,378290
270270,202012,100,45,55,47025,57475,104500
270280,202012,242,139,103,145255,107635,252890
270290,202012,1152,885,267,924825,280060,1204885
270300,202012,322,228,94,239305,98230,337535
270310,202012,852,701,151,732545.5,157795,890340.5
270320,202012,823,701,122,732545.29,127490,860035.29
270330,202012,295,247,48,258115,50160,308275
270340,202012,55,43,12,44935,12540,57475
270350,202012,89,50,39,52250,40755,93005
270360,202012,68,38,30,39710,31350,71060
270370,202012,57,46,11,48070,11495,59565
270375,202012,71,42,29,43890,30305,74195
270380,202012,1011,647,364,676115.5,382470,1058585.5
270390,202012,187,114,73,119130,76285,195415
270400,202012,703,524,179,548625.79,187055,735680.79
270410,202012,657,482,175,504735,183920,688655
270420,202012,396,270,126,282150,131670,413820
270430,202012,32905,23598,9307,24680203.81,9733704.07,34413907.88
270440,202012,481,380,101,397134.83,105545,502679.83
270450,202012,797,451,346,471295,361570,832865
270460,202012,186,148,38,154660,39710,194370
270470,202012,1474,1020,454,1066074.16,474430,1540504.16
270480,202012,536,441,95,460845.5,99275.5,560121.0
270490,202012,23,18,5,18810,5225,24035
270500,202012,489,413,76,431585,80465,512050
270510,202012,806,500,306,522500,320815,843315
270520,202012,289,186,103,194370,107635,302005
270530,202012,66,59,7,61655,7315,68970
270540,202012,100,78,22,81510,22990,104500
270550,202012,1728,1323,405,1382535,423225,1805760
270560,202012,269,149,120,155705,125400,281105
270570,202012,519,362,157,378290,164065,542355
270580,202012,88,69,19,72105,19855,91960
270590,202012,65,52,13,55385,13585,68970
270600,202012,174,146,28,152570,29260,181830
270610,202012,232,176,56,183920,58520,242440
270620,202012,18,18,0,18810,0,18810
270630,202012,3732,2831,901,2960067.99,942590,3902657.99
270640,202012,866,642,224,670890,234080,904970
270642,202012,211,178,33,187055,34485,221540
270644,202012,255,162,93,169290,97185,266475
270650,202012,324,193,131,201685,137940,339625
270660,202012,236,198,38,206910,39710,246620
270670,202012,3031,2295,736,2400368.55,770165,3170533.55
270680,202012,425,254,171,265430,178695,444125
270690,202012,1174,770,404,805695.95,422180,1227875.95
270700,202012,27,22,5,22990,5225,28215
270710,202012,868,682,186,712690,194370,907060
270720,202012,237,185,52,193325,54340,247665
270730,202012,1855,1120,735,1171445.5,769120.25,1940565.75
270740,202012,44,31,13,32395,13585,45980
270750,202012,640,481,159,502645,166155,668800
270760,202012,290,208,82,217360,85690,303050
270770,202012,2727,1803,924,1884136.55,970805,2854941.55
270780,202012,72,46,26,48070,27170,75240
270790,202012,271,174,97,181830,101365,283195
270800,202012,2013,1613,400,1686630,418000,2104630
270810,202012,229,187,42,196460,43890,240350
270820,202012,141,97,44,101365,45980.5,147345.5
270830,202012,784,588,196,614460,204820,819280
270840,202012,1359,1030,329,1077395.33,343805.85,1421201.18
270850,202012,1488,927,561,968715.5,586245,1554960.5
270860,202012,2561,1694,867,1770232.46,906015,2676247.46
270870,202012,116,63,53,65835,55385,121220
270880,202012,889,697,192,728365,200640,929005
270890,202012,291,217,74,226765.5,77330,304095.5
270895,202012,49,45,4,48070,4180,52250
270900,202012,88,68,20,71060,20900,91960
270910,202012,306,249,57,260205,59565,319770
270915,202012,1889,1211,678,1266541.25,709555.6,1976096.85
270920,202012,470,393,77,410685,80465,491150
270930,202012,5936,4443,1493,4642935,1560185.03,6203120.03
270940,202012,2270,1776,494,1858010,517275,2375285
280010,202012,38,32,6,33440,6270,39710
280020,202012,484,414,70,432630.45,73150,505780.45
280030,202012,20658,13341,7317,13944506.84,7649405.97,21593912.81
280040,202012,333,217,116,226765,121220,347985
280050,202012,407,312,95,326040,99275,425315
280060,202012,353,227,126,237215.7,131670,368885.7
280067,202012,1078,778,300,813010.5,313500.62,1126511.12
280070,202012,123,99,24,103455,25080,128535
280100,202012,639,492,147,514140,153615,667755
280110,202012,74,69,5,72105,5225,77330
280120,202012,659,538,121,562210.5,126445,688655.5
280130,202012,1744,1145,599,1196525,625955.5,1822480.5
280140,202012,482,395,87,413820.5,90915,504735.5
280150,202012,400,283,117,295735,122265,418000
280160,202012,108,90,18,94050,18810,112860
280170,202012,396,273,123,285285.25,128535,413820.25
280190,202012,25,22,3,22990,3135,26125
280200,202012,30,26,4,27170,4180,31350
280210,202012,2929,2103,826,2198557.36,864215.5,3062772.86
280220,202012,39,31,8,32395,8360,40755
280230,202012,327,267,60,279015,62700,341715
280240,202012,123,117,6,122265,6270,128535
280250,202012,16,10,6,10450,6270,16720
280260,202012,77,70,7,73150,7315,80465
280270,202012,151,117,34,122265,35530,157795
280280,202012,199,127,72,132715.37,75240,207955.37
280290,202012,3350,2417,933,2527344.49,976030.1,3503374.59
280300,202012,1599,1249,350,1305205.5,365750,1670955.5
280310,202012,101,96,5,100320,5225,105545
280320,202012,641,451,190,471295,198550,669845
280330,202012,322,233,89,243589.5,93005,336594.5
280340,202012,403,326,77,340670,80465,421135
280350,202012,3693,2859,834,2987657.26,872575.77,3860233.03
280360,202012,483,327,156,341715.5,163020,504735.5
280370,202012,95,83,12,86735.65,12540,99275.65
280380,202012,53,41,12,42845,12540,55385
280390,202012,172,147,25,153615,26125,179740
280400,202012,352,242,110,252890.5,115995,368885.5
280410,202012,286,235,51,245575,53295,298870
280420,202012,170,143,27,149435,28215,177650
280430,202012,51,39,12,40755,12540,53295
280440,202012,694,543,151,568480.65,157795,726275.65
280445,202012,119,108,11,112860,11495,124355
280450,202012,1193,1031,162,1077395.5,169290,1246685.5
280460,202012,617,449,168,470251.63,175560,645811.63
280470,202012,180,169,11,176605,11495.75,188100.75
280480,202012,2714,1885,829,1974008.71,866305.32,2840314.03
280490,202012,259,244,15,254981.16,15675,270656.16
280500,202012,43,39,4,40755,4180,44935
280510,202012,139,112,27,117040.5,28215.5,145256.0
280520,202012,52,38,14,39710,14630,54340
280530,202012,80,50,30,52250,31350,83600
280540,202012,535,449,86,469205,89870,559075
280550,202012,734,677,57,707466.71,59565,767031.71
280560,202012,487,431,56,450395,58520,508915
280570,202012,2207,1726,481,1803671.45,503690,2307361.45
280580,202012,590,456,134,476520,140030,616550
280590,202012,213,135,78,141075,81510,222585
280600,202012,385,323,62,337535,64790,402325
280610,202012,111,83,28,86735,29260,115995
280620,202012,551,449,102,469205,106590,575795
280630,202012,154,126,28,131670,29260,160930
280640,202012,197,155,42,161975,43890,205865
280650,202012,91,57,34,59565,35530,95095
280660,202012,143,106,37,110770,38665,149435
280670,202012,1860,1162,698,1214293.28,729411.55,1943704.83
280680,202012,193,171,22,178695,22990,201685
280690,202012,80,71,9,74195,9405,83600
280700,202012,24,24,0,25080,0,25080
280710,202012,1476,1133,343,1183985,358435,1542420
280720,202012,112,71,41,74195,42845,117040
280730,202012,26,21,5,21945,5225,27170
280740,202012,2522,1879,643,1963555.5,671935,2635490.5
280750,202012,235,203,32,212135,33440,245575
280760,202012,787,543,244,567435.9,254980,822415.9
290010,202012,201,140,61,146300,63745,210045
290020,202012,186,167,19,174515,19855,194370
290030,202012,615,397,218,414865,227810,642675
290035,202012,132,108,24,112860,25080,137940
290040,202012,304,204,100,213180,104500,317680
290050,202012,84,65,19,67925,19855,87780
290060,202012,265,117,148,123310,155705,279015
290070,202012,5714,2745,2969,2870616.1,3103651.25,5974267.35
290080,202012,450,203,247,212135,259160,471295
290090,202012,381,170,211,177650,220495,398145
290100,202012,1638,1060,578,1107700,604011,1711711
290110,202012,830,484,346,505780.75,361570,867350.75
290115,202012,195,182,13,190190,13585,203775
290120,202012,773,511,262,533995,273790,807785
290130,202012,424,261,163,272745,171380,444125
290135,202012,303,231,72,241395,75240,316635
290140,202012,314,259,55,270655,57475,328130
290150,202012,138,98,40,102410,41800,144210
290160,202012,245,188,57,196460,60610,257070
290170,202012,91,65,26,67925,27170,95095
290180,202012,180,130,50,135850,52250,188100
290190,202012,437,356,81,372020,84645,456665
290195,202012,316,204,112,213180,117040,330220
290200,202012,270,221,49,230945,51205,282150
290205,202012,151,91,60,95095,62700,157795
290210,202012,1160,853,307,891385.5,320815,1212200.5
290220,202012,222,119,103,124355,107635,231990
290225,202012,285,118,167,123310,174515,297825
290230,202012,78,49,29,51205,30305,81510
290240,202012,362,131,231,136895,241395,378290
290250,202012,253,234,19,244530,19855,264385
290260,202012,323,267,56,279015.5,58520,337535.5
290265,202012,187,160,27,168245,28215,196460
290270,202012,1413,1177,236,1231010,246620.5,1477630.5
290280,202012,476,336,140,351120,146300,497420
290290,202012,1332,797,535,832865.97,560120.5,1392986.47
290300,202012,431,367,64,384560.5,66880,451440.5
290310,202012,299,138,161,144210,168245,312455
290320,202012,4014,2471,1543,2582195.3,1615570.1,4197765.4
290323,202012,187,162,25,169290,26125,195415
290327,202012,171,135,36,141075,37620,178695
290330,202012,112,57,55,59565,57475,117040
290340,202012,827,338,489,354255,512050,866305
290350,202012,630,377,253,393965.5,264385,658350.5
290360,202012,347,268,79,280061.64,82555,362616.64
290370,202012,914,386,528,403370.75,551760,955130.75
290380,202012,324,205,119,214225,124355,338580
290390,202012,2434,1516,918,1585266.25,959310,2544576.25
290395,202012,244,139,105,145255.25,109725,254980.25
290400,202012,271,201,70,210045.5,73150,283195.5
290405,202012,246,211,35,220495,36575,257070
290410,202012,622,520,102,543400.53,106590,649990.53
290420,202012,253,204,49,213180,51205,264385
290430,202012,476,309,167,322905,175560,498465
290440,202012,77,68,9,71060,9405,80465
290450,202012,201,151,50,157795,52250,210045
290460,202012,1942,1159,783,1212200,819280,2031480
290470,202012,1381,606,775,633270.5,809875,1443145.5
290475,202012,553,518,35,541310.2,36575,577885.2
290480,202012,290,165,125,172425,130625,303050
290485,202012,237,217,20,226765,20900,247665
290490,202012,1224,873,351,912285,366795,1279080
290500,202012,743,380,363,397100,379335,776435
290510,202012,227,178,49,186010,51205,237215
290515,202012,157,94,63,98230,65835,164065
290520,202012,1400,918,482,959310,503691.44,1463001.44
290530,202012,298,275,23,287375,24035,311410
290540,202012,106,56,50,58520,52250,110770
290550,202012,160,135,25,141075,26125,167200
290560,202012,3155,1365,1790,1428515,1871595,3300110
290570,202012,6246,3002,3244,3139181.62,3393116.5,6532298.12
290580,202012,1272,750,522,783750,545490,1329240
290590,202012,571,471,100,493240,104500,597740
290600,202012,1754,1197,557,1251910.63,582065,1833975.63
290610,202012,201,181,20,189145,20900,210045
290620,202012,356,321,35,335445,37620,373065
290630,202012,2008,847,1161,885115,1213245.5,2098360.5
290640,202012,146,117,29,122265,30305,152570
290650,202012,1784,825,959,863171.42,1004245,1867416.42
290660,202012,278,226,52,236170,54340,290510
290670,202012,937,481,456,502646,476520,979166
290680,202012,1225,988,237,1032460,247665,1280125
290682,202012,303,226,77,236170.8,80465,316635.8
290685,202012,241,158,83,165110,86735,251845
290687,202012,1054,675,379,705545.1,396055,1101600.1
290689,202012,144,76,68,79420,71060,150480
290690,202012,609,256,353,267520,368885,636405
290700,202012,242,118,124,123310,129580,252890
290710,202012,755,514,241,537130,251845,788975
290720,202012,1022,826,196,865260,204820,1070080
290730,202012,1175,673,502,703285.75,524590,1227875.75
290740,202012,17,14,3,14630,3135,17765
290750,202012,1415,634,781,662530,817191.25,1479721.25
290755,202012,72,65,7,67925,7315,75240
290760,202012,290,251,39,263340,40755,304095
290770,202012,185,173,12,180785,12540,193325
290780,202012,1116,854,262,892431,273790,1166221
290790,202012,364,253,111,264385,115995.5,380380.5
290800,202012,2455,993,1462,1037685.5,1531970,2569655.5
290810,202012,466,320,146,334400,152570,486970
290820,202012,399,233,166,243485,173470,416955
290830,202012,422,302,120,315590,125400,440990
290840,202012,1761,1088,673,1136961.7,704330.5,1841292.2
290850,202012,846,436,410,455620,428450,884070
290860,202012,641,289,352,302005,367840,669845
290870,202012,625,444,181,463980.6,189145.6,653126.2
290880,202012,119,64,55,66880,57475,124355
290890,202012,399,265,134,276925,140030,416955
290900,202012,167,126,41,131670,42845,174515
290910,202012,382,287,95,299915,99275,399190
290920,202012,206,179,27,187055,28215,215270
290930,202012,817,619,198,648945.5,206910,855855.5
290940,202012,245,205,40,214225,41800,256025
290950,202012,157,95,62,99275,64790,164065
290960,202012,474,334,140,349030,146300,495330
290970,202012,246,215,31,224675,32395,257070
290980,202012,1639,1147,492,1198615.7,515186,1713801.7
290990,202012,395,333,62,347985,64790,412775
291000,202012,861,260,601,271700,629090,900790
291005,202012,2316,1003,1313,1048135,1373130.42,2421265.42
291010,202012,164,148,16,154660,16720,171380
291020,202012,101,81,20,84645,20900,105545
291030,202012,97,69,28,72105,29260,101365
291040,202012,612,341,271,356345,283195,639540
291050,202012,1445,790,655,825550,685520,1511070
291060,202012,1546,844,702,883025,734635,1617660
291070,202012,1974,1469,505,1536150.62,528770.62,2064921.24
291072,202012,7172,2648,4524,2771340.5,4729672,7501012.5
291075,202012,238,193,45,201685,48070,249755
291077,202012,59,40,19,41800,19855,61655
291080,202012,20352,8815,11537,9217947.46,12062436.77,21280384.23
291085,202012,296,243,53,253935,55385,309320
291090,202012,302,124,178,129580.5,186010,315590.5
291100,202012,656,199,457,207955,477565,685520
291110,202012,422,321,101,335445,105545,440990
291120,202012,2381,1186,1195,1240415.75,1248775,2489190.75
291125,202012,65,31,34,32395,35530,67925
291130,202012,200,176,24,183920,25080,209000
291140,202012,129,104,25,108680,26125.5,134805.5
291150,202012,394,146,248,152570,259160,411730
291160,202012,384,311,73,324995.25,77330,402325.25
291165,202012,45,36,9,37620,9405,47025
291170,202012,3141,1546,1595,1615572.42,1668865.5,3284437.92
291180,202012,1264,506,758,529815,794200,1324015
291185,202012,93,88,5,91960,5225,97185
291190,202012,1393,640,753,668800.25,786885,1455685.25
291200,202012,170,124,46,130625,48070,178695
291210,202012,2303,913,1390,954085.2,1453595.5,2407680.7
291220,202012,275,207,68,216315,71060,287375
291230,202012,975,335,640,350075.5,668800,1018875.5
291240,202012,426,396,30,413820.5,31350,445170.5
291250,202012,434,351,83,366795,86735,453530
291260,202012,59,49,10,51205,10450,61655
291270,202012,1151,473,678,494285,708510,1202795
291280,202012,351,166,185,173470,194370,367840
291290,202012,1719,887,832,926915.5,870485.5,1797401.0
291300,202012,227,180,47,189145,49115,238260
291310,202012,224,201,23,210045,24035,234080
291320,202012,1361,957,404,1001110,423225,1424335
291330,202012,131,112,19,117040,19855,136895
291340,202012,215,128,87,133760,90915,224675
291345,202012,131,91,40,95095,41800,136895
291350,202012,1649,585,1064,611325,1111880.75,1723205.75
291360,202012,8354,4016,4338,4200901.25,4538436.75,8739338.00
291370,202012,1121,646,475,675070.5,497420,1172490.5
291380,202012,264,210,54,219450,56430,275880
291390,202012,3920,1705,2215,1781725.9,2315720.5,4097446.4
291400,202012,2070,1475,595,1542420,621775.84,2164195.84
291410,202012,194,169,25,176605,26125,202730
291420,202012,119,87,32,90915,33440,124355
291430,202012,166,90,76,94050,79420.02,173470.02
291440,202012,513,420,93,438900.5,97185,536085.5
291450,202012,932,592,340,618640.25,355300,973940.25
291460,202012,1861,1505,356,1573770.5,372020.5,1945791.0
291465,202012,2198,1034,1164,1080530.5,1218470,2299000.5
291470,202012,2860,1435,1425,1500620.97,1490170.5,2990791.47
291480,202012,11811,5191,6620,5427734.88,6928352.75,12356087.63
291490,202012,608,243,365,253935,381425,635360
291500,202012,379,222,157,231990,164065,396055
291510,202012,1212,464,748,484880,782705,1267585
291520,202012,948,426,522,446215,545490,991705
291530,202012,937,249,688,260205,718960,979165
291535,202012,123,100,23,104500,24035,128535
291540,202012,349,106,243,110770.5,253935,364705.5
291550,202012,1240,580,660,606100,689700.5,1295800.5
291560,202012,5245,2626,2619,2744170,2738946,5483116
291570,202012,204,103,101,107635,105545,213180
291580,202012,1198,738,460,772255.55,480700,1252955.55
291590,202012,90,37,53,38665,55385,94050
291600,202012,1141,559,582,584155.25,608190,1192345.25
291610,202012,1456,700,756,731500,790020,1521520
291620,202012,570,266,304,277970,317680,595650
291630,202012,480,149,331,155705,345895,501600
291640,202012,3957,1994,1963,2085822.2,2051336,4137158.2
291650,202012,428,289,139,302006.12,145255,447261.12
291660,202012,385,154,231,160930,241395,402325
291670,202012,224,134,90,140030,94050,234080
291680,202012,646,387,259,404415,270655.5,675070.5
291685,202012,581,324,257,338580,268565,607145
291690,202012,518,311,207,324995,216315.27,541310.27
291700,202012,966,749,217,782705,226765,1009470
291710,202012,1621,785,836,821370,874665.5,1696035.5
291720,202012,430,288,142,300960,148390,449350
291730,202012,928,541,387,566390,406505,972895
291733,202012,291,196,95,204820,99275,304095
291735,202012,73,56,17,58520,18810,77330
291740,202012,353,269,84,281105,87780,368885
291750,202012,2160,1393,767,1455685.38,802560,2258245.38
291760,202012,2948,1637,1311,1713800,1372085,3085885
291770,202012,770,517,253,540266.05,265430,805696.05
291780,202012,59,37,22,38665,22990,61655
291790,202012,156,80,76,83600,79420,163020
291800,202012,10074,4157,5917,4346158.38,6184311.5,10530469.88
291810,202012,1097,817,280,853765.5,292600,1146365.5
291820,202012,278,200,78,209000,81510,290510
291830,202012,1053,423,630,442036.46,659395,1101431.46
291835,202012,560,520,40,543400,41800,585200
291840,202012,4896,2461,2435,2572790.75,2545620.5,5118411.25
291845,202012,273,88,185,91960,193325,285285
291850,202012,327,290,37,303050,38665,341715
291855,202012,261,103,158,107635,165110,272745
291860,202012,171,107,64,111815,66880,178695
291870,202012,83,35,48,36575,50160,86735
291875,202012,177,163,14,170335,14630,184965
291880,202012,450,359,91,376200,95095,471295
291890,202012,252,81,171,84645,178695.5,263340.5
291900,202012,58,33,25,34485,26125,60610
291905,202012,127,92,35,96140.5,36575,132715.5
291910,202012,157,127,30,132715,31350,164065
291915,202012,431,381,50,398145.25,52250,450395.25
291920,202012,5123,2532,2591,2650120.5,2708641.5,5358762.0
291930,202012,170,100,70,104500.55,73150,177650.55
291940,202012,357,204,153,213180.5,160930,374110.5
291950,202012,1134,910,224,950951,234080,1185031
291955,202012,1255,748,507,781660,530860.25,1312520.25
291960,202012,189,136,53,142120,55385,197505
291970,202012,763,577,186,602965,194370,797335
291980,202012,1500,1326,174,1385671.23,181831,1567502.23
291990,202012,137,127,10,132715,10450,143165
291992,202012,170,88,82,91960,85690,177650
291995,202012,186,120,66,125400,68970,194370
292000,202012,397,302,95,315590,99275,414865
292010,202012,315,217,98,226765,102410,329175
292020,202012,301,220,81,229900,84645,314545
292030,202012,144,111,33,115995,34485,150480
292040,202012,626,317,309,331265,322905,654170
292045,202012,106,95,11,100320,11495,111815
292050,202012,941,683,258,713735,269610.5,983345.5
292060,202012,905,743,162,776435.65,169290,945725.65
292070,202012,62,19,43,19855,44935,64790
292080,202012,137,92,45,96140,47025,143165
292090,202012,544,186,358,194370,374110,568480
292100,202012,1481,623,858,651035,896610,1547645
292105,202012,190,169,21,176605,21945,198550
292110,202012,2277,824,1453,861080,1519430,2380510
292120,202012,689,542,147,566390,153615,720005
292130,202012,448,250,198,261250,206910,468160
292140,202012,207,168,39,175560,40755,216315
292145,202012,162,87,75,90915,78375,169290
292150,202012,1482,1210,272,1264450,284240,1548690
292160,202012,167,135,32,141075,33440,174515
292170,202012,1187,1029,158,1075305,165110,1240415
292180,202012,221,163,58,170335,60610,230945
292190,202012,160,104,56,108680,58520,167200
292200,202012,1353,489,864,511005,904970.5,1415975.5
292205,202012,125,108,17,112860,17765,130625
292210,202012,362,252,110,263340,114950.25,378290.25
292220,202012,31,22,9,22990,9405,32395
292225,202012,38,32,6,33440,6270,39710
292230,202012,953,754,199,788975.75,207955,996930.75
292240,202012,604,436,168,455620.75,175560,631180.75
292250,202012,1714,1120,594,1171445,621775,1793220
292260,202012,402,237,165,247665,172425,420090
292265,202012,246,177,69,184965,72105,257070
292270,202012,739,339,400,354255,418000,772255
292273,202012,206,114,92,119130,96140,215270
292275,202012,172,85,87,88825,90915,179740
292280,202012,143,100,43,104500,44935,149435
292285,202012,75,61,14,63745,14630,78375
292290,202012,576,387,189,404415,197505,601920
292300,202012,1696,626,1070,654170,1118150.3,1772320.3
292303,202012,114,73,41,76285,42845,119130
292305,202012,114,84,30,87780,31350,119130
292310,202012,927,598,329,624911.25,343805.9,968717.15
292320,202012,594,450,144,470250,150480,620730
292330,202012,174,99,75,103455,78375,181830
292335,202012,278,219,59,228855,61655,290510
292340,202012,579,402,177,420090,186010,606100
292350,202012,270,146,124,152570,129580,282150
292360,202012,705,538,167,562210.9,174515,736725.9
292370,202012,732,559,173,584155,180785,764940
292380,202012,631,511,120,535040.35,125400,660440.35
292390,202012,459,182,277,190190,289465,479655
292400,202012,3590,2224,1366,2325128.11,1428515,3753643.11
292405,202012,265,176,89,183920,93005,276925
292410,202012,134,82,52,85690,54340,140030
292420,202012,296,257,39,268565,40755,309320
292430,202012,543,407,136,425315,142120,567435
292440,202012,598,508,90,530860.16,94050,624910.16
292450,202012,238,186,52,194370,55385,249755
292460,202012,541,403,138,421135.95,145255,566390.95
292465,202012,208,175,33,182875,34485,217360
292467,202012,137,82,55,85690,57475,143165
292470,202012,290,195,95,203775,99275,303050
292480,202012,362,247,115,258115,120175.5,378290.5
292490,202012,238,169,69,176605,72105,248710
292500,202012,857,376,481,392920.15,502645,895565.15
292510,202012,3451,1595,1856,1666775.6,1939520.5,3606296.1
292520,202012,1094,506,588,528770,616550,1145320
292525,202012,399,285,114,297825,119130,416955
292530,202012,4404,1748,2656,1829795.96,2778656,4608451.96
292540,202012,476,268,208,280060,217360,497420
292550,202012,1104,582,522,608190,545490,1153680
292560,202012,330,307,23,320815,24035,344850
292570,202012,308,240,68,250800,71060,321860
292575,202012,484,321,163,336490,170335,506825
292580,202012,990,651,339,680295,354255.5,1034550.5
292590,202012,562,491,71,513095,74195,587290
292593,202012,136,108,28,112860,29260,142120
292595,202012,203,157,46,164065,48070,212135
292600,202012,1246,906,340,946770.29,355300,1302070.29
292610,202012,129,98,31,102410,32395,134805
292620,202012,526,445,81,465025.5,84645,549670.5
292630,202012,1436,794,642,829730,670890,1500620
292640,202012,842,582,260,608190,272745,880935
292650,202012,188,156,32,163020.5,33440,196460.5
292660,202012,2032,1450,582,1515250,608190.42,2123440.42
292665,202012,146,103,43,107635,44935,152570
292670,202012,388,310,78,323950,81510,405460
292680,202012,260,193,67,201685,70015.5,271700.5
292690,202012,194,142,52,148390,54340,202730
292700,202012,972,642,330,670890.05,344850,1015740.05
292710,202012,115,100,15,104500,15675,120175
292720,202012,929,527,402,550715,421135.5,971850.5
292730,202012,197,92,105,96140,109725,205865
292740,202012,69106,33497,35609,35028416.71,37249036.33,72277453.04
292750,202012,391,277,114,289465.95,120175,409640.95
292760,202012,337,280,57,292600.95,59565,352165.95
292770,202012,825,345,480,360525,504735,865260
292780,202012,413,159,254,166155,265430,431585
292790,202012,775,395,380,412775,397100,809875
292800,202012,1258,747,511,780615,533995,1314610
292805,202012,396,124,272,129580,285285,414865
292810,202012,1500,853,647,891386.5,676115,1567501.5
292820,202012,718,603,115,630136.25,120175,750311.25
292830,202012,109,89,20,93005,20900,113905
292840,202012,690,563,127,588335,132715,721050
292850,202012,144,95,49,99275,51205,150480
292860,202012,2146,1245,901,1301025.5,942590,2243615.5
292870,202012,3490,2313,1177,2417085.95,1229965,3647050.95
292880,202012,1491,979,512,1023055.05,536085,1559140.05
292890,202012,517,438,79,457710,82555,540265
292895,202012,141,94,47,98230,49115,147345
292900,202012,382,273,109,285285.4,113905,399190.4
292905,202012,483,238,245,248710,256025,504735
292910,202012,466,348,118,363661.25,123310,486971.25
292920,202012,526,230,296,240350,309320,549670
292925,202012,499,457,42,477565,43890,521455
292930,202012,631,380,251,397100,262295,659395
292935,202012,286,123,163,128535,171380,299915
292937,202012,224,152,72,158840,75240,234080
292940,202012,193,149,44,155705,45980,201685
292950,202012,1172,581,591,607145.75,617595.6,1224741.35
292960,202012,581,410,171,428450,179740,608190
292970,202012,241,169,72,176605.3,75240,251845.3
292975,202012,109,64,45,66880,47025,113905
292980,202012,288,196,92,204820.52,96140,300960.52
292990,202012,1315,973,342,1016785.75,357390,1374175.75
293000,202012,116,80,36,83600,37620,121220
293010,202012,2803,1650,1153,1727385.75,1205930.72,2933316.47
293015,202012,632,516,116,539220,121220,660440
293020,202012,332,270,62,282150,64790,346940
293030,202012,604,526,78,549670,82555,632225
293040,202012,359,284,75,296780,78375,375155
293050,202012,2872,1690,1182,1768140.98,1236236,3004376.98
293060,202012,258,206,52,215270.6,54340,269610.6
293070,202012,3507,1756,1751,1836067.72,1830841.75,3666909.47
293075,202012,90,59,31,61655,32395,94050
293076,202012,75,55,20,57475,20900,78375
293077,202012,524,301,223,314545.5,233035,547580.5
293080,202012,432,386,46,403370.85,48070,451440.85
293090,202012,129,116,13,121220,13585,134805
293100,202012,524,365,159,382470,166155,548625
293105,202012,342,249,93,260205,97185,357390
293110,202012,167,114,53,119130,55385,174515
293120,202012,306,206,100,215270,104500,319770
293130,202012,246,170,76,177650,79420,257070
293135,202012,8076,3142,4934,3284437.25,5160213.5,8444650.75
293140,202012,215,131,84,136895,87780,224675
293150,202012,324,281,43,293645,44935,338580
293160,202012,428,256,172,267520,179740,447260
293170,202012,179,120,59,125400,61655,187055
293180,202012,538,377,161,393965.5,168245,562210.5
293190,202012,1349,922,427,963491.11,446215,1409706.11
293200,202012,554,485,69,506825,72105,578930
293210,202012,398,300,98,313500,102410,415910
293220,202012,2477,1049,1428,1096205.5,1492260,2588465.5
293230,202012,1747,646,1101,675070.94,1151590,1826660.94
293240,202012,232,213,19,222585,19855,242440
293245,202012,126,106,20,110770,20900,131670
293250,202012,733,265,468,276925.9,491150,768075.9
293260,202012,303,251,52,262295,54340,316635
293270,202012,1177,540,637,564300.25,665665,1229965.25
293280,202012,277,152,125,158840,130625,289465
293290,202012,3055,1978,1077,2069100,1125465,3194565
293300,202012,744,525,219,548625.75,228855,777480.75
293305,202012,193,151,42,157795,43890,201685
293310,202012,152,114,38,119130,39710,158840
293315,202012,165,128,37,133760,38665,172425
293317,202012,88,62,26,64790,27170,91960
293320,202012,1064,577,487,602965.92,508915,1111880.92
293325,202012,186,68,118,71060,123310,194370
293330,202012,13755,6358,7397,6645158.02,7731958.75,14377116.77
293340,202012,272,192,80,200640,84645,285285
293345,202012,247,201,46,210045,48070,258115
293350,202012,608,352,256,367840,267520,635360
293360,202012,1520,1086,434,1135915,453530,1589445
310010,202012,141,76,65,79420,67925.5,147345.5
310020,202012,1031,564,467,589380,489060,1078440
310030,202012,328,262,66,273790,68970,342760
310040,202012,43,29,14,30305,14630,44935
310050,202012,175,107,68,112860,71060,183920
310060,202012,254,175,79,182876,82555,265431
310070,202012,15,10,5,10450,5225,15675
310080,202012,40,24,16,25080,16720,41800
310090,202012,1016,532,484,555942,506826,1062768
310100,202012,308,223,85,233035,88825,321860
310110,202012,710,388,322,406505,336490,742995
310120,202012,384,219,165,228855,172425,401280
310130,202012,31,17,14,17765,14630,32395
310140,202012,23,10,13,10450,13585,24035
310150,202012,1191,802,389,838090.5,406506,1244596.5
310160,202012,2049,998,1051,1042912.15,1098295.5,2141207.65
310163,202012,88,49,39,51205,40755,91960
310170,202012,2546,1109,1437,1158905.85,1501667,2660572.85
310180,202012,152,56,96,58520,100320,158840
310190,202012,492,335,157,350075,165110,515185
310200,202012,488,311,177,324995,184965,509960
310205,202012,58,39,19,40755,19855,60610
310210,202012,285,229,56,239305,59565,298870
310220,202012,60,34,26,35530,27170,62700
310230,202012,280,192,88,200640,91960,292600
310240,202012,107,93,14,97185,14630,111815
310250,202012,97,80,17,83600,17765,101365
310260,202012,760,397,363,414866.17,380380,795246.17
310270,202012,267,170,97,177650.6,101365,279015.6
310280,202012,372,272,100,284240,104500,388740
310285,202012,204,150,54,156750,56430,213180
310290,202012,242,134,108,140030,113905,253935
310300,202012,158,130,28,135850,29260,165110
310310,202012,9,7,2,7315,2090,9405
310320,202012,29,10,19,10450,19855,30305
310330,202012,39,26,13,27170,13585,40755
310340,202012,1734,1142,592,1193392,618640.5,1812032.5
310350,202012,2792,1479,1313,1545555,1374175,2919730
310360,202012,41,34,7,35530,7315,42845
310370,202012,118,97,21,101365,21945,123310
310375,202012,104,37,67,39710,70015,109725
310380,202012,48,28,20,29260,20900,50160
310390,202012,98,65,33,67925,34485,102410
310400,202012,2350,1508,842,1578995,879890,2458885
310410,202012,126,69,57,72105,59565,131670
310420,202012,660,343,317,358435,332310,690745
310430,202012,296,183,113,191235,118085,309320
310440,202012,73,42,31,43890,32395,76285
310445,202012,79,64,15,66880,15675,82555
310450,202012,622,384,238,401280,248710,649990
310460,202012,259,182,77,190190,80465,270655
310470,202012,511,324,187,338580,195415,533995
310480,202012,83,54,29,56430,30305,86735
310490,202012,537,246,291,257070,304095,561165
310500,202012,137,55,82,57475,85690,143165
310510,202012,602,418,184,436810,192280,629090
310520,202012,138,95,43,99275,44935,144210
310530,202012,107,43,64,44935,66880,111815
310540,202012,468,267,201,279015,211090,490105
310550,202012,74,48,26,50160,27170,77330
310560,202012,2973,2043,930,2137026.5,971850,3108876.5
310570,202012,91,57,34,59565,35530,95095
310590,202012,373,239,134,249755.25,140030,389785.25
310600,202012,148,80,68,83600.5,71060,154660.5
310610,202012,56,21,35,21945,36575,58520
310620,202012,47022,22232,24790,23254324.18,25941085.9,49195410.08
310630,202012,655,399,256,416955,267520.5,684475.5
310640,202012,125,98,27,102410,28215,130625
310650,202012,157,140,17,146300,17765,164065
310660,202012,98,65,33,67925,34485,102410
310665,202012,61,46,15,48070,15675,63745
310670,202012,6725,2841,3884,2971982,4064005.9,7035987.9
310680,202012,57,34,23,35530,24035,59565
310690,202012,612,425,187,444125.25,196460,640585.25
310700,202012,60,39,21,40755,21945,62700
310710,202012,1319,891,428,931095.5,448305.5,1379401.0
310720,202012,135,35,100,36575,104500,141075
310730,202012,1473,1012,461,1057541.25,482790,1540331.25
310740,202012,974,539,435,563256,454575.25,1017831.25
310750,202012,238,143,95,149435.65,99275,248710.65
310760,202012,63,48,15,50160.69,15675.5,65836.19
310770,202012,87,44,43,45980,44935,90915
310780,202012,359,289,70,302005,73150,375155
310790,202012,104,85,19,88825,19855,108680
310800,202012,450,207,243,216315.25,253935,470250.25
310810,202012,171,120,51,125400.72,53295.5,178696.22
310820,202012,331,262,69,274835,72105,346940
310825,202012,191,162,29,169290,30305,199595
310830,202012,475,223,252,233035.5,263340,496375.5
310840,202012,359,212,147,221540,154660,376200
310850,202012,81,65,16,67925,16720,84645
310855,202012,398,312,86,326040.5,89870,415910.5
310860,202012,1570,1155,415,1206977.5,434721.25,1641698.75
310870,202012,57,47,10,49115,10450,59565
310880,202012,80,62,18,64790,18810,83600
310890,202012,305,175,130,182875,135850,318725
310900,202012,653,293,360,306194.14,377256.52,683450.66
310910,202012,240,161,79,168245.5,82555,250800.5
310920,202012,450,260,190,271701.45,198550.5,470251.95
310925,202012,32,26,6,27170,6270,33440
310930,202012,1286,817,469,854810,491150,1345960
310940,202012,692,341,351,356345,366795,723140
310945,202012,121,78,43,81510.5,44935,126445.5
310950,202012,225,181,44,189145,45980,235125
310960,202012,77,24,53,25080,55385,80465
310970,202012,169,104,65,108680,67925.5,176605.5
310980,202012,48,31,17,32395,17765,50160
310990,202012,165,84,81,87780,84645,172425
311000,202012,812,392,420,410686.49,438900.5,849586.99
311010,202012,47,41,6,42845,6270,49115
311020,202012,47,28,19,29260,19855,49115
311030,202012,385,222,163,231990.5,170335,402325.5
311040,202012,43,33,10,34485,10450,44935
311050,202012,476,182,294,191235,307230,498465
311060,202012,777,427,350,447260,365750.5,813010.5
311070,202012,341,148,193,155705,201685,357390
311080,202012,108,59,49,61655,51205,112860
311090,202012,335,154,181,160930,190190,351120
311100,202012,574,341,233,357390,243485,600875
311110,202012,690,483,207,504735,216315,721050
311115,202012,73,50,23,52250,24035,76285
311120,202012,1059,561,498,586245.5,521455,1107700.5
311130,202012,331,196,135,204820,141075,345895
311140,202012,171,92,79,96140,82555,178695
311150,202012,342,219,123,228855,128535,357390
311160,202012,710,507,203,529815.5,212135,741950.5
311170,202012,86,68,18,71060,18810,89870
311180,202012,316,209,107,218405,111815.5,330220.5
311190,202012,39,17,22,17765,22990,40755
311200,202012,327,228,99,238260,103455,341715
311205,202012,33,24,9,25080,9405,34485
311210,202012,42,37,5,38665.5,5225,43890.5
311220,202012,29,24,5,25080,5225,30305
311230,202012,1635,1071,564,1120240.5,589380,1709620.5
311240,202012,190,121,69,126445,72105,198550
311250,202012,57,21,36,21945,37620,59565
311260,202012,558,353,205,368885,214225,583110
311265,202012,122,83,39,86735,41800,128535
311270,202012,289,194,95,203775,99275,303050
311280,202012,205,95,110,99275,114950,214225
311290,202012,103,84,19,87780,19855,107635
311300,202012,577,361,216,377245,225720,602965
311310,202012,21,16,5,16720,5225,21945
311320,202012,655,486,169,508915,176605,685520
311330,202012,1079,788,291,824505.5,304095.5,1128601.0
311340,202012,2645,1866,779,1951017.5,814055.5,2765073.0
311350,202012,273,211,62,220495,64790,285285
311360,202012,177,103,74,107635,77330,184965
311370,202012,1223,496,727,518320.25,760760,1279080.25
311380,202012,7,6,1,6270,1045,7315
311390,202012,247,135,112,141075,117040,258115
311400,202012,134,82,52,86735,54340,141075
311410,202012,115,60,55,62700,57475,120175
311420,202012,303,165,138,173470,144210,317680
311430,202012,839,556,283,581020,295735.5,876755.5
311440,202012,459,321,138,335445,144210,479655
311450,202012,308,186,122,194370,127490,321860
311455,202012,277,191,86,199595,89870,289465
311460,202012,137,60,77,62700,80465,143165
311470,202012,26,13,13,13585,13585,27170
311480,202012,48,22,26,22990,27170,50160
311490,202012,13,9,4,9405,4180,13585
311500,202012,24,11,13,11495,13585,25080
311510,202012,646,440,206,459800,215270,675070
311520,202012,39,31,8,32395,8360,40755
311530,202012,1815,1321,494,1380448.2,516230,1896678.2
311535,202012,65,44,21,45980,21945,67925
311540,202012,33,29,4,30305,4180,34485
311545,202012,167,122,45,127490,47025,174515
311547,202012,36,30,6,31350,6270,37620
311550,202012,690,310,380,323950,398145,722095
311560,202012,43,28,15,29260,15675,44935
311570,202012,283,189,94,197505,98230,295735
311580,202012,351,208,143,217360,149435,366795
311590,202012,32,29,3,30305,3135,33440
311600,202012,105,83,22,86735,22990,109725
311610,202012,248,211,37,220495.25,38665,259160.25
311615,202012,91,71,20,74195,20900,95095
311620,202012,24,14,10,14630,10450,25080
311630,202012,89,75,14,78375,14630,93005
311640,202012,133,64,69,66880,72105,138985
311650,202012,120,81,39,84645,40755,125400
311660,202012,407,195,212,203775,221540.5,425315.5
311670,202012,147,96,51,102410,53295,155705
311680,202012,206,154,52,161975,54340,216315
311690,202012,16,12,4,12540,4180,16720
311700,202012,197,138,59,144210,61655,205865
311710,202012,192,131,61,136895,63745,200640
311720,202012,43,31,12,32395.5,12540,44935.5
311730,202012,560,381,179,399190,188100,587290
311740,202012,28,20,8,20900,8360,29260
311750,202012,722,481,241,502645.76,251845,754490.76
311760,202012,69,31,38,32395,39710,72105
311770,202012,382,190,192,198550.5,200640,399190.5
311780,202012,173,86,87,89870.5,91960,181830.5
311783,202012,90,80,10,83600,10450,94050
311787,202012,35,11,24,11495,25080,36575
311790,202012,258,111,147,115995,155705,271700
311800,202012,682,446,236,466070.25,247665,713735.25
311810,202012,48,38,10,40755,10450,51205
311820,202012,121,99,22,103455,22990,126445
311830,202012,1881,1150,731,1201751,763895,1965646
311840,202012,1009,556,453,582066,473385.25,1055451.25
311850,202012,12,8,4,8360,4180,12540
311860,202012,9594,4111,5483,4302302.08,5736005.5,10038307.58
311870,202012,120,65,55,67925,58520,126445
311880,202012,922,666,256,698060,267520,965580
311890,202012,200,96,104,100234,108680,208914
311900,202012,71,27,44,28215,45980,74195
311910,202012,1387,866,521,906015.75,544445.5,1450461.25
311920,202012,224,146,78,152570,81510,234080
311930,202012,896,502,394,524590.5,411730,936320.5
311940,202012,2495,1293,1202,1352230,1258181.15,2610411.15
311950,202012,55,38,17,39710,17765,57475
311960,202012,60,44,16,45980,16720,62700
311970,202012,24,15,9,15675,9405,25080
311980,202012,42,33,9,34485,9405,43890
311990,202012,38,29,9,30305,9405,39710
311995,202012,58,37,21,38665,21945,60610
312000,202012,25,16,9,16720,9405,26125
312010,202012,76,59,17,61655,17765,79420
312015,202012,73,54,19,56430,19855,76285
312020,202012,126,84,42,87780,43890,131670
312030,202012,60,44,16,45980,16720,62700
312040,202012,81,51,30,53295.5,32395,85690.5
312050,202012,201,111,90,115995,94050,210045
312060,202012,20,12,8,12540,8360,20900
312070,202012,75,48,27,50160,28215,78375
312080,202012,524,236,288,246620,300960,547580
312083,202012,55,36,19,37620,19855,57475
312087,202012,95,73,22,77330,22990,100320
312090,202012,3189,1898,1291,1983412,1351185.5,3334597.5
312100,202012,148,104,44,109484.65,45980,155464.65
312110,202012,116,64,52,66880,54340,121220
312120,202012,136,102,34,106590.29,35530,142120.29
312125,202012,89,51,38,53295,39710,93005
312130,202012,126,82,44,85690.5,45980,131670.5
312140,202012,135,104,31,108680.5,33440,142120.5
312150,202012,42,32,10,33440,10450,43890
312160,202012,1550,1011,539,1057671.58,563255.5,1620927.08
312170,202012,10,8,2,8360,2090,10450
312180,202012,111,67,44,71060,45980,117040
312190,202012,35,31,4,32395,4180,36575
312200,202012,750,639,111,668800.5,115995,784795.5
312210,202012,111,59,52,61655,54340,115995
312220,202012,129,98,31,102410.25,32395,134805.25
312230,202012,3648,1665,1983,1742015.4,2076416,3818431.4
312235,202012,154,102,52,106590,54340,160930
312240,202012,94,67,27,70015,28215,98230
312245,202012,190,128,62,133760,64790,198550
312247,202012,72,50,22,52250,22990,75240
312250,202012,173,82,91,85690,95095,180785
312260,202012,102,67,35,70015,36575,106590
312270,202012,131,77,54,80465,56430,136895
312280,202012,26,14,12,14630,12540,27170
312290,202012,145,103,42,107635,43890,151525
312300,202012,205,133,72,138985,75240,214225
312310,202012,61,54,7,56430,7315,63745
312320,202012,423,263,160,274835,167200.75,442035.75
312330,202012,89,77,12,80465,12540,93005
312340,202012,36,17,19,17765,19855,37620
312350,202012,17,9,8,9405,8360,17765
312352,202012,88,67,21,70015,21945,91960
312360,202012,577,241,336,251845,353210,605055
312370,202012,319,174,145,181830,151525,333355
312380,202012,134,88,46,93005,48070,141075
312385,202012,161,129,32,134805,33440,168245
312390,202012,295,184,111,192280,115995.5,308275.5
312400,202012,378,278,100,290544.83,104501,395045.83
312410,202012,1019,316,703,330220,735680,1065900
312420,202012,619,470,149,491150.5,155705,646855.5
312430,202012,870,634,236,662531.11,246620,909151.11
312440,202012,40,30,10,31350,10450,41800
312450,202012,206,131,75,136895,78375,215270
312460,202012,31,16,15,16720,15675,32395
312470,202012,44,30,14,31350,14630,45980
312480,202012,188,116,72,121220,75240,196460
312490,202012,269,186,83,194370,86735,281105
312500,202012,34,20,14,20900,14630,35530
312510,202012,525,196,329,204820,343805,548625
312520,202012,32,9,23,9405,24035,33440
312530,202012,45,31,14,32395,14630,47025
312540,202012,90,79,11,82555,11495,94050
312550,202012,36,29,7,30305,7315,37620
312560,202012,208,156,52,163020.5,54340,217360.5
312570,202012,431,255,176,266475,183920,450395
312580,202012,87,46,41,48070,42845,90915
312590,202012,242,194,48,202730,51205,253935
312595,202012,124,108,16,112860,16720,129580
312600,202012,67,36,31,37620.25,32395,70015.25
312610,202012,1590,807,783,843317,819280.5,1662597.5
312620,202012,215,155,60,161975,62700,224675
312630,202012,71,58,13,60610,13585,74195
312640,202012,41,11,30,11495,31350,42845
312650,202012,146,120,26,125400.5,27170,152570.5
312660,202012,90,63,27,65835.76,28215,94050.76
312670,202012,920,589,331,615505,345895,961400
312675,202012,28,23,5,24035,5225,29260
312680,202012,74,44,30,45980,31350,77330
312690,202012,243,124,119,129580,124355,253935
312695,202012,27,23,4,24035,4180,28215
312700,202012,225,128,97,134805,101365,236170
312705,202012,80,63,17,65835,17765,83600
312707,202012,132,92,40,96140,41800,137940
312710,202012,1849,986,863,1032461.41,903925,1936386.41
312720,202012,56,28,28,29260,29260,58520
312730,202012,284,163,121,170335,126445,296780
312733,202012,47,38,9,39710,9405,49115
312735,202012,22,14,8,14630,8360,22990
312737,202012,64,34,30,35530,31350,66880
312738,202012,58,39,19,40755,19855,60610
312740,202012,83,54,29,56430,30305,86735
312750,202012,87,60,27,63745,28215,91960
312760,202012,290,208,82,217360,85690,303050
312770,202012,8161,3696,4465,3866504.75,4670105,8536609.75
312780,202012,441,337,104,352165,108680,460845
312790,202012,21,15,6,15675,6270,21945
312800,202012,1585,1101,484,1150545.75,505780.65,1656326.40
312810,202012,367,235,132,245575,137940,383515
312820,202012,183,140,43,146300,44935,191235
312825,202012,26,17,9,17765,9405,27170
312830,202012,222,127,95,132715,101365,234080
312840,202012,157,105,52,109725,54340,164065
312850,202012,45,39,6,40755,6270,47025
312860,202012,153,95,58,99275,60610,159885
312870,202012,1063,553,510,577885.75,535040,1112925.75
312880,202012,122,86,36,89870,37620,127490
312890,202012,155,109,46,113905,48070,161975
312900,202012,192,144,48,150480,50160,200640
312910,202012,172,90,82,94050,85690,179740
312920,202012,147,84,63,87780,65835,153615
312930,202012,323,223,100,233035,104500,337535
312940,202012,123,84,39,87780,40755,128535
312950,202012,691,469,222,491150.5,231990,723140.5
312960,202012,161,119,42,124355.9,43890,168245.9
312965,202012,80,66,14,68970,14630,83600
312970,202012,272,224,48,235125.25,50160,285285.25
312980,202012,2468,1225,1243,1280126,1303115,2583241
312990,202012,46,25,21,26125,21945,48070
313000,202012,52,26,26,27170,27170,54340
313005,202012,171,133,38,138985,39710.5,178695.5
313010,202012,913,355,558,370975.5,584155,955130.5
313020,202012,200,103,97,107635,101365,209000
313030,202012,191,128,63,133760.35,65835,199595.35
313040,202012,77,25,52,26125,54340,80465
313050,202012,178,129,49,134805,51205,186010
313055,202012,39,29,10,30305,10450,40755
313060,202012,130,87,43,90915,44935,135850
313065,202012,63,44,19,45980,19855.5,65835.5
313070,202012,135,69,66,72105,68970,141075
313080,202012,39,17,22,17765,22990,40755
313090,202012,663,433,230,452485,240350,692835
313100,202012,189,63,126,65835,131670,197505
313110,202012,138,68,70,71060,73150,144210
313115,202012,213,118,95,124355,99275,223630
313120,202012,830,470,360,492195,376200.5,868395.5
313130,202012,5770,3110,2660,3255177.2,2782836.75,6038013.95
313140,202012,140,76,64,79420,66880,146300
313150,202012,304,239,65,249755,67925,317680
313160,202012,187,138,49,144210.5,51205,195415.5
313170,202012,1397,928,469,969761.08,490105,1459866.08
313180,202012,300,174,126,181830.5,131670,313500.5
313190,202012,738,439,299,458755.5,313500,772255.5
313200,202012,25,20,5,20900,5225,26125
313210,202012,997,846,151,885117.55,157795,1042912.55
313220,202012,286,175,111,182875,115995.5,298870.5
313230,202012,258,196,62,204820.87,65835,270655.87
313240,202012,2151,1100,1051,1149503,1100385,2249888
313250,202012,1253,951,302,994840.5,315590.8,1310431.3
313260,202012,93,48,45,50160,47025,97185
313270,202012,989,571,418,596800.25,436811.5,1033611.75
313280,202012,51,43,8,44935,8360,53295
313290,202012,215,173,42,180785,43890,224675
313300,202012,346,180,166,188100,173470,361570
313310,202012,260,121,139,126445,145255,271700
313320,202012,386,283,103,295735,107635,403370
313330,202012,1400,849,551,888250.5,576840.5,1465091.0
313340,202012,325,230,95,240350,99275,339625
313350,202012,487,323,164,337535,171380,508915
313360,202012,146,69,77,72105,80465,152570
313370,202012,223,69,154,72105,160930,233035
313375,202012,291,173,118,180785,123310,304095
313380,202012,1348,696,652,730456,682385,1412841
313390,202012,51,47,4,49115,4180,53295
313400,202012,392,263,129,274835,134806,409641
313410,202012,24,13,11,13585,11495,25080
313420,202012,4546,2422,2124,2530991.5,2225852.45,4756843.95
313430,202012,141,68,73,71060,76285,147345
313440,202012,1406,964,442,1008426.81,462937,1471363.81
313450,202012,67,27,40,28215,41800,70015
313460,202012,384,168,216,175560,225720,401280
313470,202012,526,244,282,254980,294690.5,549670.5
313480,202012,148,109,39,113905.5,40755,154660.5
313490,202012,519,238,281,248710.5,293645.25,542355.75
313500,202012,28,15,13,15675,13585,29260
313505,202012,1024,801,223,839135,234080,1073215
313507,202012,103,62,41,64790,42845,107635
313510,202012,2834,1772,1062,1852878.54,1111880,2964758.54
313520,202012,3448,2686,762,2808963.16,797335,3606298.16
313530,202012,33,21,12,21945,12540,34485
313535,202012,61,48,13,50160,13585,63745
313540,202012,69,51,18,53295,18810,72105
313545,202012,111,93,18,97185,18810,115995
313550,202012,228,193,35,201685,36575.5,238260.5
313560,202012,341,161,180,168245,188100,356345
313570,202012,60,21,39,21945,40755,62700
313580,202012,1314,731,583,763895.5,609236.5,1373132.0
313590,202012,69,38,31,39710.5,32395,72105.5
313600,202012,671,404,267,423225,279015.5,702240.5
313610,202012,63,48,15,50160,15675,65835
313620,202012,1393,691,702,723141,735680.87,1458821.87
313630,202012,1610,1214,396,1268631.5,414865,1683496.5
313640,202012,121,73,48,76285,50160,126445
313650,202012,235,108,127,112860,132715,245575
313652,202012,19,18,1,18810,1045,19855
313655,202012,68,45,23,47025,24035,71060
313657,202012,43,40,3,41800,3135,44935
313660,202012,132,89,43,93005,44953.81,137958.81
313665,202012,638,288,350,300960.75,365750,666710.75
313670,202012,10268,6942,3326,7260663.55,3486121.25,10746784.80
313680,202012,42,32,10,33440,10450,43890
313690,202012,140,106,34,110770,35530,146300
313695,202012,63,46,17,48070,17765,65835
313700,202012,310,248,62,259160.5,64790,323950.5
313710,202012,134,97,37,101365,38665,140030
313720,202012,1120,516,604,540265.5,631181.5,1171447.0
313730,202012,73,42,31,43890,32395,76285
313740,202012,148,119,29,124355,30305,154660
313750,202012,420,301,119,314545,124355,438900
313753,202012,231,172,59,179740,61655,241395
313760,202012,1320,474,846,496375.88,884071.5,1380447.38
313770,202012,381,270,111,282150.25,115995,398145.25
313780,202012,785,409,376,428450,392920,821370
313790,202012,28,27,1,28215,1045,29260
313800,202012,138,83,55,86735,57475,144210
313810,202012,77,44,33,45980,34485,80465
313820,202012,1306,611,695,638496,727320.5,1365816.5
313830,202012,57,41,16,42845,16720,59565
313835,202012,59,49,10,51205,10450,61655
313840,202012,1656,981,675,1025146.5,706420.5,1731567.0
313850,202012,205,75,130,78375,135850,214225
313860,202012,468,354,114,369930.5,120175,490105.5
313862,202012,158,104,54,108680,56430,165110
313865,202012,120,90,30,95095,31350,126445
313867,202012,50,40,10,41800,10450,52250
313868,202012,35,20,15,20900,15675,36575
313870,202012,115,61,54,63745,56430,120175
313880,202012,378,230,148,240350,154660,395010
313890,202012,326,168,158,175560,165110,340670
313900,202012,867,468,399,490105.91,419045.25,909151.16
313910,202012,149,103,46,107635,48070,155705
313920,202012,631,438,193,457710,201685.44,659395.44
313925,202012,33,28,5,29260,5225,34485
313930,202012,854,660,194,691790,202730,894520
313940,202012,1864,1145,719,1197570,754490,1952060
313950,202012,864,539,325,563255,340670,903925
313960,202012,1409,804,605,840180.9,633272,1473452.9
313970,202012,169,107,62,111815,65835,177650
313980,202012,201,129,72,134805.25,75240,210045.25
313990,202012,236,157,79,164065,82555,246620
314000,202012,894,587,307,613415.85,321860,935275.85
314010,202012,82,47,35,49115,36575,85690
314015,202012,64,16,48,16720,50160,66880
314020,202012,53,33,20,34485,20900,55385
314030,202012,75,35,40,36575,41800,78375
314040,202012,46,27,19,28215,19855,48070
314050,202012,285,170,115,177650,120175,297825
314053,202012,99,64,35,66880,36575,103455
314055,202012,296,183,113,191235,118085,309320
314060,202012,132,115,17,120175.04,17765,137940.04
314070,202012,1030,519,511,542355,535040,1077395
314080,202012,208,131,77,136895.25,80465.4,217360.65
314085,202012,147,97,50,101365,52250,153615
314090,202012,379,269,110,281105.25,114950,396055.25
314100,202012,509,410,99,428450.75,103455,531905.75
314110,202012,790,388,402,405460.5,420090,825550.5
314120,202012,73,44,29,45980,30305,76285
314130,202012,21,12,9,12540,9405,21945
314140,202012,1112,682,430,713735,449350,1163085
314150,202012,187,120,67,125400,70015,195415
314160,202012,332,247,85,258115,88825,346940
314170,202012,84,65,19,67925,19855,87780
314180,202012,727,640,87,668800.5,90915.25,759715.75
314190,202012,100,59,41,61655,42845,104500
314200,202012,498,337,161,352165,168245.5,520410.5
314210,202012,245,186,59,194370,61655.5,256025.5
314220,202012,298,218,80,227810.5,83600,311410.5
314225,202012,59,42,17,43890,17765,61655
314230,202012,116,51,65,53295,67925,121220
314240,202012,148,107,41,112860,42845,155705
314250,202012,52,29,23,30305,24035,54340
314260,202012,211,104,107,108680,111815,220495
314270,202012,376,291,85,304095,88825,392920
314280,202012,719,386,333,403323,347985,751308
314290,202012,546,435,111,454575,115995,570570
314300,202012,351,256,95,267520.25,99275,366795.25
314310,202012,1363,925,438,966888.32,459800,1426688.32
314315,202012,34,26,8,27170,8360,35530
314320,202012,588,390,198,407550.5,207955,615505.5
314330,202012,11148,5402,5746,5647183,6012931,11660114
314340,202012,600,268,332,280060,346941,627001
314345,202012,48,32,16,33440,16720,50160
314350,202012,182,113,69,118085,72105,190190
314360,202012,59,34,25,35530,26125,61655
314370,202012,64,42,22,43890,22990,66880
314380,202012,95,60,35,62700,36575,99275
314390,202012,3323,2117,1206,2216446.85,1260270,3476716.85
314400,202012,693,485,208,506826.3,217360,724186.3
314410,202012,488,317,171,331265,178695,509960
314420,202012,14,8,6,8360,6270,14630
314430,202012,2421,884,1537,923780.78,1607210.5,2530991.28
314435,202012,181,105,76,109725,79420,189145
314437,202012,28,21,7,21945,7315,29260
314440,202012,99,69,30,72105,31350,103455
314450,202012,159,110,49,114950,51205,166155
314460,202012,635,298,337,311410,352165.5,663575.5
314465,202012,92,59,33,61655.98,34485,96140.98
314467,202012,67,54,13,56430,13585,70015
314470,202012,413,202,211,212136.45,220495,432631.45
314480,202012,1040,482,558,503690,584155,1087845
314490,202012,47,31,16,32395,16720,49115
314500,202012,279,195,84,203775.5,87780,291555.5
314505,202012,109,68,41,71060,42845,113905
314510,202012,247,202,45,211090,47025,258115
314520,202012,1299,687,612,718965.5,639541.5,1358507.0
314530,202012,729,582,147,608191.01,153615,761806.01
314535,202012,166,97,69,101365,72105,173470
314537,202012,62,36,26,37620,27170,64790
314540,202012,15,9,6,9405,6270,15675
314545,202012,51,33,18,34485,18810,53295
314550,202012,80,41,39,42845,40755,83600
314560,202012,850,458,392,478610.5,409640,888250.5
314570,202012,21,16,5,16720,5225,21945
314580,202012,14,5,9,5225,9405,14630
314585,202012,27,18,9,18810,9405,28215
314587,202012,81,67,14,70015,14630,84645
314590,202012,552,390,162,407550.25,169290,576840.25
314600,202012,938,598,340,625956,355300.79,981256.79
314610,202012,942,483,459,504735.5,479655,984390.5
314620,202012,134,100,34,104500,35530,140030
314625,202012,97,70,27,73150,28215,101365
314630,202012,1167,615,552,642675.25,576840,1219515.25
314640,202012,82,53,29,55385,30305.5,85690.5
314650,202012,176,99,77,103455,80465,183920
314655,202012,61,45,16,47025,16720,63745
314660,202012,16,13,3,13585,3135,16720
314670,202012,200,153,47,159885.5,49115,209000.5
314675,202012,209,122,87,127490,90915,218405
314690,202012,592,312,280,326040,292600,618640
314700,202012,2258,1206,1052,1260271.5,1101430,2361701.5
314710,202012,1713,969,744,1013652.25,779570.5,1793222.75
314720,202012,389,226,163,236170,170335,406505
314730,202012,517,268,249,280060.5,260205,540265.5
314740,202012,725,340,385,355300,402325,757625
314750,202012,18,14,4,14630,4180,18810
314760,202012,347,154,193,160930,201685,362615
314770,202012,105,72,33,75240,34485,109725
314780,202012,22,8,14,8360,14630,22990
314790,202012,2416,1519,897,1588401.5,937365,2525766.5
314795,202012,49,38,11,39710,11495,51205
314800,202012,2916,1685,1231,1760827.22,1287440,3048267.22
314810,202012,1492,841,651,879890,684475,1564365
314820,202012,105,57,48,59565,50160,109725
314830,202012,213,170,43,177650,44935,222585
314840,202012,88,54,34,56430,35530,91960
314850,202012,398,193,205,201685.5,214225,415910.5
314860,202012,655,501,154,523545,160930,684475
314870,202012,1527,791,736,826595.5,769120,1595715.5
314875,202012,52,47,5,49115,5225,54340
314880,202012,44,30,14,31350,14630,45980
314890,202012,51,30,21,31350,22990,54340
314900,202012,28,22,6,22990,7315,30305
314910,202012,242,157,85,164065,88825,252890
314915,202012,135,122,13,127490,13585,141075
314920,202012,104,65,39,67925,40755,108680
314930,202012,1046,507,539,529815.5,565345,1095160.5
314940,202012,47,37,10,38665,10450,49115
314950,202012,30,21,9,21945,9405,31350
314960,202012,30,22,8,22990,8360,31350
314970,202012,146,69,77,72105,80465,152570
314980,202012,312,200,112,209000,117040,326040
314990,202012,433,236,197,246620,206910.25,453530.25
314995,202012,159,65,94,67925,98230,166155
315000,202012,77,58,19,60610,19855,80465
315010,202012,43,28,15,29260,15675,44935
315015,202012,165,130,35,135850,36575,172425
315020,202012,69,58,11,60610,11495,72105
315030,202012,106,81,25,84645.5,26125,110770.5
315040,202012,72,48,24,50160,25080,75240
315050,202012,182,106,76,110770,79420,190190
315053,202012,42,33,9,34485,9405,43890
315057,202012,102,78,24,81510,25080,106590
315060,202012,76,63,13,65835.8,13585,79420.8
315070,202012,103,58,45,60610,47025,107635
315080,202012,369,290,79,303050,82555,385605
315090,202012,91,53,38,55385,39710,95095
315100,202012,78,40,38,41800,40755,82555
315110,202012,269,144,125,150480,130625,281105
315120,202012,1729,835,894,873620,934230.2,1807850.2
315130,202012,342,247,95,258115,99275,357390
315140,202012,530,294,236,307230,249756.43,556986.43
315150,202012,979,461,518,482790,541310,1024100
315160,202012,212,104,108,108680,113905,222585
315170,202012,312,207,105,217360.5,109725,327085.5
315180,202012,3230,1328,1902,1387761,1987591.25,3375352.25
315190,202012,312,185,127,193325,132715,326040
315200,202012,1225,721,504,754490,527725,1282215
315210,202012,1648,934,714,976030.25,746130,1722160.25
315213,202012,30,18,12,18810,12540,31350
315217,202012,199,155,44,161975,45980,207955
315220,202012,1574,1182,392,1235190.95,409640,1644830.95
315230,202012,168,120,48,125400.5,50160,175560.5
315240,202012,418,266,152,277970,158841,436811
315250,202012,2573,1236,1337,1291620,1400300.5,2691920.5
315260,202012,145,81,64,85690,66880,152570
315270,202012,132,90,42,94050,43890,137940
315280,202012,644,413,231,431585,241395,672980
315290,202012,189,119,70,124355,73150,197505
315300,202012,79,57,22,59565,22990,82555
315310,202012,75,67,8,70015,8360,78375
315320,202012,154,91,63,95095,65835,160930
315330,202012,53,43,10,44935,10450,55385
315340,202012,383,280,103,292600,107635,400235
315350,202012,151,90,61,94050,63745,157795
315360,202012,87,40,47,41800,49115,90915
315370,202012,54,34,20,35530,20900,56430
315380,202012,8,8,0,8360,0,8360
315390,202012,60,15,45,15675,47025.5,62700.5
315400,202012,827,616,211,643721.25,220495,864216.25
315410,202012,326,190,136,198550.5,142121.5,340672.0
315415,202012,56,42,14,43890,14630,58520
315420,202012,199,145,54,151525.5,56430.5,207956.0
315430,202012,659,377,282,393965.5,294690,688655.5
315440,202012,94,64,30,66880,31350,98230
315445,202012,231,192,39,200640,40755,241395
315450,202012,180,135,45,141075,47025,188100
315460,202012,4086,1940,2146,2030435.5,2245705.5,4276141.0
315470,202012,40,16,24,16720,25080,41800
315480,202012,70,20,50,20900,52250,73150
315490,202012,695,422,273,442035,285285,727320
315500,202012,16,12,4,12540,4180,16720
315510,202012,148,99,49,103455,51205,154660
315520,202012,72,62,10,64790,10450,75240
315530,202012,43,23,20,24035,20900,44935
315540,202012,245,168,77,175560,80465,256025
315550,202012,182,146,36,152570,38665,191235
315560,202012,740,589,151,615505.5,158840,774345.5
315570,202012,308,152,156,158842.19,163020,321862.19
315580,202012,710,479,231,500555,242440.5,742995.5
315590,202012,196,99,97,103455,101365,204820
315600,202012,301,228,73,238260,76285,314545
315610,202012,102,52,50,54340,52250,106590
315620,202012,37,29,8,30305,8360,38665
315630,202012,127,84,43,87780,44935,132715
315640,202012,77,45,32,47025,33440,80465
315645,202012,45,30,15,31350,15675.5,47025.5
315650,202012,172,123,49,128535.5,51205,179740.5
315660,202012,455,199,256,207955.5,267520,475475.5
315670,202012,2387,1124,1263,1174581.5,1321925,2496506.5
315680,202012,821,581,240,608190,250800,858990
315690,202012,672,462,210,482791.97,219450,702241.97
315700,202012,1916,1000,916,1047091.21,957220,2004311.21
315710,202012,354,102,252,106590,263340,369930
315720,202012,453,276,177,288420,184965,473385
315725,202012,184,150,34,156750.5,35530,192280.5
315727,202012,51,22,29,22990,30305,53295
315730,202012,45,42,3,43890,3135,47025
315733,202012,87,59,28,61655,29260,90915
315737,202012,49,36,13,37620,13585,51205
315740,202012,32,25,7,26125,7315,33440
315750,202012,154,114,40,119130,41800,160930
315760,202012,36,26,10,27170,10450,37620
315765,202012,118,67,51,70015,53295,123310
315770,202012,218,135,83,141075,86735,227810
315780,202012,3522,1730,1792,1807850.5,1874730,3682580.5
315790,202012,233,181,52,189145,54340,243485
315800,202012,298,204,94,214225,98230,312455
315810,202012,93,56,37,58520,38665,97185
315820,202012,747,540,207,564300.5,216315,780615.5
315830,202012,122,78,44,82555,45980,128535
315840,202012,86,56,30,58520,31350,89870
315850,202012,258,182,76,190190.25,79420,269610.25
315860,202012,14,5,9,5225,9405,14630
315870,202012,40,30,10,31350,10450,41800
315880,202012,103,65,38,67925,39710,107635
315890,202012,89,65,24,67925,25080,93005
315895,202012,419,273,146,285285.75,152571,437856.75
315900,202012,67,32,35,33440,36575,70015
315910,202012,39,22,17,22990,17765,40755
315920,202012,157,105,52,109725,54340.75,164065.75
315930,202012,51,18,33,18810,34485,53295
315935,202012,131,103,28,107635.5,29260,136895.5
315940,202012,101,74,27,77330,28215,105545
315950,202012,36,29,7,30305,7315,37620
315960,202012,534,254,280,265430,292600.5,558030.5
315970,202012,34,27,7,28215,7315,35530
315980,202012,672,333,339,347985,354255,702240
315990,202012,254,147,107,153615,111815.5,265430.5
316000,202012,47,30,17,31350,17765,49115
316010,202012,78,65,13,67925,13585,81510
316020,202012,115,98,17,102410,17765,120175
316030,202012,377,209,168,218405.5,175560.75,393966.25
316040,202012,528,218,310,227810.5,326040.5,553851.0
316045,202012,50,44,6,45980,6270,52250
316050,202012,16,12,4,12540,4180,16720
316060,202012,92,60,32,62700,33440,96140
316070,202012,1080,690,390,722095.75,407550,1129645.75
316080,202012,96,64,32,66971.96,33440,100411.96
316090,202012,42,21,21,21945,21945,43890
316095,202012,97,77,20,80465,20900,101365
316100,202012,314,177,137,184965,143165,328130
316105,202012,37,23,14,24035,14630,38665
316110,202012,1868,1472,396,1538240.62,413820,1952060.62
316120,202012,78,55,23,57475,24035,81510
316130,202012,122,90,32,94050.5,33440,127490.5
316140,202012,30,19,11,19855,11495,31350
316150,202012,205,142,63,148390,65835,214225
316160,202012,79,45,34,47025,35530,82555
316165,202012,64,45,19,47025,19855,66880
316170,202012,182,119,63,124355,65835,190190
316180,202012,202,86,116,89870,121220.5,211090.5
316190,202012,132,95,37,99275,38665,137940
316200,202012,668,359,309,375155,322905,698060
316210,202012,772,510,262,533129.74,273790,806919.74
316220,202012,121,80,41,83600,42845,126445
316225,202012,28,15,13,15675,13585,29260
316230,202012,35,19,16,19855,16720,36575
316240,202012,648,518,130,541310,135850,677160
316245,202012,128,110,18,114950,18810,133760
316250,202012,1531,1034,497,1080531.5,520410,1600941.5
316255,202012,124,98,26,102410,27170,129580
316257,202012,177,92,85,96140,88825,184965
316260,202012,190,135,55,141075.25,57475.5,198550.75
316265,202012,27,18,9,18810,9405,28215
316270,202012,684,477,207,499510.5,216315.6,715826.1
316280,202012,550,338,212,353210.29,222585.5,575795.79
316290,202012,749,490,259,513095.65,270655,783750.65
316292,202012,512,199,313,207955,328130,536085
316294,202012,103,63,40,65835,41800,107635
316295,202012,309,129,180,134805.5,188100,322905.5
316300,202012,109,71,38,75240,39710,114950
316310,202012,28,14,14,14630,14630,29260
316320,202012,51,26,25,27170,26125,53295
316330,202012,165,112,53,117040.25,55385,172425.25
316340,202012,131,86,45,89870,47025,136895
316350,202012,190,133,57,138985.74,59565,198550.74
316360,202012,23,15,8,15675,8360,24035
316370,202012,1128,563,565,588336.25,591470,1179806.25
316380,202012,116,86,30,89870,31350,121220
316390,202012,108,77,31,81510,32395,113905
316400,202012,133,103,30,107635,31350,138985
316410,202012,301,219,82,228855,85690,314545
316420,202012,204,136,68,142120,71060,213180
316430,202012,149,77,72,80465,75240,155705
316440,202012,88,42,46,43890,48070,91960
316443,202012,39,37,2,38665,2090,40755
316447,202012,48,36,12,37620,12540,50160
316450,202012,222,169,53,176605,55385,231990
316460,202012,81,29,52,30305,54340,84645
316470,202012,1677,1218,459,1273848.01,479655,1753503.01
316480,202012,11,8,3,8360,3135,11495
316490,202012,20,6,14,6270,14630,20900
316500,202012,153,103,50,107635,52250,159885
316510,202012,152,115,37,121220,38665,159885
316520,202012,191,115,76,120175,79420,199595
316530,202012,165,106,59,110770.5,61655,172425.5
316540,202012,145,74,71,77330,74195,151525
316550,202012,141,90,51,94050,53295,147345
316553,202012,297,133,164,138985,171380.72,310365.72
316555,202012,42,36,6,37620,6270,43890
316556,202012,13,9,4,9405,4180,13585
316557,202012,22,18,4,18810,4180,22990
316560,202012,66,45,21,47025,21945,68970
316570,202012,216,196,20,204820,20900,225720
316580,202012,20,14,6,14630,6270,20900
316590,202012,101,84,17,87780.25,17765,105545.25
316600,202012,173,141,32,147345.5,33440,180785.5
316610,202012,64,48,16,50160,16720,66880
316620,202012,139,101,38,105545,39710,145255
316630,202012,39,30,9,31350,9405,40755
316640,202012,22,14,8,14630,8360,22990
316650,202012,71,56,15,58520,15675,74195
316660,202012,8,3,5,3135,5225,8360
316670,202012,442,150,292,156750,305140,461890
316680,202012,156,109,47,113905,49115,163020
316690,202012,183,114,69,119130,72105,191235
316695,202012,61,51,10,53295,10450,63745
316700,202012,17,11,6,11495,6270,17765
316710,202012,762,569,193,594605.25,202730,797335.25
316720,202012,5016,2419,2597,2528901.99,2714910.5,5243812.49
316730,202012,18,16,2,16720,2090,18810
316740,202012,140,90,50,94050,52250,146300
316750,202012,17,10,7,10450,7315,17765
316760,202012,321,257,64,268565,66880,335445
316770,202012,156,84,72,88825,76285,165110
316780,202012,66,41,25,42845,26125,68970
316790,202012,55,39,16,40755,16720,57475
316800,202012,1755,1086,669,1134870,699105.6,1833975.6
316805,202012,25,18,7,18810,7315,26125
316810,202012,65,40,25,41800,26125,67925
316820,202012,40,21,19,21945,19855,41800
316830,202012,98,43,55,44935,57475,102410
316840,202012,523,303,220,317680,233035,550715
316850,202012,322,216,106,225720,111815,337535
316860,202012,5917,2601,3316,2719094.4,3470445.75,6189540.15
316870,202012,1540,981,559,1025147.25,585200.5,1610347.75
316880,202012,129,62,67,64790,70015,134805
316890,202012,239,164,75,171380,78375,249755
316900,202012,416,289,127,302005.65,132715,434720.65
316905,202012,21,11,10,11495,10450,21945
316910,202012,71,29,42,30305,43890,74195
316920,202012,140,108,32,112860,33440,146300
316930,202012,1895,967,928,1010516.14,972895.75,1983411.89
316935,202012,909,541,368,565345.1,385605.5,950950.6
316940,202012,1094,615,479,642675.5,501600.5,1144276.0
316950,202012,178,87,91,90915,95095,186010
316960,202012,1097,608,489,635361,511005,1146366
316970,202012,651,511,140,533995,146300,680295
316980,202012,73,40,33,41800,34485,76285
316990,202012,2148,1424,724,1489125.85,757626.44,2246752.29
317000,202012,334,256,78,267520,81510.5,349030.5
317005,202012,233,162,71,169290,74195,243485
317010,202012,6384,3509,2875,3670498.06,3007511,6678009.06
317020,202012,15966,6980,8986,7303514.4,9399780.1,16703294.5
317030,202012,79,30,49,31350,51205,82555
317040,202012,3042,1900,1142,1986547.21,1196525.5,3183072.71
317043,202012,70,51,19,53295,19855,73150
317047,202012,34,17,17,17765,17765,35530
317050,202012,158,121,37,126445,38665,165110
317052,202012,135,103,32,107635,33440,141075
317057,202012,169,130,39,136895,40755,177650
317060,202012,62,38,24,39710,25080,64790
317065,202012,48,37,11,38665,11495,50160
317070,202012,1958,898,1060,938410.75,1109790.5,2048201.25
317075,202012,98,52,46,54340,49115,103455
317080,202012,909,458,451,479655.25,471295,950950.25
317090,202012,667,524,143,547580,149435,697015
317100,202012,418,314,104,328130,108680,436810
317103,202012,105,83,22,86735,22990,109725
317107,202012,44,38,6,39710,6270,45980
317110,202012,117,53,64,55385,66880,122265
317115,202012,40,36,4,37620,4180,41800
317120,202012,1929,917,1012,959312,1060675.5,2019987.5
317130,202012,1956,1297,659,1356411.5,688655,2045066.5
317140,202012,10,8,2,8360,2090,10450
317150,202012,264,157,107,164065.5,111815,275880.5
317160,202012,311,232,79,242441.29,82555,324996.29
317170,202012,218,148,70,154660,73150,227810
317180,202012,444,302,142,315590,149435,465025
317190,202012,262,184,78,192280,81510,273790
317200,202012,824,570,254,595652.9,265430,861082.9
317210,202012,183,100,83,104500,86735,191235
317220,202012,24,13,11,13585,11495,25080
320010,202012,600,430,170,449350.25,177650,627000.25
320013,202012,120,84,36,87780,37620,125400
320016,202012,262,164,98,171380,102410,273790
320020,202012,712,413,299,431587.37,312455,744042.37
320030,202012,153,109,44,113905.06,45980.33,159885.39
320035,202012,139,101,38,105545,39710,145255
320040,202012,501,253,248,264385,259160,523545
320050,202012,106,76,30,79420,31350,110770
320060,202012,1687,790,897,827640.25,937366.75,1765007.00
320070,202012,97,60,37,62700,38665,101365
320080,202012,803,459,344,479656.25,359480,839136.25
320090,202012,1254,831,423,868395,444125,1312520
320100,202012,325,188,137,197505,143165,340670
320110,202012,123,78,45,81511.25,47025,128536.25
320115,202012,111,91,20,95095,20900,115995
320120,202012,3537,1863,1674,1948929.15,1750375,3699304.15
320130,202012,7476,3357,4119,3511203.02,4306446.5,7817649.52
320140,202012,436,285,151,297825,158841.16,456666.16
320150,202012,2050,1142,908,1194435.75,949905.5,2144341.25
320160,202012,658,293,365,306185,382470.5,688655.5
320170,202012,109,86,23,89870.1,24035.02,113905.12
320180,202012,58,33,25,34485,26125,60610
320190,202012,238,151,87,157795,90915,248710
320200,202012,57,42,15,43890,15675,59565
320210,202012,897,489,408,511006,426360.5,937366.5
320220,202012,300,105,195,109725,203775,313500
320225,202012,83,65,18,67925,18810,86735
320230,202012,626,388,238,407550,248710,656260
320240,202012,3347,1597,1750,1668868,1829795.5,3498663.5
320245,202012,474,320,154,334400.5,160930,495330.5
320250,202012,225,115,110,120175,115995,236170
320255,202012,131,102,29,106590,30305,136895
320260,202012,220,138,82,144210.7,85690.12,229900.82
320265,202012,150,113,37,118085,38665,156750
320270,202012,150,117,33,122265,35530,157795
320280,202012,1129,636,493,664621.07,516230.02,1180851.09
320290,202012,55,47,8,49115,8360,57475
320300,202012,588,401,187,420091.37,195416.6,615507.97
320305,202012,676,351,325,366795,340670.5,707465.5
320310,202012,198,112,86,117040.58,89870,206910.58
320313,202012,338,161,177,168245.25,184965,353210.25
320316,202012,111,84,27,87780,28215,115995
320320,202012,3406,1504,1902,1573770.65,1989680,3563450.65
320330,202012,257,192,65,200640,67925,268565
320332,202012,759,459,300,479657,313500.25,793157.25
320334,202012,243,140,103,147345.52,107635,254980.52
320335,202012,150,101,49,105545,51205,156750
320340,202012,557,387,170,405460.75,179740.5,585201.25
320350,202012,1016,426,590,445170.97,616550.5,1061721.47
320360,202012,167,90,77,94050,80465,174515
320370,202012,242,179,63,187055.9,65835.5,252891.4
320380,202012,285,194,91,202730.5,95095,297825.5
320390,202012,1150,682,468,712690,490105.5,1202795.5
320400,202012,311,225,86,235125,89870,324995
320405,202012,960,390,570,407550.25,595650.5,1003200.75
320410,202012,956,483,473,504735,495330.25,1000065.25
320420,202012,511,244,267,254980.75,279015,533995.75
320425,202012,187,99,88,103455,91960,195415
320430,202012,399,215,184,224675.25,192280,416955.25
320435,202012,158,104,54,108680,56430,165110
320440,202012,198,114,84,119130.28,88825.22,207955.50
320450,202012,129,71,58,74195,60610,134805
320455,202012,253,203,50,212135.5,52250,264385.5
320460,202012,275,166,109,174515,113905,288420
320465,202012,114,77,37,80465,38665,119130
320470,202012,694,416,278,434720.5,291555,726275.5
320480,202012,196,126,70,131670,73150,204820
320490,202012,3075,1498,1577,1565411.76,1647967.98,3213379.74
320495,202012,112,68,44,71060,45980.5,117040.5
320500,202012,9634,4661,4973,4877023.6,5203060.95,10080084.55
320501,202012,540,271,269,283195,281105,564300
320503,202012,290,203,87,212135.1,90915.02,303050.12
320506,202012,265,185,80,194370,83600,277970
320510,202012,1055,464,591,484880.5,617595,1102475.5
320515,202012,84,64,20,66880,20900,87780
320517,202012,216,152,64,158840,66880,225720
320520,202012,7020,2977,4043,3115148.07,4229117.5,7344265.57
320530,202012,6220,3047,3173,3184608.22,3316830,6501438.22
330010,202012,3083,1539,1544,1609302.5,1620795,3230097.5
330015,202012,167,68,99,71060.9,103455,174515.9
330020,202012,3747,1533,2214,1605434.6,2315720,3921154.6
330022,202012,251,126,125,131670,130625,262295
330023,202012,679,224,455,234080,476520,710600
330025,202012,585,111,474,115995,497420.94,613415.94
330030,202012,1888,1174,714,1227875.12,747175.5,1975050.62
330040,202012,2436,1222,1214,1278035,1279080.5,2557115.5
330045,202012,9120,2727,6393,2851806.5,6691135,9542941.5
330050,202012,878,556,322,582065,337535,919600
330060,202012,1019,601,418,629091.25,436810,1065901.25
330070,202012,3769,1316,2453,1375220.4,2565475.5,3940695.9
330080,202012,1584,686,898,716870.75,938410,1655280.75
330090,202012,392,228,164,238260,171380,409640
330093,202012,260,113,147,118085,153615,271700
330095,202012,75,44,31,45980,32395,78375
330100,202012,9940,4923,5017,5150808.17,5257396.25,10408204.42
330110,202012,471,195,276,203775.75,288420,492195.75
330115,202012,519,276,243,289465.5,253935,543400.5
330120,202012,387,193,194,201685,202731.5,404416.5
330130,202012,1569,379,1190,398145,1243550,1641695
330140,202012,610,318,292,332310,306185,638495
330150,202012,516,293,223,307230,233035,540265
330160,202012,207,122,85,127490,89870,217360
330170,202012,27163,9017,18146,9427992.1,18983474.24,28411466.34
330180,202012,238,140,98,146300,102410,248710
330185,202012,973,342,631,358435,660440.5,1018875.5
330187,202012,397,118,279,123310,291555,414865
330190,202012,5859,2194,3665,2295866.9,3830970.5,6126837.4
330200,202012,4705,1383,3322,1445236.81,3475670.5,4920907.31
330205,202012,440,249,191,260205,199595.5,459800.5
330210,202012,949,577,372,605055,388741,993796
330220,202012,2686,1575,1111,1647965.2,1162040.5,2810005.7
330225,202012,568,285,283,297825,296780,594605
330227,202012,2433,725,1708,758670,1784860.25,2543530.25
330230,202012,254,142,112,148390,117040,265430
330240,202012,3827,1875,1952,1961466.25,2047157,4008623.25
330245,202012,151,66,85,68970.1,88825,157795.1
330250,202012,6667,3305,3362,3455816.25,3517472.52,6973288.77
330260,202012,610,152,458,159885,480701,640586
330270,202012,3626,1194,2432,1247730,2542486,3790216
330280,202012,449,285,164,297825.5,171380.45,469205.95
330285,202012,7000,2139,4861,2239435.75,5082882.25,7322318.00
330290,202012,659,235,424,245575.75,446215,691790.75
330300,202012,767,491,276,513216.47,288420,801636.47
330310,202012,443,241,202,251845.5,211090,462935.5
330320,202012,8050,2899,5151,3033636.99,5387070.5,8420707.49
330330,202012,9131,3352,5779,3507021.67,6050551,9557572.67
330340,202012,2660,1537,1123,1608255,1174580,2782835
330350,202012,18688,6947,11741,7264846.65,12282937.07,19547783.72
330360,202012,2218,1052,1166,1101431,1223695.5,2325126.5
330370,202012,1022,499,523,521457,547580,1069037
330380,202012,901,370,531,386650,554895.01,941545.01
330385,202012,632,320,312,334400,329175,663575
330390,202012,5639,2913,2726,3050356.25,2851805.5,5902161.75
330395,202012,309,181,128,189145,133760.75,322905.75
330400,202012,716,374,342,390830.5,357390,748220.5
330410,202012,502,363,139,379335.25,146300.5,525635.75
330411,202012,260,137,123,143165.55,128535,271700.55
330412,202012,232,92,140,96140.5,146300,242440.5
330414,202012,5343,2117,3226,2215402.7,3377441.27,5592843.97
330415,202012,614,268,346,280061.5,362615,642676.5
330420,202012,2221,1111,1110,1160996.55,1160995.5,2321992.05
330430,202012,1769,782,987,818236,1034552.5,1852788.5
330440,202012,292,133,159,138985,166155,305140
330450,202012,120,52,68,54340,71060,125400
330452,202012,2090,902,1188,943635.5,1242505.5,2186141.0
330455,202012,113714,38819,74895,40594181.63,78342626.93,118936808.56
330460,202012,254,109,145,113905,151525,265430
330470,202012,1223,662,561,692837.25,586246.75,1279084.00
330475,202012,1563,412,1151,430540,1203840,1634380
330480,202012,825,441,384,460845.5,402325,863170.5
330490,202012,14793,4648,10145,4866666.25,10627653.05,15494319.30
330500,202012,1421,604,817,631180,853765.14,1484945.14
330510,202012,10882,3695,7187,3865458.15,7518775.5,11384233.65
330513,202012,97,49,48,51205,50160,101365
330515,202012,796,326,470,340671.25,491150.5,831821.75
330520,202012,2522,871,1651,911240.35,1726340,2637580.35
330530,202012,201,113,88,118085.25,91960,210045.25
330540,202012,362,179,183,187055.5,193325.5,380381.0
330550,202012,2958,1005,1953,1050226.24,2046110,3096336.24
330555,202012,800,311,489,324995,511005,836000
330560,202012,698,226,472,236170,494285,730455
330570,202012,271,194,77,202730,80465,283195
330575,202012,791,282,509,294690,531906.25,826596.25
330580,202012,3392,1868,1524,1952061.62,1592580.5,3544642.12
330590,202012,278,144,134,150480.92,142120,292600.92
330600,202012,1192,734,458,769121,478610,1247731
330610,202012,1578,842,736,880937.5,771210.75,1652148.25
330615,202012,216,168,48,175560,50160,225720
330620,202012,1086,408,678,427405,708510,1135915
330630,202012,4100,2502,1598,2618771.46,1674091.25,4292862.71
350010,202012,583,384,199,401281.47,210045,611326.47
350020,202012,55,21,34,21945,35530,57475
350030,202012,513,317,196,331265.5,204820.5,536086.0
350040,202012,126,52,74,54340.5,77330,131670.5
350050,202012,320,168,152,175560,159885,335445
350055,202012,99,49,50,51205,52250,103455
350060,202012,87,31,56,33440,58520,91960
350070,202012,779,454,325,474430.49,340671,815101.49
350075,202012,77,49,28,51205,29260,80465
350080,202012,60,27,33,28215,34485,62700
350090,202012,81,46,35,48070,36575,84645
350100,202012,282,171,111,179740,115995,295735
350110,202012,60,42,18,43890,18810,62700
350115,202012,140,86,54,89870,56430,146300
350120,202012,103,65,38,67925,39710,107635
350130,202012,371,162,209,169290.03,218405,387695.03
350140,202012,41,25,16,26125,16720,42845
350150,202012,76,57,19,59565,19855,79420
350160,202012,2419,941,1478,984390.75,1545555,2529945.75
350170,202012,390,221,169,230945.5,176605.5,407551.0
350180,202012,166,93,73,97185,76285.5,173470.5
350190,202012,986,516,470,541310.29,491150.5,1032460.79
350200,202012,70,26,44,27170,45980,73150
350210,202012,1302,713,589,746131,616550.29,1362681.29
350220,202012,659,540,119,564300.29,124355,688655.29
350230,202012,76,49,27,51205,29260,80465
350240,202012,60,43,17,44935,17765,62700
350250,202012,1167,548,619,573706.5,646856.25,1220562.75
350260,202012,95,68,27,71060,28215,99275
350270,202012,894,595,299,622821,313500.5,936321.5
350275,202012,289,119,170,124355,177650,302005
350280,202012,4546,2288,2258,2394099.92,2361700,4755799.92
350290,202012,456,202,254,212135,266475.5,478610.5
350300,202012,52,26,26,27170,27170,54340
350310,202012,81,51,30,53295,31350,84645
350315,202012,59,28,31,29260,32395,61655
350320,202012,3338,1611,1727,1683495.5,1805760.5,3489256.0
350330,202012,1658,877,781,917964.26,816145,1734109.26
350335,202012,17,12,5,12540,5225,17765
350340,202012,123,53,70,55385,73150.75,128535.75
350350,202012,93,46,47,48070,49115,97185
350360,202012,108,70,38,73150,39710,112860
350370,202012,83,47,36,49115.29,37620,86735.29
350380,202012,779,325,454,339625,474430.5,814055.5
350390,202012,1616,593,1023,619685.37,1070080,1689765.37
350395,202012,23,19,4,19855,4180,24035
350400,202012,1687,835,852,872578.12,891385.29,1763963.41
350410,202012,2771,1166,1605,1222650,1677244.29,2899894.29
350420,202012,252,151,101,158840.79,105545,264385.79
350430,202012,73,41,32,42845,34485,77330
350440,202012,152,109,43,113906,44935,158841
350450,202012,1690,974,716,1018875.56,749266,1768141.56
350460,202012,398,133,265,138985,277970,416955
350470,202012,20,11,9,11495,9405,20900
350480,202012,180,96,84,101365,89870,191235
350490,202012,238,112,126,117040,131670,248710
350500,202012,52,21,31,21945,33440,55385
350510,202012,168,108,60,112860,62700,175560
350520,202012,448,231,217,241395,226765,468160
350530,202012,438,200,238,209000,248710,457710
350535,202012,84,63,21,65835,21945,87780
350540,202012,373,189,184,197505,192280,389785
350550,202012,2671,1543,1128,1613480.83,1180851.08,2794331.91
350560,202012,605,414,191,433675,199595,633270
350570,202012,4181,1696,2485,1772321.29,2598916.35,4371237.64
350580,202012,369,180,189,188100,197505,385605
350590,202012,921,491,430,513095,450395,963490
350600,202012,6085,2869,3216,3001243.25,3364900.5,6366143.75
350610,202012,1502,774,728,809875.29,760760,1570635.29
350620,202012,28,18,10,18810,10450,29260
350630,202012,246,136,110,142120.29,114950.29,257070.58
350635,202012,975,379,596,396056.35,624910.5,1020966.85
350640,202012,117,89,28,93005,29260,122265
350650,202012,1872,1246,626,1303115.45,654170,1957285.45
350660,202012,746,309,437,322905,456665,779570
350670,202012,306,152,154,158840,160930,319770
350680,202012,175,89,86,93005,89871,182876
350690,202012,194,92,102,96140,107635,203775
350700,202012,805,381,424,399191.5,444125,843316.5
350710,202012,388,139,249,145255,261250,406505
350715,202012,55,44,11,45980,11495,57475
350720,202012,19,13,6,13585,6270,19855
350730,202012,46,29,17,30305,17765,48070
350740,202012,217,124,93,129580,97185,226765
350745,202012,23,8,15,8360,15675,24035
350750,202012,2224,1354,870,1414931.25,909150,2324081.25
350760,202012,3743,1567,2176,1639605.59,2276010,3915615.59
350770,202012,57,40,17,41800,17765,59565
350775,202012,40,28,12,29260,12540,41800
350780,202012,422,211,211,220495,220495,440990
350790,202012,363,150,213,156750,223630,380380
350800,202012,477,275,202,287375,212135,499510
350810,202012,515,410,105,428450.75,109725,538175.75
350820,202012,91,53,38,55385,40755,96140
350830,202012,76,40,36,41800,37620,79420
350840,202012,765,300,465,313500.5,485925,799425.5
350850,202012,1732,938,794,982300.5,830775.5,1813076.0
350860,202012,607,336,271,351120.75,283195,634315.75
350870,202012,436,287,149,299915,156750,456665
350880,202012,289,160,129,167200.25,134805.5,302005.75
350890,202012,41,25,16,26125,16720,42845
350900,202012,1483,452,1031,472340.75,1078440.29,1550781.04
350910,202012,29,16,13,16720,13585,30305
350920,202012,707,361,346,378290,364705,742995
350925,202012,1200,641,559,669846.45,584156.89,1254003.34
350930,202012,100,59,41,61655,42845,104500
350940,202012,726,393,333,411730,347985,759715
350945,202012,112,81,31,84645,32395,117040
350950,202012,16434,7531,8903,7877214.84,9317223.25,17194438.09
350960,202012,1434,625,809,655215,846450,1501665
350970,202012,1083,559,524,584044.19,547580.5,1131624.69
350980,202012,94,62,32,64790,33440,98230
350990,202012,373,134,239,140030,249755,389785
350995,202012,37,17,20,17765,20900,38665
351000,202012,633,427,206,447260.29,215270,662530.29
351010,202012,53,32,21,33440,21945,55385
351015,202012,49,33,16,34485,16720,51205
351020,202012,1570,942,628,984390.5,656260,1640650.5
351030,202012,337,211,126,220495,131670,352165
351040,202012,905,457,448,477565.95,469205.89,946771.84
351050,202012,3320,1483,1837,1549738.3,1920710.5,3470448.8
351060,202012,5321,1996,3325,2090210.7,3476715,5566925.7
351070,202012,399,254,145,266477.01,151525,418002.01
351080,202012,716,519,197,543400.5,205865,749265.5
351090,202012,53,24,29,25080,30305,55385
351100,202012,434,242,192,252890.7,200640,453530.7
351110,202012,2030,955,1075,997976.31,1125466,2123442.31
351120,202012,65,34,31,35530,33440,68970
351130,202012,182,59,123,61655,129580,191235
351140,202012,321,207,114,218405,119130,337535
351150,202012,443,230,213,240350.75,222585.5,462936.25
351160,202012,283,183,100,191236.13,104500,295736.13
351170,202012,186,97,89,101365,93005,194370
351190,202012,88,62,26,64790,27170,91960
351200,202012,361,235,126,245575.5,131670,377245.5
351210,202012,113,52,61,54340,64790,119130
351220,202012,528,314,214,328131.91,224675,552806.91
351230,202012,261,181,80,191235,83600,274835
351240,202012,241,111,130,115995,135850,251845
351250,202012,80,56,24,58520.57,25080,83600.57
351260,202012,150,109,41,113905,42845,156750
351270,202012,44,17,27,17765,28215,45980
351280,202012,1020,464,556,485925.29,583110.29,1069035.58
351290,202012,237,102,135,106590,141075,247665
351300,202012,3736,1624,2112,1696999.86,2210175.5,3907175.36
351310,202012,740,364,376,381425,393965,775390
351320,202012,113,64,49,66880,51205,118085
351330,202012,37,25,12,26125,12540,38665
351340,202012,1254,729,525,761805.5,549671,1311476.5
351350,202012,2352,1340,1012,1403436.79,1058585,2462021.79
351360,202012,779,370,409,386650,428450,815100
351370,202012,381,190,191,198550.5,199595,398145.5
351380,202012,8962,3955,5007,4136116.35,5236496.79,9372613.14
351385,202012,26,17,9,17765,9405,27170
351390,202012,278,208,70,217360.35,73150,290510.35
351400,202012,67,41,26,42845,27170,70015
351410,202012,428,267,161,279015.77,168245,447260.77
351420,202012,72,52,20,54340,20900,75240
351430,202012,71,39,32,40755,33440,74195
351440,202012,776,537,239,562212.33,250800,813012.33
351450,202012,263,127,136,132715,143165,275880
351460,202012,131,55,76,58520,79420,137940
351470,202012,141,78,63,81510,65835,147345
351480,202012,493,284,209,296780.79,218405,515185.79
351490,202012,287,105,182,109725,192280,302005
351492,202012,24,17,7,17765,7315,25080
351495,202012,26,18,8,18810,8360,27170
351500,202012,3523,1450,2073,1517340.5,2169421.9,3686762.4
351510,202012,1967,741,1226,774346.5,1282215.5,2056562.0
351512,202012,17,13,4,13585,4180,17765
351515,202012,181,105,76,109725,79420,189145
351518,202012,718,452,266,472340,277970,750310
351519,202012,79,45,34,47025,35530,82555
351520,202012,151,90,61,94050,63763.81,157813.81
351530,202012,25,14,11,14630,11495,26125
351535,202012,131,80,51,83600,54340,137940
351540,202012,467,329,138,343805.6,144210,488015.6
351550,202012,1401,814,587,850632.43,614460,1465092.43
351560,202012,72,41,31,42845,32395,75240
351565,202012,12,8,4,8360,4180,12540
351570,202012,2707,1288,1419,1345960.5,1484945,2830905.5
351580,202012,39,34,5,35530,5225,40755
351590,202012,56,35,21,36575,21945,58520
351600,202012,188,132,56,137940,58520,196460
351610,202012,47,22,25,22990,26125,49115
351620,202012,5823,3211,2612,3357589.4,2738945.75,6096535.15
351630,202012,2852,1380,1472,1443145.5,1539285,2982430.5
351640,202012,2025,898,1127,938410.52,1178760.79,2117171.31
351650,202012,29,25,4,26125,4180,30305
351660,202012,133,85,48,88825,50160,138985
351670,202012,705,438,267,457711.5,279015,736726.5
351680,202012,64,54,10,56430,10450,66880
351685,202012,13,10,3,10450,3135,13585
351690,202012,300,204,96,213180.37,100320,313500.37
351700,202012,166,112,54,117040.5,56430,173470.5
351710,202012,71,45,26,47025,27170,74195
351720,202012,133,75,58,78375,60610,138985
351730,202012,107,66,41,68970,42845,111815
351740,202012,713,452,261,473385.6,273790,747175.6
351750,202012,354,142,212,148390,221540,369930
351760,202012,754,576,178,601920,187055,788975
351770,202012,307,255,52,266475.29,55385,321860.29
351780,202012,163,96,67,101365,70015,171380
351790,202012,248,129,119,134805,124355.75,259160.75
351800,202012,38,24,14,25080,14630,39710
351810,202012,119,80,39,84645,40755,125400
351820,202012,808,582,226,608191.25,236170,844361.25
351830,202012,552,187,365,195415,381425,576840
351840,202012,1942,915,1027,959311.6,1074260,2033571.6
351850,202012,231,166,65,173470,67925,241395
351860,202012,640,444,196,463981.44,204820,668801.44
351870,202012,5545,2539,3006,2655348.54,3144360.55,5799709.09
351880,202012,19658,7801,11857,8159364.29,12406242.45,20565606.74
351885,202012,82,50,32,52250,33440,85690
351890,202012,69,54,15,56430,15675,72105
351900,202012,231,130,101,135850.85,105545,241395.85
351905,202012,83,33,50,34485,52250,86735
351907,202012,3475,1400,2075,1465090.85,2170465.5,3635556.35
351910,202012,176,72,104,75240,108680,183920
351920,202012,113,61,52,63745,54340,118085
351925,202012,88,57,31,59565,32395,91960
351930,202012,389,250,139,262295,145255,407550
351940,202012,236,100,136,104500,142120,246620
351950,202012,141,75,66,78375,68970,147345
351960,202012,918,451,467,472667.37,488015.5,960682.87
351970,202012,1942,1001,941,1047090.5,983345.5,2030436.0
351980,202012,160,71,89,74195,93005,167200
351990,202012,257,166,91,173471,95095,268566
352000,202012,333,213,120,223630.5,125400,349030.5
352010,202012,388,238,150,248777,156750,405527
352020,202012,179,71,108,74195,112860,187055
352030,202012,1094,548,546,572660,570570,1143230
352040,202012,566,236,330,246620,344850.5,591470.5
352042,202012,286,76,210,80465,219451,299916
352044,202012,355,217,138,227810.5,144210,372020.5
352050,202012,3213,1208,2005,1262361.64,2098361.85,3360723.49
352060,202012,103,61,42,63745,43890,107635
352070,202012,91,68,23,71060.58,24035,95095.58
352080,202012,64,41,23,42845,24035,66880
352090,202012,155,101,54,105545,56430,161975
352100,202012,288,138,150,144210,156750.5,300960.5
352110,202012,117,37,80,38665,83600,122265
352115,202012,61,21,40,21945,41800,63745
352120,202012,77,52,25,54340.29,26125,80465.29
352130,202012,221,183,38,191235,39710,230945
352140,202012,185,87,98,90915,102410,193325
352150,202012,116,60,56,62700,58520,121220
352160,202012,135,86,49,89870,51205,141075
352170,202012,384,258,126,270655,131670,402325
352180,202012,633,392,241,409640.29,251845.5,661485.79
352190,202012,242,98,144,102410,150480,252890
352200,202012,29,14,15,14630,15675,30305
352210,202012,4171,1675,2496,1752466.65,2610411,4362877.65
352215,202012,62,35,27,36575,28215,64790
352220,202012,6661,2453,4208,2563387,4400496.29,6963883.29
352230,202012,3308,2125,1183,2225851.66,1243551.62,3469403.28
352240,202012,2500,1428,1072,1493305.5,1125465.5,2618771.0
352250,202012,2803,1325,1478,1384626.58,1547645.5,2932272.08
352260,202012,991,521,470,544445,492195.5,1036640.5
352265,202012,55,27,28,28215,29260,57475
352270,202012,392,223,169,233035,176605.25,409640.25
352280,202012,462,276,186,288420.58,194370,482790.58
352290,202012,175,103,72,107635,75240,182875
352300,202012,96,66,30,68970,31350,100320
352310,202012,6482,2832,3650,2960486.19,3819475.8,6779961.99
352320,202012,1056,545,511,569525.5,535040,1104565.5
352330,202012,523,254,269,265430,281105,546535
352340,202012,1341,603,738,630137,771211.5,1401348.5
352350,202012,341,199,142,207955,148390.5,356345.5
352360,202012,220,96,124,100320,129580,229900
352370,202012,104,67,37,70015,38665,108680
352380,202012,111,73,38,76285,39710,115995
352390,202012,2511,1084,1427,1132781.09,1492261.3,2625042.39
352400,202012,500,218,282,227810,294690.5,522500.5
352410,202012,869,599,270,625955.79,283195,909150.79
352420,202012,95,67,28,70015,30305,100320
352430,202012,1754,793,961,829731.87,1005290.58,1835022.45
352440,202012,3232,1565,1667,1637516.6,1743060.5,3380577.1
352450,202012,201,161,40,168245,41800,210045
352460,202012,621,310,311,323950,324995,648945
352470,202012,651,220,431,229900.5,450395,680295.5
352480,202012,1414,774,640,808830,668800,1477630
352490,202012,65,21,44,21945,45980,67925
352500,202012,1229,511,718,535040.85,750310,1285350.85
352510,202012,711,375,336,391875.29,352165.5,744040.79
352520,202012,720,320,400,334540.03,418000,752540.03
352530,202012,1761,908,853,948860,892430.5,1841290.5
352540,202012,72,46,26,48070,28215,76285
352550,202012,194,115,79,120175,82555,202730
352560,202012,48,37,11,38665,11495,50160
352570,202012,696,341,355,356345.29,370975,727320.29
352580,202012,57,44,13,45980,13585,59565
352585,202012,20,6,14,6270,14630,20900
352590,202012,4363,2144,2219,2242570.79,2324080.5,4566651.29
352600,202012,345,244,101,254980,105545,360525
352610,202012,936,424,512,443080.67,535040,978120.67
352620,202012,1040,391,649,410685,679250,1089935
352630,202012,179,64,115,66880,120175,187055
352640,202012,515,339,176,354255,183920,538175
352650,202012,80,61,19,63745,20900,84645
352660,202012,63,37,26,38665,27170,65835
352670,202012,1677,872,805,912286.32,843315,1755601.32
352680,202012,923,567,356,592515,373065,965580
352690,202012,4516,2003,2513,2098362.09,2630265.29,4728627.38
352700,202012,103,59,44,61655,47025,108680
352710,202012,1403,727,676,760760,706420.5,1467180.5
352720,202012,1387,624,763,652080,798380.5,1450460.5
352725,202012,22,17,5,17765,5225,22990
352730,202012,379,184,195,192280,203775,396055
352740,202012,411,263,148,274836.4,154660.11,429496.51
352750,202012,19,13,6,13585,6270,19855
352760,202012,185,119,66,124355,68970,193325
352770,202012,88,65,23,67925,24035,91960
352780,202012,81,43,38,44935,39710,84645
352790,202012,26,20,6,20900,6270,27170
352800,202012,237,178,59,186010,62700,248710
352810,202012,155,97,58,101365,60610,161975
352820,202012,50,39,11,40755,11495,52250
352830,202012,76,51,25,53295,26125,79420
352840,202012,657,315,342,330220.25,360525,690745.25
352850,202012,1577,501,1076,525635,1124420,1650055
352860,202012,118,76,42,79420,43890,123310
352870,202012,46,30,16,31350,16720,48070
352880,202012,183,117,66,122265,68970,191235
352885,202012,32,21,11,21945,11495,33440
352890,202012,54,36,18,37620,18810.5,56430.5
352900,202012,4706,2252,2454,2357521.5,2565475.5,4922997.0
352910,202012,40,32,8,33440,8360,41800
352920,202012,651,386,265,404415,276925,681340
352930,202012,1235,591,644,617596,672980.25,1290576.25
352940,202012,6121,2468,3653,2583290.07,3820520.5,6403810.57
352950,202012,111,37,74,38665,78375,117040
352960,202012,60,37,23,38665,24035,62700
352965,202012,17,8,9,8360,9405,17765
352970,202012,513,393,120,410685.23,125400,536085.23
352980,202012,157,85,72,88825,75240,164065
352990,202012,983,455,528,475475,551760,1027235
353000,202012,57,24,33,25080,34485,59565
353010,202012,548,334,214,351120,223630,574750
353020,202012,304,219,85,228855,88825,317680
353030,202012,1270,569,701,594605.85,735680,1330285.85
353040,202012,92,54,38,57475,39710,97185
353050,202012,1311,851,460,889296.19,481745,1371041.19
353060,202012,8458,3588,4870,3754689.71,5091241,8845930.71
353070,202012,1766,1063,703,1110836.33,734448.99,1845285.32
353080,202012,1274,680,594,711645.47,621775,1333420.47
353090,202012,58,30,28,31350,29260,60610
353100,202012,48,38,10,39710,10450,50160
353110,202012,2092,635,1457,663575.5,1523610,2187185.5
353120,202012,98,47,51,49115,53295,102410
353130,202012,858,422,436,442035.41,455620,897655.41
353140,202012,546,218,328,227810.29,343805,571615.29
353150,202012,329,186,143,195415.29,149435,344850.29
353160,202012,94,73,21,76285,21945,98230
353170,202012,219,69,150,72105,156750,228855
353180,202012,1092,484,608,506825.75,635361.25,1142187.00
353190,202012,490,357,133,374110,138985,513095
353200,202012,222,104,118,108680,123310,231990
353205,202012,19,12,7,12540,7315,19855
353210,202012,70,39,31,40755,32395,73150
353215,202012,42,23,19,24035,19855,43890
353220,202012,75,42,33,43890,34485,78375
353230,202012,153,58,95,60610,99275,159885
353240,202012,324,164,160,171380,167200,338580
353250,202012,208,101,107,105545,111815,217360
353260,202012,459,313,146,327085.8,152570,479655.8
353270,202012,72,53,19,55385,19855,75240
353280,202012,99,47,52,49115,54340,103455
353282,202012,127,90,37,94050,40755,134805
353284,202012,26,19,7,19855,7315,27170
353286,202012,2,0,2,0,2090,2090
353290,202012,81,45,36,47025,37620,84645
353300,202012,440,229,211,240351.33,220495,460846.33
353310,202012,49,41,8,42845,8360,51205
353320,202012,36,20,16,20900,16720,37620
353325,202012,50,29,21,30305,21945.5,52250.5
353330,202012,60,42,18,43890.75,18810,62700.75
353340,202012,648,230,418,241395,436810,678205
353350,202012,894,423,471,442035,492195,934230
353360,202012,100,80,20,83600,20900,104500
353370,202012,109,62,47,64790,49115,113905
353380,202012,33,18,15,18810,15675,34485
353390,202012,1107,522,585,546535,611325.5,1157860.5
353400,202012,43,22,21,24035,21945,45980
353410,202012,109,64,45,66880,47025.25,113905.25
353420,202012,59,23,36,24035,37620,61655
353430,202012,569,379,190,396056.41,198550,594606.41
353440,202012,11230,4846,6384,5069297.44,6676506,11745803.44
353450,202012,55,29,26,30305,27170,57475
353460,202012,605,322,283,336490.25,295735,632225.25
353470,202012,2177,1114,1063,1165175.37,1110835.5,2276010.87
353475,202012,246,165,81,172425,85690,258115
353480,202012,184,152,32,158840,33440,192280
353490,202012,237,139,98,146300,103455.5,249755.5
353500,202012,205,117,88,122265,91960,214225
353510,202012,96,64,32,66880,33440,100320
353520,202012,205,144,61,150480,63745,214225
353530,202012,465,242,223,252890,233035,485925
353540,202012,382,247,135,259160,141075,400235
353550,202012,715,463,252,483836.47,263340,747176.47
353560,202012,584,231,353,242440,369930,612370
353570,202012,65,37,28,38665,29260,67925
353580,202012,348,249,99,260205.5,103455,363660.5
353590,202012,82,60,22,62700,22990,85690
353600,202012,272,158,114,165110.29,119130,284240.29
353610,202012,128,69,59,72105,61655,133760
353620,202012,626,322,304,336490.5,317680,654170.5
353625,202012,50,26,24,27170,25080,52250
353630,202012,230,164,66,171380.45,68970,240350.45
353640,202012,126,81,45,85690,47025,132715
353650,202012,944,351,593,366795,619685,986480
353657,202012,25,18,7,18810,7315,26125
353660,202012,270,142,128,148390,134805,283195
353670,202012,758,448,310,468160.79,323950.5,792111.29
353680,202012,108,79,29,82555.25,30305,112860.25
353690,202012,39,30,9,31350,9405,40755
353700,202012,274,190,84,198550,87780,286330
353710,202012,478,221,257,230945,268565.5,499510.5
353715,202012,50,32,18,34485,18810,53295
353720,202012,347,153,194,159885.5,202730,362615.5
353730,202012,1095,666,429,697015.5,449350,1146365.5
353740,202012,610,334,276,349031.25,288420.75,637452.00
353750,202012,76,45,31,47025,33440,80465
353760,202012,3017,1129,1888,1180851.15,1974006.65,3154857.80
353770,202012,85,67,18,70015,18810,88825
353780,202012,1262,584,678,612370.79,709555,1321925.79
353790,202012,495,300,195,314546.4,204820,519366.4
353800,202012,3439,1637,1802,1711730.5,1886296.5,3598027.0
353810,202012,233,127,106,132715,110770,243485
353820,202012,208,89,119,93005,124355,217360
353830,202012,52,45,7,47025,7315,54340
353850,202012,175,83,92,86735,96140,182875
353860,202012,510,217,293,226765,306185,532950
353870,202012,5403,2684,2719,2805828.75,2849716.75,5655545.50
353880,202012,684,467,217,488015,226765,714780
353890,202012,542,313,229,327085.5,239305.61,566391.11
353900,202012,134,69,65,72105,67925,140030
353910,202012,178,78,100,81510,104500,186010
353920,202012,419,233,186,244530.75,194370,438900.75
353930,202012,1021,596,425,623865,446216.1,1070081.1
353940,202012,193,95,98,99275,102410,201685
353950,202012,504,310,194,323950,203775,527725
353960,202012,77,63,14,65835,14630,80465
353970,202012,43,28,15,29260,15675,44935
353980,202012,1695,763,932,797335,974985,1772320
353990,202012,74,44,30,45980,31350,77330
354000,202012,383,180,203,188100,212135,400235
354010,202012,87,50,37,52250,38665.5,90915.5
354020,202012,505,316,189,331265,197505,528770
354025,202012,38,33,5,34485,5225,39710
354030,202012,52,31,21,32395,21945,54340
354040,202012,98,74,24,77330,25080,102410
354050,202012,174,98,76,102410.79,79420,181830.79
354060,202012,758,364,394,381425,412775,794200
354070,202012,907,507,400,529815.5,418000,947815.5
354075,202012,183,84,99,87780,103455,191235
354080,202012,312,132,180,137940,188100,326040
354085,202012,20,13,7,13585,7315,20900
354090,202012,285,166,119,174427,124355,298782
354100,202012,5553,2228,3325,2330352.03,3478807.35,5809159.38
354105,202012,95,44,51,45980,53295,99275
354110,202012,46,22,24,22990,25080,48070
354120,202012,140,97,43,101365,44935,146300
354130,202012,714,441,273,460845,286330,747175
354140,202012,3182,1455,1727,1521521.52,1809940.5,3331462.02
354150,202012,636,376,260,392920.87,271700,664620.87
354160,202012,644,408,236,426360.5,247666.39,674026.89
354165,202012,17,14,3,14630,3135,17765
354170,202012,167,113,54,118085,56430,174515
354180,202012,57,35,22,36575.59,22990,59565.59
354190,202012,189,77,112,80465,117040,197505
354200,202012,108,56,52,59565,54340,113905
354210,202012,60,23,37,24035,38665,62700
354220,202012,654,413,241,432630.29,251845,684475.29
354230,202012,167,69,98,72105,102410,174515
354240,202012,335,213,122,222585.62,127490,350075.62
354250,202012,82,51,31,53295,32395,85690
354260,202012,2089,982,1107,1026191.82,1159951.6,2186143.42
354270,202012,86,63,23,65835,24035,89870
354280,202012,45,22,23,22990,24035,47025
354290,202012,139,97,42,101365,43890,145255
354300,202012,368,258,110,269610.29,115995,385605.29
354310,202012,87,66,21,68970.5,21945,90915.5
354320,202012,208,103,105,107635,109725,217360
354323,202012,11,10,1,10450,1045,11495
354325,202012,118,68,50,71060.83,52250,123310.83
354330,202012,2406,799,1607,835851.5,1682450.75,2518302.25
354340,202012,10305,4850,5455,5072212.09,5703614,10775826.09
354350,202012,138,89,49,93005,51205,144210
354360,202012,67,36,31,37620,32395,70015
354370,202012,237,124,113,130625,118085,248710
354380,202012,180,109,71,113905,74195,188100
354390,202012,2678,964,1714,1008425,1794265,2802690
354400,202012,298,164,134,172425,140030,312455
354410,202012,615,290,325,303051.6,339625.5,642677.1
354420,202012,268,172,96,179740,101365,281105
354425,202012,304,176,128,186059,133760,319819
354430,202012,187,105,82,109725,85690,195415
354440,202012,33,25,8,26125,8360,34485
354450,202012,52,34,18,35530,18810,54340
354460,202012,102,57,45,59565,47025,106590
354470,202012,33,18,15,18810,15675,34485
354480,202012,116,62,54,64790,56430,121220
354490,202012,142,86,56,89870,58520,148390
354500,202012,392,181,211,189145,220495,409640
354510,202012,93,64,29,66880,30305,97185
354515,202012,36,10,26,10450,27170,37620
354520,202012,1596,678,918,708361.75,959310.5,1667672.25
354530,202012,785,388,397,405460.5,414865,820325.5
354540,202012,264,138,126,144210,131670,275880
354550,202012,36,23,13,24035,13585,37620
354560,202012,149,75,74,78375,77330,155705
354570,202012,130,86,44,89870,45980,135850
354580,202012,1827,848,979,887207,1025145.5,1912352.5
354600,202012,257,136,121,142120,126445,268565
354610,202012,73,62,11,64790.15,11495,76285.15
354620,202012,60,14,46,14630,48070,62700
354625,202012,15,9,6,9405,6270,15675
354630,202012,297,192,105,200640,109725,310365
354640,202012,801,508,293,530860.75,307230,838090.75
354650,202012,67,39,28,40755,29260,70015
354660,202012,785,579,206,607145.54,215270,822415.54
354670,202012,235,89,146,93005,152570,245575
354680,202012,1277,463,814,483835,851675.68,1335510.68
354690,202012,82,55,27,57475.5,28215,85690.5
354700,202012,68,48,20,50160,20900,71060
354710,202012,46,32,14,33440,14630,48070
354720,202012,19,19,0,19855,0,19855
354730,202012,1731,715,1016,749265.55,1062765.5,1812031.05
354740,202012,77,52,25,54340,26125,80465
354750,202012,420,244,176,254980,183920,438900
354760,202012,460,274,186,286331.25,194370.5,480701.75
354765,202012,10,5,5,5225,5225,10450
354770,202012,347,225,122,235125,128535,363660
354780,202012,8176,3168,5008,3313699.21,5242766.2,8556465.41
354790,202012,92,52,40,54340,41800,96140
354800,202012,446,240,206,250708.68,216315,467023.68
354805,202012,89,40,49,41800.5,51205,93005.5
354810,202012,106,63,43,65835,44935,110770
354820,202012,209,82,127,85690.9,132715,218405.9
354830,202012,41,21,20,21945,20900,42845
354840,202012,55,38,17,39710,17765,57475
354850,202012,4467,1941,2526,2031481.73,2641761.83,4673243.56
354860,202012,329,157,172,164065,179740.04,343805.04
354870,202012,11955,5262,6693,5505065.53,7001502.25,12506567.78
354880,202012,2728,1003,1725,1050225.88,1805761.65,2855987.53
354890,202012,2905,1545,1360,1615571.75,1421200,3036771.75
354900,202012,62,42,20,43890,20900,64790
354910,202012,1251,635,616,664621,643720,1308341
354920,202012,40,32,8,33440,8360,41800
354925,202012,16,7,9,7315,9405,16720
354930,202012,36,32,4,33440.78,4180,37620.78
354940,202012,786,566,220,591732.75,229900,821632.75
354950,202012,199,127,72,132715.25,75240,207955.25
354960,202012,143,54,89,56430,93005,149435
354970,202012,987,654,333,683432.43,350075.5,1033507.93
354980,202012,8729,3089,5640,3233233.45,5901116.02,9134349.47
354990,202012,9398,4223,5175,4417218.5,5414145.5,9831364.0
354995,202012,544,173,371,180785,387695,568480
355000,202012,459,156,303,163020,316635,479655
355010,202012,590,358,232,374110.5,243485.29,617595.79
355020,202012,776,480,296,501600,309320.5,810920.5
355030,202012,207957,78541,129416,82154538.55,135369376.65,217523915.20
355040,202012,785,348,437,363660.5,456665,820325.5
355050,202012,153,89,64,93005,66880,159885
355060,202012,1636,807,829,845406.5,866305,1711711.5
355070,202012,1462,689,773,721050.77,807785.33,1528836.10
355080,202012,191,117,74,122265,77330,199595
355090,202012,288,167,121,174515,126445.19,300960.19
355100,202012,5016,2365,2651,2473414.54,2775520.5,5248935.04
355110,202012,238,160,78,168245,81510,249755
355120,202012,58,37,21,38665,21945,60610
355130,202012,47,26,21,27170,21945,49115
355140,202012,177,106,71,110770,74195,184965
355150,202012,668,388,280,405460.5,292600,698060.5
355160,202012,473,224,249,235125.29,260205.5,495330.79
355170,202012,2036,1050,986,1098295.4,1033505,2131800.4
355180,202012,687,284,403,296780,421135,717915
355190,202012,206,137,69,144210,72105,216315
355200,202012,110,62,48,64790,51205,115995
355210,202012,692,383,309,400235,322905,723140
355220,202012,7193,3622,3571,3788129,3736923,7525052
355230,202012,99,61,38,63745,39710,103455
355240,202012,4436,1804,2632,1887272.16,2753575,4640847.16
355250,202012,5861,2561,3300,2678355.39,3454770.25,6133125.64
355255,202012,50,28,22,29260,22990,52250
355260,202012,179,111,68,115995.5,71060,187055.5
355270,202012,168,106,62,110770,64790,175560
355280,202012,6435,2469,3966,2581152,4147605.5,6728757.5
355290,202012,77,62,15,64790,15675,80465
355300,202012,193,112,81,118085,84645,202730
355310,202012,109,57,52,60610,54340,114950
355320,202012,90,48,42,50160.75,43890,94050.75
355330,202012,280,160,120,167200,125400,292600
355340,202012,1456,505,951,529816.27,996930,1526746.27
355350,202012,143,67,76,70015,79420,149435
355360,202012,167,109,58,113905,60610,174515
355365,202012,20,16,4,16720,4180,20900
355370,202012,1037,613,424,641630.29,443080,1084710.29
355380,202012,827,517,310,542355.5,326040,868395.5
355385,202012,73,48,25,50160,26125,76285
355390,202012,109,60,49,62700,51205,113905
355395,202012,194,106,88,111815.92,91960,203775.92
355400,202012,1701,1001,700,1045961.55,731500.29,1777461.84
355410,202012,4875,2253,2622,2357523.25,2743125.25,5100648.50
355420,202012,47,33,14,34485,14630,49115
355430,202012,388,238,150,248710.5,156750,405460.5
355440,202012,87,50,37,53295,38665,91960
355450,202012,450,221,229,230946.2,240350,471296.2
355460,202012,63,47,16,50160.35,16720,66880.35
355465,202012,45,26,19,27170,19855,47025
355470,202012,176,73,103,76285.75,107635,183920.75
355475,202012,11,7,4,7315,4180,11495
355480,202012,534,214,320,223630,334400,558030
355490,202012,117,82,35,85690,36575,122265
355495,202012,65,24,41,25080,42845,67925
355500,202012,1563,859,704,898702.05,735680.5,1634382.55
355510,202012,270,196,74,204820.29,77330,282150.29
355520,202012,31,23,8,24035,8360,32395
355530,202012,21,12,9,12540,9405,21945
355535,202012,74,33,41,34485,42845,77330
355540,202012,2496,967,1529,1010662.84,1597805.79,2608468.63
355550,202012,59,37,22,38665,22990,61655
355560,202012,248,115,133,120175,138985,259160
355570,202012,22,14,8,14630,8360,22990
355580,202012,242,173,69,181830,72105.5,253935.5
355590,202012,16,10,6,10450,6270,16720
355600,202012,268,135,133,141075,138985,280060
355610,202012,228,153,75,159885,78375,238260
355620,202012,1316,579,737,605055.5,770165,1375220.5
355630,202012,426,311,115,324995,120175.29,445170.29
355635,202012,114,53,61,55385,63745,119130
355640,202012,551,308,243,322905,253935,576840
355645,202012,853,330,523,344850,546536,891386
355650,202012,1956,818,1138,856901.35,1190255,2047156.35
355660,202012,245,130,115,135850,120175,256025
355670,202012,578,238,340,248710,355300,604010
355680,202012,205,115,90,120175,94050,214225
355690,202012,91,41,50,42845,52250.66,95095.66
355695,202012,21,13,8,13585,8360,21945
355700,202012,1133,583,550,609235.65,575796,1185031.65
355710,202012,2210,1192,1018,1245640.5,1064855.5,2310496.0
355715,202012,12,10,2,10450,2090,12540
355720,202012,234,139,95,145255.6,99275,244530.6
355730,202012,100,58,42,60610,44935,105545
410010,202012,130,106,24,110770,25080,135850
410020,202012,113,87,26,90915,27170,118085
410030,202012,169,94,75,98230,78375,176605
410040,202012,1201,591,610,618640,637450,1256090
410045,202012,38,29,9,30305,9405,39710
410050,202012,476,268,208,280060,217360,497420
410060,202012,281,207,74,216315,77330,293645
410070,202012,293,243,50,253935,52250,306185
410080,202012,170,105,65,109725,67925,177650
410090,202012,76,66,10,68970.9,10450,79420.9
410100,202012,286,199,87,209000,90915,299915
410105,202012,46,28,18,29260,18810,48070
410110,202012,334,198,136,206910,142120,349030
410115,202012,35,23,12,24035,12540,36575
410120,202012,420,204,216,213180,225720,438900
410130,202012,52,32,20,33440,20900,54340
410140,202012,3127,1475,1652,1545557.67,1727388.83,3272946.50
410150,202012,2674,1028,1646,1074261.35,1720071,2794332.35
410160,202012,509,311,198,326040,207955,533995
410165,202012,58,37,21,38665,21945,60610
410170,202012,176,112,64,117040,66880,183920
410180,202012,2246,1243,1003,1298935,1049180,2348115
410185,202012,32,28,4,29260,4180,33440
410190,202012,498,312,186,326040,195415,521455
410200,202012,936,670,266,701195,277970,979165
410210,202012,612,307,305,320815,318725,639540
410220,202012,45,21,24,21945,25080,47025
410230,202012,148,70,78,73150,81510,154660
410240,202012,737,471,266,492195,277970,770165
410250,202012,375,267,108,280060,112860,392920
410260,202012,299,165,134,172425,140030.5,312455.5
410270,202012,28,21,7,21945,7315,29260
410275,202012,53,41,12,42845,12540,55385
410280,202012,321,181,140,189145,146300,335445
410290,202012,249,149,100,155705,104500,260205
410300,202012,80,57,23,59565,24035,83600
410302,202012,22,14,8,14630,8360,22990
410304,202012,38,25,13,26125,13585,39710
410305,202012,210,108,102,112860,106590,219450
410310,202012,217,127,90,132715,94050,226765
410315,202012,48,34,14,35530,14630,50160
410320,202012,138,95,43,99275,44935,144210
410322,202012,32,21,11,21945,11495,33440
410330,202012,181,123,58,128535,60610,189145
410335,202012,103,57,46,59565,48070,107635
410337,202012,44,33,11,34485,11495,45980
410340,202012,39,32,7,33440,7315,40755
410345,202012,208,117,91,122265,95095,217360
410347,202012,46,35,11,36575,11495,48070
410350,202012,236,141,95,147345,99275,246620
410360,202012,459,288,171,303050.5,178696,481746.5
410370,202012,2311,954,1357,997975.45,1419111.35,2417086.80
410380,202012,208,130,78,135850,81510,217360
410390,202012,382,262,120,273790,125400,399190
410395,202012,33,20,13,20900,13585,34485
410400,202012,836,372,464,388740.27,484880,873620.27
410405,202012,88,65,23,67925,24035,91960
410410,202012,29,21,8,21945,8360,30305
410420,202012,1691,791,900,827546.99,941545.85,1769092.84
410425,202012,178,72,106,75240,110770,186010
410430,202012,2310,1251,1059,1307295,1107701.15,2414996.15
410440,202012,379,275,104,287375,108680,396055
410442,202012,356,232,124,242440,130625,373065
410445,202012,427,301,126,314545,132715,447260
410450,202012,398,197,201,205865,211090,416955
410460,202012,522,260,262,272745,273790,546535
410465,202012,227,134,93,140030,97185,237215
410470,202012,244,142,102,150480,106590,257070
410480,202012,6245,2948,3297,3085888.75,3446412.25,6532301.00
410490,202012,1414,843,571,881980.51,597740.5,1479721.01
410500,202012,267,150,117,156750,122265,279015
410510,202012,167,123,44,128535,45980,174515
410520,202012,249,183,66,192280,68970,261250
410530,202012,307,104,203,108680,212135,320815
410540,202012,323,237,86,247665,90915,338580
410550,202012,1687,711,976,744040.2,1019920.5,1763960.7
410560,202012,149,104,45,108680,47025,155705
410570,202012,429,287,142,299916.3,149435,449351.3
410580,202012,3468,1474,1994,1541377.08,2085820.54,3627197.62
410590,202012,397,265,132,276907,140030,416937
410600,202012,191,163,28,170335,29260,199595
410610,202012,51,42,9,43890,9405,53295
410620,202012,247,164,83,171380.03,86735,258115.03
410630,202012,436,243,193,253935,203775,457710
410640,202012,1018,641,377,670890.75,393965,1064855.75
410645,202012,109,78,31,81510,32395,113905
410650,202012,359,230,129,240350,134805,375155
410655,202012,91,64,27,66880,28215,95095
410657,202012,28,10,18,10450,18810,29260
410660,202012,601,412,189,430540.52,197505,628045.52
410670,202012,72,60,12,62700,12540,75240
410680,202012,210,165,45,172425,47025,219450
410685,202012,18,11,7,11495,7315,18810
410690,202012,28473,11844,16629,12387434.54,17397164.69,29784599.23
410700,202012,320,236,84,246620,87780,334400
410710,202012,128,102,26,106590,27170,133760
410712,202012,38,27,11,28215,11495,39710
410715,202012,86,63,23,65835,24035,89870
410720,202012,683,380,303,398145,316635,714780
410725,202012,180,129,51,134805,53295,188100
410730,202012,97,46,51,48070,53295,101365
410740,202012,105,75,30,78375,31350,109725
410750,202012,264,174,90,181830,94050,275880
410752,202012,25,15,10,15675,10450,26125
410753,202012,57,23,34,24035,35530,59565
410754,202012,51,26,25,27170.5,26125,53295.5
410755,202012,85,50,35,52250,36575,88825
410760,202012,767,417,350,435765.5,365750,801515.5
410765,202012,1790,806,984,842270.5,1028281.5,1870552.0
410770,202012,109,82,27,85690,28215,113905
410773,202012,57,40,17,41800,17765,59565
410775,202012,185,138,47,144210,49115,193325
410780,202012,86,47,39,49115,40755,89870
410785,202012,54,42,12,43890,12540,56430
410790,202012,81,36,45,37620,47025,84645
410800,202012,285,176,109,183920,113905.5,297825.5
410810,202012,24,16,8,16720,8360.5,25080.5
410820,202012,174,126,48,131670,50160,181830
410830,202012,8584,3647,4937,3816341.78,5162300.5,8978642.28
410832,202012,104,70,34,73150,35530,108680
410840,202012,1466,780,686,818236.44,717915.25,1536151.69
410845,202012,51,32,19,33440,19855,53295
410850,202012,185,131,54,136895,56430,193325
410855,202012,62,50,12,52250,12540,64790
410860,202012,745,395,350,412775.5,365750,778525.5
410865,202012,102,74,28,77330,29260,106590
410870,202012,156,133,23,138985,24035,163020
410880,202012,1124,562,562,587290.5,588335,1175625.5
410890,202012,88,62,26,64790,27170,91960
410895,202012,73,55,18,57475,19855,77330
410900,202012,23,17,6,17765,6270,24035
410910,202012,18,13,5,13585,5225,18810
410920,202012,36,24,12,25080,12540,37620
410930,202012,535,330,205,344850,215270,560120
410940,202012,4392,2406,1986,2517406.57,2079550.5,4596957.07
410950,202012,106,76,30,79420,31350,110770
410960,202012,838,337,501,354255.5,523545,877800.5
410965,202012,64,44,20,45980,20900,66880
410970,202012,626,439,187,458755,195415,654170
410975,202012,126,77,49,80465.16,51205,131670.16
410980,202012,1629,720,909,752400.5,953040,1705440.5
410990,202012,269,190,79,198550,82555,281105
411000,202012,66,39,27,40755,28215.5,68970.5
411005,202012,29,24,5,25080,5225,30305
411007,202012,255,146,109,153615,114950,268565
411010,202012,609,405,204,423225,213180,636405
411020,202012,283,188,95,196460.25,99275,295735.25
411030,202012,19,10,9,10450,9405,19855
411040,202012,55,37,18,38665,18810,57475
411050,202012,210,158,52,165110,54340,219450
411060,202012,516,344,172,359480,179740,539220
411065,202012,52,46,6,48070,6270,54340
411070,202012,1256,747,509,780615,531905,1312520
411080,202012,240,170,70,177650,73150,250800
411090,202012,97,75,22,78375,22990,101365
411095,202012,285,107,178,111815,186010,297825
411100,202012,118,96,22,100320,22990,123310
411110,202012,130,77,53,80465,55385,135850
411120,202012,216,144,72,150480,75240,225720
411125,202012,242,101,141,105545,147345,252890
411130,202012,128,108,20,112860,20900,133760
411140,202012,212,139,73,145255,76285,221540
411150,202012,1231,799,432,834955,451440.54,1286395.54
411155,202012,117,79,38,82555,39710,122265
411160,202012,25,10,15,10450,15675,26125
411170,202012,52,46,6,48070,6270,54340
411180,202012,962,632,330,660440,346940,1007380
411190,202012,334,190,144,199595,150480,350075
411200,202012,674,403,271,421135.29,283195,704330.29
411210,202012,681,356,325,373065,339625.5,712690.5
411220,202012,156,109,47,113905,49115,163020
411230,202012,40,33,7,34485,7315,41800
411240,202012,115,72,43,75240,44935,120175
411250,202012,431,311,120,324995,125400,450395
411260,202012,16,11,5,11495,5225,16720
411270,202012,269,143,126,149435,131670,281105
411275,202012,176,154,22,160930,22990,183920
411280,202012,210,147,63,153615.29,65835,219450.29
411290,202012,63,48,15,50160,15675,65835
411295,202012,135,106,29,110770,30305,141075
411300,202012,83,36,47,37620,49115,86735
411310,202012,88,66,22,68970,22990,91960
411320,202012,795,520,275,543400,287375,830775
411325,202012,61,41,20,42845,20900,63745
411330,202012,912,580,332,606100.5,346940.99,953041.49
411340,202012,29,19,10,19855,10450,30305
411342,202012,63,47,16,50160,16720,66880
411345,202012,120,59,61,61655,63745,125400
411350,202012,479,360,119,376200.45,124355.5,500555.95
411360,202012,55,36,19,37620,19855,57475
411370,202012,14245,5690,8555,5953370.77,8948337.86,14901708.63
411373,202012,173,120,53,125400,55385,180785
411375,202012,81,64,17,66880,17765,84645
411380,202012,86,61,25,63745,26125,89870
411390,202012,131,77,54,80465,57475,137940
411400,202012,385,274,111,286330,115995,402325
411410,202012,459,220,239,229900,249755.5,479655.5
411420,202012,993,428,565,447260.35,591470.5,1038730.85
411430,202012,474,266,208,277970,217360,495330
411435,202012,31,19,12,19855,12540,32395
411440,202012,457,357,100,373065,104500,477565
411450,202012,425,358,67,374110,70015,444125
411460,202012,768,283,485,295735,506825.57,802560.57
411470,202012,94,64,30,66880,31350,98230
411480,202012,670,365,305,381425.5,319770,701195.5
411490,202012,292,186,106,194370,110770,305140
411500,202012,99,81,18,84645,18810,103455
411510,202012,218,175,43,183920,44935,228855
411520,202012,6040,2227,3813,2327216,3991902.01,6319118.01
411530,202012,129,86,43,89870,44935,134805
411535,202012,52,20,32,20900,33440,54340
411540,202012,351,238,113,249755,118085,367840
411545,202012,55,39,16,40755,16720,57475
411550,202012,83,64,19,66880,19855,86735
411560,202012,397,167,230,174515,240350,414865
411570,202012,870,302,568,315590.2,595650,911240.2
411573,202012,23,14,9,14630,9405,24035
411575,202012,298,182,116,190190,121220,311410
411580,202012,1264,450,814,470564.35,851675,1322239.35
411585,202012,76,37,39,38665,40755,79420
411590,202012,20,13,7,13585,7315,20900
411600,202012,24,10,14,10450,14630,25080
411605,202012,237,96,141,100320,148390,248710
411610,202012,206,133,73,138985,76285,215270
411620,202012,375,198,177,206910,184965,391875
411630,202012,55,37,18,38665,18810,57475
411640,202012,33,23,10,24035,10450,34485
411650,202012,12,7,5,7315,5225,12540
411660,202012,38,26,12,27170,12540,39710
411670,202012,238,173,65,180785,68970,249755
411680,202012,166,135,31,141075,32395,173470
411690,202012,583,307,276,320815,288420,609235
411695,202012,63,44,19,45980,19855,65835
411700,202012,143,115,28,120175,30305,150480
411705,202012,106,70,36,73150,37620,110770
411710,202012,295,197,98,205865,102410,308275
411720,202012,133,88,45,91960,47025,138985
411721,202012,69,57,12,59565,12540,72105
411722,202012,105,45,60,48070,62700,110770
411725,202012,155,116,39,121220.5,40755,161975.5
411727,202012,84,64,20,66880,20900,87780
411729,202012,40,32,8,33440,8360,41800
411730,202012,558,348,210,363660,219450,583110
411740,202012,36,21,15,21945,15675,37620
411745,202012,69,50,19,52250,19855,72105
411750,202012,849,369,480,385605.5,503690,889295.5
411760,202012,1173,864,309,902880.6,323950,1226830.6
411770,202012,456,297,159,310365,167200,477565
411780,202012,348,224,124,234080,129580,363660
411790,202012,526,293,233,306185.22,243485,549670.22
411800,202012,156,117,39,122265.96,40755,163020.96
411810,202012,173,129,44,134805,45980,180785
411820,202012,2246,971,1275,1014696.7,1334465,2349161.7
411830,202012,10,9,1,9405,1045,10450
411840,202012,2037,1231,806,1286395,842271,2128666
411845,202012,54,19,35,19855,37620,57475
411850,202012,1215,660,555,690745.5,579975.75,1270721.25
411860,202012,49,31,18,32395.5,18810,51205.5
411870,202012,73,47,26,49115,27170,76285
411880,202012,423,265,158,276925,165110,442035
411885,202012,100,64,36,67925,37620,105545
411890,202012,306,196,110,205866.49,114950,320816.49
411900,202012,79,61,18,63745.5,18810,82555.5
411910,202012,183,143,40,149435,41800,191235
411915,202012,2218,887,1331,927960.5,1394030.05,2321990.55
411920,202012,122,97,25,101365,26125,127490
411925,202012,12,7,5,7315,5225,12540
411930,202012,800,570,230,595717.73,240350,836067.73
411940,202012,584,389,195,407550.85,203775,611325.85
411950,202012,1035,483,552,505780.76,577885,1083665.76
411960,202012,1068,706,362,737770.75,378290,1116060.75
411965,202012,19,12,7,12540,7315,19855
411970,202012,89,78,11,81510,11495,93005
411980,202012,169,107,62,111815,64790,176605
411990,202012,5137,2885,2252,3014831.64,2353409.75,5368241.39
411995,202012,524,168,356,175560,372020,547580
412000,202012,319,203,116,212135,121220,333355
412010,202012,43,27,16,28215,16720,44935
412015,202012,42,30,12,31350,12540,43890
412020,202012,31,24,7,25080,7315,32395
412030,202012,45,43,2,44935,2090,47025
412033,202012,53,29,24,30305,25080,55385
412035,202012,71,44,27,45980,28215,74195
412040,202012,44,25,19,26125.5,19855,45980.5
412050,202012,209,156,53,163020,55385,218405
412060,202012,781,567,214,593560,224675,818235
412065,202012,51,31,20,32395,20900,53295
412070,202012,162,109,53,113905,55385,169290
412080,202012,297,146,151,152570,157795,310365
412085,202012,40,17,23,17765,24035,41800
412090,202012,805,506,299,529815.25,313500,843315.25
412100,202012,244,204,40,213180,41800,254980
412110,202012,73,56,17,58520,17765,76285
412120,202012,325,191,134,199595,140030,339625
412125,202012,78,48,30,50160,31350,81510
412130,202012,37,24,13,25080.4,13585,38665.4
412135,202012,29,16,13,16720,13585,30305
412140,202012,352,223,129,233035.5,134805,367840.5
412150,202012,251,167,84,174515,88825,263340
412160,202012,90,51,39,53295,40755,94050
412170,202012,700,476,224,497420.5,234080,731500.5
412175,202012,36,26,10,27170,10450,37620
412180,202012,190,144,46,150480,48070,198550
412190,202012,325,257,68,268565,71060,339625
412200,202012,186,120,66,126445,68970,195415
412210,202012,74,56,18,58520,18810,77330
412215,202012,233,164,69,171687.23,72105,243792.23
412217,202012,64,52,12,54340,12540,66880
412220,202012,831,576,255,601920,266475,868395
412230,202012,319,196,123,204820,129580,334400
412240,202012,1339,648,691,678205.75,723140,1401345.75
412250,202012,409,250,159,261250,166155,427405
412260,202012,108,76,32,79420,33440,112860
412265,202012,176,134,42,140030,43890,183920
412270,202012,84,58,26,60610,27170,87780
412280,202012,88,70,18,73150,18810,91960
412290,202012,95,64,31,66880,32395,99275
412300,202012,206,137,69,143165,72105,215270
412310,202012,53,43,10,44935,10450,55385
412320,202012,96,78,18,81510,18810,100320
412330,202012,182,153,29,160930,30305,191235
412340,202012,157,111,46,115995,48070.5,164065.5
412350,202012,621,303,318,317680,332310,649990
412360,202012,26,22,4,22990,4180,27170
412370,202012,162,140,22,146300.5,22990,169290.5
412380,202012,257,196,61,204820,63745,268565
412382,202012,58,33,25,34485,26125,60610
412385,202012,150,104,46,108680,48070,156750
412390,202012,280,211,69,220495,72105,292600
412395,202012,66,54,12,56430,12540,68970
412400,202012,95,64,31,66880,32395,99275
412402,202012,232,115,117,120175.5,122265,242440.5
412405,202012,883,306,577,319770,604010,923780
412410,202012,967,587,380,614461,397100,1011561
412420,202012,13,12,1,12540,1045,13585
412430,202012,20,17,3,17765,3135,20900
412440,202012,614,324,290,338580,304095,642675
412450,202012,76,66,10,68970,10450,79420
412460,202012,94,72,22,75240,22990,98230
412470,202012,219,173,46,180785,48070,228855
412480,202012,142,102,40,106590.75,41800,148390.75
412490,202012,156,138,18,144210,18810,163020
412500,202012,431,347,84,362615.56,87780,450395.56
412510,202012,176,141,35,147345,36575,183920
412520,202012,91,61,30,63745,31350,95095
412530,202012,106,55,51,57475,53295,110770
412535,202012,92,67,25,70015,26125,96140
412540,202012,81,38,43,39710,44935,84645
412545,202012,88,59,29,61655,30305,91960
412550,202012,3834,1569,2265,1639606.02,2366927,4006533.02
412555,202012,10,6,4,6270,4180,10450
412560,202012,619,427,192,446878.33,200640.5,647518.83
412570,202012,756,376,380,393965,397100,791065
412575,202012,91,62,29,64790,30305,95095
412580,202012,177,118,59,124355,61655,186010
412590,202012,36,31,5,32395,5225,37620
412600,202012,175,126,49,131670.85,51205,182875.85
412610,202012,35,16,19,16720,19855,36575
412620,202012,142,119,23,124355,24035,148390
412625,202012,2118,1094,1024,1145320.54,1070081.35,2215401.89
412627,202012,68,50,18,52250,18810,71060
412630,202012,394,260,134,272745,140030,412775
412635,202012,65,18,47,18810,49115,67925
412640,202012,101,72,29,76285,30305,106590
412650,202012,326,212,114,222585,119130,341715
412660,202012,463,277,186,289465,194370,483835
412665,202012,44,40,4,41800,4180,45980
412667,202012,298,199,99,207955,103455,311410
412670,202012,62,50,12,52250,12540,64790
412680,202012,296,228,68,238260,71060.7,309320.7
412690,202012,110,70,40,73150,41800,114950
412700,202012,167,112,55,117040,57475,174515
412710,202012,1367,806,561,845406.25,589380,1434786.25
412720,202012,229,141,88,147345,91960,239305
412730,202012,186,157,29,164065,30305,194370
412740,202012,421,215,206,225720,215270,440990
412750,202012,426,240,186,250800,195415.5,446215.5
412760,202012,289,147,142,153615,148390,302005
412770,202012,2140,1181,959,1236235.29,1005291,2241526.29
412780,202012,138,108,30,112860,31350,144210
412785,202012,285,136,149,142120,155705,297825
412788,202012,36,22,14,22990.5,15675,38665.5
412790,202012,119,98,21,102410,21945,124355
412795,202012,154,108,46,112860,48070,160930
412796,202012,311,201,110,210045,114950,324995
412800,202012,626,367,259,384560.25,270655,655215.25
412810,202012,2955,1577,1378,1651102.25,1441055,3092157.25
412820,202012,933,573,360,598786.75,376200.5,974987.25
412830,202012,14,11,3,11495,3135,14630
412840,202012,236,164,72,172425.5,75240,247665.5
412850,202012,746,475,271,496375,283195,779570
412853,202012,172,85,87,88825,90915,179740
412855,202012,187,99,88,103455.09,91960,195415.09
412860,202012,93,61,32,63745,33440,97185
412862,202012,56,35,21,36575,21945,58520
412863,202012,7,5,2,5225,2090,7315
412865,202012,47,32,15,33440,15675,49115
412870,202012,109,66,43,68970,44935,113905
412880,202012,91,65,26,67925.5,27170,95095.5
420005,202012,42,38,4,39710,4180,43890
420010,202012,361,229,132,239305,137940,377245
420020,202012,80,67,13,70015,13585,83600
420030,202012,23,20,3,20900,3135,24035
420040,202012,105,82,23,85690,24035,109725
420050,202012,58,35,23,36575,24035,60610
420055,202012,19,19,0,19855,0,19855
420060,202012,29,22,7,22990,7315,30305
420070,202012,102,85,17,88825,17765,106590
420075,202012,11,11,0,11495,0,11495
420080,202012,42,37,5,38665,5225,43890
420090,202012,34,30,4,31350,4180,35530
420100,202012,146,125,21,130625.5,21945,152570.5
420110,202012,20,19,1,19855,1045,20900
420120,202012,56,39,17,40755,17765,58520
420125,202012,78,60,18,62700,18810,81510
420127,202012,31,25,6,26125,6270,32395
420130,202012,433,263,170,274835,177650,452485
420140,202012,1297,715,582,748220.75,609235,1357455.75
420150,202012,43,35,8,36575,8360,44935
420160,202012,32,30,2,31350,2090,33440
420165,202012,15,10,5,10450,5225,15675
420170,202012,76,48,28,50160,29260,79420
420180,202012,21,18,3,18810,3135,21945
420190,202012,25,22,3,22990,3135,26125
420195,202012,134,64,70,66880,73150,140030
420200,202012,1242,542,700,566390.5,732545,1298935.5
420205,202012,94,48,46,50160,48070,98230
420207,202012,118,64,54,66880,57475,124355
420208,202012,19,15,4,15675,4180,19855
420209,202012,17,14,3,14630,3135,17765
420210,202012,511,236,275,246620,287375,533995
420213,202012,42,34,8,35530,8360,43890
420215,202012,27,24,3,25080,3135,28215
420220,202012,62,40,22,41800,22990,64790
420230,202012,836,476,360,497420,376200.5,873620.5
420240,202012,2202,1427,775,1491216.4,813010,2304226.4
420243,202012,42,33,9,34485,9405,43890
420245,202012,162,82,80,86735,83600,170335
420250,202012,63,42,21,43890,21945,65835
420253,202012,30,24,6,25080,6270,31350
420257,202012,13,10,3,10450,3135,13585
420260,202012,97,80,17,84645,17765,102410
420270,202012,30,25,5,26125,5225,31350
420280,202012,283,215,68,225720.75,71060.75,296781.50
420285,202012,22,13,9,13585,9405,22990
420287,202012,49,32,17,33440,17765,51205
420290,202012,965,662,303,691790.5,316635,1008425.5
420300,202012,1443,1137,306,1189212.95,320815.65,1510028.60
420310,202012,49,33,16,34485,16720,51205
420315,202012,36,28,8,29260.5,8360,37620.5
420320,202012,955,462,493,482790.1,515185,997975.1
420325,202012,2,0,2,0,2090,2090
420330,202012,122,79,43,82555,44935,127490
420340,202012,165,109,56,113905,58520,172425
420350,202012,263,184,79,193325,82555,275880
420360,202012,717,547,170,573705.83,177650,751355.83
420370,202012,120,70,50,73150,52250.5,125400.5
420380,202012,1177,818,359,855855.75,378290.5,1234146.25
420390,202012,240,170,70,177650,73150,250800
420395,202012,193,137,56,143165,58520,201685
420400,202012,243,186,57,194370.15,59565,253935.15
420410,202012,60,45,15,47025,15675,62700
420415,202012,35,29,6,30305,6270,36575
420417,202012,50,38,12,39710,12540,52250
420419,202012,11,11,0,11495,0,11495
420420,202012,2833,1732,1101,1812032.5,1150545.5,2962578.0
420425,202012,69,56,13,58520,13585,72105
420430,202012,1146,814,332,851675.45,346940,1198615.45
420435,202012,15,13,2,13585,2090,15675
420440,202012,102,71,31,74195.5,32395,106590.5
420445,202012,27,26,1,27170,1045,28215
420450,202012,75,37,38,38665,39710,78375
420455,202012,208,157,51,164065,53295,217360
420460,202012,2315,1472,843,1538242,880935,2419177
420470,202012,96,70,26,73150,27170,100320
420475,202012,8,8,0,8360,0,8360
420480,202012,842,625,217,653126.5,226765.5,879892.0
420490,202012,102,76,26,79420,27170.65,106590.65
420500,202012,448,234,214,244531.09,223630,468161.09
420510,202012,21,18,3,18810,3135,21945
420515,202012,27,17,10,17765,10450,28215
420517,202012,9,9,0,9405,0,9405
420519,202012,0,,,,,0.0
420520,202012,66,50,16,53295,16720,70015
420530,202012,156,104,52,108680.75,54340,163020.75
420535,202012,19,17,2,17765,2090,19855
420540,202012,5542,3311,2231,3461445.13,2335575.5,5797020.63
420543,202012,32,30,2,31350,2090,33440
420545,202012,203,145,58,151525,60610,212135
420550,202012,843,692,151,724186.4,157795,881981.4
420555,202012,39,28,11,29260,11495,40755
420560,202012,62,51,11,53295,11495,64790
420570,202012,167,96,71,100320,75240,175560
420580,202012,278,131,147,136895,153615.5,290510.5
420590,202012,501,339,162,355300,169290,524590
420600,202012,120,66,54,68970,56430,125400
420610,202012,40,36,4,37620,4180,41800
420620,202012,85,65,20,67925,20900,88825
420630,202012,146,98,48,102410,50160,152570
420640,202012,83,73,10,76285,10450,86735
420650,202012,242,121,121,126445,126445,252890
420660,202012,50,40,10,41800.5,10450,52250.5
420665,202012,34,24,10,25080,10450,35530
420670,202012,293,228,65,238260.5,68970,307230.5
420675,202012,11,10,1,10450,1045,11495
420680,202012,36,26,10,27170,10450,37620
420690,202012,175,135,40,141075,41800,182875
420700,202012,681,455,226,476520.46,236170,712690.46
420710,202012,142,76,66,79420,68970,148390
420720,202012,109,88,21,91960,21945,113905
420730,202012,616,380,236,397100.4,246620.5,643720.9
420740,202012,51,50,1,52250,1045,53295
420750,202012,483,327,156,341715,163020,504735
420757,202012,16,14,2,14630,2090,16720
420760,202012,38,30,8,31350,8360,39710
420765,202012,80,60,20,62700,20900,83600
420768,202012,48,42,6,43890,6270,50160
420770,202012,70,61,9,63745,9405,73150
420775,202012,40,37,3,38665,3135,41800
420780,202012,214,167,47,174515,49115,223630
420785,202012,12,9,3,9405,3135,12540
420790,202012,165,135,30,141075,31350,172425
420800,202012,66,49,17,51205,17765,68970
420810,202012,257,211,46,220495,48070,268565
420820,202012,2365,1328,1037,1391452.83,1083666.22,2475119.05
420830,202012,632,329,303,343805.5,316635,660440.5
420840,202012,151,105,46,110770,48070,158840
420845,202012,411,173,238,180785,249755.5,430540.5
420850,202012,255,186,69,194370,72105,266475
420860,202012,55,46,9,48070,9405,57475
420870,202012,125,85,40,88825,41800,130625
420880,202012,179,112,67,117040,70015,187055
420890,202012,941,467,474,488015.25,495330,983345.25
420895,202012,8,8,0,9405,0,9405
420900,202012,402,316,86,330220,89870,420090
420910,202012,5786,3156,2630,3300113.58,2754620,6054733.58
420915,202012,60,56,4,58520,4180,62700
420917,202012,22,15,7,15675,7315,22990
420920,202012,22,15,7,15675,7315,22990
420930,202012,2783,1727,1056,1806106,1105611.42,2911717.42
420940,202012,586,431,155,452486,161975.9,614461.9
420945,202012,9,7,2,7315,2090,9405
420950,202012,53,45,8,47025,8360,55385
420960,202012,111,89,22,93005,22990,115995
420970,202012,285,227,58,237216,60610,297826
420980,202012,24,23,1,24035,1045,25080
420985,202012,57,51,6,53295,6270,59565
420990,202012,81,57,24,59565,25080,84645
421000,202012,44,26,18,27170,18810,45980
421003,202012,49,33,16,34485,16720,51205
421005,202012,7,4,3,4180,3135,7315
421010,202012,773,509,264,531906,275880.75,807786.75
421020,202012,24,19,5,19855,5225,25080
421030,202012,116,97,19,102410.75,19855,122265.75
421040,202012,72,54,18,56430,18810,75240
421050,202012,346,237,109,248711,113905,362616
421055,202012,21,16,5,16720,5225,21945
421060,202012,88,49,39,51205,40755,91960
421070,202012,49,41,8,43890.5,8360,52250.5
421080,202012,35,31,4,32395,4180,36575
421085,202012,21,17,4,17765,4180,21945
421090,202012,36,28,8,29260,8360,37620
421100,202012,124,90,34,94050,35530,129580
421105,202012,192,153,39,159885,40755,200640
421110,202012,109,84,25,88825,26125,114950
421120,202012,170,124,46,129580.42,48070,177650.42
421125,202012,18,12,6,12540,6270,18810
421130,202012,824,512,312,535040,327085.5,862125.5
421140,202012,28,19,9,19855,9405,29260
421145,202012,42,33,9,34485,9405,43890
421150,202012,98,71,27,74195,28215,102410
421160,202012,67,45,22,47025,22990,70015
421165,202012,17,14,3,14630,3135,17765
421170,202012,184,154,30,161056,31350,192406
421175,202012,160,109,51,114950,53295,168245
421180,202012,47,33,14,34485.1,14630,49115.1
421185,202012,18,14,4,14630,4180,18810
421187,202012,1,0,1,0,1045,1045
421189,202012,46,31,15,32395,15675,48070
421190,202012,1688,1046,642,1096205,671935,1768140
421200,202012,91,67,24,70015,25080,95095
421205,202012,28,19,9,19855,9405,29260
421210,202012,173,118,55,123310,57475,180785
421220,202012,264,201,63,210045,65835,275880
421223,202012,45,36,9,37620,9405,47025
421225,202012,71,44,27,45980,28215,74195
421227,202012,85,67,18,70015,18810,88825
421230,202012,57,43,14,44935,14630,59565
421240,202012,17,17,0,17765,0,17765
421250,202012,370,211,159,220495.5,166155,386650.5
421260,202012,24,20,4,21945,4180,26125
421265,202012,2,2,0,2090,0,2090
421270,202012,50,44,6,45980,6270,52250
421280,202012,350,185,165,193325,172425,365750
421290,202012,334,220,114,229900,119130.5,349030.5
421300,202012,23,19,4,19855,4180,24035
421310,202012,46,33,13,34485,13585,48070
421315,202012,30,18,12,18810,12540,31350
421320,202012,127,81,46,84645,48070,132715
421330,202012,111,79,32,82555,33440,115995
421335,202012,39,27,12,28215,12540,40755
421340,202012,240,156,84,163020,87780,250800
421350,202012,186,107,79,111815.82,82555,194370.82
421360,202012,645,465,180,485925.25,188100,674025.25
421370,202012,191,144,47,150480,49115,199595
421380,202012,130,99,31,104500,32395,136895
421390,202012,18,12,6,12540,6270,18810
421400,202012,117,102,15,106590,15675,122265
421410,202012,16,14,2,14630,2090,16720
421415,202012,18,17,1,17765,1045,18810
421420,202012,125,102,23,106590,24035,130625
421430,202012,17,12,5,12540,5225,17765
421440,202012,58,50,8,52250,8360,60610
421450,202012,90,74,16,77330,16720.33,94050.33
421460,202012,63,50,13,52250,13585,65835
421470,202012,70,42,28,43890.25,29260,73150.25
421480,202012,727,553,174,578930,182875,761805
421490,202012,23,22,1,22990,1045,24035
421500,202012,489,309,180,322905.5,188100.25,511005.75
421505,202012,23,16,7,16720,7315,24035
421507,202012,31,24,7,25080,7315,32395
421510,202012,71,46,25,48070,26125,74195
421520,202012,54,45,9,47025,9405,56430
421530,202012,47,40,7,41800,7315,49115
421535,202012,25,23,2,24035,2090,26125
421540,202012,51,43,8,44935,8360,53295
421545,202012,102,73,29,76285,30305,106590
421550,202012,276,198,78,206910,81510,288420
421555,202012,19,16,3,16720,3135,19855
421560,202012,9,8,1,8360,1045,9405
421565,202012,119,80,39,83600,40755,124355
421567,202012,31,24,7,25080,7315,32395
421568,202012,39,34,5,35530,5225,40755
421569,202012,12,12,0,12540,0,12540
421570,202012,202,138,64,144210,66880,211090
421575,202012,27,22,5,22990,5225,28215
421580,202012,716,423,293,442103,306185,748288
421590,202012,20,19,1,19855,1045,20900
421600,202012,155,100,55,104500.5,57475.5,161976.0
421605,202012,107,74,33,77330.75,34485,111815.75
421610,202012,181,136,45,142120,47025,189145
421620,202012,1024,593,431,622820,450395,1073215
421625,202012,20,17,3,17765,3135,20900
421630,202012,310,192,118,200640.25,123311.5,323951.75
421635,202012,17,8,9,9405,9405,18810
421640,202012,99,82,17,85690,17765,103455
421650,202012,294,172,122,179740,127490,307230
421660,202012,2252,1336,916,1397167,957221,2354388
421670,202012,179,129,50,134805,52250,187055
421680,202012,176,160,16,167200,16720,183920
421690,202012,341,238,103,248711.25,107635.6,356346.85
421700,202012,53,36,17,37620,17765,55385
421710,202012,25,23,2,24035,2090,26125
421715,202012,5,4,1,4180,1045,5225
421720,202012,623,434,189,454576.27,199595,654171.27
421725,202012,18,7,11,7315,11495,18810
421730,202012,31,22,9,22990,9405,32395
421740,202012,92,32,60,33440,62700,96140
421750,202012,203,152,51,158840,54340,213180
421755,202012,22,20,2,20900,2090,22990
421760,202012,103,68,35,71060,37620,108680
421770,202012,655,404,251,424271.75,262295,686566.75
421775,202012,27,16,11,16720,11495,28215
421780,202012,190,145,45,151525.5,47025,198550.5
421790,202012,149,127,22,132715,22990,155705
421795,202012,17,14,3,14630,3135,17765
421800,202012,521,326,195,341715,203775,545490
421810,202012,68,54,14,56430,14630,71060
421820,202012,304,196,108,204820.5,113905,318725.5
421825,202012,143,121,22,126445,22990,149435
421830,202012,140,88,52,91960,54340,146300
421835,202012,7,4,3,4180,3135,7315
421840,202012,47,42,5,43890,5225,49115
421850,202012,81,67,14,70015,14630,84645
421860,202012,41,32,9,33440,9405,42845
421870,202012,1018,756,262,791066.55,273790,1064856.55
421875,202012,54,44,10,45980,10450,56430
421880,202012,169,119,50,124355,53295.5,177650.5
421885,202012,22,17,5,17765,5225,22990
421890,202012,130,89,41,93005,42845.79,135850.79
421895,202012,44,39,5,40755,5225,45980
421900,202012,153,119,34,125400,35530,160930
421910,202012,62,36,26,38665,27170,65835
421915,202012,30,24,6,25080,6270,31350
421917,202012,37,28,9,29260,9405,38665
421920,202012,39,35,4,37620,4180,41800
421930,202012,651,520,131,543400,136895,680295
421935,202012,52,45,7,47025,7315,54340
421940,202012,46,39,7,40755,7315,48070
421950,202012,876,582,294,608191,307230,915421
421960,202012,44,39,5,40755,5225,45980
421970,202012,337,216,121,226765.5,126445,353210.5
421985,202012,21,13,8,13585,8360,21945
422000,202012,0,,,,,0.0
430003,202012,197,54,143,56430,149435,205865
430005,202012,35,22,13,22990,13585,36575
430010,202012,267,193,74,201685,77330,279015
430020,202012,141,92,49,96140.5,51205,147345.5
430030,202012,122,98,24,102410,25080,127490
430040,202012,2902,1711,1191,1789042,1247730.5,3036772.5
430045,202012,64,53,11,55385,11495,66880
430047,202012,8,7,1,7315,1045,8360
430050,202012,78,63,15,65835,15675,81510
430055,202012,11,10,1,10450,1045,11495
430057,202012,5,4,1,4180,1045,5225
430060,202012,3711,2137,1574,2235255.75,1649010.5,3884266.25
430063,202012,54,49,5,51205,5225,56430
430064,202012,154,123,31,128535,32395,160930
430066,202012,5,2,3,2090,3135,5225
430070,202012,41,28,13,29260,13585,42845
430080,202012,68,45,23,47025,24035,71060
430085,202012,28,10,18,10450,18810,29260
430087,202012,27,18,9,18810.75,9405,28215.75
430090,202012,72,64,8,66880,8360,75240
430100,202012,126,84,42,87780,43890,131670
430105,202012,149,84,65,87780,67925,155705
430107,202012,18,12,6,12540,6270,18810
430110,202012,457,254,203,265430,212135,477565
430120,202012,160,148,12,154660,12540,167200
430130,202012,796,483,313,504735.35,328130,832865.35
430140,202012,124,114,10,119130,10450,129580
430150,202012,108,68,40,71060,41800,112860
430155,202012,33,28,5,29260,5225,34485
430160,202012,3589,2097,1492,2193457.75,1561230.5,3754688.25
430163,202012,356,153,203,159885,212135,372020
430165,202012,32,22,10,22990,10450,33440
430170,202012,86,71,15,74195,15675,89870
430175,202012,73,57,16,59565,16720,76285
430180,202012,106,86,20,89870,20900,110770
430185,202012,29,18,11,18810,11495,30305
430187,202012,60,30,30,31350,31350,62700
430190,202012,218,119,99,124355,103455,227810
430192,202012,13,11,2,11495,2090,13585
430195,202012,16,10,6,10450,6270,16720
430200,202012,163,140,23,146300,24035,170335
430205,202012,21,21,0,21945,0,21945
430210,202012,672,508,164,530860,171380,702240
430215,202012,11,10,1,10450,1045,11495
430220,202012,73,49,24,51205,25080,76285
430222,202012,13,6,7,6270,7315,13585
430223,202012,15,8,7,8360,7315,15675
430225,202012,2,1,1,1045,1045,2090
430230,202012,306,181,125,189145,130625.5,319770.5
430235,202012,51,39,12,40755,12540,53295
430237,202012,28,21,7,21945,7315,29260
430240,202012,114,77,37,80465,38665,119130
430245,202012,73,58,15,60610,15675,76285
430250,202012,183,107,76,111815,79420,191235
430258,202012,8,7,1,7315,1045,8360
430260,202012,31,27,4,28215,4180,32395
430265,202012,34,28,6,29260,6270,35530
430270,202012,512,382,130,399191.25,135850,535041.25
430280,202012,1030,615,415,643720,434720,1078440
430290,202012,403,216,187,225720,195415,421135
430300,202012,2111,1157,954,1210110.75,997975.5,2208086.25
430310,202012,2011,990,1021,1036640.5,1071126.21,2107766.71
430320,202012,55,46,9,48070,9405,57475
430330,202012,99,86,13,89870,13585,103455
430340,202012,70,56,14,58520,14630,73150
430350,202012,1647,1101,546,1151591,571615,1723206
430355,202012,21,19,2,19855,2090,21945
430360,202012,86,43,43,44935,44935,89870
430367,202012,35,26,9,27170,9405,36575
430370,202012,52,47,5,49115,5225,54340
430380,202012,123,95,28,99275,29260,128535
430390,202012,581,361,220,379335,229900,609235
430400,202012,253,180,73,188100.5,77330,265430.5
430410,202012,54,43,11,44935,11495,56430
430420,202012,505,323,182,337535.85,190190,527725.85
430430,202012,53,52,1,54689.03,1045,55734.03
430435,202012,151,111,40,115995,41800,157795
430440,202012,490,319,171,333355,178695,512050
430450,202012,1142,939,203,982300,212135,1194435
430460,202012,5300,2737,2563,2863301.9,2682515.5,5545817.4
430461,202012,16,15,1,15675,1045,16720
430462,202012,7,3,4,3135,4180,7315
430463,202012,1110,590,520,616550,543400,1159950
430465,202012,24,13,11,13585,11495,25080
430466,202012,645,451,194,471295.5,203775,675070.5
430467,202012,106,58,48,60610,50160,110770
430468,202012,116,68,48,71060,50160,121220
430469,202012,21,16,5,16720,5225,21945
430470,202012,1147,639,508,668066.62,532950,1201016.62
430471,202012,55,37,18,38665,18810,57475
430480,202012,100,63,37,65835,38665,104500
430485,202012,7,7,0,7315.5,0,7315.5
430490,202012,71,57,14,59565,14630,74195
430495,202012,34,25,9,26125,9405,35530
430500,202012,188,126,62,131670,64790.5,196460.5
430510,202012,3441,2206,1235,2306315.63,1293710.5,3600026.13
430511,202012,16,16,0,16720,0,16720
430512,202012,153,106,47,110770,49115,159885
430513,202012,52,42,10,43890,10450,54340
430515,202012,25,24,1,25080,1045,26125
430517,202012,169,145,24,152570,25080,177650
430520,202012,340,237,103,247665,107635,355300
430530,202012,82,46,36,48070,37620,85690
430535,202012,439,296,143,309320,149435,458755
430537,202012,10,10,0,10450,0,10450
430540,202012,82,56,26,58520,27170,85690
430543,202012,361,113,248,118085,260205,378290
430544,202012,43,40,3,41800,3135,44935
430545,202012,383,185,198,193325.5,206910,400235.5
430550,202012,41,33,8,34485,8360,42845
430558,202012,1,1,0,1045,0,1045
430560,202012,55,29,26,30305,27170,57475
430570,202012,103,39,64,40755,66880,107635
430580,202012,129,104,25,108680,26125,134805
430583,202012,13,13,0,13585,0,13585
430585,202012,10,5,5,5225,5225,10450
430587,202012,16,7,9,7315,9405,16720
430590,202012,144,118,26,123310,27170,150480
430593,202012,2,2,0,2090,0,2090
430595,202012,17,14,3,14630,3135,17765
430597,202012,44,22,22,22990,22990,45980
430600,202012,217,161,56,168245,58520,226765
430605,202012,158,97,61,101365,63745,165110
430607,202012,25,20,5,20900,5225,26125
430610,202012,1651,768,883,802560.5,922735.5,1725296.0
430613,202012,3,3,0,3135,0,3135
430620,202012,110,77,33,80465,34485,114950
430630,202012,46,40,6,41800,6270,48070
430632,202012,33,27,6,28215,6270,34485
430635,202012,35,31,4,32395,4180,36575
430637,202012,63,30,33,31350,34485,65835
430640,202012,178,93,85,97185,88825.5,186010.5
430642,202012,20,16,4,16720,4180,20900
430645,202012,32,26,6,27170,6270,33440
430650,202012,240,198,42,206910.5,43890,250800.5
430655,202012,2,2,0,2090,0,2090
430660,202012,974,483,491,504735,514140.5,1018875.5
430670,202012,78,53,25,55385,26125,81510
430673,202012,71,43,28,44935,29260,74195
430675,202012,10,8,2,8360,2090,10450
430676,202012,523,306,217,319770,226765,546535
430680,202012,235,162,73,169290.5,76285,245575.5
430690,202012,522,320,202,334400,211090.29,545490.29
430692,202012,9,7,2,7315,2090,9405
430693,202012,137,89,48,94050,50160,144210
430695,202012,63,52,11,54340,11495,65835
430697,202012,58,35,23,36575,24035,60610
430700,202012,1465,1011,454,1056495.9,477565,1534060.9
430705,202012,27,24,3,25080,3135,28215
430710,202012,251,157,94,164065,98230,262295
430720,202012,107,92,15,96140,15675,111815
430730,202012,139,119,20,124355,20900,145255
430740,202012,74,51,23,53295,24035,77330
430745,202012,30,24,6,25080,6270,31350
430750,202012,325,216,109,225720,114950,340670
430755,202012,86,46,40,48070,41800,89870
430760,202012,383,211,172,220495.6,179789,400284.6
430770,202012,1489,764,725,799425.5,757625,1557050.5
430780,202012,297,186,111,194370,115995,310365
430781,202012,24,20,4,20900,4180,25080
430783,202012,60,49,11,51205,11495,62700
430786,202012,5,3,2,3135,2090,5225
430790,202012,511,333,178,347985,186010.5,533995.5
430800,202012,153,123,30,128535.76,31350,159885.76
430805,202012,40,33,7,34485,7315,41800
430807,202012,50,26,24,27170,25080,52250
430810,202012,75,45,30,47025,31350,78375
430820,202012,145,85,60,88825,62700,151525
430825,202012,10,8,2,8360,2090,10450
430830,202012,236,217,19,226765.5,19855,246620.5
430840,202012,129,84,45,87780,47025,134805
430843,202012,6,4,2,4180,2090,6270
430845,202012,73,39,34,40755,35530,76285
430850,202012,583,417,166,435765,173470,609235
430860,202012,153,97,56,101365,59565,160930
430865,202012,72,38,34,39710,35530,75240
430870,202012,82,66,16,70015,16720,86735
430880,202012,155,112,43,117040,44935,161975
430885,202012,11,9,2,9405,2090,11495
430890,202012,338,200,138,209000,145255,354255
430900,202012,518,358,160,374110,168245,542355
430905,202012,124,51,73,53295,76285,129580
430910,202012,277,156,121,164065,126445,290510
430912,202012,4,4,0,4180,0,4180
430915,202012,34,30,4,31350,4180,35530
430920,202012,4331,2277,2054,2383645,2149565.75,4533210.75
430925,202012,5,4,1,4180,1045,5225
430930,202012,2070,1188,882,1243551.75,923780.5,2167332.25
430940,202012,256,166,90,173470,94050,267520
430950,202012,156,127,29,132715,30305,163020
430955,202012,24,13,11,13585,11495,25080
430957,202012,18,16,2,16720,2090,18810
430960,202012,243,160,83,167200,86735,253935
430965,202012,113,72,41,75240,42845,118085
430970,202012,90,72,18,75240,18810,94050
430975,202012,44,38,6,39710,6270,45980
430980,202012,45,28,17,29260,17765,47025
430990,202012,100,77,23,80465,24035,104500
430995,202012,112,106,6,110770,6270,117040
431000,202012,295,142,153,148391.1,159885,308276.1
431010,202012,348,195,153,203775,159885,363660
431020,202012,1856,1066,790,1115015.5,826595,1941610.5
431030,202012,39,31,8,32395,8360,40755
431033,202012,401,189,212,197505,222585,420090
431036,202012,11,6,5,6270,5225,11495
431040,202012,143,88,55,91960,57475.5,149435.5
431041,202012,40,26,14,27170.5,14630,41800.5
431043,202012,42,25,17,26125,17765,43890
431046,202012,11,8,3,8360,3135,11495
431050,202012,198,126,72,131670,75240,206910
431053,202012,64,38,26,39710,27170,66880
431055,202012,62,43,19,44935,19855,64790
431057,202012,18,18,0,18810,0,18810
431060,202012,1595,1031,564,1078441.09,589380.75,1667821.84
431065,202012,17,11,6,11495,6270,17765
431070,202012,66,61,5,63745,5225,68970
431075,202012,7,7,0,7315,0,7315
431080,202012,134,78,56,83600,58520,142120
431085,202012,33,30,3,31350,3135,34485
431087,202012,16,14,2,14630,2090,16720
431090,202012,55,43,12,44935,12540,57475
431100,202012,1217,727,490,759715.5,512050,1271765.5
431110,202012,229,139,90,145255,94050.95,239305.95
431112,202012,24,15,9,15675,10450,26125
431113,202012,35,25,10,26125,10450,36575
431115,202012,159,111,48,115995,50160,166155
431120,202012,598,355,243,370975,253935,624910
431123,202012,3,2,1,2090,1045,3135
431125,202012,95,84,11,87780,11495,99275
431127,202012,11,6,5,6270,5225,11495
431130,202012,692,448,244,468160,254980,723140
431140,202012,736,507,229,529815.5,241395,771210.5
431142,202012,25,21,4,21945.67,4180,26125.67
431150,202012,190,142,48,148390,50160,198550
431160,202012,47,44,3,45980,3135,49115
431162,202012,5,4,1,4180,1045,5225
431164,202012,6,6,0,6270,0,6270
431170,202012,107,85,22,88825,22990,111815
431171,202012,67,40,27,41800,28215,70015
431173,202012,1,1,0,1045,0,1045
431175,202012,199,99,100,103455.5,104500,207955.5
431177,202012,85,61,24,63745,25080,88825
431179,202012,13,11,2,11495,2090,13585
431180,202012,423,256,167,268565,174515,443080
431190,202012,79,60,19,62700,19855,82555
431198,202012,73,53,20,55385,20900,76285
431200,202012,21,16,5,16720,5225,21945
431205,202012,21,20,1,20900,1045,21945
431210,202012,96,60,36,62700,37620,100320
431213,202012,31,26,5,27170,5225,32395
431215,202012,22,19,3,19855,3135,22990
431217,202012,6,5,1,5225,1045,6270
431220,202012,65,56,9,58520,9405,67925
431225,202012,156,99,57,103455,59565,163020
431230,202012,96,83,13,86735,13585,100320
431235,202012,7,7,0,7315,0,7315
431237,202012,19,15,4,15675,4180,19855
431238,202012,11,7,4,7315,4180,11495
431240,202012,1021,637,384,665665,401280,1066945
431242,202012,39,38,1,39710,1045,40755
431244,202012,14,10,4,10450,4180,14630
431245,202012,50,37,13,38665,13585,52250
431247,202012,11,6,5,6270,5225,11495
431250,202012,280,142,138,148390,144210,292600
431260,202012,61,49,12,51205,12540,63745
431261,202012,18,11,7,11495,7315,18810
431262,202012,15,14,1,14630,1045,15675
431265,202012,148,79,69,83600,72105,155705
431267,202012,17,15,2,15675,2090,17765
431270,202012,320,260,60,271700,62700,334400
431275,202012,39,36,3,37620,3135,40755
431280,202012,20,16,4,16720,4180,20900
431290,202012,21,19,2,19855,2090,21945
431295,202012,1,1,0,1045,0,1045
431300,202012,22,20,2,20900,2090,22990
431301,202012,5,5,0,5225,0,5225
431303,202012,61,39,22,40755,22990,63745
431306,202012,245,129,116,134618.99,121220,255838.99
431308,202012,6,4,2,4180,2090,6270
431310,202012,62,51,11,53295,11495,64790
431320,202012,155,93,62,99275,64790.5,164065.5
431330,202012,181,110,71,114950,74195,189145
431333,202012,25,20,5,20900,5225,26125
431335,202012,9,5,4,5225,4180,9405
431337,202012,359,157,202,165110,211090,376200
431339,202012,21,18,3,18810,3135,21945
431340,202012,3032,1646,1386,1721081.44,1450461.25,3171542.69
431342,202012,37,25,12,26125.5,12540,38665.5
431344,202012,18,18,0,18810,0,18810
431346,202012,5,5,0,5225,0,5225
431349,202012,34,30,4,31350,4180,35530
431350,202012,920,524,396,547580.75,415910,963490.75
431360,202012,50,42,8,43890,8360,52250
431365,202012,341,152,189,158840,199595,358435
431370,202012,1210,691,519,722095.5,542355,1264450.5
431380,202012,98,86,12,89870,12540,102410
431390,202012,506,268,238,281105,248710,529815
431395,202012,303,127,176,132715,183920,316635
431400,202012,46,30,16,31350,16720,48070
431402,202012,108,78,30,81510,31350,112860
431403,202012,23,14,9,14630,9405,24035
431405,202012,675,370,305,386650.25,319770,706420.25
431406,202012,29,24,5,25080,5225,30305
431407,202012,53,41,12,42845,12540,55385
431410,202012,3367,2047,1320,2142250.5,1380445.75,3522696.25
431413,202012,15,12,3,12540,3135,15675
431415,202012,65,48,17,50160,17765,67925
431417,202012,27,12,15,12540,15675,28215
431420,202012,322,219,103,228855,107635,336490
431430,202012,54,24,30,25080,31350,56430
431440,202012,8835,6084,2751,6368238.4,2876935.75,9245174.15
431442,202012,28,13,15,13585,15675,29260
431445,202012,27,25,2,26125,2090,28215
431446,202012,4,3,1,3135,1045,4180
431447,202012,85,59,26,61655,27170,88825
431449,202012,51,43,8,44935,8360,53295
431450,202012,409,272,137,284240,143165,427405
431454,202012,8,3,5,3135,5225,8360
431455,202012,49,39,10,40755,10450,51205
431460,202012,509,350,159,365750,166155,531905
431470,202012,117,88,29,91960,30305,122265
431475,202012,10,8,2,8360,2090,10450
431477,202012,35,23,12,24035,12540,36575
431478,202012,8,7,1,7315,1045,8360
431480,202012,525,314,211,328130,220495.5,548625.5
431490,202012,28439,15742,12697,16461895.3,13279864.5,29741759.8
431500,202012,76,62,14,65835,14630,80465
431505,202012,25,15,10,15675,10450,26125
431507,202012,9,7,2,7315,2090,9405
431510,202012,255,180,75,188100.25,78375,266475.25
431513,202012,24,21,3,21945,3135,25080
431514,202012,5,4,1,4180,1045,5225
431515,202012,78,64,14,66880,14630,81510
431517,202012,6,3,3,3135,3135,6270
431520,202012,38,34,4,35530,4180,39710
431530,202012,1434,643,791,671935,827640,1499575
431531,202012,24,23,1,24035,1045,25080
431532,202012,33,24,9,25080,9405,34485
431535,202012,28,15,13,15675,13585,29260
431540,202012,141,121,20,127490,20900,148390
431545,202012,14,12,2,12540,2090,14630
431550,202012,344,188,156,196460,164065,360525
431555,202012,12,12,0,12540,0,12540
431560,202012,4512,3064,1448,3206063.85,1513160,4719223.85
431570,202012,810,424,386,443081,403370,846451
431575,202012,44,24,20,25080,20900,45980
431580,202012,92,61,31,63745,32395,96140
431590,202012,136,115,21,120175,21945,142120
431595,202012,19,15,4,15675,4180,19855
431600,202012,240,137,103,144210,107635,251845
431610,202012,115,84,31,87780,32395,120175
431620,202012,43,36,7,37620,7315,44935
431630,202012,128,105,23,109725,24035,133760
431640,202012,1329,836,493,873620.5,515185.5,1388806.0
431642,202012,36,33,3,34485,3135,37620
431643,202012,46,21,25,21945,26125,48070
431645,202012,310,184,126,192280,131670,323950
431647,202012,9,8,1,8360,1045,9405
431650,202012,34,22,12,22990,12540,35530
431660,202012,286,180,106,188100,110770,298870
431670,202012,227,101,126,105545,131670,237215
431673,202012,7,7,0,7315,0,7315
431675,202012,23,18,5,18810,5225,24035
431680,202012,1110,816,294,854810,307230,1162040
431690,202012,4744,2830,1914,2958399.92,2001176,4959575.92
431695,202012,22,16,6,16720,6270,22990
431697,202012,1,0,1,0,1045,1045
431700,202012,180,137,43,143165,44935,188100
431710,202012,3997,1733,2264,1812030.5,2367970,4180000.5
431720,202012,1332,814,518,850108,542355,1392463
431725,202012,2,1,1,1045,1045,2090
431730,202012,1160,779,381,814057.9,398145,1212202.9
431740,202012,1352,660,692,689700,724185.5,1413885.5
431750,202012,1817,1178,639,1231010.55,668800,1899810.55
431755,202012,6,5,1,5225,1045,6270
431760,202012,1024,645,379,676117,397100,1073217
431770,202012,414,293,121,306185,126445,432630
431775,202012,26,19,7,19855,7315,27170
431780,202012,541,322,219,336490.22,228855,565345.22
431790,202012,159,122,37,127490,39710,167200
431795,202012,12,10,2,10450,2090,12540
431800,202012,3183,1655,1528,1729477.2,1598851,3328328.2
431805,202012,21,19,2,19855,2090,21945
431810,202012,599,393,206,410685,215270,625955
431820,202012,325,192,133,201685,138985,340670
431830,202012,2281,1363,918,1425380.5,960355,2385735.5
431840,202012,480,313,167,327085,174515,501600
431842,202012,33,26,7,27170,7315,34485
431843,202012,10,7,3,7315,3135,10450
431844,202012,17,13,4,13585,4180,17765
431845,202012,26,24,2,25080,2090,27170
431846,202012,26,22,4,22990,4180,27170
431848,202012,10,8,2,8360,2090,10450
431849,202012,7,6,1,6270,1045,7315
431850,202012,776,626,150,654170,156750,810920
431860,202012,114,77,37,80465,38665,119130
431861,202012,6,2,4,2090,4180,6270
431862,202012,56,37,19,38665,19855,58520
431870,202012,3489,1982,1507,2072236.25,1577950,3650186.25
431880,202012,929,674,255,704330,267520,971850
431890,202012,1312,778,534,815100.5,558030,1373130.5
431900,202012,182,126,56,131670,58520,190190
431910,202012,52,38,14,39710,14630,54340
431912,202012,43,26,17,27170,17765,44935
431915,202012,127,97,30,101365,31350,132715
431920,202012,159,113,46,118085,48070,166155
431930,202012,78,65,13,67925,13585,81510
431935,202012,3,3,0,3135,0,3135
431936,202012,8,7,1,7315,1045,8360
431937,202012,19,14,5,14630,5225,19855
431940,202012,453,301,152,314545,158840.25,473385.25
431950,202012,491,311,180,324995.5,189145,514140.5
431960,202012,728,391,337,408595.5,352165,760760.5
431970,202012,69,62,7,64790,7315,72105
431971,202012,3,3,0,3135,0,3135
431973,202012,19,15,4,15675,4180,19855
431975,202012,9,8,1,8360,1045,9405
431980,202012,212,128,84,134805,87780,222585
431990,202012,1123,597,526,623797.52,550715,1174512.52
432000,202012,1753,912,841,954086.25,879890.25,1833976.50
432010,202012,272,186,86,194370,89870,284240
432020,202012,172,141,31,147345,32395,179740
432023,202012,15,13,2,13585,2090,15675
432026,202012,66,59,7,61655,7315,68970
432030,202012,66,33,33,34485,34485,68970
432032,202012,18,14,4,14630,4180,18810
432035,202012,54,43,11,44935,11495,56430
432040,202012,92,64,28,67925,29260,97185
432045,202012,1,1,0,1045,0,1045
432050,202012,80,47,33,49115,34485,83600
432055,202012,125,92,33,96140,34485,130625
432057,202012,8,6,2,6270.5,2090,8360.5
432060,202012,34,31,3,32395,3135,35530
432065,202012,32,28,4,29260,4180,33440
432067,202012,88,79,9,82555,9405,91960
432070,202012,378,293,85,306447.5,93005,399452.5
432080,202012,808,560,248,586245,259160,845405
432085,202012,8,5,3,5225,3135,8360
432090,202012,263,174,89,181830,93005,274835
432100,202012,169,109,60,113905,62700,176605
432110,202012,547,361,186,377245,194370,571615
432120,202012,961,543,418,567436,436810.5,1004246.5
432130,202012,479,338,141,354255,148390,502645
432132,202012,23,20,3,20900,3135,24035
432135,202012,82,66,16,68970,16720,85690
432140,202012,268,206,62,215270,64790,280060
432143,202012,210,130,80,135850,83600,219450
432145,202012,278,192,86,201685,89870,291555
432146,202012,13,12,1,12540,1045,13585
432147,202012,114,60,54,62700,56430,119130
432149,202012,16,10,6,10450,6270,16720
432150,202012,882,533,349,558030.5,365750,923780.5
432160,202012,1504,755,749,790020.22,784795,1574815.22
432162,202012,3,2,1,2090,1045,3135
432163,202012,19,14,5,14630,5225,19855
432166,202012,120,90,30,94312.5,32395,126707.5
432170,202012,232,117,115,122265,120175,242440
432180,202012,542,332,210,346940.5,219450.5,566391.0
432183,202012,8,8,0,8360,0,8360
432185,202012,77,66,11,68970,11495,80465
432190,202012,485,284,201,296780,210045,506825
432195,202012,85,69,16,72105,16720,88825
432200,202012,395,245,150,256025,156750,412775
432210,202012,117,73,44,76285,45980,122265
432215,202012,39,35,4,36575,4180,40755
432218,202012,21,20,1,20900,1045,21945
432220,202012,651,337,314,352165,329175.29,681340.29
432225,202012,14,9,5,9405,5225,14630
432230,202012,134,90,44,94050,45980,140030
432232,202012,12,11,1,11495,1045,12540
432234,202012,3,2,1,2090,1045,3135
432235,202012,3,2,1,2090,1045,3135
432237,202012,26,16,10,16720,10450,27170
432240,202012,4307,2389,1918,2498596,2004311.5,4502907.5
432250,202012,1113,716,397,748220,415910,1164130
432252,202012,45,43,2,44935,2090,47025
432253,202012,59,47,12,49115,12540,61655
432254,202012,26,11,15,11495,15675,27170
432255,202012,14,12,2,12540,2090,14630
432260,202012,813,636,177,664620.5,186010,850630.5
432270,202012,228,171,57,180785,59565,240350
432280,202012,140,105,35,109725,36575,146300
432285,202012,2,2,0,2090,0,2090
432290,202012,65,56,9,58520,9405,67925
432300,202012,4641,2499,2142,2615567.07,2241526.27,4857093.34
432310,202012,130,105,25,109725,26125,135850
432320,202012,22,17,5,17765,5225,22990
432330,202012,14,9,5,9405,5225,14630
432335,202012,9,7,2,7315,2090,9405
432340,202012,39,33,6,34485,6270,40755
432345,202012,104,68,36,71060,38665,109725
432350,202012,20,19,1,19855,1045,20900
432360,202012,4,3,1,3135,1045,4180
432370,202012,22,21,1,21945,1045,22990
432375,202012,31,28,3,29260,3135,32395
432377,202012,8,8,0,8360,0,8360
432380,202012,172,74,98,78375,102410,180785
500020,202012,243,130,113,135850,120175,256025
500025,202012,140,69,71,72105,74195,146300
500060,202012,1449,902,547,942590.5,572661,1515251.5
500070,202012,778,368,410,384560.29,429495,814055.29
500080,202012,134,106,28,110770,29260,140030
500085,202012,130,107,23,112860.5,24035,136895.5
500090,202012,359,161,198,168245,206910,375155
500100,202012,715,376,339,392920,355301,748221
500110,202012,2256,1046,1210,1093071.5,1264451.25,2357522.75
500124,202012,263,144,119,150480,124355,274835
500150,202012,343,132,211,137940,220495,358435
500190,202012,519,354,165,369930,172425.5,542355.5
500200,202012,192,164,28,171380.2,29260,200640.2
500210,202012,1579,530,1049,553850,1100385,1654235
500215,202012,241,134,107,140030,111815,251845
500220,202012,726,473,253,494285.77,265430,759715.77
500230,202012,237,144,93,150480,97185,247665
500240,202012,658,449,209,469205,218405.5,687610.5
500260,202012,586,224,362,234080,378290,612370
500270,202012,29873,12661,17212,13247876.9,18005356.61,31253233.51
500280,202012,200,67,133,70015,138985,209000
500290,202012,1162,702,460,734635.5,481745,1216380.5
500295,202012,441,284,157,296780.5,164065,460845.5
500310,202012,79,24,55,25080,57475,82555
500315,202012,761,434,327,453530,341715,795245
500320,202012,3587,1749,1838,1828750.54,1920710,3749460.54
500325,202012,932,502,430,524591,450395.5,974986.5
500330,202012,1493,699,794,730455,829730,1560185
500345,202012,304,230,74,240350.5,77330,317680.5
500348,202012,254,146,108,152570,112860,265430
500350,202012,122,57,65,59565,67925,127490
500370,202012,5635,2498,3137,2611456.95,3281301.5,5892758.45
500375,202012,340,240,100,250800,104500,355300
500380,202012,588,329,259,343805,270655,614460
500390,202012,73,36,37,37620,38665,76285
500400,202012,219,138,81,144210,84645,228855
500410,202012,533,216,317,225720,331265,556985
500430,202012,526,368,158,384560,165110,549670
500440,202012,197,102,95,106590,99275,205865
500450,202012,400,169,231,176605.5,241395,418000.5
500460,202012,271,145,126,151525,131670,283195
500470,202012,428,333,95,347985.5,99275,447260.5
500480,202012,103,62,41,64790,42845,107635
500490,202012,105,45,60,47025,62700,109725
500500,202012,1417,513,904,536085,944680,1480765
500510,202012,42,35,7,36575,7315,43890
500515,202012,100,69,31,72105,32395,104500
500520,202012,305,161,144,168245,150480.5,318725.5
500525,202012,92,49,43,51205,44935,96140
500540,202012,886,380,506,397100,528770.5,925870.5
500560,202012,928,513,415,536085,433675.5,969760.5
500568,202012,979,551,428,576840,450396,1027236
500570,202012,1200,698,502,729411,524590,1254001
500580,202012,327,163,164,170335,171380,341715
500600,202012,335,163,172,171380,179740,351120
500620,202012,913,646,267,675070.92,279015,954085.92
500625,202012,79,62,17,64790,17765,82555
500627,202012,18,9,9,9405,9405,18810
500630,202012,1574,871,703,910197.54,735680,1645877.54
500635,202012,520,310,210,323950.5,219450,543400.5
500640,202012,374,201,173,210045,180785,390830
500660,202012,5556,2009,3547,2099406.75,3706616,5806022.75
500690,202012,601,206,395,215270,412775,628045
500710,202012,406,206,200,215270.5,209000,424270.5
500720,202012,925,528,397,552805.73,416955,969760.73
500730,202012,185,112,73,117040.5,76285,193325.5
500740,202012,887,365,522,381425,546535,927960
500750,202012,145,45,100,48070,104500,152570
500755,202012,123,91,32,95095.5,33440,128535.5
500769,202012,742,400,342,419045.5,357390,776435.5
500770,202012,413,215,198,224675,206910,431585
500780,202012,150,100,50,104500,52250,156750
500790,202012,1062,533,529,558030,552805,1110835
500793,202012,271,142,129,148390,134805.5,283195.5
500795,202012,184,126,58,131670,60610,192280
500797,202012,47,33,14,34485,14630,49115
500800,202012,438,193,245,201685,256025,457710
500830,202012,2214,1226,988,1283260,1034550,2317810
500840,202012,133,99,34,103455,35530,138985
510010,202012,171,88,83,91960,86735,178695
510020,202012,504,214,290,223630,304095,527725
510025,202012,1663,948,715,990660.2,747175.5,1737835.7
510030,202012,665,340,325,356345.5,339625.5,695971.0
510035,202012,126,62,64,64790,66880,131670
510040,202012,397,181,216,189145,226765.3,415910.3
510050,202012,392,214,178,223630,186010.73,409640.73
510060,202012,119,59,60,61655,62700,124355
510080,202012,229,89,140,93005,146300,239305
510100,202012,66,28,38,29260,39710,68970
510120,202012,33,20,13,20900,13585,34485
510125,202012,378,235,143,245575,150480,396055
510130,202012,540,314,226,328130,236170.5,564300.5
510140,202012,426,123,303,128535,316635,445170
510160,202012,112,36,76,37620,79420,117040
510170,202012,785,478,307,499510.03,321860,821370.03
510180,202012,2922,1365,1557,1427471,1628111.25,3055582.25
510185,202012,19,8,11,8360,11495,19855
510190,202012,232,83,149,86735,155705,242440
510250,202012,2574,1526,1048,1594671.5,1099341,2694012.5
510260,202012,172,126,46,131670,48070,179740
510263,202012,457,249,208,260205.5,217360,477565.5
510267,202012,659,365,294,382470.5,308275,690745.5
510268,202012,62,28,34,29260,35530,64790
510269,202012,74,33,41,34485,42845,77330
510270,202012,385,193,192,201685,200640,402325
510279,202012,216,163,53,170335,55385,225720
510285,202012,185,73,112,76285,117040,193325
510300,202012,509,264,245,275880,256025,531905
510305,202012,199,91,108,95095,112860,207955
510310,202012,107,54,53,56430,55385,111815
510320,202012,846,530,316,554895,330220,885115
510325,202012,419,174,245,181830,256025,437855
510330,202012,423,235,188,245575,197505,443080
510335,202012,633,359,274,375155,286330,661485
510336,202012,57,40,17,41800,17765,59565
510337,202012,109,45,64,47025,66880,113905
510340,202012,17173,7728,9445,8082031.79,9877342.25,17959374.04
510343,202012,62,43,19,44935,19855,64790
510345,202012,159,102,57,106590,59565.5,166155.5
510350,202012,652,353,299,368885,312455.5,681340.5
510360,202012,201,122,79,127490,82555,210045
510370,202012,155,71,84,74195,87780,161975
510380,202012,84,62,22,64790,22990,87780
510385,202012,62,27,35,28215,36575,64790
510390,202012,110,47,63,49115,65835,114950
510395,202012,45,32,13,33440,13585,47025
510410,202012,713,459,254,482790,265430,748220
510420,202012,554,267,287,279015,299915,578930
510450,202012,50,25,25,26125,26125,52250
510452,202012,53,25,28,26125,29260,55385
510454,202012,55,25,30,26125,31350,57475
510455,202012,137,78,59,81510,61655,143165
510460,202012,178,81,97,84645,101365,186010
510480,202012,700,411,289,429495.2,302005,731500.2
510490,202012,349,175,174,182875,181830,364705
510500,202012,239,180,59,188100,61655,249755
510510,202012,781,455,326,475475.5,340670,816145.5
510515,202012,1226,628,598,657305,624910,1282215
510517,202012,256,109,147,114950,153615,268565
510520,202012,223,146,77,152570,80465,233035
510523,202012,101,79,22,82555,22990,105545
510525,202012,808,480,328,501600,342760,844360
510530,202012,20,13,7,13585,7315,20900
510550,202012,243,112,131,118085.53,138985,257070.53
510558,202012,287,141,146,147345,152570,299915
510560,202012,413,240,173,250800.5,180785,431585.5
510562,202012,636,462,174,483835,181830,665665
510590,202012,745,384,361,401280,378290,779570
510600,202012,233,121,112,126445,118085,244530
510610,202012,206,84,122,88825,127490,216315
510615,202012,178,82,96,85690,100320,186010
510617,202012,18,9,9,9405,9405,18810
510618,202012,121,58,63,60610,65835,126445
510619,202012,92,64,28,66880,29260,96140
510620,202012,163,93,70,98230,74195,172425
510621,202012,172,109,63,113905,65835,179740
510622,202012,493,296,197,310365,205865,516230
510623,202012,321,220,101,229900,106590,336490
510624,202012,93,45,48,47025,50160,97185
510625,202012,521,323,198,337535,206910.29,544445.29
510626,202012,108,67,41,70015,42845,112860
510627,202012,75,52,23,54340,24035,78375
510628,202012,152,90,62,94050,64790,158840
510629,202012,268,157,111,164065,116013.81,280078.81
510630,202012,431,219,212,228855,221540,450395
510631,202012,13,3,10,3135,10450,13585
510637,202012,348,197,151,206910,157795,364705
510642,202012,999,527,472,550715,493240,1043955
510645,202012,2,0,2,0,2090,2090
510650,202012,1374,898,476,939455.5,497420,1436875.5
510665,202012,83,35,48,36575,50160,86735
510670,202012,59,33,26,34485,27170,61655
510675,202012,1137,727,410,760342.5,429495,1189837.5
510677,202012,341,177,164,184965,171380,356345
510680,202012,106,61,45,63745,47025,110770
510682,202012,205,104,101,108680,105545,214225
510685,202012,53,40,13,41800,13585,55385
510700,202012,568,324,244,338580,254980,593560
510704,202012,1158,600,558,627000,583110,1210110
510706,202012,133,66,67,68970,70015,138985
510710,202012,391,279,112,291555,117040,408595
510715,202012,58,40,18,41800,18810,60610
510718,202012,216,109,107,113905,111815,225720
510719,202012,41,17,24,17765,25080,42845
510720,202012,184,128,56,133760,58520,192280
510724,202012,85,33,52,34485,54340,88825
510726,202012,52,27,25,28215,26125,54340
510729,202012,55,21,34,21945,35530,57475
510730,202012,480,263,217,274835,226765,501600
510735,202012,113,46,67,48070,70015,118085
510740,202012,19,10,9,10450,9405,19855
510757,202012,24,18,6,18810,6270,25080
510760,202012,7154,3653,3501,3820521.5,3663771.75,7484293.25
510770,202012,672,317,355,332310,370975,703285
510774,202012,17,5,12,5225,12540,17765
510775,202012,107,80,27,83600,28215,111815
510776,202012,28,11,17,11495,17765,29260
510777,202012,192,82,110,85690,114950,200640
510779,202012,50,24,26,25080,27170,52250
510780,202012,284,158,126,165110,131670,296780
510785,202012,385,207,178,216315,186010,402325
510787,202012,193,92,101,96140,105545,201685
510788,202012,5,1,4,1045,4180,5225
510790,202012,2493,1310,1183,1369000.75,1236235.25,2605236.00
510792,202012,1138,637,501,665665,525635.66,1191300.66
510794,202012,113,62,51,64790,54340,119130
510795,202012,2291,1336,955,1398210.5,997976,2396186.5
510800,202012,174,103,71,107635,74195,181830
510805,202012,185,124,61,129580,63745,193325
510810,202012,97,43,54,44935,56430,101365
510820,202012,239,118,121,124355.45,126445.12,250800.57
510830,202012,74,43,31,44935,32395,77330
510835,202012,14,9,5,9405,5225,14630
510840,202012,9066,4290,4776,4485144,4995100.5,9480244.5
510850,202012,220,89,131,93005,136895,229900
510860,202012,373,168,205,175560,214225.5,389785.5
510880,202012,71,50,21,52250,21945,74195
510885,202012,70,38,32,39710,33440,73150
510890,202012,64,37,27,38665,29260,67925
510895,202012,169,99,70,103455,73150.5,176605.5
520005,202012,128,53,75,55385,78375,133760
520010,202012,284,127,157,132715,164065.5,296780.5
520013,202012,720,468,252,489061,263340,752401
520015,202012,52,38,14,39710,14630,54340
520017,202012,87,49,38,51205.5,39710,90915.5
520020,202012,18,10,8,10450,8360,18810
520025,202012,2355,1217,1138,1272810.5,1189210,2462020.5
520030,202012,809,430,379,450656.25,396055,846711.25
520050,202012,70,49,21,51205,21945,73150
520055,202012,56,35,21,36575,21945,58520
520060,202012,173,113,60,118085,62700,180785
520080,202012,585,423,162,442035.98,169290,611325.98
520082,202012,17,12,5,12540,5225,17765
520085,202012,91,67,24,70015,25080,95095
520090,202012,90,61,29,63745,30305,94050
520110,202012,9274,3956,5318,4136111,5560447.16,9696558.16
520120,202012,12,7,5,7315,5225,12540
520130,202012,804,556,248,581020,259160.5,840180.5
520140,202012,11956,6619,5337,6919993.54,5582391.7,12502385.24
520145,202012,54,32,22,33440,22990,56430
520150,202012,161,128,33,133760,34485,168245
520160,202012,41,30,11,31350,11495,42845
520170,202012,250,143,107,150480,111815,262295
520180,202012,170,80,90,83600,94050,177650
520215,202012,209,140,69,146300,72105,218405
520235,202012,81,64,17,66880,17765,84645
520250,202012,127,71,56,74195,58520,132715
520260,202012,114,73,41,76285,42845,119130
520280,202012,45,31,14,32395,14630,47025
520310,202012,39,26,13,27170,13585,40755
520320,202012,181,111,70,115995,73150,189145
520330,202012,796,422,374,440990,390830,831820
520340,202012,358,211,147,220495,153615,374110
520350,202012,512,241,271,251845,283195,535040
520355,202012,89,50,39,52250,40755,93005
520357,202012,25,18,7,18810,7315,26125
520360,202012,2,2,0,2090,0,2090
520380,202012,133,72,61,75240,63745,138985
520390,202012,259,109,150,113905.5,156750,270655.5
520393,202012,17,12,5,12540,5225,17765
520396,202012,75,48,27,50160,28215,78375
520400,202012,192,114,78,119130,81510,200640
520410,202012,198,95,103,99275,107635,206910
520420,202012,20,13,7,13585,7315,20900
520425,202012,285,142,143,148390,149435,297825
520430,202012,489,241,248,251941.14,259160.75,511101.89
520440,202012,699,504,195,526680,204820,731500
520450,202012,1986,847,1139,885115,1191300,2076415
520455,202012,60,33,27,34485,28215,62700
520460,202012,38,23,15,24035,15675,39710
520465,202012,32,27,5,28215,5225,33440
520470,202012,438,283,155,295735,161975,457710
520480,202012,77,45,32,47025,33440,80465
520485,202012,108,39,69,40755,72105,112860
520490,202012,412,306,106,319770,110770,430540
520495,202012,163,99,64,103455,66880,170335
520500,202012,184,145,39,151525,40755,192280
520505,202012,190,110,80,114950,83600,198550
520510,202012,1805,847,958,886160.5,1004248,1890408.5
520520,202012,44,30,14,31350,14630,45980
520530,202012,222,169,53,176605,55385,231990
520540,202012,589,397,192,414865,200640,615505
520545,202012,137,80,57,83600,59565,143165
520547,202012,60,33,27,34485,28215,62700
520549,202012,1212,560,652,585201.3,681340,1266541.3
520551,202012,307,165,142,173470,148390.5,321860.5
520552,202012,35,23,12,24035,12540,36575
520570,202012,15,9,6,9405,6270,15675
520580,202012,272,168,104,175560,108680,284240
520590,202012,144,87,57,90915,59565,150480
520620,202012,1130,526,604,550715.5,632225.25,1182940.75
520630,202012,41,24,17,26125,19855,45980
520640,202012,387,227,160,237215,167200,404415
520650,202012,66,36,30,37620,31350,68970
520660,202012,44,23,21,24035,21945,45980
520670,202012,37,31,6,32395,6270,38665
520680,202012,50,33,17,34485,17765,52250
520690,202012,41,11,30,11495,31350,42845
520710,202012,32,29,3,30305,3135,33440
520725,202012,205,150,55,156750,57475,214225
520735,202012,56,36,20,37620,20900,58520
520740,202012,427,206,221,215270,230945,446215
520750,202012,34,25,9,26125,9405,35530
520753,202012,67,46,21,48070,21945,70015
520760,202012,101,67,34,70015,35530,105545
520780,202012,282,206,76,215270,79420,294690
520790,202012,158,92,66,96140,68970,165110
520800,202012,3401,1832,1569,1915486,1641695.2,3557181.2
520810,202012,148,116,32,121220,33440,154660
520815,202012,5,4,1,4180,1045,5225
520830,202012,145,98,47,102410,49115,151525
520840,202012,351,230,121,240350,126445,366795
520850,202012,101,60,41,62700,42845,105545
520860,202012,1758,1131,627,1182940.5,655215.5,1838156.0
520870,202012,31664,14751,16913,15424209.47,17685588.33,33109797.80
520880,202012,1158,612,546,639540.5,570570.5,1210111.0
520890,202012,786,481,305,502645,318725,821370
520910,202012,975,518,457,542355.93,478610,1020965.93
520915,202012,95,73,22,76285,22990,99275
520920,202012,428,202,226,211090,237215,448305
520929,202012,18,16,2,16720,2090,18810
520940,202012,73,49,24,51205,25080,76285
520945,202012,16,11,5,11495,5225,16720
520960,202012,44,28,16,29260,16720,45980
520970,202012,346,207,139,216315.5,145255,361570.5
520980,202012,95,69,26,72105,27170,99275
520990,202012,451,310,141,323950,148390,472340
520993,202012,123,58,65,61655,67925,129580
520995,202012,246,138,108,144210.65,112860,257070.65
521000,202012,1559,898,661,938410.5,690745.5,1629156.0
521010,202012,684,338,346,353210,361570,714780
521015,202012,14,9,5,9405,5225,14630
521020,202012,1414,999,415,1043955,433675.5,1477630.5
521030,202012,57,38,19,39710,19855,59565
521040,202012,940,602,338,630135.25,353210.5,983345.75
521056,202012,51,34,17,35530,17765,53295
521060,202012,129,84,45,87780,47025,134805
521080,202012,407,313,94,328130,98230,426360
521090,202012,551,357,194,374110,202730,576840
521100,202012,271,203,68,212135,71060,283195
521120,202012,1055,744,311,778525.5,324995,1103520.5
521130,202012,352,251,101,262295,106590.5,368885.5
521140,202012,178,100,78,104500,81510,186010
521150,202012,2632,1140,1492,1192345.5,1560185,2752530.5
521160,202012,28,14,14,14630,14630,29260
521170,202012,219,122,97,127490,101365,228855
521180,202012,1173,748,425,781660.5,444125.25,1225785.75
521190,202012,2517,1059,1458,1107700.5,1523610.5,2631311.0
521200,202012,55,41,14,42845,14630,57475
521205,202012,11,8,3,8360,3135,11495
521210,202012,120,71,49,74195,52250,126445
521220,202012,755,527,228,550715,238260.25,788975.25
521225,202012,31,21,10,21945,10450,32395
521230,202012,107,70,37,73150,38665,111815
521250,202012,6174,3475,2699,3632425.05,2822548.03,6454973.08
521260,202012,30,14,16,14630,16720,31350
521270,202012,144,111,33,115995,34485,150480
521280,202012,425,261,164,272745,171380,444125
521290,202012,27,15,12,15675,12540,28215
521295,202012,97,63,34,65835,35530,101365
521300,202012,222,123,99,128535,103455.5,231990.5
521305,202012,36,25,11,26125,11495,37620
521308,202012,1050,808,242,844360,252890.5,1097250.5
521310,202012,1327,766,561,800470,586245,1386715
521340,202012,17,14,3,14630,3135,17765
521350,202012,123,93,30,97185,31350,128535
521370,202012,176,125,51,130625,53295,183920
521375,202012,176,92,84,96140,87780,183920
521377,202012,49,38,11,39710,11495,51205
521380,202012,1056,668,388,698061.05,406505,1104566.05
521385,202012,13,8,5,8360,5225,13585
521390,202012,100,81,19,85690,20900,106590
521400,202012,349,232,117,242440,122265,364705
521405,202012,146,80,66,83600,68970,152570
521410,202012,67,46,21,48070,21945,70015
521440,202012,196,141,55,147345,57475.5,204820.5
521450,202012,730,408,322,426360,336490,762850
521460,202012,1142,733,409,767030,428450,1195480
521470,202012,13,9,4,9405,4180,13585
521480,202012,42,29,13,30305,13585.25,43890.25
521483,202012,312,188,124,196460.5,129580,326040.5
521486,202012,282,183,99,191235,103455,294690
521487,202012,23,11,12,11495,12540,24035
521490,202012,23,12,11,12540,11495,24035
521500,202012,128,75,53,78375,55385,133760
521520,202012,46,32,14,33440,14630,48070
521523,202012,736,434,302,453530,315590,769120
521525,202012,47,29,18,30305,18810,49115
521530,202012,243,133,110,138985.5,114950,253935.5
521540,202012,33,16,17,16720,17765,34485
521550,202012,89,38,51,39710.5,53295,93005.5
521560,202012,815,556,259,581020.5,270655.75,851676.25
521565,202012,61,42,19,43890,19855,63745
521570,202012,526,352,174,367840.5,181830.25,549670.75
521580,202012,55,31,24,32395,25080,57475
521590,202012,37,17,20,17765,20900,38665
521600,202012,21,11,10,11495,10450,21945
521630,202012,249,135,114,141075,119130.25,260205.25
521640,202012,308,165,143,172425,149435,321860
521645,202012,33,17,16,17765,16720,34485
521680,202012,243,149,94,155705,98230,253935
521690,202012,2,2,0,2090,0,2090
521710,202012,1140,548,592,574750,618640,1193390
521720,202012,563,389,174,408595,181830.85,590425.85
521730,202012,659,314,345,329175.5,360525,689700.5
521740,202012,885,380,505,397100,527725.5,924825.5
521760,202012,1973,1023,950,1069035.95,993795.5,2062831.45
521770,202012,817,514,303,537130,317680,854810
521800,202012,1987,1284,703,1344916.5,734635,2079551.5
521805,202012,34,18,16,18810,16720,35530
521810,202012,83,53,30,55385,31350,86735
521830,202012,963,685,278,715825.09,291555.35,1007380.44
521839,202012,86,53,33,55385,34485,89870
521850,202012,1097,566,531,592516.61,554895.5,1147412.11
521860,202012,338,210,128,219450,133760,353210
521870,202012,72,44,28,45980,29260,75240
521878,202012,33,16,17,16720,17765,34485
521880,202012,4735,2104,2631,2199726.5,2751487.5,4951214.0
521890,202012,593,415,178,433675.3,186010,619685.3
521900,202012,283,229,54,239305,57475,296780
521910,202012,160,113,47,118085,49115,167200
521920,202012,45,23,22,24035,22990,47025
521925,202012,52,31,21,32395,21945,54340
521930,202012,1152,642,510,670890.5,533995,1204885.5
521935,202012,34,24,10,25080,10450,35530
521940,202012,204,98,106,102410,110770,213180
521945,202012,17,13,4,13585,4180,17765
521950,202012,9,5,4,5225,4180,9405
521960,202012,71,53,18,55385,18810,74195
521970,202012,404,255,149,266475,155705,422180
521971,202012,102,55,47,57475,49115,106590
521973,202012,34,17,17,17765,17765,35530
521975,202012,1455,718,737,751355.91,770166.47,1521522.38
521980,202012,243,167,76,174515,79420,253935
521990,202012,77,55,22,57475,22990,80465
522000,202012,294,188,106,196095.29,110770,306865.29
522005,202012,18,10,8,10450,8360,18810
522010,202012,1135,631,504,659395,526680,1186075
522015,202012,60,36,24,37620,25080,62700
522020,202012,889,512,377,536085,393965.5,930050.5
522026,202012,23,14,9,14630,9405,24035
522028,202012,15,11,4,11495,4180,15675
522040,202012,773,313,460,327085.25,480700,807785.25
522045,202012,2329,1418,911,1482856.25,953041.25,2435897.50
522050,202012,160,78,82,81510,85690,167200
522060,202012,537,333,204,347985,213180,561165
522068,202012,108,76,32,80465,33440,113905
522070,202012,11,10,1,10450,1045,11495
522100,202012,37,21,16,21945,16720,38665
522108,202012,42,31,11,32395,11495,43890
522119,202012,55,30,25,31350,26125,57475
522130,202012,76,29,47,30305,49115,79420
522140,202012,4040,2065,1975,2157925.6,2065965.5,4223891.1
522145,202012,49,35,14,36575,14630,51205
522150,202012,96,68,28,71060,29260,100320
522155,202012,56,39,17,40755.5,17765,58520.5
522157,202012,7,3,4,3135,4180,7315
522160,202012,1694,998,696,1043955,728365,1772320
522170,202012,403,272,131,284240,136895,421135
522180,202012,36,17,19,17765,19855,37620
522185,202012,2086,826,1260,863171,1316700,2179871
522190,202012,52,27,25,28215,26125,54340
522200,202012,301,179,122,187055,127490,314545
522205,202012,139,93,46,97185,48070,145255
522220,202012,146,107,39,111815,40755,152570
522230,202012,33,24,9,25080,9405,34485
530010,202012,53913,27164,26749,28413983.27,27978947.8,56392931.07
